city,state,outbound,inbound,netgain,pct_inbound
29 PALMS,CA,1861,1447,-414,0.43742442563482464
6609 GAZEBO DR,MO,52,51,-1,0.49514563106796117
7185 WEST CREEK ROAD,NY,15,0,-15,0
AARONSBURG,PA,67,13,-54,0.1625
ABBEVILLE,AL,2118,2226,108,0.5124309392265194
ABBEVILLE,GA,544,578,34,0.5151515151515151
ABBEVILLE,LA,8010,7492,-518,0.48329247838988515
ABBEVILLE,MS,342,318,-24,0.4818181818181818
ABBEVILLE,SC,3213,3329,116,0.5088657902782023
ABBOT,ME,205,247,42,0.5464601769911505
ABBOTSFORD,WI,1272,1128,-144,0.47
ABBOTT,TX,34,88,54,0.7213114754098361
ABBOTTSTOWN,PA,1290,1406,116,0.521513353115727
ABBYVILLE,KS,15,11,-4,0.4230769230769231
ABER PROV GRD,MD,373,301,-72,0.4465875370919881
ABERDEEN,ID,747,599,-148,0.4450222882615156
ABERDEEN,MD,10850,11810,960,0.5211827007943513
ABERDEEN,MS,2585,2635,50,0.5047892720306514
ABERDEEN,NC,5807,6394,587,0.524055405294648
ABERDEEN,NJ,1125,1109,-16,0.4964189794091316
ABERDEEN,OH,1152,1011,-141,0.46740638002773927
ABERDEEN,SD,18406,14353,-4053,0.43813913733630455
ABERDEEN,WA,10874,9240,-1634,0.4593815253057572
ABERDEEN PROVING GROUND,MD,1486,1268,-218,0.46042120551924476
ABERNATHY,TX,798,799,1,0.5003130870381967
ABIE,NE,29,24,-5,0.4528301886792453
ABILENE,KS,4877,4229,-648,0.4644190643531737
ABILENE,TX,65689,56821,-8868,0.46380703616031344
ABINGDON,IL,1733,1460,-273,0.4572502348888193
ABINGDON,MD,11885,11110,-775,0.4831485105457708
ABINGDON,VA,8638,8755,117,0.5033634220663485
ABINGTON,MA,5144,5200,56,0.502706883217324
ABINGTON,PA,3869,3567,-302,0.4796933835395374
ABIQUIU,NM,262,213,-49,0.44842105263157894
ABITA SPRINGS,LA,2209,2532,323,0.5340645433452859
ABQ,NM,370,374,4,0.5026881720430108
ABRAMS,WI,553,687,134,0.5540322580645162
ABSAROKEE,MT,895,575,-320,0.391156462585034
ABSECON,NJ,4387,4518,131,0.5073554183043234
ACAMPO,CA,1724,1772,48,0.5068649885583524
ACCIDENT,MD,440,360,-80,0.45
ACCOKEEK,MD,3280,3919,639,0.5443811640505626
ACCOMAC,VA,303,320,17,0.5136436597110754
ACCORD,MA,11,11,0,0.5
ACCORD,NY,1378,1696,318,0.5517241379310345
ACKERMAN,MS,1111,1042,-69,0.4839758476544357
ACKLEY,IA,967,683,-284,0.41393939393939394
ACKWORTH,IA,0,24,24,1
ACME,MI,494,415,-79,0.45654565456545654
ACME,PA,651,602,-49,0.48044692737430167
ACME,WA,25,22,-3,0.46808510638297873
ACOMA,NM,0,12,12,1
ACRA,NY,73,35,-38,0.32407407407407407
ACTON,CA,2682,2774,92,0.5084310850439883
ACTON,MA,8020,7828,-192,0.4939424533064109
ACTON,ME,1135,1425,290,0.556640625
ACUSHNET,MA,2476,2601,125,0.5123104195390978
ACWORTH,GA,36231,37298,1067,0.5072556406315876
ACWORTH,NH,11,78,67,0.8764044943820225
ADA,MI,5424,5785,361,0.516103131412258
ADA,MN,809,698,-111,0.46317186463171867
ADA,OH,2858,2191,-667,0.43394731630025746
ADA,OK,13178,12478,-700,0.48635796694730277
ADAH,PA,17,12,-5,0.41379310344827586
ADAIR,IA,314,301,-13,0.4894308943089431
ADAIR,IL,24,0,-24,0
ADAIR,OK,1051,926,-125,0.4683864441072332
ADAIRSVILLE,GA,5266,5834,568,0.5255855855855855
ADAIRVILLE,KY,558,424,-134,0.4317718940936864
ADAMANT,VT,13,0,-13,0
ADAMS,MA,3782,3316,-466,0.4671738517892364
ADAMS,MN,325,219,-106,0.4025735294117647
ADAMS,ND,11,0,-11,0
ADAMS,NE,158,184,26,0.5380116959064327
ADAMS,NY,2033,1699,-334,0.4552518756698821
ADAMS,OR,59,27,-32,0.313953488372093
ADAMS,TN,1491,1718,227,0.5353692739171081
ADAMS,WI,1819,1651,-168,0.47579250720461097
ADAMS CENTER,NY,1092,901,-191,0.4520822880080281
ADAMS COUNTY,OH,37,38,1,0.5066666666666667
ADAMS RUN,SC,171,214,43,0.5558441558441558
ADAMSBURG,PA,0,11,11,1
ADAMSTOWN,MD,879,1065,186,0.5478395061728395
ADAMSTOWN,PA,413,198,-215,0.32405891980360063
ADAMSVILLE,AL,2385,2244,-141,0.4847699287103046
ADAMSVILLE,OH,26,44,18,0.6285714285714286
ADAMSVILLE,RI,0,12,12,1
ADAMSVILLE,TN,2245,2477,232,0.524565861922914
ADDIEVILLE,IL,0,11,11,1
ADDIS,LA,2100,2515,415,0.5449620801733478
ADDISON,AL,487,474,-13,0.49323621227887615
ADDISON,IL,11590,10478,-1112,0.474805147725213
ADDISON,ME,567,563,-4,0.4982300884955752
ADDISON,MI,992,839,-153,0.4582195521572911
ADDISON,NY,2147,1940,-207,0.4746758013212625
ADDISON,PA,109,24,-85,0.18045112781954886
ADDISON,TX,20204,18488,-1716,0.4778248733588339
ADDISON TOWNSHIP,MI,74,76,2,0.5066666666666667
ADDISON TWP,MI,45,25,-20,0.35714285714285715
ADDY,WA,517,558,41,0.5190697674418605
ADDYSTON,OH,201,122,-79,0.37770897832817335
ADEL,GA,4030,4137,107,0.5065507530304886
ADEL,IA,3179,3527,348,0.5259469132120489
ADELANTO,CA,12516,11845,-671,0.48622798735684086
ADELL,WI,431,202,-229,0.31911532385466035
ADELPHI,MD,3092,2153,-939,0.41048617731172543
ADELPHI,OH,0,11,11,1
ADELPHIA,NJ,0,12,12,1
ADENA,OH,229,241,12,0.5127659574468085
ADGER,AL,770,747,-23,0.4924192485168095
ADIRONDACK,NY,478,373,-105,0.4383078730904818
ADKINS,TX,1923,2575,652,0.5724766562916852
ADOLPHUS,KY,1018,848,-170,0.45444801714898175
ADONA,AR,25,12,-13,0.32432432432432434
ADRIAN,GA,542,633,91,0.5387234042553192
ADRIAN,MI,16985,14663,-2322,0.4633152173913043
ADRIAN,MN,445,264,-181,0.3723554301833568
ADRIAN,MO,1162,1198,36,0.5076271186440678
ADRIAN,OR,11,42,31,0.7924528301886793
ADRIAN,PA,74,55,-19,0.4263565891472868
ADVANCE,IN,0,12,12,1
ADVANCE,MO,1419,1190,-229,0.45611345343043314
ADVANCE,NC,3514,4636,1122,0.5688343558282208
AFFTON,MO,573,610,37,0.5156382079459002
AFTON,IA,555,421,-134,0.43135245901639346
AFTON,MI,132,77,-55,0.3684210526315789
AFTON,MN,925,939,14,0.503755364806867
AFTON,NY,1156,1105,-51,0.48872180451127817
AFTON,OK,2884,2656,-228,0.47942238267148013
AFTON,TN,1308,1490,182,0.5325232308791994
AFTON,VA,989,1099,110,0.5263409961685823
AFTON,WY,1621,1627,6,0.5009236453201971
AGATE,CO,0,11,11,1
AGAWAM,MA,6411,6504,93,0.5036004645760743
AGENCY,IA,224,135,-89,0.37604456824512533
AGENCY,MO,142,140,-2,0.49645390070921985
AGOURA,CA,173,248,75,0.5890736342042755
AGOURA HILLS,CA,8174,8950,776,0.5226582574164915
AGRA,OK,177,201,24,0.5317460317460317
AGUA DULCE,CA,844,873,29,0.5084449621432732
AGUA DULCE,TX,0,20,20,1
AGUANGA,CA,1788,1723,-65,0.49074337795499856
AGUILA,AZ,283,362,79,0.5612403100775194
AGUILAR,CO,239,277,38,0.5368217054263565
AHMEEK,MI,24,0,-24,0
AHOSKIE,NC,3212,2787,-425,0.46457742957159526
AHWAHNEE,CA,532,507,-25,0.4879692011549567
AIEA,HI,13320,11870,-1450,0.47121873759428345
AIKEN,SC,27529,30001,2472,0.5214844428993568
AILEY,GA,94,205,111,0.68561872909699
AINSWORTH,IA,235,197,-38,0.45601851851851855
AINSWORTH,NE,1214,1083,-131,0.4714845450587723
AIRMONT,NY,2537,1895,-642,0.427572202166065
AIRVILLE,PA,678,670,-8,0.4970326409495549
AIRWAY HEIGHTS,WA,4778,4596,-182,0.4902922978451035
AITKIN,MN,5293,4750,-543,0.47296624514587277
AJO,AZ,3167,3295,128,0.5099040544722996
AKELEY,MN,833,822,-11,0.49667673716012084
AKRON,AL,80,119,39,0.5979899497487438
AKRON,CO,1391,1093,-298,0.44001610305958133
AKRON,IA,812,752,-60,0.48081841432225064
AKRON,IN,937,747,-190,0.44358669833729214
AKRON,MI,363,391,28,0.5185676392572944
AKRON,NY,3423,3522,99,0.5071274298056155
AKRON,OH,102976,93712,-9264,0.47645001220206623
AKRON,PA,1866,1557,-309,0.4548641542506573
AKWESASNE,NY,56,55,-1,0.4954954954954955
ALABASTER,AL,8830,8840,10,0.5002829654782116
ALABASTER,MI,39,85,46,0.6854838709677419
ALACHUA,FL,5667,6684,1017,0.5411707554044207
ALAFAYA,FL,356,318,-38,0.47181008902077154
ALAMANCE,NC,12,0,-12,0
ALAMEDA,CA,31809,29668,-2141,0.48258698375002035
ALAMEDA,NM,0,13,13,1
ALAMO,CA,3836,4822,986,0.5569415569415569
ALAMO,GA,333,402,69,0.5469387755102041
ALAMO,NM,12,13,1,0.52
ALAMO,NV,38,41,3,0.5189873417721519
ALAMO,TN,1805,1601,-204,0.47005284791544333
ALAMO,TX,6554,10213,3659,0.6091131389037991
ALAMOGORDO,NM,18728,17974,-754,0.48972808021361236
ALAMOSA,CO,7434,6792,-642,0.47743568114719526
ALANSON,MI,2329,2305,-24,0.4974104445403539
ALAPAHA,GA,277,362,85,0.5665101721439749
ALBA,MO,0,26,26,1
ALBA,TX,1759,2093,334,0.5433541017653167
ALBANY,CA,9467,8203,-1264,0.4642331635540464
ALBANY,GA,38568,36525,-2043,0.4863968678838241
ALBANY,IL,102,103,1,0.5024390243902439
ALBANY,IN,1417,1399,-18,0.4968039772727273
ALBANY,KY,2933,2992,59,0.5049789029535865
ALBANY,LA,1690,1681,-9,0.49866508454464553
ALBANY,MN,1266,1304,38,0.5073929961089494
ALBANY,MO,1037,1007,-30,0.4926614481409002
ALBANY,NH,260,244,-16,0.48412698412698413
ALBANY,NY,71375,61761,-9614,0.4638940632135561
ALBANY,OH,1603,1543,-60,0.49046408137317227
ALBANY,OR,28545,29573,1028,0.5088440758456932
ALBANY,TX,708,562,-146,0.44251968503937006
ALBANY,WI,793,855,62,0.5188106796116505
ALBANY TWP,ME,75,76,1,0.5033112582781457
ALBEMARLE,NC,8462,8995,533,0.5152660823738329
ALBERS,IL,176,88,-88,0.3333333333333333
ALBERT CITY,IA,129,102,-27,0.44155844155844154
ALBERT LEA,MN,10650,9355,-1295,0.46763309172706824
ALBERTA,AL,11,12,1,0.5217391304347826
ALBERTA,VA,126,166,40,0.5684931506849316
ALBERTON,MT,617,724,107,0.5398956002982849
ALBERTSON,NC,74,137,63,0.6492890995260664
ALBERTSON,NY,1732,1686,-46,0.49327091866588646
ALBERTVILLE,AL,9279,8965,-314,0.4913944310458233
ALBERTVILLE,MN,3129,3369,240,0.5184672206832872
ALBIA,IA,2320,2355,35,0.5037433155080214
ALBIN,WY,23,0,-23,0
ALBION,CA,63,49,-14,0.4375
ALBION,IA,29,24,-5,0.4528301886792453
ALBION,ID,14,0,-14,0
ALBION,IL,1468,1177,-291,0.4449905482041588
ALBION,IN,2811,2645,-166,0.4847873900293255
ALBION,ME,711,559,-152,0.4401574803149606
ALBION,MI,5181,4806,-375,0.48122559327125264
ALBION,NE,1112,979,-133,0.4681970349115256
ALBION,NY,4764,4207,-557,0.4689555233530264
ALBION,PA,1330,1222,-108,0.4788401253918495
ALBION,RI,225,174,-51,0.43609022556390975
ALBION,WA,106,13,-93,0.1092436974789916
ALBRIGHT,WV,318,198,-120,0.38372093023255816
ALBRIGHTSVILLE,PA,3362,2920,-442,0.46482012098057945
ALBRIGHTSVLLE,PA,159,160,1,0.5015673981191222
ALBUQUERQUE,NM,278734,263777,-14957,0.48621502605477124
ALBURG,VT,66,75,9,0.5319148936170213
ALBURGH,VT,1332,1158,-174,0.4650602409638554
ALBURNETT,IA,150,109,-41,0.42084942084942084
ALBURTIS,PA,1732,1572,-160,0.47578692493946734
ALCALDE,NM,14,42,28,0.75
ALCESTER,SD,512,379,-133,0.42536475869809204
ALCOA,TN,3511,3767,256,0.5175872492442979
ALCOLU,SC,170,312,142,0.6473029045643154
ALCOVA,WY,11,41,30,0.7884615384615384
ALDA,NE,448,208,-240,0.3170731707317073
ALDAN,PA,1248,716,-532,0.3645621181262729
ALDEN,IA,527,372,-155,0.41379310344827586
ALDEN,MI,938,513,-425,0.35354927636113026
ALDEN,MN,131,171,40,0.5662251655629139
ALDEN,NY,2883,2803,-80,0.49296517762926484
ALDERSON,WV,1205,1257,52,0.5105605199025183
ALDIE,VA,7672,11323,3651,0.5961042379573572
ALDRICH,MO,46,49,3,0.5157894736842106
ALEDO,IL,2225,1845,-380,0.4533169533169533
ALEDO,TX,6020,9567,3547,0.6137807146981459
ALEX,OH,18,13,-5,0.41935483870967744
ALEX,OK,33,35,2,0.5147058823529411
ALEX BAY,NY,80,36,-44,0.3103448275862069
ALEX CITY,AL,89,33,-56,0.27049180327868855
ALEXANDER,AR,5825,6809,984,0.5389425360139307
ALEXANDER,IA,11,0,-11,0
ALEXANDER,ME,258,216,-42,0.45569620253164556
ALEXANDER,NC,1245,1331,86,0.5166925465838509
ALEXANDER,ND,404,267,-137,0.3979135618479881
ALEXANDER,NY,460,397,-63,0.4632438739789965
ALEXANDER CITY,AL,7558,6402,-1156,0.45859598853868194
ALEXANDRIA,AL,1210,1298,88,0.5175438596491229
ALEXANDRIA,IN,4460,3947,-513,0.4694897109551564
ALEXANDRIA,KY,5090,6114,1024,0.5456979650124956
ALEXANDRIA,LA,24762,22528,-2234,0.47637978430957917
ALEXANDRIA,MN,14887,13655,-1232,0.47841777030341254
ALEXANDRIA,MO,38,11,-27,0.22448979591836735
ALEXANDRIA,NH,454,456,2,0.5010989010989011
ALEXANDRIA,OH,509,633,124,0.5542907180385289
ALEXANDRIA,PA,583,425,-158,0.42162698412698413
ALEXANDRIA,SD,11,12,1,0.5217391304347826
ALEXANDRIA,TN,793,926,133,0.5386852821407795
ALEXANDRIA,VA,208718,189001,-19717,0.4752123987036073
ALEXANDRIA BAY,NY,2119,1682,-437,0.44251512759800055
ALEXIS,IL,432,277,-155,0.3906911142454161
ALEXIS,NC,16,120,104,0.8823529411764706
ALFORD,FL,1027,1158,131,0.5299771167048055
ALFORD,MA,14,0,-14,0
ALFRED,ME,466,704,238,0.6017094017094017
ALFRED,NY,643,267,-376,0.2934065934065934
ALFRED STA,NY,16,0,-16,0
ALFRED STATION,NY,355,277,-78,0.43829113924050633
ALGER,MI,1480,1481,1,0.5001688618709895
ALGER,OH,753,482,-271,0.3902834008097166
ALGODONES,NM,12,24,12,0.6666666666666666
ALGOMA,WI,2209,2006,-203,0.4759193357058126
ALGONA,IA,4001,3457,-544,0.4635290962724591
ALGONA,WA,533,494,-39,0.4810126582278481
ALGONAC,MI,2604,2171,-433,0.45465968586387434
ALGONQUIN,IL,10186,10462,276,0.5066834560247966
ALHAMBRA,CA,28597,24619,-3978,0.4626240228502706
ALHAMBRA,IL,174,154,-20,0.4695121951219512
ALICE,TX,8041,7143,-898,0.4704293993677555
ALICEVILLE,AL,1127,1108,-19,0.49574944071588367
ALICIA,AR,0,13,13,1
ALIEF,TX,171,469,298,0.7328125
ALINE,OK,0,11,11,1
ALIQUIPPA,PA,10342,9722,-620,0.4845494417862839
ALISO VIEJO,CA,19975,19644,-331,0.4958227113253742
ALKOL,WV,24,36,12,0.6
ALLAGASH,ME,22,13,-9,0.37142857142857144
ALLARDT,TN,136,169,33,0.5540983606557377
ALLEGAN,MI,7857,7290,-567,0.48128342245989303
ALLEGANY,NY,2127,2009,-118,0.4857350096711799
ALLEN,KS,12,0,-12,0
ALLEN,KY,504,129,-375,0.2037914691943128
ALLEN,MI,290,305,15,0.5126050420168067
ALLEN,NE,25,11,-14,0.3055555555555556
ALLEN,OK,456,507,51,0.5264797507788161
ALLEN,SD,30,0,-30,0
ALLEN,TX,39030,46385,7355,0.5430544986243634
ALLEN PARK,MI,8044,7489,-555,0.4821348097598661
ALLENDALE,IL,50,23,-27,0.3150684931506849
ALLENDALE,MI,11421,6954,-4467,0.3784489795918367
ALLENDALE,NJ,1576,1899,323,0.5464748201438849
ALLENDALE,SC,1326,1231,-95,0.4814235432147047
ALLENHURST,GA,2434,2325,-109,0.48854801428871614
ALLENHURST,NJ,648,620,-28,0.4889589905362776
ALLENPORT,PA,0,12,12,1
ALLENSPARK,CO,242,252,10,0.5101214574898786
ALLENSTOWN,NH,1566,1514,-52,0.4915584415584416
ALLENSVILLE,KY,12,0,-12,0
ALLENTON,MI,438,511,73,0.5384615384615384
ALLENTON,WI,744,644,-100,0.46397694524495675
ALLENTOWN,NJ,1383,1539,156,0.526694045174538
ALLENTOWN,NY,0,11,11,1
ALLENTOWN,PA,80927,73381,-7546,0.4755489021956088
ALLENVILLE,IL,63,45,-18,0.4166666666666667
ALLENWOOD,NJ,89,198,109,0.6898954703832753
ALLENWOOD,PA,307,186,-121,0.3772819472616633
ALLERTON,IA,82,89,7,0.52046783625731
ALLERTON,IL,24,0,-24,0
ALLEYTON,TX,24,52,28,0.6842105263157895
ALLIANCE,NE,4786,4111,-675,0.46206586489828033
ALLIANCE,OH,14531,12186,-2345,0.45611408466519443
ALLIGATOR POINT,FL,177,253,76,0.5883720930232558
ALLISON,IA,425,408,-17,0.4897959183673469
ALLISON,PA,15,11,-4,0.4230769230769231
ALLISON PARK,PA,6290,6695,405,0.5155949172121679
ALLISONIA,VA,28,11,-17,0.28205128205128205
ALLONS,TN,207,406,199,0.6623164763458401
ALLOUEZ,MI,13,0,-13,0
ALLOWAY,NJ,155,13,-142,0.07738095238095238
ALLSTON,MA,17620,10577,-7043,0.37511082739298507
ALLYN,WA,2045,1956,-89,0.4888777805548613
ALMA,AR,5619,5788,169,0.507407732094328
ALMA,CO,532,125,-407,0.1902587519025875
ALMA,GA,3644,3463,-181,0.48726607570001407
ALMA,IL,26,27,1,0.5094339622641509
ALMA,KS,325,330,5,0.5038167938931297
ALMA,MI,6140,5063,-1077,0.4519325180755155
ALMA,MO,0,11,11,1
ALMA,NE,292,275,-17,0.48500881834215165
ALMA,WI,696,565,-131,0.44805709754163364
ALMA,WV,36,0,-36,0
ALMA CENTER,WI,271,150,-121,0.35629453681710216
ALMENA,KS,48,44,-4,0.4782608695652174
ALMENA,WI,684,623,-61,0.47666411629686306
ALMO,KY,626,609,-17,0.4931174089068826
ALMOND,NC,39,62,23,0.6138613861386139
ALMOND,NY,260,269,9,0.5085066162570888
ALMOND,WI,692,564,-128,0.44904458598726116
ALMONT,CO,331,407,76,0.551490514905149
ALMONT,MI,1799,1815,16,0.5022136137244051
ALNA,ME,60,84,24,0.5833333333333334
ALOHA,OR,5560,5086,-474,0.4777381176028555
ALORTON,IL,108,62,-46,0.36470588235294116
ALPAUGH,CA,11,0,-11,0
ALPENA,AR,460,515,55,0.5282051282051282
ALPENA,AZ,12,19,7,0.6129032258064516
ALPENA,MI,11585,9439,-2146,0.4489630898021309
ALPENA,SD,0,23,23,1
ALPHA,IL,201,122,-79,0.37770897832817335
ALPHA,MI,12,0,-12,0
ALPHARETTA,GA,71507,76895,5388,0.5181533941591083
ALPINE,AL,698,886,188,0.5593434343434344
ALPINE,AZ,617,715,98,0.5367867867867868
ALPINE,CA,8711,7181,-1530,0.4518625723634533
ALPINE,NJ,572,636,64,0.5264900662251656
ALPINE,NY,192,201,9,0.5114503816793893
ALPINE,TN,12,11,-1,0.4782608695652174
ALPINE,TX,3529,3140,-389,0.47083520767731296
ALPINE,UT,2318,2556,238,0.5244152646696758
ALPINE,WY,1152,1144,-8,0.49825783972125437
ALPINE MDWS,CA,18,23,5,0.5609756097560976
ALPINE MEADOWS,CA,85,102,17,0.5454545454545454
ALSEA,OR,153,221,68,0.5909090909090909
ALSIP,IL,5221,4545,-676,0.4653901290190457
ALSTEAD,NH,846,868,22,0.5064177362893816
ALTA,CA,150,125,-25,0.45454545454545453
ALTA,IA,1119,924,-195,0.4522760646108664
ALTA,WY,38,61,23,0.6161616161616161
ALTA LOMA,CA,3728,3606,-122,0.49168257431142626
ALTA VISTA,IA,0,12,12,1
ALTA VISTA,KS,141,82,-59,0.36771300448430494
ALTADENA,CA,8907,9105,198,0.5054963357761493
ALTAMONT,IL,1404,1408,4,0.5007112375533428
ALTAMONT,KS,457,404,-53,0.4692218350754936
ALTAMONT,MO,22,23,1,0.5111111111111111
ALTAMONT,NY,2684,2857,173,0.5156109005594658
ALTAMONT,SD,11,11,0,0.5
ALTAMONT,TN,435,641,206,0.595724907063197
ALTAMONT,UT,12,33,21,0.7333333333333333
ALTAMONTE SPG,FL,651,554,-97,0.4597510373443983
ALTAMONTE SPRINGS,FL,47801,40383,-7418,0.4579402159121836
ALTAVILLE,CA,145,80,-65,0.35555555555555557
ALTAVISTA,VA,1813,1789,-24,0.4966685174902832
ALTHA,FL,1446,1497,51,0.508664627930683
ALTHEIMER,AR,36,11,-25,0.23404255319148937
ALTMAR,NY,1100,845,-255,0.43444730077120824
ALTO,GA,2481,1943,-538,0.4391952983725136
ALTO,MI,2076,2221,145,0.5168722364440307
ALTO,NM,2861,2345,-516,0.4504417979254706
ALTO,TX,984,1063,79,0.5192965315095261
ALTO PASS,IL,120,36,-84,0.23076923076923078
ALTON,IA,304,282,-22,0.4812286689419795
ALTON,IL,13769,11963,-1806,0.4649075081610446
ALTON,ME,277,167,-110,0.3761261261261261
ALTON,MO,1488,1430,-58,0.4900616860863605
ALTON,NH,1743,1859,116,0.5161021654636313
ALTON,TX,1306,1514,208,0.5368794326241135
ALTON,VA,345,317,-28,0.4788519637462236
ALTON BAY,NH,1405,1495,90,0.5155172413793103
ALTONA,IL,27,0,-27,0
ALTONA,NY,507,378,-129,0.4271186440677966
ALTOONA,AL,2022,2138,116,0.5139423076923076
ALTOONA,FL,1867,2038,171,0.5218950064020487
ALTOONA,IA,9662,10506,844,0.5209242364141213
ALTOONA,KS,93,76,-17,0.44970414201183434
ALTOONA,PA,22398,20784,-1614,0.48131165763512573
ALTOONA,WI,4891,4955,64,0.5032500507820434
ALTURA,MN,106,124,18,0.5391304347826087
ALTURAS,CA,2541,2564,23,0.5022526934378061
ALTUS,AR,825,622,-203,0.42985487214927437
ALTUS,OK,9525,8741,-784,0.4785393627504653
ALUM BANK,PA,108,159,51,0.5955056179775281
ALUM CREEK,WV,313,277,-36,0.4694915254237288
ALVA,FL,3929,5409,1480,0.5792460912400942
ALVA,OK,3254,2269,-985,0.4108274488502625
ALVADA,OH,11,24,13,0.6857142857142857
ALVARADO,TX,6234,7529,1295,0.5470464288309235
ALVATON,KY,1345,1911,566,0.586916461916462
ALVIN,IL,11,0,-11,0
ALVIN,TX,15036,16157,1121,0.5179687750456833
ALVIN,WI,0,16,16,1
ALVISO,CA,359,284,-75,0.4416796267496112
ALVORD,TX,1332,1636,304,0.5512129380053908
ALVORDTON,OH,42,26,-16,0.38235294117647056
ALYS BEACH,FL,64,55,-9,0.46218487394957986
AMA,LA,15,104,89,0.8739495798319328
AMADO,AZ,331,333,2,0.5015060240963856
AMAGANSETT,NY,1694,1759,65,0.5094121054155807
AMAGON,AR,18,11,-7,0.3793103448275862
AMANA,IA,511,491,-20,0.49001996007984033
AMANDA,OH,1476,1332,-144,0.47435897435897434
AMARGOSA VALLEY,NV,758,664,-94,0.4669479606188467
AMARILLO,TX,94640,87730,-6910,0.4810549980808247
AMASA,MI,11,0,-11,0
AMAWALK,NY,48,105,57,0.6862745098039216
AMAZONIA,MO,48,26,-22,0.35135135135135137
AMBER,OK,314,54,-260,0.14673913043478262
AMBERG,WI,215,150,-65,0.410958904109589
AMBERLEY,OH,195,204,9,0.5112781954887218
AMBIA,IN,23,0,-23,0
AMBLER,PA,8130,8841,711,0.520947498674209
AMBOY,IL,1715,1419,-296,0.45277600510529675
AMBOY,IN,160,154,-6,0.49044585987261147
AMBOY,MN,154,90,-64,0.36885245901639346
AMBOY,WA,1234,1348,114,0.5220759101471727
AMBRIDGE,PA,6050,4457,-1593,0.42419339487960406
AMBROSE,GA,150,157,7,0.511400651465798
AMELIA,LA,27,27,0,0.5
AMELIA,OH,9971,9783,-188,0.4952414700820087
AMELIA COURT HOUSE,VA,2710,3007,297,0.5259751617981459
AMELIA CT HSE,VA,49,56,7,0.5333333333333333
AMELIA ISLAND,FL,332,419,87,0.5579227696404794
AMENIA,NY,717,775,58,0.5194369973190348
AMERICAN CANYON,CA,4685,4699,14,0.5007459505541347
AMERICAN CYN,CA,251,238,-13,0.4867075664621677
AMERICAN FALLS,ID,2262,1740,-522,0.43478260869565216
AMERICAN FLS,ID,264,163,-101,0.38173302107728335
AMERICAN FORK,UT,10489,12427,1938,0.5422848664688428
AMERICUS,GA,8083,7176,-907,0.470279834851563
AMERICUS,KS,148,135,-13,0.47703180212014135
AMERY,WI,3677,3592,-85,0.4941532535424405
AMES,IA,44926,33401,-11525,0.4264302220179504
AMES,NE,0,12,12,1
AMESBURY,MA,7438,6823,-615,0.478437697216184
AMESVILLE,OH,48,63,15,0.5675675675675675
AMHERST,MA,13889,10110,-3779,0.42126755281470063
AMHERST,NE,27,0,-27,0
AMHERST,NH,3708,4073,365,0.5234545688214882
AMHERST,NY,8100,7374,-726,0.4765412950756107
AMHERST,OH,5941,6540,599,0.523996474641455
AMHERST,TX,0,24,24,1
AMHERST,VA,2457,2683,226,0.5219844357976654
AMHERST,WI,1047,1076,29,0.5068299576071597
AMHERST JCT,WI,14,43,29,0.7543859649122807
AMHERST JUNCTION,WI,101,145,44,0.5894308943089431
AMHERSTDALE,WV,14,16,2,0.5333333333333333
AMISSVILLE,VA,1322,1486,164,0.5292022792022792
AMITE,LA,2522,2813,291,0.5272727272727272
AMITY,AR,1087,1182,95,0.5209343323049802
AMITY,ME,14,49,35,0.7777777777777778
AMITY,OR,1569,1571,2,0.5003184713375797
AMITY,PA,23,25,2,0.5208333333333334
AMITYVILLE,NY,9587,8371,-1216,0.46614322307606637
AMMON,ID,6589,6664,75,0.5028295480268619
AMO,IN,11,0,-11,0
AMORY,MS,3626,3763,137,0.5092705372851536
AMSTERDAM,MO,13,0,-13,0
AMSTERDAM,NY,12917,11966,-951,0.48089056785757345
AMSTERDAM,OH,244,270,26,0.5252918287937743
AMSTON,CT,943,1121,178,0.5431201550387597
ANACOCO,LA,1293,1343,50,0.5094840667678301
ANACONDA,MT,4447,4280,-167,0.4904319926664375
ANACORTES,WA,11550,12280,730,0.5153168275283256
ANADARKO,OK,2499,2420,-79,0.4919699125838585
ANAHEIM,CA,114798,101797,-13001,0.46998776518386853
ANAHOLA,HI,759,319,-440,0.29591836734693877
ANAHUAC,TX,1231,1217,-14,0.497140522875817
ANAMOOSE,ND,11,0,-11,0
ANAMOSA,IA,3388,3172,-216,0.48353658536585364
ANATONE,WA,11,0,-11,0
ANC,AK,34,42,8,0.5526315789473685
ANCHO,NM,11,0,-11,0
ANCHOR POINT,AK,1344,940,-404,0.4115586690017513
ANCHORAGE,AK,118374,105877,-12497,0.4721361331722044
ANCHORAGE,KY,255,256,1,0.5009784735812133
ANCRAM,NY,157,388,231,0.7119266055045872
ANCRAMDALE,NY,23,255,232,0.9172661870503597
ANDALE,KS,250,284,34,0.5318352059925093
ANDALUSIA,AL,7969,7353,-616,0.4798981856154549
ANDALUSIA,IL,187,143,-44,0.43333333333333335
ANDALUUA,AL,45,57,12,0.5588235294117647
ANDERSON,AL,408,275,-133,0.40263543191800877
ANDERSON,CA,10581,9492,-1089,0.4728740098639964
ANDERSON,IN,39024,34465,-4559,0.4689817523711032
ANDERSON,MO,2307,2082,-225,0.47436773752563227
ANDERSON,OH,829,852,23,0.5068411659726353
ANDERSON,SC,34890,36410,1520,0.5106591865357644
ANDERSON,TX,769,1059,290,0.5793216630196937
ANDERSON IS,WA,33,11,-22,0.25
ANDERSON ISLAND,WA,686,783,97,0.5330156569094622
ANDERSON TOWNSHIP,OH,656,584,-72,0.47096774193548385
ANDERSONVILLE,GA,35,36,1,0.5070422535211268
ANDERSONVILLE,TN,1420,1585,165,0.5274542429284526
ANDES,NY,623,560,-63,0.47337278106508873
ANDOVER,CT,910,1000,90,0.5235602094240838
ANDOVER,KS,7194,6768,-426,0.48474430597335627
ANDOVER,MA,11205,12095,890,0.519098712446352
ANDOVER,ME,169,139,-30,0.4512987012987013
ANDOVER,MN,12304,13103,799,0.5157240130672649
ANDOVER,NH,807,867,60,0.517921146953405
ANDOVER,NJ,1314,1325,11,0.5020841227737779
ANDOVER,NY,690,619,-71,0.47288006111535524
ANDOVER,OH,2165,1999,-166,0.48006724303554277
ANDREAS,PA,80,100,20,0.5555555555555556
ANDREW,IA,53,13,-40,0.19696969696969696
ANDREWS,IN,813,703,-110,0.4637203166226913
ANDREWS,NC,2080,2079,-1,0.49987977879297907
ANDREWS,SC,2063,2125,62,0.5074021012416428
ANDREWS,TX,6435,4831,-1604,0.4288123557606959
ANDREWS AIR FORCE BASE,MD,81,93,12,0.5344827586206896
ANETA,ND,0,14,14,1
ANGEL FIRE,NM,1604,1475,-129,0.4790516401429035
ANGELICA,NY,587,412,-175,0.4124124124124124
ANGELS CAMP,CA,1541,1678,137,0.5212799005902454
ANGELUS OAKS,CA,51,65,14,0.5603448275862069
ANGIE,LA,1089,1087,-2,0.49954044117647056
ANGIER,NC,5833,7019,1186,0.5461406784936197
ANGLE INLET,MN,0,13,13,1
ANGLETON,TX,11307,10468,-839,0.48073478760045923
ANGOLA,IN,11593,8772,-2821,0.4307390130125215
ANGOLA,NY,3237,3116,-121,0.4904769400283331
ANGOON,AK,11,30,19,0.7317073170731707
ANGORA,MN,11,11,0,0.5
ANGUILLA,MS,86,88,2,0.5057471264367817
ANGUS,MN,19,14,-5,0.42424242424242425
ANGWIN,CA,1808,1022,-786,0.36113074204947
ANIAK,AK,11,0,-11,0
ANITA,IA,408,293,-115,0.41797432239657634
ANITA,PA,12,11,-1,0.4782608695652174
ANIWA,WI,23,79,56,0.7745098039215687
ANKENY,IA,33804,35852,2048,0.5147008154358562
ANMOORE,WV,11,15,4,0.5769230769230769
ANN ARBOR,MI,86996,68806,-18190,0.4416246261280343
ANNA,IL,2761,2591,-170,0.48411808669656203
ANNA,OH,1447,1143,-304,0.4413127413127413
ANNA,TX,7909,11962,4053,0.601982788988979
ANNA MARIA,FL,1667,1592,-75,0.48849340288432036
ANNABELLA,UT,25,64,39,0.7191011235955056
ANNANDALE,MN,3152,3185,33,0.5026037557203724
ANNANDALE,NJ,2594,2794,200,0.5185597624350409
ANNANDALE,VA,20733,19280,-1453,0.48184340089470923
ANNAPOLIS,MD,49760,41880,-7880,0.4570056743780009
ANNAPOLIS,MO,253,290,37,0.5340699815837937
ANNAPOLIS JCT,MD,115,125,10,0.5208333333333334
ANNAPOLIS JUNCTION,MD,1037,945,-92,0.47679112008072655
ANNAWAN,IL,180,179,-1,0.4986072423398329
ANNISTON,AL,16976,16555,-421,0.493722227192747
ANNONA,TX,31,34,3,0.5230769230769231
ANNVILLE,KY,447,616,169,0.5794920037629351
ANNVILLE,PA,3241,3489,248,0.5184249628528975
ANOKA,MN,20091,18397,-1694,0.4779931407191852
ANSLEY,NE,77,72,-5,0.48322147651006714
ANSON,ME,717,748,31,0.510580204778157
ANSON,TX,1415,1249,-166,0.46884384384384387
ANSONIA,CT,7053,6641,-412,0.48495691543741787
ANSONIA,OH,1247,1002,-245,0.4455313472654513
ANSTED,WV,334,169,-165,0.3359840954274354
ANTELOPE,CA,16908,15081,-1827,0.47144330863734407
ANTHEM,AZ,10154,12352,2198,0.548831422731716
ANTHON,IA,188,65,-123,0.25691699604743085
ANTHONY,FL,1782,1794,12,0.5016778523489933
ANTHONY,KS,1486,1357,-129,0.4773126978543792
ANTHONY,NM,1948,2149,201,0.5245301440078106
ANTHONY,TX,660,669,9,0.5033860045146726
ANTIGO,WI,6531,5652,-879,0.4639251415907412
ANTIOCH,CA,41595,36286,-5309,0.4659159486909516
ANTIOCH,IL,8833,8623,-210,0.4939848762603116
ANTIOCH,TN,50188,43594,-6594,0.46484399991469577
ANTLERS,OK,2330,2329,-1,0.49989268083279675
ANTON,TX,98,93,-5,0.4869109947643979
ANTONITO,CO,529,786,257,0.5977186311787073
ANTRIM,NH,1157,1241,84,0.5175145954962469
ANTWERP,NY,401,531,130,0.5697424892703863
ANTWERP,OH,1204,941,-263,0.4386946386946387
ANZA,CA,1666,1508,-158,0.4751102709514808
APACHE,OK,760,742,-18,0.4940079893475366
APACHE JCT,AZ,3238,5053,1815,0.6094560366662646
APACHE JUNCTION,AZ,42718,58040,15322,0.5760336648206594
APALACHICOLA,FL,1193,1375,182,0.535436137071651
APALACHIN,NY,2122,2081,-41,0.4951225315251011
APEX,NC,28489,38824,10335,0.5767682319908487
APISON,TN,1278,1954,676,0.6045792079207921
APLINGTON,IA,469,347,-122,0.4252450980392157
APOLLO,PA,3811,3838,27,0.5017649365930187
APOLLO BEACH,FL,13022,16256,3234,0.5552291823211968
APOPKA,FL,39171,41884,2713,0.5167355499352292
APPALACHIA,VA,1125,567,-558,0.3351063829787234
APPLE CREEK,OH,1342,1141,-201,0.459524768425292
APPLE GROVE,WV,143,62,-81,0.3024390243902439
APPLE RIVER,IL,551,345,-206,0.38504464285714285
APPLE SPRINGS,TX,27,101,74,0.7890625
APPLE VALLEY,CA,27375,29573,2198,0.5192983072276462
APPLE VALLEY,MN,11756,10643,-1113,0.47515514085450244
APPLE VALLEY,UT,192,253,61,0.5685393258426966
APPLEGATE,CA,658,702,44,0.5161764705882353
APPLEGATE,MI,423,302,-121,0.416551724137931
APPLETON,ME,629,644,15,0.5058915946582875
APPLETON,MN,1122,895,-227,0.443728309370352
APPLETON,NY,97,155,58,0.6150793650793651
APPLETON,WI,60642,52111,-8531,0.46216952098835506
APPLETON CITY,MO,454,554,100,0.5496031746031746
APPLING,GA,1300,1701,401,0.566811062979007
APPOMATTOX,VA,2584,2895,311,0.5283810914400437
APTOS,CA,9757,9113,-644,0.4829358770535241
AQUASCO,MD,24,42,18,0.6363636363636364
AQUEBOGUE,NY,763,222,-541,0.22538071065989848
AQUILLA,TX,23,136,113,0.8553459119496856
AQUINNAH,MA,546,173,-373,0.24061196105702365
ARAB,AL,6820,6437,-383,0.4855548012370823
ARABI,GA,73,123,50,0.6275510204081632
ARABI,LA,1435,1713,278,0.5441550190597204
ARAGON,GA,1712,1743,31,0.5044862518089726
ARANSAS PASS,TX,5031,6264,1233,0.5545816733067729
ARAPAHO,OK,75,86,11,0.5341614906832298
ARAPAHOE,NC,234,538,304,0.6968911917098446
ARAPAHOE,NE,451,284,-167,0.38639455782312926
ARARAT,NC,210,133,-77,0.3877551020408163
ARARAT,VA,797,443,-354,0.357258064516129
ARBOLES,CO,11,0,-11,0
ARBOR VITAE,WI,112,200,88,0.6410256410256411
ARBUCKLE,CA,739,719,-20,0.49314128943758573
ARBUTUS,MD,783,668,-115,0.4603721571330117
ARBYRD,MO,89,36,-53,0.288
ARCADE,NY,2070,1860,-210,0.4732824427480916
ARCADIA,CA,19645,20231,586,0.5073477781121477
ARCADIA,FL,14193,19202,5009,0.5749962569246894
ARCADIA,IN,907,876,-31,0.4913067863151991
ARCADIA,KS,23,56,33,0.7088607594936709
ARCADIA,LA,1217,1221,4,0.5008203445447088
ARCADIA,MI,608,457,-151,0.4291079812206573
ARCADIA,MO,323,370,47,0.5339105339105339
ARCADIA,NE,22,0,-22,0
ARCADIA,OH,78,40,-38,0.3389830508474576
ARCADIA,OK,896,1571,675,0.6368058370490475
ARCADIA,SC,196,185,-11,0.48556430446194226
ARCADIA,WI,3612,1865,-1747,0.34051488040898303
ARCANUM,OH,2068,2061,-7,0.4991523371276338
ARCATA,CA,13154,10234,-2920,0.4375748246964255
ARCHBALD,PA,1419,1453,34,0.5059192200557103
ARCHBOLD,OH,2302,2091,-211,0.47598452082859094
ARCHDALE,NC,3883,3214,-669,0.45286740876426657
ARCHER,FL,2586,2636,50,0.504787437763309
ARCHER CITY,TX,287,378,91,0.5684210526315789
ARCHIE,MO,866,1005,139,0.5371459112773918
ARCO,ID,815,809,-6,0.4981527093596059
ARCOLA,IL,1237,1120,-117,0.4751803139584217
ARCOLA,IN,12,0,-12,0
ARDEN,NC,13067,14368,1301,0.5237105886641151
ARDMORE,AL,1924,1807,-117,0.4843205574912892
ARDMORE,OK,16843,15103,-1740,0.4727665435422275
ARDMORE,PA,5774,5191,-583,0.47341541267669857
ARDMORE,SD,0,18,18,1
ARDMORE,TN,1363,1149,-214,0.45740445859872614
ARDOCH,ND,16,0,-16,0
ARDSLEY,NY,1513,1639,126,0.5199873096446701
ARENA,WI,513,577,64,0.5293577981651376
ARENAS VALLEY,NM,12,0,-12,0
ARENDTSVILLE,PA,26,0,-26,0
ARENZVILLE,IL,12,0,-12,0
ARGENTA,IL,403,406,3,0.5018541409147095
ARGILLITE,KY,191,147,-44,0.4349112426035503
ARGO,IL,67,55,-12,0.45081967213114754
ARGONIA,KS,51,31,-20,0.3780487804878049
ARGONNE,WI,225,233,8,0.5087336244541485
ARGOS,IN,1400,1330,-70,0.48717948717948717
ARGYLE,IA,0,12,12,1
ARGYLE,MN,76,11,-65,0.12643678160919541
ARGYLE,NY,1158,1179,21,0.5044929396662388
ARGYLE,TX,8744,13862,5118,0.6132000353888348
ARGYLE,WI,336,431,95,0.5619295958279009
ARIEL,WA,125,190,65,0.6031746031746031
ARIMO,ID,0,12,12,1
ARIPEKA,FL,48,82,34,0.6307692307692307
ARIPINE,AZ,44,34,-10,0.4358974358974359
ARITON,AL,1063,940,-123,0.46929605591612583
ARIVACA,AZ,25,114,89,0.8201438848920863
ARIZONA CITY,AZ,4825,6724,1899,0.5822149103818512
ARK,VA,15,0,-15,0
ARKADELPHIA,AR,7945,6194,-1751,0.43807907207016056
ARKANSAS CITY,KS,8229,6842,-1387,0.4539844734921372
ARKANSAW,WI,133,79,-54,0.37264150943396224
ARKDALE,WI,864,933,69,0.5191986644407346
ARKOMA,OK,1091,682,-409,0.38465877044557245
ARKPORT,NY,1051,964,-87,0.4784119106699752
ARKVILLE,NY,247,161,-86,0.3946078431372549
ARLEE,MT,963,886,-77,0.4791779340183883
ARLETA,CA,8615,6849,-1766,0.44289963786859804
ARLEY,AL,1205,1337,132,0.5259638080251771
ARLINGTON,AZ,11,33,22,0.75
ARLINGTON,GA,180,230,50,0.5609756097560976
ARLINGTON,IA,57,24,-33,0.2962962962962963
ARLINGTON,IN,73,57,-16,0.43846153846153846
ARLINGTON,KS,74,65,-9,0.4676258992805755
ARLINGTON,KY,343,350,7,0.5050505050505051
ARLINGTON,MA,17492,16124,-1368,0.4796525464064731
ARLINGTON,MN,1068,1011,-57,0.4862914862914863
ARLINGTON,NE,717,533,-184,0.4264
ARLINGTON,OH,786,752,-34,0.4889466840052016
ARLINGTON,OR,218,165,-53,0.4308093994778068
ARLINGTON,SD,778,768,-10,0.49676584734799484
ARLINGTON,TN,3205,3717,512,0.5369835307714533
ARLINGTON,TX,192140,157554,-34586,0.45054819356351555
ARLINGTON,VA,176738,147873,-28865,0.4555390914047891
ARLINGTON,VT,1071,1170,99,0.5220883534136547
ARLINGTON,WA,17987,18550,563,0.5077045187070641
ARLINGTON,WI,204,120,-84,0.37037037037037035
ARLINGTON HEIGHTS,IL,29420,27809,-1611,0.4859249681105733
ARLINGTON HEIGHTS,TX,241,250,9,0.5091649694501018
ARLINGTON HTS,IL,435,378,-57,0.46494464944649444
ARMA,KS,1017,814,-203,0.4445658110322228
ARMADA,MI,1459,1354,-105,0.48133665126199787
ARMAGH,PA,75,60,-15,0.4444444444444444
ARMINGTON,IL,11,0,-11,0
ARMONA,CA,1091,1018,-73,0.4826932195353248
ARMONK,NY,2397,2640,243,0.5241215008933889
ARMOUR,SD,46,0,-46,0
ARMSTRONG,IA,406,310,-96,0.4329608938547486
ARMSTRONG,MO,13,11,-2,0.4583333333333333
ARMSTRONG CREEK,WI,28,62,34,0.6888888888888889
ARMUCHEE,GA,559,658,99,0.5406737880032868
ARNAUDVILLE,LA,1707,1960,253,0.5344968639214617
ARNEGARD,ND,51,54,3,0.5142857142857142
ARNETT,OK,74,22,-52,0.22916666666666666
ARNETT,WV,23,0,-23,0
ARNOLD,CA,2039,1221,-818,0.3745398773006135
ARNOLD,MD,6928,7082,154,0.5054960742326909
ARNOLD,MI,51,19,-32,0.2714285714285714
ARNOLD,MO,12573,11566,-1007,0.4791416380131737
ARNOLD,NE,176,120,-56,0.40540540540540543
ARNOLD,PA,525,511,-14,0.49324324324324326
ARNOLDS PARK,IA,1148,832,-316,0.4202020202020202
ARNOLDSBURG,WV,95,193,98,0.6701388888888888
ARNOLDSVILLE,GA,156,277,121,0.6397228637413395
ARODA,VA,11,0,-11,0
AROMA PARK,IL,164,28,-136,0.14583333333333334
AROMAS,CA,1022,984,-38,0.4905284147557328
ARP,TX,926,1148,222,0.553519768563163
ARPIN,WI,296,401,105,0.5753228120516499
ARRIBA,CO,14,13,-1,0.48148148148148145
ARRINGTON,TN,588,1192,604,0.6696629213483146
ARRINGTON,VA,249,275,26,0.5248091603053435
ARROWBEAR LAKE,CA,56,40,-16,0.4166666666666667
ARROWSIC,ME,97,156,59,0.616600790513834
ARROWSMITH,IL,11,0,-11,0
ARROYO GRANDE,CA,10102,10826,724,0.5172974006116208
ARROYO HONDO,NM,11,50,39,0.819672131147541
ARROYO SECO,NM,481,444,-37,0.48
ARTEMUS,KY,0,11,11,1
ARTESIA,CA,4733,3961,-772,0.4556015642972165
ARTESIA,NM,6036,5584,-452,0.48055077452667816
ARTHUR,IA,35,0,-35,0
ARTHUR,IL,1244,1025,-219,0.4517408550022036
ARTHUR CITY,TX,339,264,-75,0.43781094527363185
ARUNDEL,ME,1214,986,-228,0.4481818181818182
ARVADA,CO,68330,63726,-4604,0.48256800145392864
ARVERNE,NY,4871,4337,-534,0.47100347523892266
ARVIN,CA,3072,2806,-266,0.4773732562095951
ARVONIA,VA,12,12,0,0.5
ASBURY,IA,493,545,52,0.5250481695568401
ASBURY,MO,38,30,-8,0.4411764705882353
ASBURY,NJ,1015,1084,69,0.5164363982848976
ASBURY,WV,11,0,-11,0
ASBURY PARK,NJ,4448,4282,-166,0.49049255441008016
ASCUTNEY,VT,194,72,-122,0.2706766917293233
ASH,NC,849,928,79,0.522228474957794
ASH FLAT,AR,1188,1276,88,0.5178571428571429
ASH FORK,AZ,1445,987,-458,0.4058388157894737
ASH GROVE,MO,1328,1379,51,0.509420022164758
ASHAWAY,RI,782,924,142,0.5416178194607268
ASHBURN,GA,1905,1960,55,0.5071151358344114
ASHBURN,VA,35772,38364,2592,0.5174813855616704
ASHBURNHAM,MA,2128,2205,77,0.5088852988691438
ASHBY,MA,1024,925,-99,0.4746023601847101
ASHBY,MN,381,244,-137,0.3904
ASHCAMP,KY,23,37,14,0.6166666666666667
ASHDOWN,AR,2903,2843,-60,0.49477897667942916
ASHEBORO,NC,21926,17474,-4452,0.443502538071066
ASHER,OK,137,125,-12,0.4770992366412214
ASHEVILLE,NC,79761,77454,-2307,0.4926629138440988
ASHFIELD,MA,393,435,42,0.5253623188405797
ASHFORD,AL,1910,2142,232,0.5286278381046396
ASHFORD,CT,1566,1591,25,0.5039594551789673
ASHFORD,WA,240,152,-88,0.3877551020408163
ASHFORD,WV,0,16,16,1
ASHKUM,IL,253,136,-117,0.3496143958868895
ASHLAND,AL,1989,1464,-525,0.42397914856646396
ASHLAND,IL,537,417,-120,0.4371069182389937
ASHLAND,KS,158,11,-147,0.0650887573964497
ASHLAND,KY,14045,13144,-901,0.4834307992202729
ASHLAND,MA,7176,6857,-319,0.4886339342977268
ASHLAND,ME,314,329,15,0.5116640746500778
ASHLAND,MO,2499,2748,249,0.5237278444825615
ASHLAND,MS,663,704,41,0.514996342355523
ASHLAND,MT,92,13,-79,0.12380952380952381
ASHLAND,NE,1857,2126,269,0.5337685161938237
ASHLAND,NH,1350,1142,-208,0.4582664526484751
ASHLAND,OH,11844,11247,-597,0.4870728855398207
ASHLAND,OR,18503,16750,-1753,0.47513686778430203
ASHLAND,PA,2404,2504,100,0.5101874490627547
ASHLAND,VA,5598,6019,421,0.5181199965567702
ASHLAND,WI,4932,4349,-583,0.4685917465790324
ASHLAND CITY,TN,7087,7958,871,0.528946493851778
ASHLEY,IL,262,236,-26,0.4738955823293173
ASHLEY,IN,748,624,-124,0.45481049562682213
ASHLEY,MI,181,230,49,0.559610705596107
ASHLEY,ND,255,96,-159,0.27350427350427353
ASHLEY,OH,960,842,-118,0.4672586015538291
ASHLEY,PA,1350,1291,-59,0.4888299886406664
ASHLEY FALLS,MA,11,92,81,0.8932038834951457
ASHMORE,IL,279,130,-149,0.31784841075794623
ASHTABULA,OH,14545,13839,-706,0.48756341600901915
ASHTON,IA,14,14,0,0.5
ASHTON,ID,1321,1082,-239,0.45027049521431545
ASHTON,IL,292,323,31,0.5252032520325203
ASHTON,MD,594,964,370,0.6187419768934531
ASHTON,NE,13,0,-13,0
ASHTON,WV,0,11,11,1
ASHUELOT,NH,50,12,-38,0.1935483870967742
ASHVILLE,AL,2075,2230,155,0.5180023228803716
ASHVILLE,NY,1290,1087,-203,0.4572991165334455
ASHVILLE,OH,4739,5074,335,0.5170691939264241
ASHVILLE,PA,25,23,-2,0.4791666666666667
ASKOV,MN,84,166,82,0.664
ASOTIN,WA,491,516,25,0.5124131082423039
ASPEN,CO,7349,6714,-635,0.47742302495911254
ASPEN HILL,MD,1535,1441,-94,0.4842069892473118
ASPERMONT,TX,177,127,-50,0.41776315789473684
ASPERS,PA,717,675,-42,0.4849137931034483
ASPINWALL,PA,837,872,35,0.5102399063779989
ASSARIA,KS,247,115,-132,0.31767955801104975
ASSONET,MA,1105,1120,15,0.503370786516854
ASSUMPTION,IL,550,358,-192,0.394273127753304
ASTATULA,FL,1175,1304,129,0.5260185558693021
ASTON,PA,3861,3978,117,0.5074626865671642
ASTOR,FL,2147,2409,262,0.5287532923617209
ASTORIA,IL,486,327,-159,0.4022140221402214
ASTORIA,NY,65871,49676,-16195,0.4299202921754784
ASTORIA,OR,10146,8755,-1391,0.4632030051320036
ASTORIA,SD,11,0,-11,0
ATALISSA,IA,83,62,-21,0.42758620689655175
ATASCADERO,CA,12509,12462,-47,0.49905890833366706
ATASCOCITA,TX,1140,1601,461,0.5840933965705947
ATASCOSA,TX,1458,1698,240,0.5380228136882129
ATCHISON,KS,6248,5124,-1124,0.45058037284558566
ATCO,NJ,2897,3067,170,0.5142521797451375
ATGLEN,PA,448,420,-28,0.4838709677419355
ATHELSTANE,WI,415,358,-57,0.463130659767141
ATHENA,OR,296,293,-3,0.49745331069609505
ATHENS,AL,17637,20780,3143,0.5409063695759689
ATHENS,GA,54365,45536,-8829,0.4558112531406092
ATHENS,IL,1136,1136,0,0.5
ATHENS,LA,48,0,-48,0
ATHENS,ME,80,100,20,0.5555555555555556
ATHENS,MI,724,648,-76,0.47230320699708456
ATHENS,NY,1401,1521,120,0.5205338809034907
ATHENS,OH,12432,9627,-2805,0.4364205086359309
ATHENS,PA,2454,2487,33,0.5033394049787493
ATHENS,TN,10069,10990,921,0.5218671351916045
ATHENS,TX,8414,8972,558,0.5160473944553089
ATHENS,VT,78,77,-1,0.4967741935483871
ATHENS,WI,1321,1135,-186,0.46213355048859933
ATHENS,WV,443,424,-19,0.48904267589388695
ATHERTON,CA,1811,1987,176,0.5231700895208005
ATHOL,ID,3260,3508,248,0.5183215130023641
ATHOL,MA,5696,5757,61,0.502663057714136
ATHOL,NY,11,12,1,0.5217391304347826
ATKINS,AR,2614,2532,-82,0.49203264671589586
ATKINS,IA,584,522,-62,0.4719710669077758
ATKINS,VA,462,390,-72,0.45774647887323944
ATKINSON,IL,178,89,-89,0.3333333333333333
ATKINSON,ME,43,51,8,0.5425531914893617
ATKINSON,NC,212,286,74,0.5742971887550201
ATKINSON,NE,606,495,-111,0.44959128065395093
ATKINSON,NH,2298,2562,264,0.5271604938271605
ATLANTA,GA,531117,497258,-33859,0.4835376200316033
ATLANTA,IL,719,765,46,0.5154986522911051
ATLANTA,IN,448,577,129,0.5629268292682926
ATLANTA,KS,12,12,0,0.5
ATLANTA,LA,24,12,-12,0.3333333333333333
ATLANTA,MI,2386,2178,-208,0.47721297107800176
ATLANTA,MO,117,81,-36,0.4090909090909091
ATLANTA,NY,122,69,-53,0.3612565445026178
ATLANTA,TX,3834,3781,-53,0.49652002626395275
ATLANTIC,IA,4749,3961,-788,0.4547646383467279
ATLANTIC,NC,25,0,-25,0
ATLANTIC,PA,12,0,-12,0
ATLANTIC,VA,26,39,13,0.6
ATLANTIC BCH,FL,1090,1119,29,0.5065640561339972
ATLANTIC BCH,NC,238,263,25,0.5249500998003992
ATLANTIC BCH,NY,177,166,-11,0.4839650145772595
ATLANTIC BEACH,FL,9206,9059,-147,0.49597591021078563
ATLANTIC BEACH,NC,1611,1838,227,0.5329080893012468
ATLANTIC BEACH,NY,897,1071,174,0.5442073170731707
ATLANTIC CITY,NJ,16244,14627,-1617,0.47381037219396843
ATLANTIC HIGHLANDS,NJ,3185,3301,116,0.5089423373419674
ATLANTIC MINE,MI,403,385,-18,0.4885786802030457
ATLANTIS,FL,432,356,-76,0.4517766497461929
ATMORE,AL,4198,4230,32,0.5018984337921215
ATOKA,OK,3306,3306,0,0.5
ATOKA,TN,3021,3695,674,0.5501786777843954
ATTALLA,AL,3701,3672,-29,0.4980333649803336
ATTAPULGUS,GA,52,100,48,0.6578947368421053
ATTICA,IN,2796,2447,-349,0.4667175281327484
ATTICA,KS,12,50,38,0.8064516129032258
ATTICA,MI,1802,1750,-52,0.49268018018018017
ATTICA,NY,1902,1707,-195,0.47298420615128844
ATTICA,OH,647,528,-119,0.4493617021276596
ATTLEBORO,MA,15418,15430,12,0.5001945020746889
ATTLEBORO FALLS,MA,570,673,103,0.5414320193081255
ATWATER,CA,10793,10378,-415,0.49019885692692833
ATWATER,MN,776,689,-87,0.47030716723549487
ATWATER,OH,1452,1500,48,0.508130081300813
ATWOOD,CA,41,21,-20,0.3387096774193548
ATWOOD,IL,452,311,-141,0.4076015727391874
ATWOOD,KS,611,461,-150,0.4300373134328358
ATWOOD,TN,659,551,-108,0.4553719008264463
AU GRES,MI,2215,1997,-218,0.47412155745489076
AU SABLE FORKS,NY,1346,1201,-145,0.47153513937966235
AU SABLE FRKS,NY,41,0,-41,0
AU TRAIN,MI,269,192,-77,0.4164859002169197
AUBERRY,CA,1358,1123,-235,0.45264006449012495
AUBREY,TX,15809,26191,10382,0.6235952380952381
AUBURN,AL,31907,27150,-4757,0.45972535008551063
AUBURN,CA,19307,18522,-785,0.4896243622617569
AUBURN,GA,6082,7473,1391,0.5513094798967171
AUBURN,IA,92,40,-52,0.30303030303030304
AUBURN,IL,1845,1683,-162,0.4770408163265306
AUBURN,IN,8355,7940,-415,0.48726603252531453
AUBURN,KS,937,918,-19,0.4948787061994609
AUBURN,KY,1930,1950,20,0.5025773195876289
AUBURN,MA,5734,5488,-246,0.48903938691855287
AUBURN,ME,11587,10678,-909,0.47958679541881877
AUBURN,MI,2043,1999,-44,0.4945571499257793
AUBURN,NE,2135,1976,-159,0.4806616395037704
AUBURN,NH,1412,1636,224,0.536745406824147
AUBURN,NY,19296,16804,-2492,0.4654847645429363
AUBURN,PA,1192,1401,209,0.5403008098727343
AUBURN,WA,51512,47956,-3556,0.4821249044918969
AUBURN,WV,12,0,-12,0
AUBURN,WY,15,0,-15,0
AUBURN HILLS,MI,15060,12994,-2066,0.46317815641263277
AUBURN TOWNSHIP,OH,205,192,-13,0.4836272040302267
AUBURNDALE,FL,17343,20284,2941,0.5390809790841683
AUBURNDALE,MA,3219,2890,-329,0.47307251596005895
AUBURNDALE,NY,349,371,22,0.5152777777777777
AUBURNDALE,WI,231,273,42,0.5416666666666666
AUBURNTOWN,TN,62,66,4,0.515625
AUDUBON,IA,1314,1124,-190,0.4610336341263331
AUDUBON,MN,980,945,-35,0.4909090909090909
AUDUBON,NJ,2753,2791,38,0.5034271284271284
AUDUBON,PA,679,694,15,0.5054624908958485
AUDUBON PARK,KY,165,118,-47,0.4169611307420495
AUGUSTA,AR,951,863,-88,0.4757442116868798
AUGUSTA,GA,86783,81608,-5175,0.4846339768752487
AUGUSTA,IL,106,62,-44,0.36904761904761907
AUGUSTA,KS,5795,5280,-515,0.4767494356659142
AUGUSTA,KY,1152,910,-242,0.44131910766246363
AUGUSTA,ME,12368,12093,-275,0.494378807080659
AUGUSTA,MI,1252,1310,58,0.5113192818110851
AUGUSTA,MO,60,134,74,0.6907216494845361
AUGUSTA,MT,177,102,-75,0.3655913978494624
AUGUSTA,NJ,72,65,-7,0.4744525547445255
AUGUSTA,WI,1389,1275,-114,0.4786036036036036
AUGUSTA,WV,1534,1570,36,0.5057989690721649
AUKE BAY,AK,361,353,-8,0.4943977591036415
AULANDER,NC,1039,805,-234,0.43655097613882865
AULT,CO,1244,1692,448,0.5762942779291553
AUMSVILLE,OR,3112,2567,-545,0.4520162000352175
AURELIA,IA,210,250,40,0.5434782608695652
AURORA,CO,222255,212805,-9450,0.48913942904426977
AURORA,IA,14,0,-14,0
AURORA,IL,64524,56320,-8204,0.4660554102810235
AURORA,IN,4005,3726,-279,0.4819557625145518
AURORA,ME,36,0,-36,0
AURORA,MN,1348,1146,-202,0.4595028067361668
AURORA,MO,6035,5533,-502,0.47830221300138315
AURORA,NC,603,668,65,0.5255704169944925
AURORA,NE,2172,2000,-172,0.4793863854266539
AURORA,NY,429,255,-174,0.37280701754385964
AURORA,OH,6702,7335,633,0.5225475528959179
AURORA,OR,1888,1889,1,0.5001323801959227
AURORA,SD,335,390,55,0.5379310344827586
AURORA,TX,749,872,123,0.5379395434916718
AURORA,UT,13,36,23,0.7346938775510204
AURORA,WV,36,0,-36,0
AUSTELL,GA,22587,20279,-2308,0.47307889702794753
AUSTERLITZ,NY,51,41,-10,0.44565217391304346
AUSTIN,AR,3211,3700,489,0.5353783822891043
AUSTIN,CO,509,774,265,0.603273577552611
AUSTIN,IN,4220,3516,-704,0.4544984488107549
AUSTIN,KY,61,14,-47,0.18666666666666668
AUSTIN,MN,13519,12724,-795,0.4848531036847921
AUSTIN,NV,0,23,23,1
AUSTIN,PA,386,298,-88,0.43567251461988304
AUSTIN,TX,702228,639095,-63133,0.4764661457382003
AUSTINBURG,OH,415,363,-52,0.4665809768637532
AUSTINTOWN,OH,508,457,-51,0.47357512953367875
AUSTINVILLE,VA,311,362,51,0.537890044576523
AUTAUGAVILLE,AL,176,234,58,0.5707317073170731
AUTO,WV,16,0,-16,0
AUTRYVILLE,NC,1100,995,-105,0.47494033412887826
AUXIER,KY,23,79,56,0.7745098039215687
AUXVASSE,MO,1337,1207,-130,0.4744496855345912
AVA,IL,589,575,-14,0.49398625429553267
AVA,MO,3321,3504,183,0.5134065934065934
AVA,NY,94,100,6,0.5154639175257731
AVALON,CA,752,579,-173,0.43501126972201354
AVALON,NJ,2771,3145,374,0.5316091954022989
AVALON,PA,995,800,-195,0.4456824512534819
AVANT,OK,0,11,11,1
AVE MARIA,FL,2260,2529,269,0.5280851952390896
AVELLA,PA,686,708,22,0.5078909612625538
AVENAL,CA,2265,1663,-602,0.4233706720977597
AVENEL,NJ,5512,5367,-145,0.4933357845390201
AVENTURA,FL,28295,27543,-752,0.4932662344639851
AVENUE,MD,70,58,-12,0.453125
AVERA,GA,0,22,22,1
AVERILL PARK,NY,2509,2461,-48,0.49517102615694164
AVERY,CA,0,11,11,1
AVERY,TX,257,336,79,0.5666104553119731
AVILA BEACH,CA,801,811,10,0.5031017369727047
AVILLA,IN,1750,1756,6,0.5008556759840274
AVINGER,TX,1043,1033,-10,0.4975915221579961
AVIS,PA,435,144,-291,0.24870466321243523
AVISTON,IL,473,579,106,0.5503802281368821
AVOCA,IA,894,897,3,0.5008375209380235
AVOCA,MI,247,237,-10,0.4896694214876033
AVOCA,MN,12,0,-12,0
AVOCA,NE,36,23,-13,0.3898305084745763
AVOCA,NY,1052,1016,-36,0.4912959381044487
AVOCA,PA,1200,1267,67,0.5135792460478313
AVOCA,WI,329,177,-152,0.34980237154150196
AVON,CO,6663,4267,-2396,0.3903934126258006
AVON,CT,6839,7505,666,0.5232152816508645
AVON,IL,590,381,-209,0.39237899073120497
AVON,IN,16396,17265,869,0.5129081132467841
AVON,MA,1534,1514,-20,0.4967191601049869
AVON,ME,280,187,-93,0.4004282655246253
AVON,MN,1318,1355,37,0.5069210624766181
AVON,NC,263,416,153,0.6126656848306333
AVON,NY,2391,2358,-33,0.4965255843335439
AVON,OH,6306,7429,1123,0.5408809610484164
AVON,SD,37,38,1,0.5066666666666667
AVON BY SEA,NJ,169,111,-58,0.3964285714285714
AVON BY THE SEA,NJ,807,958,151,0.5427762039660057
AVON LAKE,OH,8094,8456,362,0.5109365558912387
AVON PARK,FL,20416,19064,-1352,0.4828774062816616
AVONDALE,AZ,37894,36666,-1228,0.49176502145922746
AVONDALE,CO,418,462,44,0.525
AVONDALE,LA,812,704,-108,0.46437994722955145
AVONDALE,MO,139,135,-4,0.4927007299270073
AVONDALE,PA,1767,1921,154,0.52087852494577
AVONDALE EST,GA,71,47,-24,0.3983050847457627
AVONDALE ESTATES,GA,3730,3061,-669,0.45074363127668976
AVONMORE,PA,644,505,-139,0.4395126196692776
AWENDAW,SC,906,1341,435,0.5967957276368492
AXIS,AL,383,182,-201,0.32212389380530976
AXSON,GA,0,65,65,1
AXTELL,KS,33,0,-33,0
AXTELL,NE,131,165,34,0.5574324324324325
AXTELL,TX,590,637,47,0.5191524042379788
AXTON,VA,1589,1348,-241,0.4589717398706163
AYDEN,NC,3009,3584,575,0.543606855756105
AYDLETT,NC,0,82,82,1
AYER,MA,3181,3134,-47,0.4962787015043547
AYLETT,VA,1968,2508,540,0.5603217158176944
AYNOR,SC,1821,2266,445,0.554440910203083
AZALEA,OR,95,92,-3,0.4919786096256685
AZALEA PARK,FL,787,655,-132,0.45423023578363386
AZLE,TX,14542,16414,1872,0.5302364646595167
AZTEC,NM,6678,5540,-1138,0.4534293665084302
AZUSA,CA,14874,13490,-1384,0.4756028768861938
BABB,MT,121,109,-12,0.47391304347826085
BABBITT,MN,940,839,-101,0.4716132658797077
BABCOCK RANCH,FL,96,199,103,0.6745762711864407
BABSON PARK,FL,1362,1499,137,0.5239426773855296
BABYLON,NY,4500,4478,-22,0.4987747828024059
BACKUS,MN,1424,1344,-80,0.48554913294797686
BACLIFF,TX,5290,4108,-1182,0.43711427963396465
BACONTON,GA,1006,833,-173,0.45296356715606306
BAD AXE,MI,3001,2718,-283,0.4752579122224165
BADEN,PA,2526,2615,89,0.5086559035207158
BADGER,IA,95,11,-84,0.10377358490566038
BADGER,MN,129,135,6,0.5113636363636364
BADIN,NC,102,128,26,0.5565217391304348
BAGDAD,AZ,693,524,-169,0.4305669679539852
BAGDAD,FL,203,23,-180,0.10176991150442478
BAGDAD,KY,614,574,-40,0.4831649831649832
BAGGS,WY,62,11,-51,0.1506849315068493
BAGLEY,IA,46,0,-46,0
BAGLEY,MN,1657,1577,-80,0.4876314162028448
BAGLEY,WI,193,149,-44,0.43567251461988304
BAHAMA,NC,677,860,183,0.5595315549772284
BAILEY,CO,3729,3522,-207,0.4857261067438974
BAILEY,MI,37,25,-12,0.4032258064516129
BAILEY,MS,122,155,33,0.5595667870036101
BAILEY,NC,1559,1618,59,0.5092854894554611
BAILEY IS,ME,17,0,-17,0
BAILEY ISLAND,ME,210,303,93,0.5906432748538012
BAILEYS CROSSROADS,VA,227,219,-8,0.4910313901345291
BAILEYS HARBOR,WI,1328,1108,-220,0.4548440065681445
BAILEYTON,AL,473,733,260,0.6077943615257048
BAILEYVILLE,ME,527,518,-9,0.49569377990430624
BAINBRIDGE,GA,8366,7927,-439,0.48652795679126004
BAINBRIDGE,IN,576,687,111,0.5439429928741093
BAINBRIDGE,NY,1934,1836,-98,0.4870026525198939
BAINBRIDGE,OH,1342,1209,-133,0.4739317914543316
BAINBRIDGE,PA,651,633,-18,0.4929906542056075
BAINBRIDGE IS,WA,176,179,3,0.504225352112676
BAINBRIDGE ISLAND,WA,11400,11984,584,0.5124871707150188
BAINVILLE,MT,81,22,-59,0.21359223300970873
BAIRD,TX,1131,1026,-105,0.4756606397774687
BAITING HOLLOW,NY,178,204,26,0.5340314136125655
BAKER,FL,2079,2486,407,0.5445783132530121
BAKER,LA,5209,5238,29,0.5013879582655307
BAKER,MN,11,0,-11,0
BAKER,MT,671,402,-269,0.3746505125815471
BAKER,WV,115,174,59,0.6020761245674741
BAKER CITY,OR,6419,6189,-230,0.490878807106599
BAKERSFIELD,CA,191027,183710,-7317,0.4902371529899636
BAKERSFIELD,MO,11,23,12,0.6764705882352942
BAKERSVILLE,NC,1848,2038,190,0.5244467318579517
BAL HARBOUR,FL,4115,3756,-359,0.47719476559522295
BALA CYNWYD,PA,5202,6028,826,0.5367764915405164
BALATON,MN,242,209,-33,0.4634146341463415
BALBOA,CA,42,41,-1,0.4939759036144578
BALBOA ISLAND,CA,462,383,-79,0.4532544378698225
BALCH SPRINGS,TX,6757,6300,-457,0.482499808531822
BALD KNOB,AR,3117,2711,-406,0.4651681537405628
BALDWIN,FL,166,212,46,0.5608465608465608
BALDWIN,GA,1035,960,-75,0.48120300751879697
BALDWIN,IA,0,12,12,1
BALDWIN,IL,12,12,0,0.5
BALDWIN,LA,191,163,-28,0.4604519774011299
BALDWIN,MD,674,1095,421,0.6189937817976258
BALDWIN,ME,16,0,-16,0
BALDWIN,MI,3278,2796,-482,0.4603226868620349
BALDWIN,ND,0,13,13,1
BALDWIN,NY,3725,3570,-155,0.4893762851267992
BALDWIN,WI,2476,2385,-91,0.4906397860522526
BALDWIN CITY,KS,2551,2603,52,0.5050446255335662
BALDWIN HILLS,CA,376,349,-27,0.48137931034482756
BALDWIN PARK,CA,14387,12417,-1970,0.4632517534696314
BALDWIN PLACE,NY,545,626,81,0.5345858240819812
BALDWINSVILLE,NY,13920,13228,-692,0.48725504641225875
BALDWINVILLE,MA,866,986,120,0.5323974082073434
BALDWYN,MS,2023,2164,141,0.5168378313828517
BALL,LA,2377,2065,-312,0.464880684376407
BALL GROUND,GA,4379,5489,1110,0.5562423996757195
BALLANTINE,MT,96,23,-73,0.19327731092436976
BALLARD,UT,679,662,-17,0.4936614466815809
BALLARD,WV,54,59,5,0.5221238938053098
BALLENTINE,SC,0,12,12,1
BALLGROUND,GA,72,107,35,0.5977653631284916
BALLICO,CA,26,13,-13,0.3333333333333333
BALLINGER,TX,1931,1637,-294,0.4588004484304933
BALLSTON LAKE,NY,4910,5334,424,0.5206950409996095
BALLSTON SPA,NY,14560,14290,-270,0.4953206239168111
BALLWIN,MO,22082,21630,-452,0.49482979502196195
BALLY,PA,226,205,-21,0.4756380510440835
BALM,FL,11,0,-11,0
BALMORHEA,TX,0,13,13,1
BALSAM,NC,87,163,76,0.652
BALSAM GROVE,NC,52,0,-52,0
BALSAM LAKE,WI,1685,1427,-258,0.45854755784061696
BALTIC,CT,1142,1046,-96,0.4780621572212066
BALTIC,OH,516,376,-140,0.42152466367713004
BALTIC,SD,640,670,30,0.5114503816793893
BALTIMOR,MD,90,95,5,0.5135135135135135
BALTIMORE,MD,313896,274044,-39852,0.4661087866108787
BALTIMORE,OH,2359,2631,272,0.527254509018036
BAMBERG,SC,1561,1639,78,0.5121875
BANCROFT,IA,126,69,-57,0.35384615384615387
BANCROFT,ID,49,51,2,0.51
BANCROFT,MI,761,723,-38,0.4871967654986523
BANCROFT,NE,27,0,-27,0
BANCROFT,SD,0,26,26,1
BANCROFT,WI,216,116,-100,0.3493975903614458
BANCROFT,WV,13,0,-13,0
BANDERA,TX,3585,4998,1413,0.5823138762670395
BANDON,OR,4302,4383,81,0.5046632124352332
BANDY,VA,0,11,11,1
BANEBERRY,TN,169,208,39,0.5517241379310345
BANGOR,CA,97,86,-11,0.46994535519125685
BANGOR,ME,21159,19059,-2100,0.47389228703565567
BANGOR,MI,2343,1927,-416,0.45128805620608897
BANGOR,PA,4410,4478,68,0.5038253825382538
BANGOR,WI,925,890,-35,0.4903581267217631
BANGS,TX,1038,1138,100,0.5229779411764706
BANKS,AL,153,318,165,0.6751592356687898
BANKS,OR,1378,1482,104,0.5181818181818182
BANKSTON,AL,49,40,-9,0.449438202247191
BANNER,IL,409,416,7,0.5042424242424243
BANNER,KY,211,121,-90,0.3644578313253012
BANNER,WY,33,0,-33,0
BANNER ELK,NC,4487,6709,2222,0.5992318685244731
BANNING,CA,10598,11792,1194,0.5266636891469406
BANNISTER,MI,0,22,22,1
BANTAM,CT,512,473,-39,0.48020304568527916
BAPCHULE,AZ,151,94,-57,0.3836734693877551
BAR HARBOR,ME,3250,3305,55,0.5041952707856598
BAR MILLS,ME,0,12,12,1
BAR NUNN,WY,270,216,-54,0.4444444444444444
BARABOO,WI,11093,10127,-966,0.47723845428840717
BARAGA,MI,992,951,-41,0.4894493051981472
BARATARIA,LA,153,23,-130,0.13068181818181818
BARBEAU,MI,83,113,30,0.576530612244898
BARBERTON,OH,8799,8659,-140,0.495990376904571
BARBOURSVILLE,VA,1927,2101,174,0.5215988083416088
BARBOURSVILLE,WV,3674,3417,-257,0.48187843745593006
BARBOURVILLE,KY,2692,2590,-102,0.49034456645210145
BARCLAY,MD,27,22,-5,0.4489795918367347
BARCO,NC,37,27,-10,0.421875
BARD,CA,12,0,-12,0
BARDOLPH,IL,11,0,-11,0
BARDONIA,NY,378,371,-7,0.4953271028037383
BARDSTOWN,KY,12606,11750,-856,0.4824273279684677
BARDWELL,KY,938,881,-57,0.48433205057724027
BARDWELL,TX,11,0,-11,0
BAREFOOT BAY,FL,4169,4206,37,0.5022089552238806
BARGERSVILLE,IN,3152,4029,877,0.5610639186742793
BARHAMSVILLE,VA,55,94,39,0.6308724832214765
BARING,MO,37,26,-11,0.4126984126984127
BARING PLT,ME,24,30,6,0.5555555555555556
BARK RIVER,MI,1027,1044,17,0.5041042974408498
BARKER,NY,891,807,-84,0.4752650176678445
BARKER,TX,36,154,118,0.8105263157894737
BARKHAMSTED,CT,700,831,131,0.542782495101241
BARKSDALE AFB,LA,3888,2597,-1291,0.4004626060138782
BARLING,AR,3638,2282,-1356,0.38547297297297295
BARLOW,KY,449,347,-102,0.435929648241206
BARNARD,MO,26,0,-26,0
BARNARD,VT,37,66,29,0.6407766990291263
BARNARD TWP,ME,0,16,16,1
BARNARDSVILLE,NC,674,713,39,0.5140591204037491
BARNEGAT,NJ,9341,10522,1181,0.5297286411921663
BARNEGAT LGT,NJ,46,0,-46,0
BARNEGAT LIGHT,NJ,935,803,-132,0.4620253164556962
BARNES,WI,392,462,70,0.5409836065573771
BARNES CITY,IA,11,0,-11,0
BARNESVILLE,GA,4213,4426,213,0.512327815719412
BARNESVILLE,MN,1070,1202,132,0.5290492957746479
BARNESVILLE,OH,2428,2225,-203,0.47818611648398884
BARNESVILLE,PA,254,446,192,0.6371428571428571
BARNET,VT,200,305,105,0.6039603960396039
BARNETT,MO,677,600,-77,0.46985121378230227
BARNEVELD,NY,377,341,-36,0.47493036211699163
BARNEVELD,WI,432,543,111,0.556923076923077
BARNEY,GA,0,26,26,1
BARNHART,MO,2556,2852,296,0.5273668639053254
BARNSDALL,OK,380,385,5,0.5032679738562091
BARNSTABLE,MA,1025,1183,158,0.5357789855072463
BARNSTEAD,NH,301,165,-136,0.3540772532188841
BARNUM,MN,830,982,152,0.5419426048565121
BARNWELL,SC,3158,3133,-25,0.4980130344937212
BARODA,MI,1053,815,-238,0.43629550321199145
BARRACKVILLE,WV,11,59,48,0.8428571428571429
BARRE,MA,1365,1519,154,0.5266990291262136
BARRE,VT,7401,7150,-251,0.49137516321902275
BARREN SPRINGS,VA,26,35,9,0.5737704918032787
BARRETT,MN,24,68,44,0.7391304347826086
BARRINGTON,IL,8787,9583,796,0.5216657593903102
BARRINGTON,NH,3252,3151,-101,0.49211307199750115
BARRINGTON,NJ,1694,1672,-22,0.49673202614379086
BARRINGTON,RI,4724,5579,855,0.5414927690963797
BARRON,WI,2647,2275,-372,0.4622104835432751
BARRONETT,WI,14,40,26,0.7407407407407407
BARROW,AK,711,378,-333,0.34710743801652894
BARRY,IL,644,610,-34,0.4864433811802233
BARRY,TX,136,292,156,0.6822429906542056
BARRYTON,MI,1300,1162,-138,0.4719740048740861
BARRYVILLE,NY,434,337,-97,0.437094682230869
BARSTOW,CA,14980,14096,-884,0.4847984592103453
BARSTOW,TX,11,0,-11,0
BARTELSO,IL,11,58,47,0.8405797101449275
BARTLESVILLE,OK,17905,16592,-1313,0.4809693596544627
BARTLETT,IL,10049,10415,366,0.5089425332290852
BARTLETT,NH,0,11,11,1
BARTLETT,TN,17469,17760,291,0.504130120071532
BARTLETT,TX,714,586,-128,0.45076923076923076
BARTO,PA,1145,1243,98,0.5205192629815746
BARTON,MD,186,71,-115,0.27626459143968873
BARTON,NY,733,598,-135,0.4492862509391435
BARTON,VT,1089,1066,-23,0.49466357308584685
BARTON CITY,MI,48,69,21,0.5897435897435898
BARTONSVILLE,PA,660,667,7,0.5026375282592314
BARTONVILLE,IL,2930,2613,-317,0.4714053761500992
BARTOW,FL,12761,13666,905,0.5171226397245242
BARTOW,GA,171,104,-67,0.3781818181818182
BARWICK,GA,11,0,-11,0
BASALT,CO,4085,3740,-345,0.4779552715654952
BASCOM,FL,34,92,58,0.7301587301587301
BASCOM,OH,13,0,-13,0
BASEHOR,KS,2849,3621,772,0.5596599690880989
BASILE,LA,689,816,127,0.5421926910299003
BASIN,WY,654,517,-137,0.44150298889837747
BASKERVILLE,VA,31,12,-19,0.27906976744186046
BASKIN,LA,85,29,-56,0.2543859649122807
BASKING RIDGE,NJ,7453,8961,1508,0.5459363957597173
BASOM,NY,191,107,-84,0.35906040268456374
BASS HARBOR,ME,273,260,-13,0.4878048780487805
BASS LAKE,CA,159,79,-80,0.3319327731092437
BASSETT,NE,325,202,-123,0.38330170777988615
BASSETT,VA,3671,3316,-355,0.47459567768713323
BASSFIELD,MS,267,410,143,0.6056129985228951
BASTIAN,VA,99,149,50,0.6008064516129032
BASTROP,LA,7428,6969,-459,0.48405917899562406
BASTROP,TX,13193,15423,2230,0.5389642158233157
BASYE,VA,409,420,11,0.5066344993968637
BATAVIA,IA,92,124,32,0.5740740740740741
BATAVIA,IL,8570,8574,4,0.5001166588894074
BATAVIA,NY,10617,9032,-1585,0.4596671586340272
BATAVIA,OH,13317,13192,-125,0.497642310158814
BATCHELOR,LA,36,0,-36,0
BATES CITY,MO,1047,1184,137,0.5307037203047961
BATESBURG,SC,2238,2326,88,0.5096406660823839
BATESBURG LEESVILLE,SC,137,136,-1,0.4981684981684982
BATESVILLE,AR,8358,7897,-461,0.48581974776991693
BATESVILLE,IN,3619,3830,211,0.5141629748959592
BATESVILLE,MS,4180,4130,-50,0.4969915764139591
BATH,IL,0,17,17,1
BATH,ME,5314,5152,-162,0.49226065354481174
BATH,MI,2696,2465,-231,0.477620616159659
BATH,NC,685,790,105,0.535593220338983
BATH,NH,263,232,-31,0.4686868686868687
BATH,NY,6257,5970,-287,0.4882636787437638
BATH,OH,51,46,-5,0.4742268041237113
BATH,PA,3753,3860,107,0.5070274530408512
BATH,SC,15,0,-15,0
BATH SPRINGS,TN,51,13,-38,0.203125
BATON ROUGE,LA,143146,127962,-15184,0.47199639995868803
BATSON,TX,51,65,14,0.5603448275862069
BATTLE CREEK,IA,314,184,-130,0.36947791164658633
BATTLE CREEK,MI,44394,36852,-7542,0.45358540728158925
BATTLE CREEK,NE,309,288,-21,0.4824120603015075
BATTLE GROUND,IN,795,710,-85,0.4717607973421927
BATTLE GROUND,WA,13260,14130,870,0.515881708652793
BATTLE LAKE,MN,2331,2207,-124,0.4863375936535919
BATTLE MOUNTAIN,NV,2589,2330,-259,0.47367351087619436
BATTLEBORO,NC,906,932,26,0.5070729053318824
BATTLEFIELD,MO,2350,2518,168,0.5172555464256368
BATTLEMENT MESA,CO,86,82,-4,0.4880952380952381
BATTLETOWN,KY,178,147,-31,0.4523076923076923
BAUDETTE,MN,1685,1465,-220,0.4650793650793651
BAUSMAN,PA,11,0,-11,0
BAUXITE,AR,1560,1813,253,0.5375037058997925
BAXLEY,GA,4736,4461,-275,0.48504947265412635
BAXTER,IA,529,501,-28,0.48640776699029126
BAXTER,KY,277,240,-37,0.46421663442940037
BAXTER,MN,4158,4000,-158,0.49031625398381956
BAXTER,TN,2441,2854,413,0.5389990557129367
BAXTER SPRINGS,KS,2712,2303,-409,0.459222333000997
BAY,AR,1005,958,-47,0.4880285277636271
BAY CITY,MI,28026,25210,-2816,0.4735517319107371
BAY CITY,OR,603,586,-17,0.4928511354079058
BAY CITY,TX,9736,7979,-1757,0.45040925769122214
BAY CITY,WI,149,99,-50,0.39919354838709675
BAY HARBOR ISLANDS,FL,1855,1753,-102,0.48586474501108645
BAY HEAD,NJ,780,836,56,0.5173267326732673
BAY MINETTE,AL,5623,5786,163,0.5071434832150057
BAY PINES,FL,239,224,-15,0.4838012958963283
BAY POINT,CA,2555,2397,-158,0.48404684975767365
BAY PORT,MI,192,146,-46,0.4319526627218935
BAY SAINT LOUIS,MS,5961,6427,466,0.5188085243784307
BAY SHORE,NY,20649,17762,-2887,0.46241961937986514
BAY SPRINGS,MS,1045,974,-71,0.48241703813769193
BAY ST LOUIS,MS,493,560,67,0.5318138651471985
BAY VILLAGE,OH,3625,4355,730,0.5457393483709273
BAYARD,IA,101,49,-52,0.32666666666666666
BAYARD,NE,613,548,-65,0.4720068906115418
BAYARD,NM,404,374,-30,0.480719794344473
BAYBORO,NC,551,591,40,0.5175131348511384
BAYFIELD,CO,4283,4994,711,0.5383205777729869
BAYFIELD,WI,1708,1525,-183,0.4716981132075472
BAYLIS,IL,0,17,17,1
BAYONNE,NJ,26269,23999,-2270,0.47742102331503145
BAYOU GOULA,LA,16,20,4,0.5555555555555556
BAYOU LA BATRE,AL,482,449,-33,0.4822771213748657
BAYOU LABATRE,AL,13,0,-13,0
BAYPORT,MN,1143,1199,56,0.5119555935098207
BAYPORT,NY,2682,2706,24,0.5022271714922049
BAYSIDE,CA,705,658,-47,0.4827586206896552
BAYSIDE,NY,16748,16043,-705,0.4892500991125614
BAYSIDE,TX,12,12,0,0.5
BAYSIDE,WI,914,1062,148,0.5374493927125507
BAYSIDE HILLS,NY,691,616,-75,0.47130833970925784
BAYTOWN,TX,42715,42581,-134,0.49921450009379104
BAYVIEW,ID,565,473,-92,0.4556840077071291
BAYVIEW,TX,101,77,-24,0.43258426966292135
BAYVILLE,NJ,6361,6868,507,0.5191624461410538
BAYVILLE,NY,1995,1906,-89,0.48859266854652655
BEACH,ND,75,59,-16,0.44029850746268656
BEACH CITY,OH,566,505,-61,0.4715219421101774
BEACH CITY,TX,824,1202,378,0.5932872655478776
BEACH HAVEN,NJ,1414,2132,718,0.6012408347433729
BEACH LAKE,PA,1017,856,-161,0.4570208222103577
BEACH PARK,IL,2906,2461,-445,0.4585429476430035
BEACHWOOD,NJ,2748,2900,152,0.5134560906515581
BEACHWOOD,OH,7478,7544,66,0.502196778058847
BEACON,IA,0,13,13,1
BEACON,NY,7779,7466,-313,0.4897343391275828
BEACON FALLS,CT,1883,2127,244,0.5304239401496259
BEACONSFIELD,IA,0,11,11,1
BEALE AFB,CA,2129,2025,-104,0.48748194511314397
BEALETON,VA,3693,3709,16,0.5010807889759524
BEALLSVILLE,OH,246,202,-44,0.45089285714285715
BEALS,ME,11,0,-11,0
BEAMAN,IA,22,16,-6,0.42105263157894735
BEAN STATION,TN,2375,2455,80,0.5082815734989649
BEAR,DE,15028,14978,-50,0.49916683330000666
BEAR CREEK,AL,163,142,-21,0.46557377049180326
BEAR CREEK,NC,848,628,-220,0.4254742547425474
BEAR CREEK,WI,183,165,-18,0.47413793103448276
BEAR LAKE,MI,1479,1505,26,0.5043565683646113
BEAR RIVER CITY,UT,77,37,-40,0.32456140350877194
BEAR VALLEY SPRINGS,CA,550,573,23,0.5102404274265361
BEARDEN,AR,362,368,6,0.5041095890410959
BEARDSLEY,MN,12,0,-12,0
BEARDSTOWN,IL,3302,2804,-498,0.45922043891254505
BEARSVILLE,NY,455,469,14,0.5075757575757576
BEASLEY,TX,145,436,291,0.7504302925989673
BEASON,IL,32,0,-32,0
BEATRICE,AL,0,25,25,1
BEATRICE,NE,7718,6390,-1328,0.4529345052452509
BEATTIE,KS,0,13,13,1
BEATTY,NV,108,52,-56,0.325
BEATTY,OR,0,12,12,1
BEATTYVILLE,KY,1894,1693,-201,0.4719821577920268
BEAUFORT,MO,166,234,68,0.585
BEAUFORT,NC,4820,5009,189,0.5096144063485604
BEAUFORT,SC,25666,24169,-1497,0.4849804354369419
BEAUMONT,CA,14410,17294,2884,0.5454832197829926
BEAUMONT,MS,207,275,68,0.5705394190871369
BEAUMONT,TX,52768,47558,-5210,0.474034647050615
BEAVER,OH,1215,977,-238,0.44571167883211676
BEAVER,OK,653,537,-116,0.4512605042016807
BEAVER,OR,49,0,-49,0
BEAVER,PA,4958,5063,105,0.5052389981039817
BEAVER,UT,1172,997,-175,0.45965882895343474
BEAVER,WA,0,12,12,1
BEAVER,WV,1167,1198,31,0.506553911205074
BEAVER CITY,NE,152,118,-34,0.43703703703703706
BEAVER COVE,ME,49,70,21,0.5882352941176471
BEAVER CREEK,MN,23,12,-11,0.34285714285714286
BEAVER CROSSING,NE,13,22,9,0.6285714285714286
BEAVER DAM,KY,3229,3064,-165,0.48689019545526774
BEAVER DAM,WI,10959,10034,-925,0.4779688467584433
BEAVER DAMS,NY,1398,1005,-393,0.418227215980025
BEAVER FALLS,PA,10018,8964,-1054,0.47223685596881254
BEAVER ISLAND,MI,1062,752,-310,0.4145534729878721
BEAVER MDWS,PA,14,13,-1,0.48148148148148145
BEAVER MEADOWS,PA,476,304,-172,0.38974358974358975
BEAVER SPRGS,PA,12,16,4,0.5714285714285714
BEAVER SPRINGS,PA,374,298,-76,0.44345238095238093
BEAVERCREEK,OH,20121,19598,-523,0.4934162491502807
BEAVERCREEK,OR,1996,1474,-522,0.42478386167146975
BEAVERCREEK TOWNSHIP,OH,1173,1348,175,0.5347084490281634
BEAVERDALE,PA,46,11,-35,0.19298245614035087
BEAVERDAM,VA,937,1247,310,0.5709706959706959
BEAVERLETT,VA,15,14,-1,0.4827586206896552
BEAVERTON,AL,23,11,-12,0.3235294117647059
BEAVERTON,MI,4416,4029,-387,0.4770870337477798
BEAVERTON,OR,97789,94928,-2861,0.4925771986903075
BEAVERTOWN,PA,433,368,-65,0.45942571785268416
BEAVERVILLE,IL,0,12,12,1
BECHTELSVILLE,PA,1002,1190,188,0.5428832116788321
BECIDA,MN,14,45,31,0.7627118644067796
BECKEMEYER,IL,80,39,-41,0.3277310924369748
BECKER,MN,3038,2922,-116,0.49026845637583893
BECKET,MA,1072,1158,86,0.5192825112107623
BECKLEY,WV,10484,9336,-1148,0.4710393541876892
BECKVILLE,TX,538,688,150,0.5611745513866232
BEDDINGTON,ME,83,71,-12,0.461038961038961
BEDFORD,IA,922,843,-79,0.4776203966005666
BEDFORD,IN,12775,11215,-1560,0.46748645268862027
BEDFORD,KY,2129,2011,-118,0.4857487922705314
BEDFORD,MA,5347,5307,-40,0.4981227707903135
BEDFORD,NH,8428,8632,204,0.505978898007034
BEDFORD,NY,1664,1890,226,0.5317951603826674
BEDFORD,OH,11574,10573,-1001,0.4774010023931006
BEDFORD,PA,4482,3988,-494,0.4708382526564345
BEDFORD,TX,29855,27529,-2326,0.4797330266276314
BEDFORD,VA,6441,6319,-122,0.4952194357366771
BEDFORD,WY,61,69,8,0.5307692307692308
BEDFORD CORNERS,NY,469,483,14,0.5073529411764706
BEDFORD HEIGHTS,OH,649,582,-67,0.47278635255889523
BEDFORD HILLS,NY,1732,1628,-104,0.4845238095238095
BEDFORD PARK,IL,846,743,-103,0.4675896790434235
BEDIAS,TX,1048,1167,119,0.52686230248307
BEDMINSTER,NJ,3575,3303,-272,0.4802268101192207
BEE,NE,0,11,11,1
BEE BRANCH,AR,408,439,31,0.5182998819362455
BEE CAVE,TX,1334,1681,347,0.5575456053067993
BEE SPRING,KY,218,133,-85,0.3789173789173789
BEEBE,AR,6203,6164,-39,0.49842322309371717
BEECH BLUFF,TN,713,808,95,0.5312294543063774
BEECH BOTTOM,WV,11,14,3,0.56
BEECH CREEK,KY,22,0,-22,0
BEECH CREEK,PA,659,480,-179,0.42142230026338895
BEECH GROVE,AR,27,0,-27,0
BEECH GROVE,IN,8390,6649,-1741,0.44211716204534873
BEECH ISLAND,SC,1821,2247,426,0.5523598820058997
BEECH MOUNTAIN,NC,602,628,26,0.510569105691057
BEECHER,IL,2646,2416,-230,0.477281706835243
BEECHER CITY,IL,274,193,-81,0.4132762312633833
BEECHGROVE,TN,1681,1062,-619,0.38716733503463363
BEECHHURST,NY,536,442,-94,0.45194274028629855
BEECHMONT,KY,327,154,-173,0.3201663201663202
BEEMER,NE,262,136,-126,0.3417085427135678
BEEVILLE,TX,6538,6030,-508,0.47978994271164865
BEGGS,OK,1046,1363,317,0.5657949356579494
BEJOU,MN,11,12,1,0.5217391304347826
BEL AIR,MD,20027,21649,1622,0.519459641040407
BEL AIRE,KS,2197,1154,-1043,0.3443748134885109
BEL ALTON,MD,11,47,36,0.8103448275862069
BEL TIBURON,CA,640,627,-13,0.494869771112865
BELAIRE,KS,234,128,-106,0.35359116022099446
BELCAMP,MD,3619,3051,-568,0.45742128935532234
BELCHER,KY,15,0,-15,0
BELCHERTOWN,MA,4727,4919,192,0.5099523118391043
BELCOURT,ND,909,841,-68,0.4805714285714286
BELDEN,MS,2005,1856,-149,0.4807044807044807
BELDEN,NE,0,11,11,1
BELDENVILLE,WI,65,56,-9,0.4628099173553719
BELDING,MI,4714,4015,-699,0.4599610493756444
BELEN,NM,5500,5721,221,0.5098476071651368
BELEWS CREEK,NC,381,603,222,0.6128048780487805
BELFAIR,WA,4854,5066,212,0.5106854838709678
BELFAST,ME,4404,4668,264,0.5145502645502645
BELFAST,NY,688,629,-59,0.4776006074411541
BELFAST,TN,243,207,-36,0.46
BELFIELD,ND,822,586,-236,0.4161931818181818
BELFORD,NJ,1308,1431,123,0.5224534501642936
BELFRY,KY,931,891,-40,0.48902305159165754
BELFRY,MT,0,42,42,1
BELGIUM,WI,1135,1110,-25,0.49443207126948774
BELGRADE,ME,1454,1558,104,0.5172642762284196
BELGRADE,MN,761,599,-162,0.4404411764705882
BELGRADE,MO,12,12,0,0.5
BELGRADE,MT,11433,11805,372,0.508004131164472
BELGRADE,NE,129,125,-4,0.4921259842519685
BELGRADE LAKES,ME,374,527,153,0.5849056603773585
BELHAVEN,NC,1245,1267,22,0.5043789808917197
BELINGTON,WV,1837,1708,-129,0.48180535966149507
BELL,CA,1805,1481,-324,0.4506999391357273
BELL,FL,1746,2024,278,0.5368700265251989
BELL BUCKLE,TN,1553,1812,259,0.538484398216939
BELL CANYON,CA,1565,1649,84,0.5130678282514001
BELL CITY,LA,69,50,-19,0.42016806722689076
BELL CITY,MO,66,40,-26,0.37735849056603776
BELL GARDENS,CA,9124,7443,-1681,0.4492666143538359
BELLA COLLINA,FL,78,94,16,0.5465116279069767
BELLA VISTA,AR,12716,14618,1902,0.5347918343455038
BELLA VISTA,CA,372,495,123,0.5709342560553633
BELLAIRE,MI,3025,2930,-95,0.4920235096557515
BELLAIRE,OH,3362,2614,-748,0.43741633199464525
BELLAIRE,TX,4974,6108,1134,0.5511640498105035
BELLARTHUR,NC,0,11,11,1
BELLBROOK,OH,3378,3651,273,0.5194195475885617
BELLE,MO,1100,1230,130,0.5278969957081545
BELLE,WV,1010,945,-65,0.4833759590792839
BELLE CENTER,OH,972,968,-4,0.49896907216494846
BELLE CHASSE,LA,5029,4816,-213,0.48918232605383444
BELLE FOURCHE,SD,4676,3877,-799,0.45329124283877004
BELLE GLADE,FL,5096,4927,-169,0.4915693904020752
BELLE HARBOR,NY,883,909,26,0.5072544642857143
BELLE HAVEN,VA,84,100,16,0.5434782608695652
BELLE ISLE,FL,5058,4382,-676,0.4641949152542373
BELLE MEAD,NJ,2849,3443,594,0.5472027972027972
BELLE PLAINE,IA,1199,1075,-124,0.4727352682497801
BELLE PLAINE,KS,1222,1037,-185,0.45905267817618417
BELLE PLAINE,MN,3033,3109,76,0.5061869098013676
BELLE RIVE,IL,22,12,-10,0.35294117647058826
BELLE ROSE,LA,527,482,-45,0.47770069375619423
BELLE VALLEY,OH,13,27,14,0.675
BELLE VERNON,PA,2849,2766,-83,0.4926090828138914
BELLEAIR,FL,2577,2378,-199,0.4799192734611504
BELLEAIR BCH,FL,198,209,11,0.5135135135135135
BELLEAIR BEACH,FL,1098,1268,170,0.5359256128486898
BELLEAIR BLUFFS,FL,736,719,-17,0.4941580756013746
BELLEAIR SHORES,FL,14,60,46,0.8108108108108109
BELLECHESTER,MN,44,31,-13,0.41333333333333333
BELLEFONTAINE,OH,7969,7811,-158,0.4949936628643853
BELLEFONTE,PA,6742,6714,-28,0.49895957193816887
BELLEMONT,AZ,755,1057,302,0.5833333333333334
BELLEROSE,NY,4818,4479,-339,0.48176831235882545
BELLEROSE MANOR,NY,215,254,39,0.5415778251599147
BELLEROSE VILLAGE,NY,193,238,45,0.5522041763341067
BELLEVIEW,FL,9641,10347,706,0.5176605963578147
BELLEVIEW,MO,48,25,-23,0.3424657534246575
BELLEVIEW,VA,159,175,16,0.5239520958083832
BELLEVILLE,AR,185,189,4,0.5053475935828877
BELLEVILLE,IL,29982,27545,-2437,0.47881864168129745
BELLEVILLE,KS,1141,1086,-55,0.48765154916928605
BELLEVILLE,MI,10905,9285,-1620,0.45988112927191677
BELLEVILLE,NJ,12085,10979,-1106,0.47602323968088794
BELLEVILLE,NY,0,24,24,1
BELLEVILLE,PA,1226,1134,-92,0.48050847457627116
BELLEVILLE,WI,1612,1738,126,0.5188059701492538
BELLEVILLE,WV,54,116,62,0.6823529411764706
BELLEVUE,IA,1750,1571,-179,0.47305028605841615
BELLEVUE,ID,997,1193,196,0.5447488584474885
BELLEVUE,IL,391,269,-122,0.4075757575757576
BELLEVUE,KY,2550,2325,-225,0.47692307692307695
BELLEVUE,MI,2016,1966,-50,0.4937217478653943
BELLEVUE,NE,33204,29575,-3629,0.47109702288981986
BELLEVUE,OH,4431,4122,-309,0.4819361627499123
BELLEVUE,PA,1494,1271,-223,0.4596745027124774
BELLEVUE,TX,71,106,35,0.5988700564971752
BELLEVUE,WA,99710,91310,-8400,0.47801277353156735
BELLFLOWER,CA,21501,18896,-2605,0.4677575067455504
BELLFLOWER,MO,115,63,-52,0.3539325842696629
BELLINGHAM,MA,5050,5331,281,0.5135343415855891
BELLINGHAM,MN,23,0,-23,0
BELLINGHAM,WA,71674,65558,-6116,0.47771656756441644
BELLMAWR,NJ,3166,3215,49,0.5038395235856449
BELLMEAD,TX,629,514,-115,0.44969378827646544
BELLMONT,IL,11,0,-11,0
BELLMORE,NY,2790,2731,-59,0.4946567650787901
BELLOWS FALLS,VT,1887,1849,-38,0.49491434689507496
BELLPORT,NY,5170,4667,-503,0.47443326217342685
BELLS,TN,1506,1461,-45,0.4924165824064712
BELLS,TX,1134,1211,77,0.5164179104477612
BELLVIEW,FL,619,750,131,0.547845142439737
BELLVILLE,OH,2299,2225,-74,0.4918213969938108
BELLVILLE,TX,3269,3225,-44,0.4966122574684324
BELLVUE,CO,905,827,-78,0.47748267898383373
BELLVUE,PA,180,177,-3,0.4957983193277311
BELLWOOD,IL,5596,5356,-240,0.48904309715120525
BELLWOOD,NE,75,63,-12,0.45652173913043476
BELLWOOD,PA,719,659,-60,0.4782293178519594
BELMAR,NJ,4511,4428,-83,0.49535742253048437
BELMOND,IA,1294,1159,-135,0.47248267427639623
BELMONT,CA,11762,10898,-864,0.48093556928508385
BELMONT,MA,9917,9879,-38,0.49904021014346334
BELMONT,ME,234,263,29,0.5291750503018109
BELMONT,MI,2823,3579,756,0.5590440487347704
BELMONT,MS,969,1025,56,0.5140421263791374
BELMONT,NC,10792,13170,2378,0.549620232034054
BELMONT,NH,2990,3107,117,0.509594882729211
BELMONT,NY,980,967,-13,0.49666153055983564
BELMONT,OH,908,772,-136,0.4595238095238095
BELMONT,VT,23,92,69,0.8
BELMONT,WI,182,221,39,0.5483870967741935
BELMONT,WV,0,11,11,1
BELOIT,KS,1579,1636,57,0.5088646967340591
BELOIT,OH,1088,986,-102,0.47540983606557374
BELOIT,WI,23547,19284,-4263,0.4502346431323107
BELPRE,OH,3946,3813,-133,0.49142930790050265
BELT,MT,371,361,-10,0.4931693989071038
BELTON,KY,97,11,-86,0.10185185185185185
BELTON,MO,11464,12011,547,0.5116506922257721
BELTON,SC,5415,5967,552,0.5242488139167106
BELTON,TX,16727,18684,1957,0.5276326565191607
BELTSVILLE,MD,11832,10718,-1114,0.4752993348115299
BELVEDERE TIBURON,CA,3542,3589,47,0.5032954704809984
BELVIDERE,IL,10773,10175,-598,0.4857265610082108
BELVIDERE,NC,48,39,-9,0.4482758620689655
BELVIDERE,NE,21,13,-8,0.38235294117647056
BELVIDERE,NJ,2078,2192,114,0.5133489461358314
BELVIDERE,TN,592,620,28,0.5115511551155115
BELVIDERE CENTER,VT,15,0,-15,0
BELVIEW,MN,15,12,-3,0.4444444444444444
BELZONI,MS,1685,1390,-295,0.45203252032520325
BEMENT,IL,542,469,-73,0.4638971315529179
BEMIDJI,MN,17455,15286,-2169,0.46687639351272103
BEMUS POINT,NY,1748,1634,-114,0.48314606741573035
BEN AVON,PA,385,321,-64,0.4546742209631728
BEN BOLT,TX,40,0,-40,0
BEN LOMOND,CA,2381,1938,-443,0.4487149803195184
BEN WHEELER,TX,1708,1963,255,0.5347316807409426
BENA,MN,91,76,-15,0.4550898203592814
BENA,VA,11,0,-11,0
BENAVIDES,TX,23,49,26,0.6805555555555556
BENBROOK,TX,11654,13595,1941,0.5384371658283497
BEND,OR,79252,80551,1299,0.5040643792669725
BENDERSVILLE,PA,43,14,-29,0.24561403508771928
BENHAM,KY,0,11,11,1
BENICIA,CA,10579,9937,-642,0.48435367518034705
BENKELMAN,NE,603,383,-220,0.38843813387423937
BENLD,IL,786,540,-246,0.4072398190045249
BENNET,NE,329,366,37,0.5266187050359712
BENNETT,CO,3109,3208,99,0.5078359981003641
BENNETT,IA,80,0,-80,0
BENNETT,NC,89,109,20,0.5505050505050505
BENNETT,WI,30,26,-4,0.4642857142857143
BENNETTSVILLE,SC,5137,4590,-547,0.4718823892258662
BENNINGTON,IN,24,17,-7,0.4146341463414634
BENNINGTON,KS,202,154,-48,0.43258426966292135
BENNINGTON,NE,3933,6316,2383,0.6162552444140892
BENNINGTON,NH,422,408,-14,0.491566265060241
BENNINGTON,OK,245,330,85,0.5739130434782609
BENNINGTON,VT,6875,6234,-641,0.47555114806621407
BENOIT,MS,15,0,-15,0
BENS RUN,WV,11,11,0,0.5
BENSALEM,PA,19734,17700,-2034,0.4728321846449752
BENSENVILLE,IL,7735,5888,-1847,0.4322102326947075
BENSON,AZ,6461,7089,628,0.5231734317343173
BENSON,IL,33,0,-33,0
BENSON,MN,2154,1947,-207,0.4747622531089978
BENSON,NC,4686,5896,1210,0.5571725571725572
BENSON,VT,58,33,-25,0.3626373626373626
BENT MOUNTAIN,VA,12,40,28,0.7692307692307693
BENTLEY,KS,25,23,-2,0.4791666666666667
BENTLEY,LA,68,24,-44,0.2608695652173913
BENTLEY,MI,90,0,-90,0
BENTLEYVILLE,OH,92,206,114,0.6912751677852349
BENTLEYVILLE,PA,1177,1093,-84,0.4814977973568282
BENTON,AR,20922,21585,663,0.5077987155056815
BENTON,IL,4711,4865,154,0.5080409356725146
BENTON,KS,580,681,101,0.5400475812846947
BENTON,KY,7188,7185,-3,0.49989563765393447
BENTON,LA,4239,4921,682,0.5372270742358078
BENTON,ME,443,439,-4,0.4977324263038549
BENTON,MO,1184,1220,36,0.5074875207986689
BENTON,MS,223,300,77,0.5736137667304015
BENTON,NH,109,48,-61,0.3057324840764331
BENTON,PA,1541,1451,-90,0.48495989304812837
BENTON,TN,1743,1783,40,0.5056721497447533
BENTON,WI,173,130,-43,0.429042904290429
BENTON CITY,WA,3739,3348,-391,0.4724142796669959
BENTON HARBOR,MI,11573,10623,-950,0.4785997477022887
BENTONIA,MS,538,519,-19,0.4910122989593188
BENTONVILLE,AR,38014,37178,-836,0.49444089796786894
BENTONVILLE,VA,437,444,7,0.5039727582292849
BENWOOD,WV,484,438,-46,0.4750542299349241
BENZONIA,MI,1077,1144,67,0.515083295812697
BEOWAWE,NV,13,0,-13,0
BEREA,KY,11338,11256,-82,0.4981853589448526
BEREA,OH,6782,6046,-736,0.4713127533520424
BERESFORD,SD,1180,1156,-24,0.4948630136986301
BERGEN,NY,1152,1126,-26,0.4942932396839333
BERGENFIELD,NJ,6630,6166,-464,0.4818693341669272
BERGER,MO,35,37,2,0.5138888888888888
BERGHEIM,TX,11,0,-11,0
BERGHOLZ,OH,118,78,-40,0.3979591836734694
BERGLAND,MI,53,14,-39,0.208955223880597
BERGMAN,AR,0,11,11,1
BERKELEY,CA,60257,45692,-14565,0.4312640987644999
BERKELEY,IL,1246,1359,113,0.5216890595009597
BERKELEY,MO,1445,1267,-178,0.4671828908554572
BERKELEY HEIGHTS,NJ,2539,3583,1044,0.585266252858543
BERKELEY HTS,NJ,50,55,5,0.5238095238095238
BERKELEY LAKE,GA,741,706,-35,0.4879060124395301
BERKELEY SPGS,WV,142,191,49,0.5735735735735735
BERKELEY SPRINGS,WV,4326,4527,201,0.5113520840393088
BERKEY,OH,0,13,13,1
BERKLEY,MA,1227,1504,277,0.5507140241669718
BERKLEY,MI,5407,4938,-469,0.4773320444659256
BERKSHIRE,NY,915,735,-180,0.44545454545454544
BERLIN,CT,3955,4450,495,0.529446757882213
BERLIN,GA,14,0,-14,0
BERLIN,IL,34,27,-7,0.4426229508196721
BERLIN,MA,1240,1548,308,0.5552367288378766
BERLIN,MD,9737,10730,993,0.5242585625641276
BERLIN,MI,172,176,4,0.5057471264367817
BERLIN,NH,5554,4532,-1022,0.44933571286932383
BERLIN,NJ,4405,4920,515,0.5276139410187668
BERLIN,NY,151,33,-118,0.1793478260869565
BERLIN,OH,13,0,-13,0
BERLIN,PA,1240,1180,-60,0.48760330578512395
BERLIN,VT,76,64,-12,0.45714285714285713
BERLIN,WI,3781,3526,-255,0.48255097851375395
BERLIN BORO,NJ,69,82,13,0.543046357615894
BERLIN CENTER,OH,641,543,-98,0.45861486486486486
BERLIN HEIGHTS,OH,565,632,67,0.5279866332497911
BERLIN HTS,OH,15,17,2,0.53125
BERLIN TOWNSHIP,NJ,224,278,54,0.5537848605577689
BERMUDA DUNES,CA,2824,3853,1029,0.5770555638759922
BERMUDA RUN,NC,402,505,103,0.5567805953693495
BERN,KS,27,0,-27,0
BERNALILLO,NM,2883,2851,-32,0.49720962678758285
BERNARD,IA,36,56,20,0.6086956521739131
BERNARD,ME,186,202,16,0.520618556701031
BERNARDSTON,MA,749,724,-25,0.49151391717583165
BERNARDSVILLE,NJ,2077,2351,274,0.5309394760614273
BERNE,IN,2231,2107,-124,0.48570769940064545
BERNE,NY,314,484,170,0.606516290726817
BERNHARDS BAY,NY,432,382,-50,0.4692874692874693
BERNICE,LA,779,746,-33,0.48918032786885246
BERNICE,OK,156,202,46,0.5642458100558659
BERNIE,MO,1179,1065,-114,0.47459893048128343
BERNVILLE,PA,1996,1903,-93,0.4880738650936137
BERRIEN CENTER,MI,37,33,-4,0.4714285714285714
BERRIEN SPRINGS,MI,5159,4174,-985,0.447230258223508
BERRY,AL,1061,1131,70,0.5159671532846716
BERRY,KY,681,728,47,0.5166784953867991
BERRY CREEK,CA,1601,274,-1327,0.14613333333333334
BERRYTON,KS,628,749,121,0.5439360929557008
BERRYVILLE,AR,3865,3580,-285,0.48085963734049697
BERRYVILLE,VA,2960,3357,397,0.5314231438974196
BERTHA,MN,270,143,-127,0.34624697336561744
BERTHOLD,ND,42,23,-19,0.35384615384615387
BERTHOUD,CO,6268,9367,3099,0.5991045730732332
BERTRAM,TX,2016,2908,892,0.5905767668562144
BERTRAND,MO,402,298,-104,0.4257142857142857
BERTRAND,NE,64,69,5,0.518796992481203
BERVILLE,MI,16,0,-16,0
BERWICK,IA,34,23,-11,0.40350877192982454
BERWICK,LA,1741,1356,-385,0.43784307394252503
BERWICK,ME,2665,2669,4,0.5003749531308587
BERWICK,MS,12,19,7,0.6129032258064516
BERWICK,PA,8833,7506,-1327,0.4593916396352286
BERWYN,IL,18373,15521,-2852,0.45792765681241515
BERWYN,NE,23,0,-23,0
BERWYN,PA,3135,3560,425,0.5317401045556386
BERWYN HEIGHTS,MD,787,720,-67,0.47777040477770405
BERWYN HTS,MD,403,288,-115,0.41678726483357453
BERYL,UT,22,26,4,0.5416666666666666
BESSEMER,AL,18705,18756,51,0.5006807079362537
BESSEMER,MI,1291,1209,-82,0.4836
BESSEMER,PA,198,156,-42,0.4406779661016949
BESSEMER CITY,NC,4474,4504,30,0.501670750723992
BESSIE,OK,11,0,-11,0
BETHALTO,IL,4068,4122,54,0.5032967032967033
BETHANY,CT,1201,1441,240,0.54542013626040875
BETHANY,IL,426,410,-16,0.4904306220095694
BETHANY,LA,73,99,26,0.5755813953488372
BETHANY,MO,2114,1978,-136,0.4833822091886608
BETHANY,OK,11266,7975,-3291,0.41447949690764513
BETHANY,WV,0,23,23,1
BETHANY BEACH,DE,3333,3578,245,0.5177253653595717
BETHEL,AK,2554,1109,-1445,0.3027573027573028
BETHEL,CT,6158,6678,520,0.5202555313181677
BETHEL,ME,1476,1483,7,0.5011828320378506
BETHEL,MN,1299,1246,-53,0.48958742632612967
BETHEL,MO,23,24,1,0.5106382978723404
BETHEL,NC,379,346,-33,0.4772413793103448
BETHEL,OH,3916,3757,-159,0.4896389938746253
BETHEL,PA,1041,956,-85,0.4787180771156735
BETHEL,VT,1104,1104,0,0.5
BETHEL HEIGHTS,AR,455,423,-32,0.48177676537585423
BETHEL ISLAND,CA,752,960,208,0.5607476635514018
BETHEL PARK,PA,8074,8454,380,0.5114956437560504
BETHEL SPRINGS,TN,1274,1227,-47,0.49060375849660137
BETHESDA,MD,36365,38150,1785,0.5119774542038515
BETHESDA,OH,761,637,-124,0.45565092989985695
BETHLEHEM,CT,1285,1205,-80,0.4839357429718876
BETHLEHEM,GA,5472,6157,685,0.5294522314902399
BETHLEHEM,NH,1306,1334,28,0.5053030303030303
BETHLEHEM,PA,47560,44722,-2838,0.48462322012960274
BETHPAGE,NY,5884,5790,-94,0.4959739592256296
BETHPAGE,TN,1937,2047,110,0.5138052208835341
BETHUNE,SC,373,543,170,0.5927947598253275
BETSY LAYNE,KY,0,22,22,1
BETTENDORF,IA,17812,17561,-251,0.4964520962315891
BETTERTON,MD,13,13,0,0.5
BETTSVILLE,OH,80,28,-52,0.25925925925925924
BEULAH,CO,349,448,99,0.562107904642409
BEULAH,MI,2182,2017,-165,0.4803524648725887
BEULAH,ND,1694,1223,-471,0.4192663695577648
BEULAH,WY,12,0,-12,0
BEULAVILLE,NC,2672,2576,-96,0.49085365853658536
BEVERLY,MA,15793,15199,-594,0.49041688177594217
BEVERLY,NJ,2755,2427,-328,0.46835198764955616
BEVERLY,OH,918,752,-166,0.4502994011976048
BEVERLY,WA,80,192,112,0.7058823529411765
BEVERLY,WV,1209,1031,-178,0.4602678571428571
BEVERLY BEACH,FL,653,639,-14,0.49458204334365324
BEVERLY HILLS,CA,25551,26367,816,0.5078585461689588
BEVERLY HILLS,FL,10478,11907,1429,0.5319186955550592
BEVERLY HILLS,MI,2724,2661,-63,0.49415041782729807
BEVERLY SHORES,IN,278,277,-1,0.4990990990990991
BEVIER,MO,321,292,-29,0.4763458401305057
BEXLEY,OH,2379,2523,144,0.51468788249694
BIBLE GROVE,IL,0,15,15,1
BIBLE SCHOOL PARK,NY,12,0,-12,0
BICKNELL,IN,2566,1941,-625,0.4306634124694919
BICKNELL,UT,14,11,-3,0.44
BIDDEFORD,ME,10894,10626,-268,0.4937732342007435
BIDDEFORD PL,ME,26,11,-15,0.2972972972972973
BIDDEFORD POOL,ME,257,251,-6,0.4940944881889764
BIDWELL,OH,1582,1465,-117,0.48080078765999346
BIEBER,CA,0,15,15,1
BIG ARM,MT,244,92,-152,0.27380952380952384
BIG BAY,MI,184,124,-60,0.4025974025974026
BIG BEAR CITY,CA,4073,3120,-953,0.4337550396218546
BIG BEAR LAKE,CA,3297,2945,-352,0.47180390900352454
BIG BEND,WI,797,938,141,0.5406340057636888
BIG BEND,WV,0,13,13,1
BIG BEND NATIONAL PARK,TX,41,35,-6,0.4605263157894737
BIG CABIN,OK,291,452,161,0.6083445491251682
BIG CANOE,GA,2048,2524,476,0.5520559930008749
BIG CLIFTY,KY,541,619,78,0.5336206896551724
BIG COVE TANNERY,PA,0,29,29,1
BIG CREEK,CA,27,0,-27,0
BIG FALLS,MN,11,0,-11,0
BIG FLAT,AR,0,11,11,1
BIG FLATS,NY,670,580,-90,0.464
BIG HORN,WY,134,221,87,0.6225352112676056
BIG INDIAN,NY,0,62,62,1
BIG ISLAND,VA,212,163,-49,0.43466666666666665
BIG LAKE,AK,1532,1539,7,0.5011396939107783
BIG LAKE,MN,9128,8112,-1016,0.4705336426914153
BIG LAKE,TX,871,625,-246,0.4177807486631016
BIG LAKE TWP,ME,25,11,-14,0.3055555555555556
BIG OAK FLAT,CA,11,0,-11,0
BIG PINE,CA,390,395,5,0.5031847133757962
BIG PINE KEY,FL,4839,5576,737,0.5353816610657706
BIG PINEY,WY,719,587,-132,0.44946401225114857
BIG POOL,MD,13,50,37,0.7936507936507936
BIG PRAIRIE,OH,150,170,20,0.53125
BIG RAPIDS,MI,9455,8238,-1217,0.4656078675182275
BIG RIVER,CA,239,454,215,0.6551226551226551
BIG ROCK,IL,306,242,-64,0.4416058394160584
BIG ROCK,TN,571,445,-126,0.43799212598425197
BIG ROCK,VA,23,0,-23,0
BIG RUN,PA,199,101,-98,0.33666666666666667
BIG SANDY,MT,290,118,-172,0.28921568627450983
BIG SANDY,TN,1362,1484,122,0.5214335910049192
BIG SANDY,TX,2098,2094,-4,0.49952290076335876
BIG SKY,MT,2843,2955,112,0.5096585029320455
BIG SPRING,KY,132,151,19,0.5335689045936396
BIG SPRING,TX,12568,10568,-2000,0.45677731673582295
BIG SPRINGS,NE,23,0,-23,0
BIG SPRINGS,WV,12,0,-12,0
BIG STONE CITY,SD,445,163,-282,0.2680921052631579
BIG STONE GAP,VA,2836,2397,-439,0.45805465316262184
BIG SUR,CA,500,187,-313,0.27219796215429404
BIG TIMBER,MT,1262,1271,9,0.5017765495459929
BIG WATER,UT,70,77,7,0.5238095238095238
BIGELOW,AR,631,779,148,0.5524822695035461
BIGFOOT,TX,13,41,28,0.7592592592592593
BIGFORK,MN,929,881,-48,0.4867403314917127
BIGFORK,MT,6684,7286,602,0.521546170365068
BIGGERS,AR,11,25,14,0.6944444444444444
BIGGS,CA,839,773,-66,0.4795285359801489
BIGGSVILLE,IL,11,0,-11,0
BIGLERVILLE,PA,1591,1500,-91,0.4852798447104497
BILLERICA,MA,8665,8554,-111,0.4967768163075672
BILLINGS,MO,1755,1957,202,0.5272090517241379
BILLINGS,MT,82457,72169,-10288,0.4667326322869375
BILLINGS,OK,0,38,38,1
BILLINGSLEY,AL,253,217,-36,0.46170212765957447
BILOXI,MS,36617,30511,-6106,0.45451972351328807
BIMBLE,KY,43,12,-31,0.21818181818181817
BINFORD,ND,22,40,18,0.6451612903225806
BINGEN,WA,640,423,-217,0.39793038570084666
BINGER,OK,232,144,-88,0.3829787234042553
BINGHAM,IL,11,11,0,0.5
BINGHAM,ME,381,402,21,0.5134099616858238
BINGHAM CANYON,UT,48,12,-36,0.2
BINGHAM FARMS,MI,894,944,50,0.5136017410228509
BINGHAM LAKE,MN,15,0,-15,0
BINGHAMTON,NY,36642,30938,-5704,0.4577981651376147
BIOLA,CA,17,23,6,0.575
BIRCH HARBOR,ME,38,0,-38,0
BIRCH RIVER,WV,11,23,12,0.6764705882352942
BIRCH RUN,MI,2989,2678,-311,0.4725604376213164
BIRCH TREE,MO,1091,1097,6,0.5013711151736746
BIRCHLEAF,VA,17,11,-6,0.39285714285714285
BIRCHRUNVILLE,PA,24,0,-24,0
BIRCHWOOD,TN,746,983,237,0.5685367264314632
BIRCHWOOD,WI,1720,1612,-108,0.4837935174069628
BIRD CITY,KS,24,23,-1,0.48936170212765956
BIRD IN HAND,PA,103,96,-7,0.4824120603015075
BIRD ISLAND,MN,570,341,-229,0.3743139407244786
BIRDSBORO,PA,4303,4240,-63,0.49631277068945334
BIRDSEYE,IN,446,498,52,0.527542372881356
BIRDSNEST,VA,17,13,-4,0.43333333333333335
BIRMINGHAM,AL,145802,129846,-15956,0.4710572904573949
BIRMINGHAM,IA,149,38,-111,0.20320855614973263
BIRMINGHAM,MI,11193,10667,-526,0.48796889295516926
BIRNAMWOOD,WI,743,884,141,0.5433312845728334
BISBEE,AZ,3089,3329,240,0.5186974135244624
BISCAYNE PARK,FL,831,680,-151,0.4500330906684315
BISCOE,AR,32,0,-32,0
BISCOE,NC,702,737,35,0.5121612230715775
BISHOP,CA,5921,5409,-512,0.47740511915269196
BISHOP,GA,1204,1407,203,0.5388739946380697
BISHOP,TX,1064,1097,33,0.5076353540027765
BISHOPVILLE,MD,701,891,190,0.5596733668341709
BISHOPVILLE,SC,3345,2887,-458,0.46325417201540436
BISMARCK,AR,1870,1773,-97,0.4866867965962119
BISMARCK,IL,103,127,24,0.5521739130434783
BISMARCK,MO,1426,1482,56,0.5096286107290234
BISMARCK,ND,49534,39926,-9608,0.4463000223563604
BISON,SD,11,0,-11,0
BITELY,MI,1024,1032,8,0.5019455252918288
BIVINS,TX,157,351,194,0.6909448818897638
BIWABIK,MN,328,171,-157,0.342685370741483
BIXBY,OK,10855,13572,2717,0.5556146886641831
BLACHLY,OR,11,11,0,0.5
BLACK,AL,11,0,-11,0
BLACK CANYON CITY,AZ,2028,2174,146,0.5173726796763446
BLACK CREEK,NC,46,52,6,0.5306122448979592
BLACK CREEK,WI,1179,1067,-112,0.47506678539626
BLACK CYN CTY,AZ,83,109,26,0.5677083333333334
BLACK DIAMOND,WA,2186,3822,1636,0.6361517976031957
BLACK EAGLE,MT,367,411,44,0.5282776349614395
BLACK EARTH,WI,629,802,173,0.5604472396925227
BLACK HAWK,CO,1820,1802,-18,0.49751518498067365
BLACK HAWK,SD,2440,2054,-386,0.45705384957721407
BLACK JACK,MO,6543,6037,-506,0.4798887122416534
BLACK LICK,PA,67,36,-31,0.34951456310679613
BLACK MOUNTAIN,NC,6336,6886,550,0.5207986688851913
BLACK RIVER,MI,128,92,-36,0.41818181818181815
BLACK RIVER,NY,1395,1356,-39,0.49291166848418755
BLACK RIVER FALLS,WI,5150,4178,-972,0.44789879931389365
BLACK ROCK,AR,222,209,-13,0.48491879350348027
BLACKBURN,MO,11,12,1,0.5217391304347826
BLACKBURN,OK,68,46,-22,0.40350877192982454
BLACKDUCK,MN,927,920,-7,0.49810503519220356
BLACKEY,KY,0,13,13,1
BLACKFOOT,ID,9592,8898,-694,0.4812330989724175
BLACKHAWK,CA,683,927,244,0.575776397515528
BLACKLICK,OH,12552,13463,911,0.5175091293484528
BLACKSBURG,SC,3090,3146,56,0.5044900577293137
BLACKSBURG,VA,27031,17456,-9575,0.39238429204037134
BLACKSHEAR,GA,5109,5515,406,0.5191076807228916
BLACKSTOCK,SC,128,147,19,0.5345454545454545
BLACKSTONE,MA,2943,2958,15,0.5012709710218607
BLACKSTONE,VA,2844,2410,-434,0.4586981347544728
BLACKVILLE,SC,1136,1048,-88,0.47985347985347987
BLACKWATER,MO,24,14,-10,0.3684210526315789
BLACKWATER,VA,14,0,-14,0
BLACKWELL,MO,11,57,46,0.8382352941176471
BLACKWELL,OK,3702,3114,-588,0.45686619718309857
BLACKWELL,TX,0,25,25,1
BLACKWOOD,NJ,11058,10609,-449,0.48963862094429317
BLADEN,NE,15,0,-15,0
BLADENBORO,NC,2421,1734,-687,0.41732851985559566
BLADENSBURG,MD,4812,3663,-1149,0.43221238938053097
BLAIN,PA,94,41,-53,0.3037037037037037
BLAINE,KY,12,22,10,0.6470588235294118
BLAINE,ME,41,169,128,0.8047619047619048
BLAINE,MN,10402,10750,348,0.5082261724659607
BLAINE,TN,1024,1234,210,0.5465013286093888
BLAINE,WA,9114,10767,1653,0.5415723555153161
BLAIR,NE,4967,4659,-308,0.48400166216496987
BLAIR,OK,282,389,107,0.5797317436661699
BLAIR,SC,0,11,11,1
BLAIR,WI,970,807,-163,0.45413618458075405
BLAIRS,VA,453,633,180,0.5828729281767956
BLAIRS MILLS,PA,0,12,12,1
BLAIRSDEN,CA,143,114,-29,0.44357976653696496
BLAIRSDEN GRAEAGLE,CA,684,614,-70,0.47303543913713403
BLAIRSTOWN,IA,115,136,21,0.5418326693227091
BLAIRSTOWN,MO,11,0,-11,0
BLAIRSTOWN,NJ,1912,2249,337,0.5404950732996876
BLAIRSVILLE,GA,11641,12623,982,0.5202357401912298
BLAIRSVILLE,PA,3252,3140,-112,0.49123904881101377
BLAKELY,GA,2688,2437,-251,0.4755121951219512
BLAKELY,PA,444,513,69,0.5360501567398119
BLAKESBURG,IA,80,0,-80,0
BLAKESLEE,PA,1755,1819,64,0.5089535534415222
BLANCA,CO,85,59,-26,0.4097222222222222
BLANCH,NC,35,72,37,0.6728971962616822
BLANCHARD,ID,1000,1122,122,0.528746465598492
BLANCHARD,LA,94,27,-67,0.2231404958677686
BLANCHARD,MI,771,738,-33,0.48906560636182905
BLANCHARD,OK,5858,6882,1024,0.5401883830455259
BLANCHARD,PA,11,0,-11,0
BLANCHARD TWP,ME,29,23,-6,0.4423076923076923
BLANCHARDVILLE,WI,882,680,-202,0.4353393085787452
BLANCHESTER,OH,2852,2815,-37,0.49673548614787366
BLANCO,NM,0,13,13,1
BLANCO,TX,2145,3128,983,0.5932106959984829
BLAND,MO,588,685,97,0.5380989787902593
BLAND,VA,600,681,81,0.531615925058548
BLANDBURG,PA,13,0,-13,0
BLANDFORD,MA,173,180,7,0.509915014164306
BLANDING,UT,1187,1155,-32,0.4931682322801025
BLANDINSVILLE,IL,158,99,-59,0.3852140077821012
BLANDON,PA,2001,2026,25,0.5031040476781723
BLANKET,TX,415,199,-216,0.3241042345276873
BLASDELL,NY,1394,1488,94,0.5163081193615545
BLAUVELT,NY,1071,1113,42,0.5096153846153846
BLAWNOX,PA,398,472,74,0.542528735632184
BLENCOE,IA,15,14,-1,0.4827586206896552
BLESSING,TX,75,112,37,0.5989304812834224
BLEVINS,AR,0,11,11,1
BLG,UT,222,186,-36,0.45588235294117646
BLISS,ID,26,81,55,0.7570093457943925
BLISS,NY,535,467,-68,0.4660678642714571
BLISSFIELD,MI,1915,1692,-223,0.4690878846686998
BLMNG PRAIRIE,MN,58,61,3,0.5126050420168067
BLOCK ISLAND,RI,1875,1340,-535,0.416796267496112
BLODGETT,MO,11,0,-11,0
BLODGETT,OR,54,33,-21,0.3793103448275862
BLOMKEST,MN,26,24,-2,0.48
BLOOMBURG,TX,117,226,109,0.6588921282798834
BLOOMDALE,OH,166,90,-76,0.3515625
BLOOMER,WI,2498,2384,-114,0.4883244571896764
BLOOMFIELD,CT,9098,8966,-132,0.49634632418069086
BLOOMFIELD,IA,2408,2203,-205,0.4777705486879202
BLOOMFIELD,IN,3265,3436,171,0.51275928965826
BLOOMFIELD,KY,1442,1395,-47,0.4917166020444131
BLOOMFIELD,MI,310,386,76,0.5545977011494253
BLOOMFIELD,MO,1564,1369,-195,0.4667575860893283
BLOOMFIELD,NE,484,478,-6,0.4968814968814969
BLOOMFIELD,NJ,19033,17217,-1816,0.474951724137931
BLOOMFIELD,NM,4751,3886,-865,0.44992474238740304
BLOOMFIELD,NY,1971,1972,1,0.5001268069997464
BLOOMFIELD,PA,590,426,-164,0.41929133858267714
BLOOMFIELD,VT,0,18,18,1
BLOOMFIELD HILLS,MI,15653,15998,345,0.5054500647688857
BLOOMFIELD TOWNSHIP,MI,1832,2183,351,0.5437110834371108
BLOOMING GROVE,NY,53,0,-53,0
BLOOMING GROVE,TX,221,319,98,0.5907407407407408
BLOOMING PRAIRIE,MN,1055,976,-79,0.48055145248645986
BLOOMINGBURG,NY,2288,2249,-39,0.49570200573065903
BLOOMINGBURG,OH,292,378,86,0.564179104477612
BLOOMINGDALE,GA,3030,3281,251,0.5198859134843923
BLOOMINGDALE,IL,8746,8278,-468,0.4862546992481203
BLOOMINGDALE,IN,83,91,8,0.5229885057471264
BLOOMINGDALE,MI,878,855,-23,0.4933641084824005
BLOOMINGDALE,NJ,2445,2279,-166,0.48243014394580863
BLOOMINGDALE,NY,164,149,-15,0.476038338658147
BLOOMINGDALE,OH,630,674,44,0.5168711656441718
BLOOMINGTON,CA,5966,5766,-200,0.4914763041254688
BLOOMINGTON,IL,41161,38280,-2881,0.48186704598381186
BLOOMINGTON,IN,110785,57006,-53779,0.33974408639319154
BLOOMINGTON,MD,0,15,15,1
BLOOMINGTON,MN,20796,18184,-2612,0.46649563878912265
BLOOMINGTON,NY,24,41,17,0.6307692307692307
BLOOMINGTON,TX,364,240,-124,0.3973509933774834
BLOOMINGTON,WI,103,96,-7,0.4824120603015075
BLOOMINGTON SPRINGS,TN,226,319,93,0.5853211009174312
BLOOMSBURG,PA,9517,9412,-105,0.4972264778910666
BLOOMSBURY,NJ,713,753,40,0.5136425648021828
BLOOMSDALE,MO,666,743,77,0.5273243435060326
BLOOMVILLE,NY,93,92,-1,0.4972972972972973
BLOOMVILLE,OH,657,642,-15,0.4942263279445728
BLOSSBURG,PA,1132,964,-168,0.4599236641221374
BLOSSOM,TX,1018,994,-24,0.49403578528827036
BLOSSVALE,NY,1434,1324,-110,0.48005801305293694
BLOUNTS CREEK,NC,171,307,136,0.6422594142259415
BLOUNTSTOWN,FL,2073,2002,-71,0.4912883435582822
BLOUNTSVILLE,AL,2476,2278,-198,0.47917543121581824
BLOUNTVILLE,TN,4542,4512,-30,0.4983432736911862
BLOWING ROCK,NC,4139,3913,-226,0.48596621957277697
BLOXOM,VA,154,233,79,0.6020671834625323
BLUE ASH,OH,9197,9020,-177,0.49514190042268214
BLUE BALL,PA,11,0,-11,0
BLUE BELL,PA,7079,7957,878,0.5291965948390529
BLUE CREEK,OH,207,122,-85,0.3708206686930091
BLUE EARTH,MN,1875,1795,-80,0.4891008174386921
BLUE EYE,MO,1054,1079,25,0.5058602906704173
BLUE GRASS,IA,1255,1400,145,0.527306967984934
BLUE HILL,ME,2382,2110,-272,0.4697239536954586
BLUE HILL,NE,273,240,-33,0.4678362573099415
BLUE ISLAND,IL,8387,6699,-1688,0.4440540898846613
BLUE JAY,CA,1367,1121,-246,0.45056270096463025
BLUE LAKE,CA,380,590,210,0.6082474226804123
BLUE MOUND,IL,578,522,-56,0.47454545454545455
BLUE MOUND,KS,0,12,12,1
BLUE MOUND,TX,1088,1357,269,0.5550102249488753
BLUE MOUNDS,WI,335,397,62,0.5423497267759563
BLUE MOUNTAIN,AL,11,0,-11,0
BLUE MOUNTAIN,MS,686,589,-97,0.4619607843137255
BLUE MOUNTAIN LAKE,NY,14,28,14,0.6666666666666666
BLUE MTN LAKE,NY,14,0,-14,0
BLUE POINT,NY,1255,1260,5,0.5009940357852882
BLUE RAPIDS,KS,207,202,-5,0.4938875305623472
BLUE RIDGE,GA,5903,5589,-314,0.48633832231117297
BLUE RIDGE,TX,1259,1542,283,0.5505176722599072
BLUE RIDGE,VA,1200,1317,117,0.5232419547079857
BLUE RIDGE SUMMIT,PA,172,217,45,0.5578406169665809
BLUE RIVER,OR,801,548,-253,0.4062268346923647
BLUE RIVER,WI,294,325,31,0.5250403877221325
BLUE ROCK,OH,176,59,-117,0.251063829787234
BLUE SPRINGS,MO,24247,24640,393,0.5040194734796571
BLUE SPRINGS,MS,951,1029,78,0.5196969696969697
BLUE SPRINGS,NE,46,22,-24,0.3235294117647059
BLUEBELL,UT,11,0,-11,0
BLUEFIELD,VA,2876,2467,-409,0.46172562230956393
BLUEFIELD,WV,7432,6231,-1201,0.45604918392739513
BLUEJACKET,OK,81,102,21,0.5573770491803278
BLUEMONT,VA,736,910,174,0.5528554070473876
BLUEWATER,NM,0,12,12,1
BLUFF,UT,150,97,-53,0.39271255060728744
BLUFF CITY,TN,3610,4101,491,0.5318376345480482
BLUFF DALE,TX,326,883,557,0.7303556658395368
BLUFF POINT,NY,68,31,-37,0.31313131313131315
BLUFFDALE,UT,2485,2788,303,0.5287312725203869
BLUFFS,IL,110,65,-45,0.37142857142857144
BLUFFTON,IN,7483,6644,-839,0.47030508954484324
BLUFFTON,OH,1722,1557,-165,0.47483989021043
BLUFFTON,SC,29798,36221,6423,0.5486450870204033
BLUFORD,IL,326,217,-109,0.3996316758747698
BLUM,TX,240,334,94,0.5818815331010453
BLUNT,SD,11,11,0,0.5
BLY,OR,11,26,15,0.7027027027027027
BLYTHE,CA,6141,4708,-1433,0.43395704673241775
BLYTHE,GA,969,870,-99,0.4730831973898858
BLYTHEVILLE,AR,9841,8193,-1648,0.45430852833536656
BLYTHEWOOD,SC,7754,11101,3347,0.588756298064174
BOALSBURG,PA,2050,2214,164,0.5192307692307693
BOARDMAN,OH,3281,2889,-392,0.46823338735818476
BOARDMAN,OR,1814,1436,-378,0.44184615384615383
BOAZ,AL,7492,7209,-283,0.4903748044350724
BOAZ,KY,540,468,-72,0.4642857142857143
BOBTOWN,PA,26,0,-26,0
BOCA GRANDE,FL,4538,3307,-1231,0.4215423836838751
BOCA RATON,FL,139639,146127,6488,0.5113519452979011
BODE,IA,11,24,13,0.6857142857142857
BODEGA,CA,11,0,-11,0
BODEGA BAY,CA,583,641,58,0.5236928104575164
BODFISH,CA,1030,1010,-20,0.4950980392156863
BOELUS,NE,12,25,13,0.6756756756756757
BOERNE,TX,18948,25544,6596,0.5741256855164973
BOGALUSA,LA,7600,5806,-1794,0.4330896613456661
BOGARD,MO,0,14,14,1
BOGART,GA,3153,3590,437,0.5324039744920659
BOGATA,TX,891,867,-24,0.4931740614334471
BOGOTA,NJ,2521,2351,-170,0.4825533661740558
BOGUE,KS,17,0,-17,0
BOGUE CHITTO,MS,1491,1525,34,0.5056366047745358
BOHEMIA,NY,4410,3894,-516,0.4689306358381503
BOICEVILLE,NY,136,100,-36,0.423728813559322
BOILING SPGS,NC,11,0,-11,0
BOILING SPGS,PA,113,121,8,0.5170940170940171
BOILING SPGS,SC,478,608,130,0.5598526703499079
BOILING SPRINGS,NC,209,11,-198,0.05
BOILING SPRINGS,PA,1377,1534,157,0.5269666781174854
BOILING SPRINGS,SC,11002,12279,1277,0.5274257978609166
BOIS BLANC ISLAND,MI,15,25,10,0.625
BOIS D ARC,MO,134,262,128,0.6616161616161617
BOISE,ID,157343,136353,-20990,0.4642657714098932
BOISE CITY,OK,92,37,-55,0.2868217054263566
BOKCHITO,OK,538,611,73,0.5317667536988686
BOKEELIA,FL,5393,5136,-257,0.4877956121189097
BOKOSHE,OK,650,781,131,0.5457721872816212
BOLCKOW,MO,13,0,-13,0
BOLES,AR,24,0,-24,0
BOLIGEE,AL,51,41,-10,0.44565217391304346
BOLINAS,CA,226,159,-67,0.412987012987013
BOLING,TX,229,349,120,0.6038062283737025
BOLINGBROOK,IL,21448,20687,-761,0.49096950278865553
BOLIVAR,MO,10418,8904,-1514,0.4608218610909844
BOLIVAR,NY,1443,1275,-168,0.46909492273730685
BOLIVAR,OH,1765,1682,-83,0.4879605454017987
BOLIVAR,PA,166,132,-34,0.4429530201342282
BOLIVAR,TN,2580,2708,128,0.5121028744326778
BOLIVAR,WV,225,201,-24,0.47183098591549294
BOLIVIA,NC,2743,4645,1902,0.6287222523010287
BOLLING AFB,DC,8292,6633,-1659,0.4444221105527638
BOLTON,CT,1311,1437,126,0.5229257641921398
BOLTON,MA,1348,1677,329,0.5543801652892562
BOLTON,MS,366,475,109,0.5648038049940547
BOLTON,NC,126,149,23,0.5418181818181819
BOLTON LANDING,NY,1608,1315,-293,0.4498802600068423
BOLTON LNDG,NY,54,19,-35,0.2602739726027397
BOLTON VALLEY,VT,47,43,-4,0.4777777777777778
BOMBAY,NY,96,100,4,0.5102040816326531
BOMONT,WV,13,0,-13,0
BOMOSEEN,VT,487,401,-86,0.45157657657657657
BON AQUA,TN,2071,2257,186,0.5214879852125693
BON SECOUR,AL,81,124,43,0.6048780487804878
BON WIER,TX,239,147,-92,0.38082901554404147
BONAIRE,GA,6860,7811,951,0.5324108786040488
BONANZA,AR,76,80,4,0.5128205128205128
BONANZA,OR,872,932,60,0.516629711751663
BONAPARTE,IA,86,64,-22,0.4266666666666667
BONDSVILLE,MA,305,368,63,0.5468053491827637
BONDUEL,WI,1106,964,-142,0.46570048309178746
BONDURANT,IA,2636,3443,807,0.5663760486922191
BONDURANT,WY,119,113,-6,0.4870689655172414
BONDVILLE,IL,69,59,-10,0.4609375
BONDVILLE,VT,732,681,-51,0.4819532908704883
BONFIELD,IL,49,142,93,0.743455497382199
BONHAM,TX,5717,5330,-387,0.4824839322893093
BONIFAY,FL,4462,4597,135,0.5074511535489569
BONITA,CA,5607,6096,489,0.5208920789541144
BONITA SPGS,FL,1652,3738,2086,0.6935064935064935
BONITA SPRINGS,FL,68696,81856,13160,0.5437058292151549
BONNE TERRE,MO,5268,5502,234,0.5108635097493036
BONNEAU,SC,1744,2003,259,0.5345609821190286
BONNER,MT,552,620,68,0.5290102389078498
BONNER SPGS,KS,259,295,36,0.5324909747292419
BONNER SPRINGS,KS,3233,3199,-34,0.49735696517412936
BONNERDALE,AR,123,291,168,0.7028985507246377
BONNERS FERRY,ID,3782,3921,139,0.5090224587822926
BONNEY LAKE,WA,17298,20256,2958,0.5393832880651861
BONNIE,IL,89,40,-49,0.31007751937984496
BONNIEVILLE,KY,361,415,54,0.5347938144329897
BONNOTS MILL,MO,42,51,9,0.5483870967741935
BONNYMAN,KY,34,85,51,0.7142857142857143
BONO,AR,1995,2103,108,0.513177159590044
BONSALL,CA,2210,2609,399,0.5413986304212492
BONWIER,TX,15,0,-15,0
BOOKER,TX,180,33,-147,0.15492957746478872
BOOMER,NC,261,412,151,0.612184249628529
BOOMER,WV,24,0,-24,0
BOON,MI,45,25,-20,0.35714285714285715
BOONE,CO,104,111,7,0.5162790697674419
BOONE,IA,7847,7653,-194,0.49374193548387096
BOONE,NC,14359,11968,-2391,0.4545903445132374
BOONES MILL,VA,1676,1859,183,0.5258840169731259
BOONEVILLE,AR,3860,3888,28,0.5018069179143004
BOONEVILLE,KY,777,889,112,0.5336134453781513
BOONEVILLE,MS,5469,5261,-208,0.4903075489282386
BOONS CAMP,KY,12,0,-12,0
BOONSBORO,MD,2528,2669,141,0.5135655185684048
BOONTON,NJ,4511,4806,295,0.5158312761618546
BOONTON TOWNSHIP,NJ,524,557,33,0.515263644773358
BOONTON TWP,NJ,90,148,58,0.6218487394957983
BOONVILLE,CA,49,40,-9,0.449438202247191
BOONVILLE,IN,4679,4777,98,0.5051818950930627
BOONVILLE,MO,5536,4888,-648,0.4689178818112049
BOONVILLE,NC,1524,1487,-37,0.4938558618399203
BOONVILLE,NY,2308,1977,-331,0.46137689614935823
BOONVILLE RAD,NY,47,16,-31,0.25396825396825395
BOOTHBAY,ME,1122,1181,59,0.5128093790707773
BOOTHBAY HARBOR,ME,2032,1885,-147,0.48123563952004084
BOOTHBAY HBR,ME,79,270,191,0.7736389684813754
BOOTHWYN,PA,2085,1965,-120,0.48518518518518516
BORDEN,IN,1273,1409,136,0.5253542132736764
BORDENTOWN,NJ,5320,5479,159,0.5073617927585887
BORDULAC,ND,18,26,8,0.5909090909090909
BORGER,TX,5241,4452,-789,0.45930052615289385
BORING,OR,3349,3237,-112,0.49149711509262073
BORON,CA,904,851,-53,0.4849002849002849
BORREGO SPGS,CA,95,73,-22,0.43452380952380953
BORREGO SPRINGS,CA,3001,2688,-313,0.47249077166461595
BOSCAWEN,NH,1202,1263,61,0.5123732251521298
BOSCOBEL,WI,2223,2012,-211,0.47508854781582055
BOSQUE,NM,20,17,-3,0.4594594594594595
BOSQUE FARMS,NM,869,965,96,0.5261723009814613
BOSSIER CITY,LA,35714,33993,-1721,0.48765547219074123
BOSTIC,NC,1259,1510,251,0.5453232213795594
BOSTON,GA,828,1014,186,0.5504885993485342
BOSTON,KY,416,466,50,0.528344671201814
BOSTON,MA,144167,105139,-39028,0.42172671335627704
BOSTON,NY,770,713,-57,0.480782198246797
BOSTON,VA,80,147,67,0.6475770925110133
BOSTON HTS,OH,153,275,122,0.6425233644859814
BOSWELL,IN,257,155,-102,0.3762135922330097
BOSWELL,OK,434,518,84,0.5441176470588235
BOSWELL,PA,1004,943,-61,0.4843348741653826
BOSWORTH,MO,11,0,-11,0
BOTHELL,WA,44916,46571,1655,0.5090450009290938
BOTKINS,OH,370,338,-32,0.4774011299435028
BOTTINEAU,ND,1671,1522,-149,0.4766677106169746
BOUCKVILLE,NY,74,12,-62,0.13953488372093023
BOULDER,CO,100409,72827,-27582,0.42039183541527164
BOULDER,MT,647,759,112,0.5398293029871978
BOULDER,UT,35,36,1,0.5070422535211268
BOULDER,WY,149,129,-20,0.46402877697841727
BOULDER CITY,NV,8218,8877,659,0.5192746417081018
BOULDER CREEK,CA,4807,3276,-1531,0.40529506371396756
BOULDER JCT,WI,188,346,158,0.6479400749063671
BOULDER JUNCTION,WI,937,730,-207,0.4379124175164967
BOULEVARD,CA,618,619,1,0.5004042037186742
BOUND BROOK,NJ,4499,3781,-718,0.45664251207729467
BOUNTIFUL,UT,16451,15072,-1379,0.4781270818132792
BOURBON,IN,923,974,51,0.5134422772799156
BOURBON,MO,2001,1927,-74,0.4905804480651731
BOURBONNAIS,IL,11618,10676,-942,0.4788732394366197
BOURG,LA,1362,1287,-75,0.48584371460928655
BOURNE,MA,844,894,50,0.5143843498273878
BOUSE,AZ,2024,2343,319,0.5365239294710328
BOUTTE,LA,653,656,3,0.5011459129106188
BOVEY,MN,1561,1726,165,0.5250988743535139
BOVINA,TX,154,46,-108,0.23
BOVINA CENTER,NY,24,79,55,0.7669902912621359
BOW,NH,2296,2285,-11,0.4987993887797424
BOW,WA,1458,1399,-59,0.4896744837241862
BOWDLE,SD,11,11,0,0.5
BOWDOIN,ME,609,751,142,0.5522058823529412
BOWDOINHAM,ME,924,1033,109,0.5278487480838018
BOWDON,GA,2692,2745,53,0.5048740114033474
BOWDON,ND,11,0,-11,0
BOWERSTON,OH,167,134,-33,0.44518272425249167
BOWERSVILLE,GA,255,355,100,0.5819672131147541
BOWERSVILLE,OH,11,0,-11,0
BOWIE,AZ,11,0,-11,0
BOWIE,MD,27077,28566,1489,0.5133799399744802
BOWIE,TX,4384,4574,190,0.5106050457691449
BOWLER,WI,271,294,23,0.5203539823008849
BOWLING GREEN,FL,2546,3288,742,0.5635927322591704
BOWLING GREEN,IN,194,125,-69,0.39184952978056425
BOWLING GREEN,KY,56559,55909,-650,0.4971102891489135
BOWLING GREEN,MO,2972,2815,-157,0.4864351131847244
BOWLING GREEN,NY,53,45,-8,0.45918367346938777
BOWLING GREEN,OH,16088,12255,-3833,0.43238189323642523
BOWLING GREEN,VA,1013,1242,229,0.5507760532150776
BOWLUS,MN,43,54,11,0.5567010309278351
BOWMAN,CA,102,105,3,0.5072463768115942
BOWMAN,GA,623,789,166,0.5587818696883853
BOWMAN,ND,1017,887,-130,0.46586134453781514
BOWMAN,SC,737,812,75,0.5242091672046482
BOWMAN,TX,11,0,-11,0
BOWMANSTOWN,PA,11,0,-11,0
BOWMANSVILLE,NY,124,101,-23,0.4488888888888889
BOWMANSVILLE,PA,40,13,-27,0.24528301886792453
BOX ELDER,MT,1485,1072,-413,0.4192412983965585
BOX ELDER,SD,7272,13807,6535,0.6550120973480715
BOX SPRINGS,GA,557,745,188,0.5721966205837173
BOXBORO,MA,149,166,17,0.526984126984127
BOXBOROUGH,MA,1992,1938,-54,0.49312977099236643
BOXFORD,MA,2002,2287,285,0.5332245278619725
BOYCE,LA,1927,1686,-241,0.46664821477996127
BOYCE,VA,788,879,91,0.5272945410917816
BOYCEVILLE,WI,951,965,14,0.5036534446764092
BOYD,MN,13,0,-13,0
BOYD,TX,2591,3276,685,0.5583773649224476
BOYD,WI,469,390,-79,0.4540162980209546
BOYDEN,IA,164,32,-132,0.16326530612244897
BOYDS,MD,1889,2212,323,0.5393806388685687
BOYDTON,VA,561,874,313,0.6090592334494773
BOYERS,PA,76,58,-18,0.43283582089552236
BOYERTOWN,PA,5159,5045,-114,0.4944139553116425
BOYES HOT SPRINGS,CA,76,20,-56,0.20833333333333334
BOYKINS,VA,221,223,2,0.5022522522522522
BOYLE,MS,200,109,-91,0.35275080906148865
BOYLSTON,MA,1310,1753,443,0.5723147241266732
BOYNE CITY,MI,4758,4560,-198,0.489375402446877
BOYNE FALLS,MI,952,933,-19,0.49496021220159153
BOYNTON,OK,11,16,5,0.5925925925925926
BOYNTON BEACH,FL,111553,119625,8072,0.5174584086721055
BOYS RANCH,TX,120,0,-120,0
BOYS TOWN,NE,160,179,19,0.528023598820059
BOYSTOWN,NE,0,12,12,1
BOZEMAN,MT,55557,48432,-7125,0.465741568819779
BOZMAN,MD,0,35,35,1
BOZRAH,CT,663,918,255,0.5806451612903226
BPT,CT,172,146,-26,0.4591194968553459
BR,OH,12,14,2,0.5384615384615384
BRAA,NJ,151,168,17,0.5266457680250783
BRACEVILLE,IL,313,270,-43,0.4631217838765009
BRACEY,VA,1202,1413,211,0.5403441682600383
BRACKENRIDGE,PA,1122,1000,-122,0.471253534401508
BRACKETTVILLE,TX,919,642,-277,0.41127482383087766
BRACKNEY,PA,529,492,-37,0.48188050930460335
BRADBURY,CA,63,69,6,0.5227272727272727
BRADBURY HEIGHTS,MD,0,27,27,1
BRADDOCK,PA,4005,2565,-1440,0.3904109589041096
BRADDOCK HTS,MD,11,0,-11,0
BRADENTON,FL,164116,177020,12904,0.5189132779888374
BRADENTON BEACH,FL,587,257,-330,0.30450236966824645
BRADENVILLE,PA,86,87,1,0.5028901734104047
BRADFORD,AR,1458,1458,0,0.5
BRADFORD,IL,125,115,-10,0.4791666666666667
BRADFORD,MA,1622,1748,126,0.5186943620178042
BRADFORD,ME,127,229,102,0.6432584269662921
BRADFORD,NH,826,821,-5,0.49848208864602306
BRADFORD,NY,305,269,-36,0.4686411149825784
BRADFORD,OH,1291,1163,-128,0.473920130399348
BRADFORD,PA,7135,6565,-570,0.4791970802919708
BRADFORD,RI,606,618,12,0.5049019607843137
BRADFORD,TN,761,905,144,0.5432172869147659
BRADFORD,VT,1175,1283,108,0.5219690805532954
BRADFORDSVILLE,KY,52,11,-41,0.1746031746031746
BRADFORDWOODS,PA,127,162,35,0.5605536332179931
BRADLEY,AR,117,44,-73,0.2732919254658385
BRADLEY,CA,337,302,-35,0.4726134585289515
BRADLEY,FL,14,24,10,0.631578947368421
BRADLEY,IL,5531,4041,-1490,0.42216882574174674
BRADLEY,ME,434,379,-55,0.4661746617466175
BRADLEY,SC,101,77,-24,0.43258426966292135
BRADLEY,WV,202,24,-178,0.10619469026548672
BRADLEY BEACH,NJ,2394,2149,-245,0.47303543913713403
BRADLEYVILLE,MO,0,28,28,1
BRADNER,OH,482,440,-42,0.4772234273318872
BRADY,MT,12,0,-12,0
BRADY,NE,60,43,-17,0.4174757281553398
BRADY,TX,3938,2773,-1165,0.4132022053345254
BRADYVILLE,TN,777,755,-22,0.49281984334203655
BRAGG CITY,MO,14,11,-3,0.44
BRAGGS,OK,59,104,45,0.6380368098159509
BRAHAM,MN,1765,1491,-274,0.45792383292383293
BRAIDWOOD,IL,2156,1954,-202,0.4754257907542579
BRAINERD,MN,16239,14834,-1405,0.4773919479934348
BRAINTREE,MA,11854,11739,-115,0.4975628364345357
BRAINTREE,VT,139,141,2,0.5035714285714286
BRAITHWAITE,LA,24,62,38,0.7209302325581395
BRAMAN,OK,11,0,-11,0
BRAMBLETON,VA,8822,10080,1258,0.5332769019151412
BRANCH,LA,114,142,28,0.5546875
BRANCH,MI,565,561,-4,0.49822380106571934
BRANCHBURG,NJ,2458,2585,127,0.5125917112829664
BRANCHLAND,WV,955,922,-33,0.4912093766648908
BRANCHPORT,NY,303,328,25,0.5198098256735341
BRANCHVILLE,NJ,1100,1212,112,0.5242214532871973
BRANCHVILLE,SC,352,360,8,0.5056179775280899
BRANDENBURG,KY,5111,4966,-145,0.49280539843207305
BRANDON,FL,55812,51545,-4267,0.48012705273060907
BRANDON,IA,12,53,41,0.8153846153846154
BRANDON,MN,723,513,-210,0.41504854368932037
BRANDON,MS,22577,24655,2078,0.5219977981029811
BRANDON,SD,4598,4536,-62,0.49660608714692356
BRANDON,VT,1875,1848,-27,0.49637389202256244
BRANDON,WI,391,392,1,0.5006385696040868
BRANDY STATION,VA,125,112,-13,0.47257383966244726
BRANDYWINE,MD,4450,6349,1899,0.587924807852579
BRANDYWINE,WV,212,74,-138,0.25874125874125875
BRANFORD,CT,11521,12106,585,0.512379904346722
BRANFORD,FL,1771,2371,600,0.5724287783679382
BRANON,MO,296,299,3,0.5025210084033613
BRANSON,MO,17072,16371,-701,0.4895194809078133
BRANSON WEST,MO,745,881,136,0.541820418204182
BRANT,MI,116,79,-37,0.40512820512820513
BRANT LAKE,NY,625,559,-66,0.4721283783783784
BRANT ROCK,MA,23,57,34,0.7125
BRANTINGHAM,NY,156,172,16,0.524390243902439
BRANTLEY,AL,717,820,103,0.5335068314899154
BRASELTON,GA,5801,7056,1255,0.5488060978455316
BRASHEAR,MO,47,23,-24,0.32857142857142857
BRASHEAR,TX,90,196,106,0.6853146853146853
BRASHER FALLS,NY,1081,918,-163,0.4592296148074037
BRASSTOWN,NC,185,527,342,0.7401685393258427
BRATENAHL,OH,876,757,-119,0.46356399265156156
BRATTLEBORO,VT,5927,5636,-291,0.48741676035630893
BRAWLEY,CA,7244,6942,-302,0.489355702805583
BRAXTON,MS,655,818,163,0.5553292600135777
BRAYMER,MO,426,399,-27,0.48363636363636364
BRAZIL,IN,7576,7580,4,0.5001319609395619
BRAZORIA,TX,4587,4011,-576,0.46650383810188417
BRDGEWTR CORS,VT,12,0,-12,0
BREA,CA,17158,17048,-110,0.49839209495410164
BREAUX BRIDGE,LA,6936,6360,-576,0.47833935018050544
BRECKENRIDGE,CO,5820,5648,-172,0.4925008719916289
BRECKENRIDGE,MI,1216,1076,-140,0.4694589877835951
BRECKENRIDGE,MN,1703,1575,-128,0.4804758999389872
BRECKENRIDGE,MO,11,12,1,0.5217391304347826
BRECKENRIDGE,TX,4257,3062,-1195,0.4183631643667168
BRECKENRIDGE HILLS,MO,363,346,-17,0.48801128349788436
BRECKSVILLE,OH,3569,4206,637,0.5409646302250803
BREDA,IA,106,45,-61,0.2980132450331126
BREEDING,KY,0,24,24,1
BREESE,IL,1707,1691,-16,0.49764567392583875
BREEZEWOOD,PA,315,221,-94,0.4123134328358209
BREEZY POINT,MN,176,344,168,0.6615384615384615
BREEZY POINT,NY,917,1260,343,0.5787781350482315
BREINIGSVILLE,PA,4037,4123,86,0.5052696078431372
BREMEN,AL,858,1029,171,0.5453100158982512
BREMEN,GA,4941,5321,380,0.5185149093743909
BREMEN,IN,3005,2914,-91,0.4923128906909951
BREMEN,KY,445,328,-117,0.4243208279430789
BREMEN,ME,262,341,79,0.5655058043117744
BREMEN,OH,1026,1114,88,0.5205607476635514
BREMERTON,WA,52998,42675,-10323,0.4460506098899376
BREMO BLUFF,VA,23,11,-12,0.3235294117647059
BREMOND,TX,360,469,109,0.5657418576598311
BRENHAM,TX,9613,9556,-57,0.4985132244770202
BRENT,AL,918,911,-7,0.4980863860032805
BRENTON,WV,0,14,14,1
BRENTWOOD,CA,19809,22097,2288,0.5272991934329213
BRENTWOOD,MD,1744,1549,-195,0.4703917400546614
BRENTWOOD,MO,1805,1600,-205,0.4698972099853157
BRENTWOOD,NC,541,502,-39,0.4813039309683605
BRENTWOOD,NH,627,734,107,0.5393093313739897
BRENTWOOD,NY,17376,13636,-3740,0.43970076099574357
BRENTWOOD,PA,506,509,3,0.5014778325123153
BRENTWOOD,TN,21323,23905,2582,0.5285442646148404
BRETHREN,MI,270,201,-69,0.4267515923566879
BREVARD,NC,7764,8945,1181,0.5353402358010653
BREWER,ME,4855,4626,-229,0.48792321485075413
BREWERTON,NY,2901,2690,-211,0.48113038812377035
BREWSTER,KS,0,12,12,1
BREWSTER,MA,6245,6641,396,0.5153655129598014
BREWSTER,MN,108,40,-68,0.2702702702702703
BREWSTER,NY,4738,5194,456,0.5229561014901329
BREWSTER,OH,715,617,-98,0.46321321321321324
BREWSTER,WA,672,527,-145,0.4395329441201001
BREWTON,AL,5506,4995,-511,0.47566898390629464
BRIAN HEAD,UT,0,12,12,1
BRIARCLIFF,NY,80,118,38,0.5959595959595959
BRIARCLIFF MANOR,NY,2235,2926,691,0.5669443906219724
BRIARWOOD,NY,3718,3187,-531,0.46154960173787113
BRICE,OH,145,417,272,0.7419928825622776
BRICELYN,MN,69,51,-18,0.425
BRICEVILLE,TN,64,34,-30,0.3469387755102041
BRICK,NJ,23129,23881,752,0.5079982982344182
BRIDGE CITY,TX,3972,3760,-212,0.48629073978272114
BRIDGEHAMPTON,NY,1767,1262,-505,0.4166391548365797
BRIDGEPORT,AL,1218,1003,-215,0.4515983791085097
BRIDGEPORT,CA,164,272,108,0.6238532110091743
BRIDGEPORT,CT,52413,44242,-8171,0.45773110547824736
BRIDGEPORT,IL,1000,898,-102,0.4731296101159115
BRIDGEPORT,MI,1074,1175,101,0.5224544241885283
BRIDGEPORT,NE,709,648,-61,0.47752394988946206
BRIDGEPORT,NJ,27,0,-27,0
BRIDGEPORT,NY,1807,1361,-446,0.42960858585858586
BRIDGEPORT,OH,2371,1886,-485,0.44303500117453604
BRIDGEPORT,PA,2060,1892,-168,0.47874493927125505
BRIDGEPORT,TX,3570,3905,335,0.52240802675585285
BRIDGEPORT,WA,77,14,-63,0.15384615384615385
BRIDGEPORT,WV,5973,5709,-264,0.4887005649717514
BRIDGER,MT,566,470,-96,0.45366795366795365
BRIDGETON,MO,3886,3949,63,0.5040204211869815
BRIDGETON,NC,508,56,-452,0.09929078014184398
BRIDGETON,NJ,10540,9347,-1193,0.47000553125157135
BRIDGEVIEW,IL,4719,4322,-397,0.47804446410795265
BRIDGEVILLE,CA,147,23,-124,0.13529411764705881
BRIDGEVILLE,DE,3416,3199,-217,0.4835978835978836
BRIDGEVILLE,PA,5828,5832,4,0.5001715265866209
BRIDGEWATER,CT,455,577,122,0.5591085271317829
BRIDGEWATER,IA,16,0,-16,0
BRIDGEWATER,MA,8220,7974,-246,0.49240459429418304
BRIDGEWATER,NJ,9868,10859,991,0.5239060163072321
BRIDGEWATER,NY,22,29,7,0.5686274509803921
BRIDGEWATER,SD,193,200,7,0.5089058524173028
BRIDGEWATER,VA,2330,2308,-22,0.4976282880551962
BRIDGEWATER,VT,13,13,0,0.5
BRIDGEWATER CORNERS,VT,66,60,-6,0.47619047619047616
BRIDGMAN,MI,2145,1994,-151,0.4817588789562696
BRIDGTON,ME,3006,3599,593,0.544890234670704
BRIDPORT,VT,370,371,1,0.5006747638326585
BRIELLE,NJ,1802,2098,296,0.5379487179487179
BRIER,WA,1596,1419,-177,0.47064676616915424
BRIERFIELD,AL,159,163,4,0.5062111801242236
BRIGANTINE,NJ,5614,5307,-307,0.48594451057595456
BRIGGS,TX,49,78,29,0.6141732283464567
BRIGGSDALE,CO,25,63,38,0.7159090909090909
BRIGGSVILLE,WI,11,25,14,0.6944444444444444
BRIGHAM CITY,UT,8802,7893,-909,0.47277628032345015
BRIGHTON,AL,343,316,-27,0.4795144157814871
BRIGHTON,CO,32182,31597,-585,0.4954138509540758
BRIGHTON,IA,412,256,-156,0.38323353293413176
BRIGHTON,IL,1864,1710,-154,0.47845551203133746
BRIGHTON,MA,35731,24359,-11372,0.4053752704276918
BRIGHTON,MI,16513,16845,332,0.5049763175250315
BRIGHTON,MO,650,402,-248,0.3821292775665399
BRIGHTON,NY,242,222,-20,0.47844827586206895
BRIGHTON,TN,2556,2672,116,0.5110941086457537
BRIGHTON,VT,14,28,14,0.6666666666666666
BRIGHTWATERS,NY,1478,1053,-425,0.4160410904780719
BRIGHTWOOD,OR,59,176,117,0.7489361702127659
BRIGHTWOOD,VA,52,74,22,0.5873015873015873
BRILLIANT,AL,235,224,-11,0.4880174291938998
BRILLIANT,OH,203,209,6,0.5072815533980582
BRILLION,WI,1790,1614,-176,0.47414806110458285
BRIMFIELD,IL,763,684,-79,0.4727021423635107
BRIMFIELD,MA,1119,1176,57,0.5124183006535947
BRIMLEY,MI,1361,1234,-127,0.47552986512524087
BRINGHURST,IN,140,110,-30,0.44
BRINKHAVEN,OH,16,0,-16,0
BRINKLEY,AR,1401,1411,10,0.501778093883357
BRINNON,WA,863,902,39,0.5110481586402267
BRINSON,GA,354,356,2,0.5014084507042254
BRISBANE,CA,2547,2089,-458,0.4506039689387403
BRISBIN,PA,14,0,-14,0
BRISTOL,CT,25369,24189,-1180,0.488094757657694
BRISTOL,FL,1456,1480,24,0.5040871934604905
BRISTOL,GA,51,11,-40,0.1774193548387097
BRISTOL,IL,204,178,-26,0.46596858638743455
BRISTOL,IN,3536,3513,-23,0.49836856291672577
BRISTOL,ME,337,365,28,0.51994301994302
BRISTOL,NH,3203,3045,-158,0.48735595390524966
BRISTOL,PA,8011,7437,-574,0.4814215432418436
BRISTOL,RI,7415,7462,47,0.5015796195469516
BRISTOL,SD,0,12,12,1
BRISTOL,TN,14500,14115,-385,0.49327275904246026
BRISTOL,VA,9548,9729,181,0.5046947139077658
BRISTOL,VT,2007,2181,174,0.5207736389684814
BRISTOL,WI,1885,2005,120,0.5154241645244216
BRISTOL,WV,36,32,-4,0.47058823529411764
BRISTOLVILLE,OH,770,848,78,0.5241038318912238
BRISTOW,IA,0,11,11,1
BRISTOW,OK,3310,3417,107,0.5079530251226401
BRISTOW,VA,8217,8649,432,0.5128068303094984
BRITT,IA,1137,1008,-129,0.4699300699300699
BRITT,MN,249,207,-42,0.45394736842105265
BRITTON,MI,916,818,-98,0.4717416378316032
BRITTON,SD,515,446,-69,0.46409989594172735
BROAD BROOK,CT,2674,2610,-64,0.4939439818319455
BROAD CHANNEL,NY,99,93,-6,0.484375
BROAD RUN,VA,373,506,133,0.5756541524459613
BROADALBIN,NY,2400,2242,-158,0.4829814735028005
BROADDUS,TX,424,416,-8,0.49523809523809526
BROADLANDS,VA,3648,4822,1174,0.5693034238488784
BROADUS,MT,142,87,-55,0.3799126637554585
BROADVIEW,IL,2537,2405,-132,0.4866450829623634
BROADVIEW HEIGHTS,OH,4708,4657,-51,0.4972770955686065
BROADVIEW HTS,OH,1245,1177,-68,0.48596201486374896
BROADWAY,NC,2280,2365,85,0.5091496232508074
BROADWAY,NJ,13,0,-13,0
BROADWAY,OH,11,0,-11,0
BROADWAY,VA,2645,2730,85,0.5079069767441861
BROADWELL,IL,12,11,-1,0.4782608695652174
BROCK,TX,958,1264,306,0.5688568856885688
BROCKPORT,NY,8969,7412,-1557,0.4524754288504975
BROCKPORT,PA,131,120,-11,0.47808764940239046
BROCKTON,MA,34430,30220,-4210,0.4674400618716164
BROCKWAY,MI,286,262,-24,0.4781021897810219
BROCKWAY,PA,1632,1608,-24,0.4962962962962963
BROCTON,IL,12,0,-12,0
BROCTON,NY,1000,921,-79,0.47943779281624155
BRODERICK,CA,130,127,-3,0.49416342412451364
BRODHEAD,KY,1102,1184,82,0.5179352580927384
BRODHEAD,WI,2192,2111,-81,0.49058796188705556
BRODHEADSVILLE,PA,1018,930,-88,0.47741273100616016
BRODNAX,VA,709,720,11,0.5038488453463961
BRODVIEW HTS,OH,142,134,-8,0.4855072463768116
BROGUE,PA,414,308,-106,0.4265927977839335
BROHMAN,MI,27,11,-16,0.2894736842105263
BROKEN ARROW,OK,49509,52315,2806,0.5137786769327467
BROKEN BOW,NE,2053,2011,-42,0.49483267716535434
BROKEN BOW,OK,4219,3546,-673,0.4566645202833226
BROMLEY,KY,450,333,-117,0.42528735632183906
BRONAUGH,MO,11,0,-11,0
BRONSON,FL,1979,2363,384,0.5442192538000922
BRONSON,IA,12,0,-12,0
BRONSON,KS,24,12,-12,0.3333333333333333
BRONSON,MI,2275,2050,-225,0.47398843930635837
BRONSON,TX,256,387,131,0.6018662519440124
BRONSTON,KY,1314,1459,145,0.5261449693472773
BRONTE,TX,81,87,6,0.5178571428571429
BRONWOOD,GA,11,15,4,0.5769230769230769
BRONX,NY,333137,261199,-71938,0.4394803612771227
BRONXVILLE,NY,7272,6701,-571,0.4795677377800043
BROOK,IN,438,340,-98,0.4370179948586118
BROOK PARK,MN,876,878,2,0.500570125427594
BROOK PARK,OH,1148,1192,44,0.5094017094017094
BROOKDALE,CA,149,52,-97,0.25870646766169153
BROOKELAND,TX,879,1012,133,0.5351665785298784
BROOKER,FL,183,265,82,0.5915178571428571
BROOKESMITH,TX,0,13,13,1
BROOKEVILLE,MD,1535,1822,287,0.5427464998510575
BROOKFIELD,CT,5431,6131,700,0.5302715793115378
BROOKFIELD,IL,5351,5106,-245,0.4882853590896051
BROOKFIELD,MA,1261,1210,-51,0.48968029138000807
BROOKFIELD,MO,3040,2618,-422,0.4627076705549664
BROOKFIELD,NH,156,136,-20,0.4657534246575342
BROOKFIELD,NY,0,11,11,1
BROOKFIELD,OH,1309,1146,-163,0.46680244399185333
BROOKFIELD,VT,145,232,87,0.6153846153846154
BROOKFIELD,WI,17737,18569,832,0.5114581611854789
BROOKHAVEN,GA,19801,18393,-1408,0.4815677855160496
BROOKHAVEN,MS,6249,5893,-356,0.48534014165705813
BROOKHAVEN,NY,1082,1153,71,0.5158836689038031
BROOKHAVEN,PA,4428,4203,-225,0.4869655891553702
BROOKINGS,OR,6896,7852,956,0.5324111743965283
BROOKINGS,SD,14322,10699,-3623,0.4276008153151353
BROOKLAND,AR,2733,2901,168,0.5149094781682642
BROOKLANDVILLE,MD,28,38,10,0.5757575757575758
BROOKLAWN,NJ,351,358,7,0.5049365303244006
BROOKLET,GA,2112,2510,398,0.5430549545651233
BROOKLIN,ME,645,546,-99,0.45843828715365237
BROOKLINE,MA,30901,22862,-8039,0.42523668694083294
BROOKLINE,MO,1170,1268,98,0.5200984413453651
BROOKLINE,NH,1326,1538,212,0.5370111731843575
BROOKLINE,PA,291,277,-14,0.4876760563380282
BROOKLINE,VT,211,159,-52,0.4297297297297297
BROOKLINE STA,MO,51,69,18,0.575
BROOKLINE VILLAGE,MA,0,48,48,1
BROOKLYN,CT,2887,2900,13,0.501123207188526
BROOKLYN,IA,1360,1105,-255,0.4482758620689655
BROOKLYN,IN,62,24,-38,0.27906976744186046
BROOKLYN,MD,7876,7235,-641,0.47879028522268546
BROOKLYN,MI,4950,4394,-556,0.4702482876712329
BROOKLYN,MS,559,328,-231,0.3697857948139797
BROOKLYN,NY,813277,641146,-172131,0.4408249869535892
BROOKLYN,OH,2885,2837,-48,0.49580566235581963
BROOKLYN,WI,923,907,-16,0.49562841530054647
BROOKLYN CENTER,MN,3311,2551,-760,0.4351757079495053
BROOKLYN CTR,MN,1277,1190,-87,0.4823672476692339
BROOKLYN HEIGHTS,OH,72,84,12,0.5384615384615384
BROOKLYN HTS,OH,280,379,99,0.575113808801214
BROOKLYN PARK,MD,1880,1753,-127,0.4825213322323149
BROOKLYN PARK,MN,15609,13729,-1880,0.4679596427841025
BROOKNEAL,VA,800,865,65,0.5195195195195195
BROOKPARK,OH,4404,4378,-26,0.4985196993851059
BROOKPORT,IL,725,647,-78,0.4715743440233236
BROOKS,GA,747,1147,400,0.6055966209081309
BROOKS,KY,753,767,14,0.5046052631578948
BROOKS,ME,487,462,-25,0.4868282402528978
BROOKS,MN,11,0,-11,0
BROOKS,OR,423,371,-52,0.4672544080604534
BROOKS CB,TX,28,12,-16,0.3
BROOKS CITY BASE,TX,164,103,-61,0.3857677902621723
BROOKSBURG,PA,16,11,-5,0.4074074074074074
BROOKSHIRE,TX,4687,7253,2566,0.6074539363484087
BROOKSIDE,NJ,12,0,-12,0
BROOKSIDE,UT,23,46,23,0.6666666666666666
BROOKSTON,IN,1456,1228,-228,0.45752608047690013
BROOKSTON,TX,48,66,18,0.5789473684210527
BROOKSVILLE,FL,33929,39666,5737,0.5389768326652626
BROOKSVILLE,KY,1412,1297,-115,0.47877445551864156
BROOKSVILLE,ME,630,598,-32,0.48697068403908794
BROOKSVILLE,MS,161,283,122,0.6373873873873874
BROOKTONDALE,NY,1171,1082,-89,0.480248557478917
BROOKVILLE,IN,2703,2920,217,0.5192957495998577
BROOKVILLE,KS,12,0,-12,0
BROOKVILLE,OH,3553,3617,64,0.5044630404463041
BROOKVILLE,PA,2980,2761,-219,0.48092666782790455
BROOKWOOD,AL,1657,1519,-138,0.4782745591939547
BROOMALL,PA,4060,4477,417,0.5244230994494553
BROOMES ISLAND,MD,23,12,-11,0.34285714285714286
BROOMFIELD,CO,50273,52009,1736,0.5084863416827985
BROOTEN,MN,484,448,-36,0.48068669527896996
BROSELEY,MO,75,25,-50,0.25
BROUGHTON,IL,24,22,-2,0.4782608695652174
BROUSSARD,LA,5268,6080,812,0.5357772294677476
BROWDER,KY,11,0,-11,0
BROWERVILLE,MN,1080,967,-113,0.47239863214460187
BROWN CITY,MI,1760,1551,-209,0.4684385382059801
BROWN DEER,WI,1299,1304,5,0.5009604302727622
BROWNFIELD,ME,553,555,2,0.5009025270758123
BROWNFIELD,TX,3396,2787,-609,0.4507520621057739
BROWNING,IL,0,12,12,1
BROWNING,MT,1104,1184,80,0.5174825174825175
BROWNINGTON,VT,111,115,4,0.5088495575221239
BROWNS MILLS,NJ,7135,7068,-67,0.4976413433781595
BROWNS SUMMIT,NC,3558,3894,336,0.5225442834138486
BROWNS VALLEY,CA,676,885,209,0.566944266495836
BROWNS VALLEY,MN,296,164,-132,0.3565217391304348
BROWNSBORO,AL,1427,1515,88,0.5149558123725357
BROWNSBORO,TX,1444,1550,106,0.5177020708082832
BROWNSBURG,IN,14705,16668,1963,0.5312848627800976
BROWNSDALE,MN,86,152,66,0.6386554621848739
BROWNSTOWN,IL,636,512,-124,0.445993031358885
BROWNSTOWN,IN,2145,1998,-147,0.4822592324402607
BROWNSTOWN,MI,2107,1870,-237,0.47020367110887606
BROWNSTOWN,PA,166,22,-144,0.11702127659574468
BROWNSTOWN TOWNSHIP,MI,1837,1902,65,0.5086921636801284
BROWNSVILLE,CA,399,354,-45,0.4701195219123506
BROWNSVILLE,IN,66,12,-54,0.15384615384615385
BROWNSVILLE,KY,1815,1472,-343,0.44782476422269546
BROWNSVILLE,MN,133,61,-72,0.31443298969072164
BROWNSVILLE,OR,1148,1393,245,0.5482093663911846
BROWNSVILLE,PA,2386,2359,-27,0.4971548998946259
BROWNSVILLE,TN,5034,4784,-250,0.4872682827459768
BROWNSVILLE,TX,33324,34911,1587,0.5116289294350407
BROWNSVILLE,VT,120,252,132,0.6774193548387096
BROWNSVILLE,WI,326,315,-11,0.4914196567862715
BROWNTON,MN,204,231,27,0.5310344827586206
BROWNTOWN,VA,16,12,-4,0.42857142857142855
BROWNTOWN,WI,145,85,-60,0.3695652173913043
BROWNVILLE,ME,395,620,225,0.6108374384236454
BROWNVILLE,NY,366,188,-178,0.33935018050541516
BROWNWOOD,TX,10748,10993,245,0.5056345154316729
BROXTON,GA,1040,1059,19,0.5045259647451167
BRUCE,FL,16,36,20,0.6923076923076923
BRUCE,MS,967,894,-73,0.48038688876947877
BRUCE,SD,53,11,-42,0.171875
BRUCE,WI,1110,991,-119,0.4716801523084246
BRUCE CROSSING,MI,142,137,-5,0.4910394265232975
BRUCE TOWNSHIP,MI,577,609,32,0.5134907251264755
BRUCE TWP,MI,1107,1258,151,0.531923890063425
BRUCETON,TN,1014,1014,0,0.5
BRUCETON MILLS,WV,1510,1703,193,0.5300342359165888
BRUCEVILLE,IN,195,78,-117,0.2857142857142857
BRUCEVILLE,TX,231,401,170,0.634493670886076
BRUIN,PA,12,11,-1,0.4782608695652174
BRULE,NE,103,81,-22,0.44021739130434784
BRULE,WI,47,93,46,0.6642857142857143
BRUMLEY,MO,181,182,1,0.5013774104683195
BRUNDIDGE,AL,1628,1638,10,0.5015309246785058
BRUNEAU,ID,25,11,-14,0.3055555555555556
BRUNING,NE,41,13,-28,0.24074074074074073
BRUNSON,SC,98,103,5,0.5124378109452736
BRUNSWICK,GA,30543,28743,-1800,0.48481935026819145
BRUNSWICK,MD,2538,3063,525,0.5468666309587573
BRUNSWICK,ME,9442,10382,940,0.5237086359967716
BRUNSWICK,MO,484,404,-80,0.45495495495495497
BRUNSWICK,OH,13325,13290,-35,0.4993424760473417
BRUNSWICK,VT,15,12,-3,0.4444444444444444
BRUSH,CO,2814,2637,-177,0.4837644468904788
BRUSH CREEK,TN,404,509,105,0.5575027382256298
BRUSH PRAIRIE,WA,3892,3976,84,0.505338078291815
BRUSHTON,NY,1078,930,-148,0.4631474103585657
BRUSLY,LA,1004,1021,17,0.5041975308641975
BRUSSELS,WI,464,347,-117,0.4278668310727497
BRUTUS,MI,240,178,-62,0.4258373205741627
BRYAN,OH,6934,6126,-808,0.4690658499234303
BRYAN,TX,42034,39777,-2257,0.48620601141655767
BRYANS ROAD,MD,2441,2504,63,0.5063700707785642
BRYANT,AL,596,745,149,0.5555555555555556
BRYANT,AR,8880,7936,-944,0.4719314938154139
BRYANT,IN,188,139,-49,0.42507645259938837
BRYANT,SD,171,130,-41,0.4318936877076412
BRYANT,WI,41,54,13,0.5684210526315789
BRYANT POND,ME,306,392,86,0.5616045845272206
BRYANTOWN,MD,34,37,3,0.5211267605633803
BRYANTVILLE,MA,0,13,13,1
BRYCE,UT,80,57,-23,0.41605839416058393
BRYCEVILLE,FL,550,751,201,0.5772482705611068
BRYN ATHYN,PA,11,38,27,0.7755102040816326
BRYN MAWR,PA,7149,7194,45,0.5015687094750052
BRYSON,TX,16,37,21,0.6981132075471698
BRYSON CITY,NC,3697,3742,45,0.503024600080656
BUCHANAN,GA,1907,2247,340,0.5409244102070294
BUCHANAN,MI,3689,3682,-7,0.49952516619183285
BUCHANAN,NY,571,529,-42,0.4809090909090909
BUCHANAN,TN,1004,1192,188,0.5428051001821493
BUCHANAN,VA,1196,1252,56,0.511437908496732
BUCHANAN DAM,TX,1203,1162,-41,0.4913319238900634
BUCHTEL,OH,12,0,-12,0
BUCK HILL FALLS,PA,148,245,97,0.6234096692111959
BUCK HILL FLS,PA,52,36,-16,0.4090909090909091
BUCKATUNNA,MS,53,139,86,0.7239583333333334
BUCKEYE,AZ,45489,58937,13448,0.5643900944209297
BUCKEYE LAKE,OH,1256,1222,-34,0.49313962873284906
BUCKEYSTOWN,MD,23,76,53,0.7676767676767676
BUCKFIELD,ME,616,737,121,0.5447154471544715
BUCKHANNON,WV,7117,6537,-580,0.4787608026951809
BUCKHEAD,GA,698,927,229,0.5704615384615385
BUCKHOLTS,TX,72,197,125,0.7323420074349443
BUCKINGHAM,PA,26,11,-15,0.2972972972972973
BUCKINGHAM,VA,776,707,-69,0.47673634524612274
BUCKLEY,IL,76,58,-18,0.43283582089552236
BUCKLEY,MI,1146,1062,-84,0.48097826086956524
BUCKLEY,WA,5346,6207,861,0.5372630485588159
BUCKLIN,KS,173,46,-127,0.2100456621004566
BUCKLIN,MO,36,53,17,0.5955056179775281
BUCKNER,IL,12,0,-12,0
BUCKNER,KY,38,98,60,0.7205882352941176
BUCKNER,MO,1503,1582,79,0.512803889789303
BUCKSPORT,ME,2643,2336,-307,0.4691705161679052
BUCODA,WA,62,90,28,0.5921052631578947
BUCYRUS,KS,416,818,402,0.6628849270664505
BUCYRUS,MO,62,121,59,0.6612021857923497
BUCYRUS,OH,6781,6577,-204,0.4923641263662225
BUDA,IL,86,11,-75,0.1134020618556701
BUDA,TX,14818,18779,3961,0.5589487156591363
BUDD LAKE,NJ,5093,4764,-329,0.4833113523384397
BUDE,MS,49,35,-14,0.4166666666666667
BUECHE,LA,11,12,1,0.5217391304347826
BUELLTON,CA,1864,2044,180,0.5230296827021494
BUENA,NJ,444,527,83,0.5427394438722966
BUENA PARK,CA,22968,21406,-1562,0.4823996033713436
BUENA VISTA,CO,4775,4839,64,0.5033284793010193
BUENA VISTA,GA,1027,1111,84,0.519644527595884
BUENA VISTA,PA,45,22,-23,0.3283582089552239
BUENA VISTA,VA,3479,3103,-376,0.47143725311455487
BUEYEROS,NM,30,32,2,0.5161290322580645
BUFFALO,IA,140,23,-117,0.1411042944785276
BUFFALO,IL,13,47,34,0.7833333333333333
BUFFALO,IN,13,0,-13,0
BUFFALO,KS,0,11,11,1
BUFFALO,KY,419,428,9,0.5053128689492326
BUFFALO,MN,8951,8372,-579,0.4832881140680021
BUFFALO,MO,4048,4073,25,0.501539219307967
BUFFALO,NY,206471,182600,-23871,0.4693230798491792
BUFFALO,OH,13,11,-2,0.4583333333333333
BUFFALO,OK,130,16,-114,0.1095890410958904
BUFFALO,SC,774,626,-148,0.4471428571428571
BUFFALO,SD,105,44,-61,0.2953020134228188
BUFFALO,TX,1399,1614,215,0.5356787255227348
BUFFALO,WV,282,272,-10,0.49097472924187724
BUFFALO,WY,3629,3691,62,0.5042349726775956
BUFFALO CENTER,IA,407,248,-159,0.3786259541984733
BUFFALO CITY,WI,95,158,63,0.6245059288537549
BUFFALO CTR,IA,22,0,-22,0
BUFFALO GAP,TX,330,508,178,0.6062052505966588
BUFFALO GROVE,IL,14630,14984,354,0.5059769028162355
BUFFALO JCT,VA,11,11,0,0.5
BUFFALO JUNCTION,VA,177,135,-42,0.4326923076923077
BUFFALO LAKE,MN,191,227,36,0.5430622009569378
BUFFALO MILLS,PA,27,41,14,0.6029411764705882
BUFFALO VALLEY,TN,39,27,-12,0.4090909090909091
BUFORD,GA,36751,42162,5411,0.5342845918923371
BUHL,AL,510,450,-60,0.46875
BUHL,ID,4087,3798,-289,0.4816740646797717
BUHL,MN,120,111,-9,0.4805194805194805
BUHLER,KS,657,612,-45,0.48226950354609927
BUIES CREEK,NC,611,25,-586,0.03930817610062893
BULAN,KY,98,97,-1,0.49743589743589745
BULGER,PA,129,136,7,0.5132075471698113
BULL SHOALS,AR,1058,1035,-23,0.4945054945054945
BULL VALLEY,IL,195,195,0,0.5
BULLARD,TX,4516,5983,1467,0.5698637965520525
BULLFROG,UT,24,11,-13,0.3142857142857143
BULLHEAD CITY,AZ,27380,30327,2947,0.5255341639662433
BULLOCK,NC,103,131,28,0.5598290598290598
BULLS GAP,TN,1677,1896,219,0.5306465155331654
BULLVILLE,NY,11,0,-11,0
BULPITT,IL,25,22,-3,0.46808510638297873
BULVERDE,TX,3692,7303,3611,0.6642110050022738
BUMPASS,VA,2406,3055,649,0.5594213514008424
BUMPUS MILLS,TN,59,26,-33,0.3058823529411765
BUNA,TX,2403,2210,-193,0.47908085844352916
BUNCETON,MO,65,33,-32,0.336734693877551
BUNCH,OK,38,11,-27,0.22448979591836735
BUNCOMBE,IL,101,141,40,0.5826446280991735
BUNKER,MO,172,229,57,0.571072319201995
BUNKER HILL,IL,1189,1079,-110,0.4757495590828924
BUNKER HILL,IN,559,481,-78,0.4625
BUNKER HILL,WV,3431,4109,678,0.5449602122015915
BUNKERVILLE,NV,80,46,-34,0.36507936507936506
BUNKIE,LA,1911,1852,-59,0.4921605102311985
BUNN,NC,594,747,153,0.5570469798657718
BUNNELL,FL,4746,6049,1303,0.5603520148216767
BUNNLEVEL,NC,1639,1841,202,0.5290229885057471
BURAS,LA,485,333,-152,0.4070904645476773
BURBANK,CA,45504,41041,-4463,0.47421572592293026
BURBANK,IL,6090,5499,-591,0.47450168263008025
BURBANK,OH,263,335,72,0.560200668896321
BURBANK,OK,13,12,-1,0.48
BURBANK,WA,917,1025,108,0.527806385169928
BURDEN,KS,59,11,-48,0.15714285714285714
BURDETT,KS,11,0,-11,0
BURDETT,NY,796,716,-80,0.47354497354497355
BUREAU,IL,11,0,-11,0
BURFORDVILLE,MO,0,11,11,1
BURGAW,NC,3083,3403,320,0.524668516805427
BURGESS,VA,15,43,28,0.7413793103448276
BURGETTSTOWN,PA,1791,1701,-90,0.48711340206185566
BURGHILL,OH,84,69,-15,0.45098039215686275
BURGIN,KY,26,38,12,0.59375
BURIEN,WA,19672,17249,-2423,0.4671866959183121
BURKBURNETT,TX,5777,5302,-475,0.47856304720642656
BURKE,NY,262,204,-58,0.43776824034334766
BURKE,SD,86,74,-12,0.4625
BURKE,VA,11908,12179,271,0.5056254411093121
BURKESVILLE,KY,2410,2162,-248,0.47287839020122485
BURKEVILLE,TX,364,284,-80,0.4382716049382716
BURKEVILLE,VA,443,510,67,0.5351521511017838
BURKVILLE,AL,0,20,20,1
BURLESON,TX,27018,30075,3057,0.5267721086648101
BURLEY,ID,6397,6404,7,0.5002734161393642
BURLEY,WA,174,137,-37,0.4405144694533762
BURLINGAME,CA,16605,15407,-1198,0.48128826689991255
BURLINGAME,KS,515,554,39,0.5182413470533208
BURLINGHAM,NY,11,0,-11,0
BURLINGTON,CO,1997,1827,-170,0.47777196652719667
BURLINGTON,CT,2430,2831,401,0.5381106253563961
BURLINGTON,IA,17301,13329,-3972,0.43516160626836436
BURLINGTON,IL,100,52,-48,0.34210526315789475
BURLINGTON,IN,129,58,-71,0.31016042780748665
BURLINGTON,KS,1625,1601,-24,0.4962802231866088
BURLINGTON,KY,8546,8385,-161,0.49524540783178783
BURLINGTON,MA,11260,10572,-688,0.4842433125687065
BURLINGTON,ME,66,34,-32,0.34
BURLINGTON,MI,455,383,-72,0.45704057279236276
BURLINGTON,NC,28795,29778,983,0.5083912382838509
BURLINGTON,ND,464,392,-72,0.45794392523364486
BURLINGTON,NJ,10220,10217,-3,0.49992660370895925
BURLINGTON,PA,13,0,-13,0
BURLINGTON,TX,0,11,11,1
BURLINGTON,VT,37995,22120,-15875,0.3679614073026699
BURLINGTON,WA,7380,6686,-694,0.47533058438788567
BURLINGTON,WI,10467,9882,-585,0.48562582927908005
BURLINGTON,WV,257,207,-50,0.44612068965517243
BURLINGTON,WY,0,24,24,1
BURLINGTON FLATS,NY,203,153,-50,0.4297752808988764
BURLINGTON JUNCTION,MO,27,60,33,0.6896551724137931
BURLINGTON TOWNSHIP,NJ,167,209,42,0.5558510638297872
BURLISON,TN,564,650,86,0.5354200988467874
BURNA,KY,12,11,-1,0.4782608695652174
BURNET,TX,7366,6920,-446,0.4843903121937561
BURNETT,WI,24,45,21,0.6521739130434783
BURNETTSVILLE,IN,110,11,-99,0.09090909090909091
BURNEY,CA,1591,1522,-69,0.4889174429810472
BURNEYVILLE,OK,176,249,73,0.5858823529411765
BURNHAM,IL,405,413,8,0.5048899755501223
BURNHAM,ME,414,344,-70,0.45382585751978893
BURNHAM,PA,890,813,-77,0.4773928361714621
BURNS,KS,37,0,-37,0
BURNS,OR,2174,2024,-150,0.4821343496903287
BURNS,TN,1823,2373,550,0.565538608198284
BURNS,WY,329,362,33,0.5238784370477568
BURNS FLAT,OK,731,422,-309,0.36600173460537727
BURNSIDE,IL,167,92,-75,0.3552123552123552
BURNSIDE,KY,1555,1464,-91,0.484928784365684
BURNSVILLE,MN,41920,31753,-10167,0.43099914486989804
BURNSVILLE,MS,715,677,-38,0.4863505747126437
BURNSVILLE,NC,5867,6115,248,0.5103488566182607
BURNSVILLE,WV,126,121,-5,0.4898785425101215
BURNT CHIMNEY,VA,23,41,18,0.640625
BURNT HILLS,NY,1009,1186,177,0.5403189066059225
BURNWELL,KY,16,22,6,0.5789473684210527
BURR OAK,MI,668,592,-76,0.46984126984126984
BURR RIDGE,IL,6174,5873,-301,0.4875072632190587
BURRILLVILLE,RI,31,40,9,0.5633802816901409
BURRTON,KS,855,632,-223,0.4250168123739072
BURSON,CA,78,77,-1,0.4967741935483871
BURT,IA,88,28,-60,0.2413793103448276
BURT,MI,668,600,-68,0.47318611987381703
BURT,NY,88,112,24,0.56
BURT LAKE,MI,11,0,-11,0
BURTCHVILLE,MI,265,265,0,0.5
BURTON,MI,12382,12075,-307,0.4937236782925134
BURTON,OH,1609,1333,-276,0.4530931339225017
BURTON,TX,517,756,239,0.593872741555381
BURTON,WA,17,0,-17,0
BURTONSVILLE,MD,5394,4984,-410,0.4802466756600501
BURTRUM,MN,196,202,6,0.507537688442211
BURWELL,NE,610,626,16,0.5064724919093851
BUSBY,MT,56,23,-33,0.2911392405063291
BUSH,LA,1286,1294,8,0.5015503875968992
BUSHKILL,PA,3943,3672,-271,0.4822061720288903
BUSHLAND,TX,0,11,11,1
BUSHNELL,FL,5202,9191,3989,0.6385743069547697
BUSHNELL,IL,1686,1414,-272,0.4561290322580645
BUSHNELL,SD,24,11,-13,0.3142857142857143
BUSHWOOD,MD,50,141,91,0.7382198952879581
BUSKIRK,NY,101,53,-48,0.34415584415584416
BUSSEY,IA,40,24,-16,0.375
BUSY,KY,67,28,-39,0.29473684210526313
BUTLER,AL,1146,923,-223,0.4461092315128081
BUTLER,GA,981,940,-41,0.48932847475273294
BUTLER,IL,0,11,11,1
BUTLER,IN,2474,1920,-554,0.4369594902139281
BUTLER,KY,1290,1198,-92,0.4815112540192926
BUTLER,MO,3138,2902,-236,0.4804635761589404
BUTLER,NJ,1375,1510,135,0.5233968804159446
BUTLER,OH,930,827,-103,0.4706886738759249
BUTLER,PA,19610,18273,-1337,0.48235356228387405
BUTLER,TN,1432,1432,0,0.5
BUTLER,WI,1033,895,-138,0.4642116182572614
BUTLERVILLE,IN,277,275,-2,0.49818840579710144
BUTNER,NC,1186,1193,7,0.5014712063892391
BUTTE,MT,15356,14641,-715,0.4880821415474881
BUTTE,NE,11,12,1,0.5217391304347826
BUTTE DES MORTS,WI,41,22,-19,0.3492063492063492
BUTTE FALLS,OR,13,34,21,0.723404255319149
BUTTE MEADOWS,CA,31,51,20,0.6219512195121951
BUTTERFIELD,MN,213,37,-176,0.148
BUTTERNUT,WI,554,566,12,0.5053571428571428
BUTTONWILLOW,CA,354,82,-272,0.18807339449541285
BUXTON,ME,2376,2464,88,0.509090909090909
BUXTON,NC,438,373,-65,0.4599260172626387
BUXTON,ND,14,0,-14,0
BUYCK,MN,36,93,57,0.7209302325581395
BUZZARDS BAY,MA,4735,4861,126,0.5065652355147978
BYARS,OK,40,23,-17,0.36507936507936506
BYBEE,TN,205,354,149,0.6332737030411449
BYERS,CO,1008,951,-57,0.48545176110260335
BYESVILLE,OH,2371,1941,-430,0.450139146567718
BYFIELD,MA,654,829,175,0.5590020229265004
BYHALIA,MS,3919,4672,753,0.5438249330694913
BYLAS,AZ,82,0,-82,0
BYNUM,TX,0,11,11,1
BYRAM,MS,4907,4680,-227,0.48816105142380306
BYRAM TOWNSHIP,NJ,953,1217,264,0.5608294930875576
BYRAM TWP,NJ,53,40,-13,0.43010752688172044
BYRDSTOWN,TN,1607,1517,-90,0.485595390524968
BYRNEDALE,PA,11,0,-11,0
BYRNES MILL,MO,1411,1344,-67,0.48784029038112525
BYROMVILLE,GA,11,0,-11,0
BYRON,CA,295,254,-41,0.46265938069216755
BYRON,GA,6896,7574,678,0.5234277816171389
BYRON,IL,2680,2448,-232,0.47737909516380655
BYRON,ME,0,32,32,1
BYRON,MI,1382,1278,-104,0.48045112781954885
BYRON,MN,2548,2831,283,0.5263060048336122
BYRON,NY,748,595,-153,0.4430379746835443
BYRON,WI,11,0,-11,0
BYRON CENTER,MI,7196,8219,1023,0.5331819656179047
CABALLO,NM,61,114,53,0.6514285714285715
CABAZON,CA,1069,974,-95,0.4767498776309349
CABERY,IL,12,11,-1,0.4782608695652174
CABIN CREEK,WV,51,43,-8,0.4574468085106383
CABIN JOHN,MD,364,469,105,0.5630252100840336
CABLE,OH,211,297,86,0.5846456692913385
CABLE,WI,950,892,-58,0.48425624321389793
CABOOL,MO,2080,2111,31,0.5036984013361966
CABOT,AR,16380,16060,-320,0.49506781750924783
CABOT,PA,964,1033,69,0.5172759138708062
CABOT,VT,448,345,-103,0.43505674653215637
CACHE,OK,1825,1829,4,0.5005473453749316
CACTUS,TX,2086,445,-1641,0.1758198340576847
CADDO,OK,1033,910,-123,0.4683479155944416
CADDO GAP,AR,11,0,-11,0
CADDO MILLS,TX,2285,4017,1732,0.6374166931132974
CADES,SC,0,11,11,1
CADET,MO,1354,1425,71,0.5127743792731199
CADILLAC,MI,11973,10469,-1504,0.4664914000534712
CADIZ,KY,5720,5619,-101,0.49554634447482143
CADIZ,OH,1770,1777,7,0.5009867493656611
CADOGAN,PA,40,0,-40,0
CADOTT,WI,1746,1627,-119,0.48235991698784464
CADWELL,GA,109,131,22,0.5458333333333333
CADYVILLE,NY,561,632,71,0.5297569153394803
CAHOKIA,IL,2560,1980,-580,0.43612334801762115
CAHOKIA HEIGHTS,IL,98,66,-32,0.4024390243902439
CAHONE,CO,0,12,12,1
CAINSVILLE,MO,22,29,7,0.5686274509803921
CAIRNBROOK,PA,81,51,-30,0.38636363636363635
CAIRO,GA,6246,5607,-639,0.4730447987851177
CAIRO,IL,1032,762,-270,0.42474916387959866
CAIRO,MO,245,365,120,0.5983606557377049
CAIRO,NE,118,99,-19,0.45622119815668205
CAIRO,NY,1482,1412,-70,0.4879060124395301
CAIRO,OH,72,12,-60,0.14285714285714285
CAIRO,WV,75,82,7,0.5222929936305732
CAL NEV ARI,NV,0,12,12,1
CALABASAS,CA,11701,12113,412,0.5086503737297388
CALABASAS HILLS,CA,441,420,-21,0.4878048780487805
CALABASH,NC,2524,3807,1283,0.6013268046122255
CALAIS,ME,1929,1843,-86,0.4886002120890774
CALAIS,VT,48,11,-37,0.1864406779661017
CALAMUS,IA,48,11,-37,0.1864406779661017
CALCIUM,NY,1898,1235,-663,0.3941908713692946
CALDWELL,ID,28561,29282,721,0.5062323876700724
CALDWELL,KS,522,370,-152,0.4147982062780269
CALDWELL,NJ,3983,4482,499,0.5294743059657413
CALDWELL,OH,2063,2047,-16,0.49805352798053526
CALDWELL,TX,3916,4032,116,0.5072974333165576
CALDWELL,WV,67,56,-11,0.45528455284552843
CALEDONIA,IL,630,777,147,0.5522388059701493
CALEDONIA,MI,8870,8166,-704,0.47933787274007983
CALEDONIA,MN,1690,1458,-232,0.46315120711562896
CALEDONIA,MO,11,0,-11,0
CALEDONIA,MS,1809,1774,-35,0.4951158247278817
CALEDONIA,NY,1486,1425,-61,0.4895225008588114
CALEDONIA,OH,1126,951,-175,0.4578719306692345
CALEDONIA,WI,661,872,211,0.5688193085453359
CALERA,AL,7155,7536,381,0.5129671227282009
CALERA,OK,2597,2778,181,0.5168372093023256
CALEXICO,CA,10043,11312,1269,0.5297120112385858
CALHAN,CO,2737,3002,265,0.5230876459313469
CALHOUN,GA,14648,15117,469,0.5078783806484126
CALHOUN,KY,1177,1149,-28,0.4939810834049871
CALHOUN,LA,2594,2797,203,0.5188276757558894
CALHOUN,MO,79,120,41,0.6030150753768844
CALHOUN,TN,776,931,155,0.5454012888107791
CALHOUN CITY,MS,1172,1155,-17,0.4963472281908036
CALHOUN FALLS,SC,478,582,104,0.5490566037735849
CALICO ROCK,AR,1090,1123,33,0.5074559421599638
CALIENTE,CA,230,174,-56,0.4306930693069307
CALIENTE,NV,158,230,72,0.5927835051546392
CALIF CITY,CA,252,173,-79,0.40705882352941175
CALIFON,NJ,1655,1969,314,0.5433222958057395
CALIFORNIA,KY,730,884,154,0.5477075588599752
CALIFORNIA,MD,6805,7035,230,0.5083092485549133
CALIFORNIA,MO,2671,2700,29,0.5026996834853845
CALIFORNIA,PA,1596,1416,-180,0.4701195219123506
CALIFORNIA CITY,CA,5771,5359,-412,0.4814914645103324
CALIFORNIA HOT SPRINGS,CA,0,12,12,1
CALIMESA,CA,3417,4964,1547,0.592292089249493
CALIPATRIA,CA,509,407,-102,0.4443231441048035
CALISTOGA,CA,2778,2424,-354,0.4659746251441753
CALL,TX,387,257,-130,0.39906832298136646
CALLAHAN,FL,4810,5494,684,0.5331909937888198
CALLANDS,VA,22,27,5,0.5510204081632653
CALLAO,MO,49,52,3,0.5148514851485149
CALLAO,VA,515,542,27,0.5127719962157048
CALLAWAY,MD,368,399,31,0.5202086049543677
CALLAWAY,MN,11,46,35,0.8070175438596491
CALLAWAY,NE,166,74,-92,0.30833333333333335
CALLAWAY,VA,337,467,130,0.5808457711442786
CALLENDER,IA,0,11,11,1
CALLICOON,NY,692,727,35,0.5123326286116984
CALLICOON CENTER,NY,0,28,28,1
CALMAR,IA,736,673,-63,0.47764371894960966
CALPINE,CA,13,17,4,0.5666666666666667
CALUMET,MI,2292,2163,-129,0.4855218855218855
CALUMET,MN,11,0,-11,0
CALUMET,OK,300,168,-132,0.358974358974359
CALUMET CITY,IL,12854,12492,-362,0.49285883374102424
CALUMET PARK,IL,2073,1835,-238,0.4695496417604913
CALVERT,TX,214,314,100,0.5946969696969697
CALVERT CITY,KY,2760,2330,-430,0.4577603143418468
CALVERTON,NY,2514,2485,-29,0.4970994198839768
CALVIN,KY,0,12,12,1
CALVIN,OK,0,66,66,1
CALYPSO,NC,15,0,-15,0
CAMANCHE,IA,2020,1910,-110,0.4860050890585242
CAMANO ISLAND,WA,6556,6966,410,0.5151604792190504
CAMARGO,IL,147,40,-107,0.21390374331550802
CAMARILLO,CA,29262,30887,1625,0.5135081214982793
CAMAS,WA,14363,15639,1276,0.5212652489834011
CAMAS VALLEY,OR,50,94,44,0.6527777777777778
CAMBRIA,CA,2608,2986,378,0.5337861994994637
CAMBRIA,IL,59,51,-8,0.4636363636363636
CAMBRIA,WI,568,427,-141,0.4291457286432161
CAMBRIA HEIGHTS,NY,4156,3914,-242,0.48500619578686494
CAMBRIDG SPGS,PA,29,21,-8,0.42
CAMBRIDGE,IA,256,306,50,0.5444839857651246
CAMBRIDGE,ID,176,385,209,0.6862745098039216
CAMBRIDGE,IL,888,860,-28,0.4919908466819222
CAMBRIDGE,MA,84733,62338,-22395,0.423863304118419
CAMBRIDGE,MD,8732,8096,-636,0.4811029236985976
CAMBRIDGE,ME,13,11,-2,0.4583333333333333
CAMBRIDGE,MN,8017,7745,-272,0.4913716533434843
CAMBRIDGE,NE,472,406,-66,0.4624145785876993
CAMBRIDGE,NY,1865,1856,-9,0.4987906476753561
CAMBRIDGE,OH,9251,7985,-1266,0.463274541656997
CAMBRIDGE,VT,518,500,-18,0.4911591355599214
CAMBRIDGE,WI,2090,2096,6,0.5007166746297181
CAMBRIDGE CITY,IN,1700,1363,-337,0.44498857329415603
CAMBRIDGE SPRINGS,PA,1817,1547,-270,0.4598692033293698
CAMBY,IN,8253,7941,-312,0.49036680251945164
CAMDEN,AL,929,1035,106,0.5269857433808554
CAMDEN,AR,7110,6041,-1069,0.45935670291232605
CAMDEN,DE,1449,1710,261,0.5413105413105413
CAMDEN,IN,375,404,29,0.5186136071887034
CAMDEN,ME,3568,3714,146,0.5100247184839329
CAMDEN,MI,822,820,-2,0.4993909866017052
CAMDEN,MO,28,0,-28,0
CAMDEN,MS,26,40,14,0.6060606060606061
CAMDEN,NC,1323,1584,261,0.544891640866873
CAMDEN,NJ,22858,23120,262,0.502849188742442
CAMDEN,NY,2394,2248,-146,0.4842740198190435
CAMDEN,OH,1651,1431,-220,0.4643088903309539
CAMDEN,SC,8367,8282,-85,0.4974472941317797
CAMDEN,TN,5036,4556,-480,0.4749791492910759
CAMDEN ON GAULEY,WV,0,11,11,1
CAMDEN POINT,MO,22,12,-10,0.35294117647058826
CAMDEN WYOMING,DE,2987,3245,258,0.5206996148908858
CAMDENTON,MO,7603,7593,-10,0.4996709660436957
CAMERON,IL,0,11,11,1
CAMERON,LA,656,293,-363,0.3087460484720759
CAMERON,MO,4536,4676,140,0.5075987841945289
CAMERON,MT,456,443,-13,0.492769744160178
CAMERON,NC,10521,10243,-278,0.4933057214409555
CAMERON,NY,97,85,-12,0.46703296703296704
CAMERON,OK,537,719,182,0.572452229299363
CAMERON,SC,91,201,110,0.6883561643835616
CAMERON,TX,3093,2910,-183,0.4847576211894053
CAMERON,WI,1996,1771,-225,0.47013538624900453
CAMERON,WV,787,558,-229,0.41486988847583645
CAMERON MILLS,NY,23,0,-23,0
CAMERON PARK,CA,2933,3238,305,0.5247123642845568
CAMILLA,GA,3312,2722,-590,0.45111037454424924
CAMILLUS,NY,6333,6035,-298,0.48795278137128073
CAMINO,CA,1858,1788,-70,0.49040043883708173
CAMMACK VILLAGE,AR,716,708,-8,0.49719101123595505
CAMP CONNELL,CA,296,267,-29,0.47424511545293074
CAMP DENNISON,OH,11,0,-11,0
CAMP DOUGLAS,WI,746,663,-83,0.47054648687012063
CAMP HILL,AL,309,461,152,0.5987012987012987
CAMP HILL,PA,13412,12378,-1034,0.47995347033734004
CAMP LEJEUNE,NC,4600,3788,-812,0.4515975202670482
CAMP PENDLETON,CA,1707,2436,729,0.5879797248370746
CAMP POINT,IL,514,451,-63,0.46735751295336786
CAMP SHERMAN,OR,0,39,39,1
CAMP SPRINGS,MD,1367,1244,-123,0.4764458062045193
CAMP VERDE,AZ,5328,5981,653,0.5288708108586082
CAMP VERDE,TX,18,22,4,0.55
CAMP WOOD,TX,148,205,57,0.5807365439093485
CAMPBELL,CA,24724,21943,-2781,0.47020378425868387
CAMPBELL,MN,13,0,-13,0
CAMPBELL,MO,1399,1327,-72,0.4867938371239912
CAMPBELL,NE,12,0,-12,0
CAMPBELL,NY,1256,1148,-108,0.47753743760399336
CAMPBELL,OH,2990,2868,-122,0.4895868897234551
CAMPBELL,TX,648,980,332,0.601965601965602
CAMPBELL HALL,NY,1147,1161,14,0.5030329289428076
CAMPBELL HILL,IL,11,24,13,0.6857142857142857
CAMPBELLSBURG,IN,973,737,-236,0.43099415204678365
CAMPBELLSBURG,KY,662,631,-31,0.4880123743232792
CAMPBELLSPORT,WI,2013,1989,-24,0.4970014992503748
CAMPBELLSVILLE,KY,10906,10135,-771,0.4816786274416615
CAMPBELLSVLLE,KY,265,250,-15,0.4854368932038835
CAMPBELLTON,FL,24,23,-1,0.48936170212765956
CAMPHL,PA,245,243,-2,0.4979508196721312
CAMPO,CA,1302,1251,-51,0.4900117508813161
CAMPOBELLO,SC,2378,3019,641,0.559384843431536
CAMPTI,LA,921,851,-70,0.4802483069977427
CAMPTON,KY,1568,1518,-50,0.49189889825016203
CAMPTON,NH,2430,2119,-311,0.4658166630028578
CAMPTON HILLS,IL,261,306,45,0.5396825396825397
CAMPTONVILLE,CA,42,12,-30,0.2222222222222222
CANA,VA,902,844,-58,0.4833906071019473
CANAAN,CT,1211,1092,-119,0.47416413373860183
CANAAN,IN,15,14,-1,0.4827586206896552
CANAAN,ME,896,899,3,0.5008356545961002
CANAAN,NH,1580,1503,-77,0.48751216347713267
CANAAN,NY,390,567,177,0.5924764890282131
CANAAN,VT,151,165,14,0.5221518987341772
CANADA,KY,27,14,-13,0.34146341463414637
CANADENSIS,PA,889,850,-39,0.48878665899942497
CANADIAN,OK,211,321,110,0.6033834586466166
CANADIAN,TX,943,868,-75,0.4792932081722805
CANADIAN LAKES,MI,67,125,58,0.6510416666666666
CANAJOHARIE,NY,1601,1371,-230,0.46130551816958276
CANAL FULTON,OH,3602,3676,74,0.5050838142346799
CANAL POINT,FL,0,26,26,1
CANAL STREET,NY,1725,1069,-656,0.38260558339298495
CANAL WINCHESTER,OH,21780,20524,-1256,0.4851550680786687
CANANDAIGUA,NY,14536,14487,-49,0.49915584191847845
CANASERAGA,NY,113,127,14,0.5291666666666667
CANASTOTA,NY,4860,4555,-305,0.4838024429102496
CANBY,MN,1040,1002,-38,0.49069539666993145
CANBY,OR,8518,9243,725,0.5204098868306964
CANDIA,NH,1277,1281,4,0.5007818608287725
CANDLER,FL,0,11,11,1
CANDLER,NC,9659,9648,-11,0.49971512922774125
CANDO,ND,389,318,-71,0.4497878359264498
CANDOR,NC,1037,543,-494,0.34367088607594937
CANDOR,NY,1370,1222,-148,0.4714506172839506
CANE BEDS,AZ,0,11,11,1
CANEADEA,NY,295,268,-27,0.47602131438721135
CANEHILL,AR,28,71,43,0.7171717171717171
CANEY,KS,1470,1109,-361,0.430011632415665
CANEY,OK,13,12,-1,0.48
CANEYVILLE,KY,1067,1082,15,0.5034899953466728
CANFIELD,OH,6967,7205,238,0.5083968388371437
CANISTEO,NY,1575,1288,-287,0.44987775061124696
CANISTOTA,SD,271,224,-47,0.45252525252525255
CANMER,KY,14,34,20,0.7083333333333334
CANNELTON,IN,1456,1449,-7,0.4987951807228916
CANNON,KY,0,26,26,1
CANNON AFB,NM,0,333,333,1
CANNON BALL,ND,12,0,-12,0
CANNON BEACH,OR,743,843,100,0.5315258511979823
CANNON FALLS,MN,2813,2726,-87,0.49214659685863876
CANOGA PARK,CA,20800,18282,-2518,0.4677856813878512
CANON,GA,1113,1270,157,0.5329416701636592
CANON CITY,CO,14355,13131,-1224,0.4777341191879502
CANONCITO,NM,11,12,1,0.5217391304347826
CANONSBURG,PA,13229,14418,1189,0.5215032372409303
CANTERBURY,CT,1442,1493,51,0.5086882453151619
CANTERBURY,NH,556,694,138,0.5552
CANTON,CT,2111,2261,150,0.5171546203110704
CANTON,GA,36629,43761,7132,0.5443587510884438
CANTON,IL,6608,5940,-668,0.47338221230474975
CANTON,KS,334,263,-71,0.440536013400335
CANTON,MA,8472,8811,339,0.5098073251171672
CANTON,ME,45,112,67,0.7133757961783439
CANTON,MI,32112,32992,880,0.5067584173015482
CANTON,MN,25,34,9,0.576271186440678
CANTON,MO,1707,1376,-331,0.4463185209211807
CANTON,MS,7286,7951,665,0.5218218809476931
CANTON,NC,5870,5907,37,0.5015708584529167
CANTON,NY,4996,3790,-1206,0.4313680855907125
CANTON,OH,60891,57931,-2960,0.4875443941357661
CANTON,OK,131,70,-61,0.3482587064676617
CANTON,PA,2360,1984,-376,0.4567219152854512
CANTON,SD,1714,1523,-191,0.47049737411183196
CANTON,TX,4946,5560,614,0.5292213972967827
CANTONMENT,FL,9199,11028,1829,0.5452118455529738
CANTRALL,IL,35,13,-22,0.2708333333333333
CANTRIL,IA,0,23,23,1
CANTUA CREEK,CA,0,11,11,1
CANTWELL,AK,0,11,11,1
CANUTE,OK,115,115,0,0.5
CANUTILLO,TX,1956,2065,109,0.5135538423277791
CANVAS,WV,15,0,-15,0
CANYON,MN,11,13,2,0.5416666666666666
CANYON,TX,9263,8983,-280,0.49232708538857833
CANYON CITY,OR,198,260,62,0.5676855895196506
CANYON CNTRY,CA,2598,2638,40,0.5038197097020627
CANYON COUNTRY,CA,19765,19677,-88,0.49888443790882814
CANYON DAM,CA,46,0,-46,0
CANYON LAKE,CA,4791,4947,156,0.5080098582871226
CANYON LAKE,TX,8387,10639,2252,0.5591821717649532
CANYONVILLE,OR,1267,1125,-142,0.47031772575250835
CAPAC,MI,960,752,-208,0.4392523364485981
CAPE CANAVERAL,FL,10946,10884,-62,0.4985799358680715
CAPE CARTERET,NC,805,920,115,0.5333333333333333
CAPE CHARLES,VA,1591,1830,239,0.5349313066354867
CAPE CORAL,FL,133829,151817,17988,0.5314865252795418
CAPE ELIZ,ME,41,34,-7,0.4533333333333333
CAPE ELIZABETH,ME,3597,3924,327,0.5217391304347826
CAPE FAIR,MO,514,782,268,0.6033950617283951
CAPE FEAR,NC,347,329,-18,0.48668639053254437
CAPE GIRARDEAU,MO,22238,18201,-4037,0.45008531368233634
CAPE HAZE,FL,50,229,179,0.8207885304659498
CAPE MAY,NJ,7969,7609,-360,0.4884452432918218
CAPE MAY COURT HOUSE,NJ,5682,6160,478,0.5201824016213478
CAPE MAY POINT,NJ,238,184,-54,0.43601895734597157
CAPE NEDDICK,ME,1090,1270,180,0.538135593220339
CAPE PORPOISE,ME,154,72,-82,0.3185840707964602
CAPE VINCENT,NY,2191,1746,-445,0.44348488696977395
CAPISTRANO BEACH,CA,2918,2810,-108,0.49057262569832405
CAPITAN,NM,575,748,173,0.5653817082388511
CAPITOL HEIGHTS,MD,13501,12535,-966,0.48144876325088337
CAPITOL HGTS,MD,326,307,-19,0.4849921011058452
CAPITOLA,CA,5273,4798,-475,0.476417436202959
CAPO BEACH,CA,113,132,19,0.5387755102040817
CAPON BRIDGE,WV,621,687,66,0.5252293577981652
CAPRON,IL,618,439,-179,0.4153263954588458
CAPRON,VA,22,59,37,0.7283950617283951
CAPSHAW,AL,12,23,11,0.6571428571428571
CAPTAIN COOK,HI,1860,2189,329,0.5406273153865152
CAPTIVA,FL,1007,716,-291,0.4155542658154382
CARATUNK,ME,0,36,36,1
CARAWAY,AR,290,273,-17,0.4849023090586146
CARBON,IN,151,161,10,0.5160256410256411
CARBON,TX,34,26,-8,0.43333333333333335
CARBON CLIFF,IL,1107,551,-556,0.3323281061519904
CARBON HILL,AL,1336,1322,-14,0.49736644093303234
CARBON HILL,IL,267,208,-59,0.4378947368421053
CARBONADO,WA,460,415,-45,0.4742857142857143
CARBONDALE,CO,6806,7018,212,0.5076678240740741
CARBONDALE,IL,22782,15051,-7731,0.39782729363254304
CARBONDALE,KS,1012,978,-34,0.4914572864321608
CARBONDALE,PA,5521,4919,-602,0.47116858237547893
CARDIFF,CA,585,610,25,0.5104602510460251
CARDIFF BY THE SEA,CA,4824,4694,-130,0.4931708342088674
CARDIFF BY THE SEA NEW,CA,159,189,30,0.5431034482758621
CARDINGTON,OH,2555,2302,-253,0.4739551163269508
CARDWELL,MO,213,212,-1,0.4988235294117647
CARDWELL,MT,40,26,-14,0.3939393939393939
CAREFREE,AZ,3870,4026,156,0.5098784194528876
CARENCRO,LA,5482,5517,35,0.5015910537321575
CARET,VA,12,11,-1,0.4782608695652174
CAREY,ID,50,109,59,0.6855345911949685
CAREY,OH,2175,1874,-301,0.46283032847616695
CAREYWOOD,ID,40,0,-40,0
CARIBOU,ME,4116,3729,-387,0.47533460803059274
CARL FISHER,FL,0,11,11,1
CARL JUNCTION,MO,3913,4142,229,0.5142147734326505
CARLE PLACE,NY,1550,1426,-124,0.4791666666666667
CARLETON,MI,3141,3292,151,0.5117363593968599
CARLIN,NV,778,785,7,0.5022392834293026
CARLINVILLE,IL,3708,3310,-398,0.4716443431176974
CARLISLE,AR,1213,1029,-184,0.45896520963425513
CARLISLE,IA,2188,2037,-151,0.4821301775147929
CARLISLE,IN,510,417,-93,0.44983818770226536
CARLISLE,KY,2280,2429,149,0.5158207687407093
CARLISLE,MA,1414,1632,218,0.535784635587656
CARLISLE,NY,12,0,-12,0
CARLISLE,OH,855,888,33,0.5094664371772806
CARLISLE,PA,23044,23246,202,0.5021818967379563
CARLISLE,SC,53,65,12,0.5508474576271186
CARLOCK,IL,241,106,-135,0.30547550432276654
CARLOS,MN,231,323,92,0.5830324909747292
CARLOTTA,CA,66,13,-53,0.16455696202531644
CARLSBAD,CA,51393,54017,2624,0.5124466369414666
CARLSBAD,NM,13644,12415,-1229,0.4764188955830999
CARLSBAD,TX,17,130,113,0.8843537414965986
CARLSBORG,WA,271,472,201,0.6352624495289367
CARLSTADT,NJ,2119,1975,-144,0.4824132877381534
CARLTON,GA,342,301,-41,0.4681181959564541
CARLTON,KS,22,32,10,0.5925925925925926
CARLTON,MN,1224,1269,45,0.5090252707581228
CARLTON,OR,1483,1412,-71,0.4877374784110535
CARLTON,PA,12,14,2,0.5384615384615384
CARLTON,TX,16,0,-16,0
CARLTON,WA,55,14,-41,0.2028985507246377
CARLYLE,IL,2208,2048,-160,0.48120300751879697
CARMEL,CA,6386,7019,633,0.5236105930622902
CARMEL,IN,46588,49937,3349,0.5173478373478374
CARMEL,ME,1116,1168,52,0.51138353765324
CARMEL,NY,6712,7346,634,0.5225494380423958
CARMEL BY THE,CA,130,136,6,0.5112781954887218
CARMEL BY THE SEA,CA,1017,949,-68,0.482706002034588
CARMEL VALLEY,CA,2429,2500,71,0.5072022722661798
CARMEN,ID,11,76,65,0.8735632183908046
CARMI,IL,3262,3192,-70,0.4945770065075922
CARMICHAEL,CA,29915,25872,-4043,0.4637639593453672
CARMICHAELS,PA,1760,1678,-82,0.48807446189645143
CARMINE,TX,46,33,-13,0.4177215189873418
CARNATION,WA,2445,2535,90,0.5090361445783133
CARNEGIE,OK,530,523,-7,0.49667616334283
CARNEGIE,PA,6672,6513,-159,0.4939704209328783
CARNELIAN BAY,CA,1254,732,-522,0.3685800604229607
CARNESVILLE,GA,1448,1826,378,0.5577275503970678
CARNEY,MI,80,98,18,0.550561797752809
CARNEY,OK,177,148,-29,0.4553846153846154
CARNEYS POINT,NJ,1138,1172,34,0.5073593073593073
CARO,MI,5563,4846,-717,0.4655586511672591
CAROGA LAKE,NY,951,873,-78,0.4786184210526316
CAROL STREAM,IL,14460,13541,-919,0.4835898717902932
CAROLINA,RI,47,82,35,0.6356589147286822
CAROLINA BEACH,NC,4905,4767,-138,0.49286600496277916
CAROLINA SHORES,NC,2392,3522,1130,0.5955360162326683
CARP LAKE,MI,353,286,-67,0.4475743348982786
CARPENTER,WY,80,96,16,0.5454545454545454
CARPENTERSVILLE,IL,11520,9200,-2320,0.444015444015444
CARPINTERIA,CA,5349,5413,64,0.5029734250139379
CARR,CO,37,25,-12,0.4032258064516129
CARRABASSETT VALLEY,ME,302,346,44,0.5339506172839507
CARRABELLE,FL,1785,1968,183,0.5243804956035172
CARRBORO,NC,12235,8869,-3366,0.42025208491281274
CARRIER MILLS,IL,754,693,-61,0.47892190739460955
CARRIERE,MS,4505,5259,754,0.5386112249078246
CARRINGTON,ND,1140,887,-253,0.43759250123334975
CARRIZO SPGS,TX,133,138,5,0.5092250922509225
CARRIZO SPRINGS,TX,1774,1678,-96,0.4860950173812283
CARRIZOZO,NM,129,139,10,0.5186567164179104
CARROLL,IA,5327,4469,-858,0.45620661494487547
CARROLL,NE,41,14,-27,0.2545454545454545
CARROLL,OH,1271,1394,123,0.5230769230769231
CARROLL PLT,ME,40,68,28,0.6296296296296297
CARROLLTON,AL,296,282,-14,0.48788927335640137
CARROLLTON,GA,22797,21768,-1029,0.4884550656344665
CARROLLTON,IL,1402,1226,-176,0.4665144596651446
CARROLLTON,KY,4143,3664,-479,0.4693224029716921
CARROLLTON,MI,65,22,-43,0.25287356321839083
CARROLLTON,MO,2250,2022,-228,0.47331460674157305
CARROLLTON,MS,288,442,154,0.6054794520547945
CARROLLTON,OH,3714,3520,-194,0.4865910975946917
CARROLLTON,TX,59393,57865,-1528,0.4934844530863566
CARROLLTON,VA,3812,4142,330,0.5207442796077445
CARROLLTOWN,PA,316,329,13,0.5100775193798449
CARROLLWOOD,FL,70,108,38,0.6067415730337079
CARRSVILLE,KY,29,16,-13,0.35555555555555557
CARRSVILLE,VA,133,178,45,0.572347266881029
CARSON,CA,18524,18513,-11,0.49985149985149985
CARSON,IA,261,221,-40,0.45850622406639
CARSON,MS,36,99,63,0.7333333333333333
CARSON,ND,13,12,-1,0.48
CARSON,NM,11,0,-11,0
CARSON,PA,129,89,-40,0.40825688073394495
CARSON,VA,229,372,143,0.6189683860232945
CARSON,WA,818,1015,197,0.5537370430987453
CARSON CITY,MI,1263,1245,-18,0.4964114832535885
CARSON CITY,NV,31362,29422,-1940,0.4840418531192419
CARSONVILLE,MI,929,793,-136,0.4605110336817654
CARTER,OK,12,0,-12,0
CARTER,SD,33,36,3,0.5217391304347826
CARTER LAKE,IA,1544,1353,-191,0.4670348636520538
CARTERET,NJ,9216,7521,-1695,0.4493636852482524
CARTERSVILLE,GA,30831,27926,-2905,0.47527954116105314
CARTERSVILLE,VA,170,194,24,0.532967032967033
CARTERVILLE,IL,4371,4313,-58,0.4966605251036389
CARTERVILLE,MO,1041,863,-178,0.4532563025210084
CARTHAGE,AL,25,28,3,0.5283018867924528
CARTHAGE,IL,1503,1297,-206,0.4632142857142857
CARTHAGE,IN,427,527,100,0.5524109014675053
CARTHAGE,ME,73,111,38,0.6032608695652174
CARTHAGE,MO,9860,9022,-838,0.4778095540726618
CARTHAGE,MS,3382,3497,115,0.5083587730774822
CARTHAGE,NC,2984,3445,461,0.5358531653445325
CARTHAGE,NY,5844,5201,-643,0.47089180624717064
CARTHAGE,SD,11,0,-11,0
CARTHAGE,TN,2915,2930,15,0.5012831479897348
CARTHAGE,TX,4631,4505,-126,0.49310420315236425
CARTWRIGHT,OK,398,655,257,0.6220322886989553
CARUTHERS,CA,829,743,-86,0.47264631043257
CARUTHERSVILLE,MO,4142,3345,-797,0.44677440897555765
CARVEL BEACH,MD,274,300,26,0.5226480836236934
CARVER,MA,2922,3296,374,0.5300739787713091
CARVER,MN,1819,2393,574,0.5681386514719848
CARVERSVILLE,PA,0,11,11,1
CARVILLE,LA,0,55,55,1
CARY,IL,5832,6249,417,0.5172585050906382
CARY,NC,74524,77229,2705,0.5089125091431471
CARY PLT,ME,0,11,11,1
CARYVILLE,FL,229,344,115,0.6003490401396161
CARYVILLE,TN,1783,1650,-133,0.48062918729973786
CAS GRANDE,AZ,535,719,184,0.5733652312599681
CASA,AR,91,54,-37,0.3724137931034483
CASA GRANDE,AZ,37244,46607,9363,0.5558311767301523
CASAR,NC,254,360,106,0.5863192182410424
CASCADE,CO,880,721,-159,0.45034353529044346
CASCADE,IA,966,845,-121,0.46659304251794587
CASCADE,ID,1797,1687,-110,0.48421354764638347
CASCADE,MD,239,371,132,0.6081967213114754
CASCADE,MT,1214,1048,-166,0.46330680813439434
CASCADE,VA,331,281,-50,0.4591503267973856
CASCADE,WI,563,513,-50,0.4767657992565056
CASCADE LOCKS,OR,446,564,118,0.5584158415841585
CASCO,ME,1824,2170,346,0.543314972458688
CASCO,MI,896,1086,190,0.5479313824419778
CASCO,WI,261,236,-25,0.47484909456740443
CASEVILLE,MI,1848,1463,-385,0.4418604651162791
CASEY,IA,48,46,-2,0.48936170212765956
CASEY,IL,2013,1718,-295,0.4604663629053873
CASEYVILLE,IL,2563,2374,-189,0.48085882114644524
CASH,AR,39,24,-15,0.38095238095238093
CASHIERS,NC,2652,2926,274,0.5245607744711366
CASHION,AZ,876,774,-102,0.4690909090909091
CASHION,OK,358,634,276,0.6391129032258065
CASHMERE,WA,2341,2282,-59,0.4936188622106857
CASHTON,WI,977,897,-80,0.4786552828175027
CASNOVIA,MI,221,168,-53,0.4318766066838046
CASPAR,CA,20,0,-20,0
CASPER,WY,28154,27381,-773,0.49304042495723416
CASPIAN,MI,294,133,-161,0.3114754098360656
CASS CITY,MI,2092,2047,-45,0.49456390432471614
CASS LAKE,MN,2950,2099,-851,0.4157258863141216
CASSADAGA,FL,0,11,11,1
CASSADAGA,NY,676,615,-61,0.4763749031758327
CASSATT,SC,974,1165,191,0.5446470313230481
CASSELBERRY,FL,22828,20286,-2542,0.47052001669991184
CASSELTON,ND,895,716,-179,0.4444444444444444
CASSOPOLIS,MI,3835,3257,-578,0.45924985899605186
CASSTOWN,OH,119,96,-23,0.44651162790697674
CASSVILLE,GA,170,58,-112,0.2543859649122807
CASSVILLE,MO,3291,3534,243,0.5178021978021978
CASSVILLE,NY,81,62,-19,0.43356643356643354
CASSVILLE,PA,12,0,-12,0
CASSVILLE,WI,529,468,-61,0.46940822467402205
CASTAIC,CA,5290,5530,240,0.511090573012939
CASTALIA,IA,14,0,-14,0
CASTALIA,NC,369,388,19,0.512549537648613
CASTALIA,OH,1224,1211,-13,0.4973305954825462
CASTALIAN SPRINGS,TN,1410,1744,334,0.5529486366518707
CASTANA,IA,12,0,-12,0
CASTILE,NY,943,800,-143,0.4589787722317843
CASTINE,ME,1214,837,-377,0.4080936128717699
CASTINE,OH,51,49,-2,0.49
CASTLE,OK,15,0,-15,0
CASTLE CREEK,NY,68,63,-5,0.48091603053435117
CASTLE DALE,UT,105,203,98,0.6590909090909091
CASTLE HAYNE,NC,2593,3493,900,0.5739401906013802
CASTLE HILL,ME,37,69,32,0.6509433962264151
CASTLE HILLS,TX,334,227,-107,0.40463458110516937
CASTLE PINES,CO,4575,5787,1212,0.5584829183555298
CASTLE ROCK,CO,36042,44547,8505,0.5527677474593307
CASTLE ROCK,WA,3873,4130,257,0.5160564788204424
CASTLE SHANNON,PA,210,245,35,0.5384615384615384
CASTLEBERRY,AL,543,550,7,0.5032021957913998
CASTLEFORD,ID,126,11,-115,0.08029197080291971
CASTLETON,IN,194,167,-27,0.4626038781163435
CASTLETON,NY,226,241,15,0.5160599571734475
CASTLETON,VA,11,98,87,0.8990825688073395
CASTLETON,VT,969,1041,72,0.517910447761194
CASTLETON ON HUDSON,NY,2151,2274,123,0.5138983050847458
CASTLEWOOD,SD,157,139,-18,0.46959459459459457
CASTLEWOOD,VA,1271,1114,-157,0.46708595387840673
CASTOR,LA,329,238,-91,0.41975308641975306
CASTORLAND,NY,508,461,-47,0.4757481940144479
CASTRO VALLEY,CA,17389,16727,-662,0.4902978074803611
CASTROVILLE,CA,1613,1410,-203,0.4664240820377109
CASTROVILLE,TX,2642,3578,936,0.5752411575562701
CASWELL,ME,105,62,-43,0.3712574850299401
CASWELL BEACH,NC,91,97,6,0.5159574468085106
CAT SPRING,TX,50,116,66,0.6987951807228916
CATALDO,ID,97,159,62,0.62109375
CATALINA,AZ,79,110,31,0.582010582010582
CATASAUQUA,PA,3499,3462,-37,0.49734233587128285
CATAULA,GA,1287,1683,396,0.5666666666666667
CATAUMET,MA,432,411,-21,0.4875444839857651
CATAWBA,NC,1686,1832,146,0.5207504263786242
CATAWBA,OH,23,0,-23,0
CATAWBA,SC,1052,1108,56,0.512962962962963
CATAWBA,VA,137,85,-52,0.38288288288288286
CATAWISSA,MO,506,630,124,0.5545774647887324
CATAWISSA,PA,1585,1588,3,0.5004727387330602
CATHANCE TWP,ME,0,26,26,1
CATHARPIN,VA,135,275,140,0.6707317073170732
CATHEDRAL CITY,CA,17365,21334,3969,0.551280394842244
CATHEDRAL CTY,CA,412,380,-32,0.4797979797979798
CATHEYS VALLEY,CA,65,88,23,0.5751633986928104
CATHLAMET,WA,1379,1537,158,0.5270919067215364
CATLETT,VA,1100,1218,118,0.5254529767040552
CATLETTSBURG,KY,2415,2447,32,0.5032908268202386
CATLIN,IL,850,747,-103,0.46775203506574825
CATO,NY,1230,1047,-183,0.4598155467720685
CATO,WI,46,65,19,0.5855855855855856
CATONSVILLE,MD,14215,14225,10,0.5001758087201125
CATOOSA,OK,3440,3175,-265,0.4799697656840514
CATSKILL,NY,4424,4242,-182,0.4894991922455573
CATTARAUGUS,NY,1084,988,-96,0.4768339768339768
CAULFIELD,MO,354,390,36,0.5241935483870968
CAVALIER,ND,843,692,-151,0.450814332247557
CAVALIER AFS,ND,20,24,4,0.5454545454545454
CAVE CITY,AR,2303,2171,-132,0.4852481001341082
CAVE CITY,KY,2809,2908,99,0.5086583872660486
CAVE CREEK,AZ,14000,16193,2193,0.5363163647202994
CAVE IN ROCK,IL,139,95,-44,0.405982905982906
CAVE JUNCTION,OR,2909,3042,133,0.5111745925054613
CAVE SPRING,GA,1115,1139,24,0.5053238686779059
CAVE SPRINGS,AR,1608,2275,667,0.5858872006180788
CAVENDISH,VT,67,112,45,0.6256983240223464
CAWKER CITY,KS,11,12,1,0.5217391304347826
CAWOOD,KY,38,23,-15,0.3770491803278688
CAYCE,SC,5691,4892,-799,0.46225077955211186
CAYUCOS,CA,1602,1647,45,0.5069252077562327
CAYUGA,IN,459,546,87,0.5432835820895522
CAYUGA,NY,543,527,-16,0.49252336448598133
CAYUTA,NY,29,84,55,0.7433628318584071
CAZADERO,CA,356,368,12,0.5082872928176796
CAZENOVIA,NY,2852,3076,224,0.5188933873144399
CAZENOVIA,WI,189,120,-69,0.3883495145631068
CC,IL,14,12,-2,0.46153846153846156
CECIL,OH,87,111,24,0.5606060606060606
CECIL,PA,361,313,-48,0.46439169139465875
CECIL,WI,1002,679,-323,0.40392623438429504
CECILIA,KY,1596,1728,132,0.51985559566787
CECILIA,LA,0,12,12,1
CECILTON,MD,138,118,-20,0.4609375
CEDA RAPIDS,IA,61,28,-33,0.3146067415730337
CEDAR,MI,1563,1571,8,0.5012763241863434
CEDAR,MN,2428,2529,101,0.5101876134758927
CEDAR BLUFF,AL,1626,1806,180,0.5262237762237763
CEDAR BLUFF,VA,1878,1486,-392,0.4417360285374554
CEDAR BLUFFS,NE,312,161,-151,0.3403805496828753
CEDAR CITY,UT,20990,21145,155,0.5018393259760294
CEDAR CREEK,TX,4206,5393,1187,0.561829357224711
CEDAR CREST,NM,1116,1026,-90,0.4789915966386555
CEDAR E BETHL,MN,81,67,-14,0.4527027027027027
CEDAR EAST BETHEL,MN,142,122,-20,0.4621212121212121
CEDAR FALLS,IA,21777,18059,-3718,0.45333366803895975
CEDAR GLEN,CA,362,209,-153,0.3660245183887916
CEDAR GROVE,IN,11,24,13,0.6857142857142857
CEDAR GROVE,NC,132,359,227,0.7311608961303462
CEDAR GROVE,NJ,2649,3798,1149,0.5891112145183807
CEDAR GROVE,TN,701,818,117,0.5385121790651745
CEDAR GROVE,WI,1140,980,-160,0.46226415094339623
CEDAR GROVE,WV,26,0,-26,0
CEDAR HILL,MO,2677,2471,-206,0.47999222999223
CEDAR HILL,TN,1364,1389,25,0.5045405012713403
CEDAR HILL,TX,17533,17928,395,0.5055694988861003
CEDAR HILLS,UT,1656,1536,-120,0.48120300751879697
CEDAR KEY,FL,1190,1645,455,0.5802469135802469
CEDAR KNOLLS,NJ,1731,1669,-62,0.4908823529411765
CEDAR LAKE,IN,5336,6416,1080,0.5459496255956433
CEDAR MOUNTAIN,NC,88,154,66,0.6363636363636364
CEDAR PARK,TX,40127,40834,707,0.5043662998233718
CEDAR POINT,NC,415,464,49,0.5278725824800911
CEDAR RAPIDS,IA,87652,72108,-15544,0.4513520280420631
CEDAR RAPIDS,NE,15,0,-15,0
CEDAR RIDGE,CA,278,240,-38,0.46332046332046334
CEDAR RIVER,MI,243,167,-76,0.4073170731707317
CEDAR SPRINGS,MI,5707,5776,69,0.5030044413480798
CEDAR VALE,KS,86,80,-6,0.4819277108433735
CEDAR VALLEY,UT,64,53,-11,0.452991452991453
CEDARBLUFF,MS,24,53,29,0.6883116883116883
CEDARBURG,WI,6099,6340,241,0.5096872738966155
CEDARCREEK,MO,0,35,35,1
CEDAREDGE,CO,2637,2912,275,0.5247792395026131
CEDARHURST,NY,2683,2480,-203,0.48034088708115436
CEDARHURST,PA,90,110,20,0.55
CEDARPINES PARK,CA,35,23,-12,0.39655172413793105
CEDARPINES PK,CA,0,12,12,1
CEDARS,PA,11,0,-11,0
CEDARTOWN,GA,8090,7077,-1013,0.46660512955759215
CEDARVILLE,AR,277,482,205,0.6350461133069829
CEDARVILLE,CA,22,34,12,0.6071428571428571
CEDARVILLE,IL,12,12,0,0.5
CEDARVILLE,MI,1393,1155,-238,0.4532967032967033
CEDARVILLE,NJ,428,347,-81,0.447741935483871
CEDARVILLE,OH,1006,753,-253,0.4280841387151791
CELEBRATION,FL,1430,1809,379,0.5585057116393949
CELESTE,TX,846,1172,326,0.5807730426164519
CELESTINE,IN,11,12,1,0.5217391304347826
CELINA,OH,6931,6746,-185,0.49323682094026466
CELINA,TN,1912,1866,-46,0.4939121228163049
CELINA,TX,6947,13635,6688,0.6624720629676416
CELORON,NY,148,83,-65,0.3593073593073593
CEMENT,OK,128,214,86,0.6257309941520468
CEMENT CITY,MI,984,1021,37,0.5092269326683292
CENTENNIAL,CO,49599,50935,1336,0.5066445182724253
CENTENNIAL,WY,75,70,-5,0.4827586206896552
CENTER,CO,947,756,-191,0.44392248972401643
CENTER,KY,12,11,-1,0.4782608695652174
CENTER,MO,80,199,119,0.7132616487455197
CENTER,ND,109,40,-69,0.2684563758389262
CENTER,TX,3371,3217,-154,0.48831208257437764
CENTER BARNSTEAD,NH,1689,1681,-8,0.498813056379822
CENTER CITY,MN,594,553,-41,0.48212728857890147
CENTER CONWAY,NH,1290,1290,0,0.5
CENTER CROSS,VA,21,12,-9,0.36363636363636365
CENTER HARBOR,NH,1853,1339,-514,0.41948621553884713
CENTER HILL,FL,1162,820,-342,0.41372351160444
CENTER LINE,MI,3557,3272,-285,0.47913310880070287
CENTER LOVELL,ME,75,111,36,0.5967741935483871
CENTER MORICHES,NY,2411,2465,54,0.5055373256767842
CENTER OSSIPEE,NH,1345,1228,-117,0.4772638942868247
CENTER POINT,AL,8826,7958,-868,0.47414204003813154
CENTER POINT,IA,1323,1276,-47,0.49095806079261256
CENTER POINT,IN,29,51,22,0.6375
CENTER POINT,LA,82,139,57,0.6289592760180995
CENTER POINT,TX,1083,1020,-63,0.48502139800285304
CENTER RIDGE,AR,164,282,118,0.6322869955156951
CENTER RUTLAND,VT,23,0,-23,0
CENTER SANDWICH,NH,309,350,41,0.5311077389984825
CENTER TUFTONBORO,NH,162,222,60,0.578125
CENTER VALLEY,PA,2029,2392,363,0.541054060167383
CENTERBROOK,CT,76,91,15,0.5449101796407185
CENTERBURG,OH,2033,2163,130,0.515490943755958
CENTEREACH,NY,5960,5666,-294,0.487355926371925
CENTERFIELD,UT,22,53,31,0.7066666666666667
CENTERLINE,MI,43,40,-3,0.4819277108433735
CENTERPOINT,IN,205,238,33,0.5372460496613995
CENTERPORT,NY,2000,1952,-48,0.4939271255060729
CENTERTON,AR,8428,10282,1854,0.5495456974879743
CENTERTOWN,KY,298,193,-105,0.39307535641547864
CENTERTOWN,MO,340,237,-103,0.41074523396880414
CENTERVIEW,MO,833,602,-231,0.4195121951219512
CENTERVILLE,GA,2549,2506,-43,0.4957467853610287
CENTERVILLE,IA,3993,3709,-284,0.4815632303297845
CENTERVILLE,IN,2211,2073,-138,0.4838935574229692
CENTERVILLE,KS,0,13,13,1
CENTERVILLE,MA,5133,5328,195,0.5093203326641812
CENTERVILLE,ME,14,14,0,0.5
CENTERVILLE,MN,627,709,82,0.530688622754491
CENTERVILLE,MO,65,41,-24,0.3867924528301887
CENTERVILLE,OH,2200,2468,268,0.5287060839760068
CENTERVILLE,PA,958,823,-135,0.46209994385176867
CENTERVILLE,SD,268,234,-34,0.46613545816733065
CENTERVILLE,TN,2869,2985,116,0.5099077553809361
CENTERVILLE,TX,1584,1188,-396,0.42857142857142855
CENTERVILLE,UT,5636,5277,-359,0.48355172729771834
CENTERVILLE,WA,11,12,1,0.5217391304347826
CENTRAL,AZ,0,11,11,1
CENTRAL,IN,25,0,-25,0
CENTRAL,SC,6621,5477,-1144,0.4527194577616135
CENTRAL,UT,22,49,27,0.6901408450704225
CENTRAL BRG,NY,12,0,-12,0
CENTRAL BRIDGE,NY,211,89,-122,0.2966666666666667
CENTRAL CITY,AR,24,33,9,0.5789473684210527
CENTRAL CITY,CO,603,477,-126,0.44166666666666665
CENTRAL CITY,IA,1053,851,-202,0.44695378151260506
CENTRAL CITY,KY,3290,3326,36,0.502720677146312
CENTRAL CITY,NE,1736,1608,-128,0.48086124401913877
CENTRAL CITY,PA,909,700,-209,0.435052827843381
CENTRAL CITY,SD,53,31,-22,0.36904761904761907
CENTRAL FALLS,RI,7613,6349,-1264,0.45473427875662514
CENTRAL ISLIP,NY,12278,10923,-1355,0.4707986724710142
CENTRAL LAKE,MI,1604,1361,-243,0.4590219224283305
CENTRAL POINT,OR,12120,12659,539,0.5108761451228863
CENTRAL SQUARE,NY,3755,3519,-236,0.4837778388781963
CENTRAL VALLEY,CA,66,95,29,0.5900621118012422
CENTRAL VALLEY,NY,674,623,-51,0.48033924441017734
CENTRAL VALLEY,UT,175,223,48,0.5603015075376885
CENTRAL VILLAGE,CT,81,58,-23,0.4172661870503597
CENTRALHATCHEE,GA,62,66,4,0.515625
CENTRALIA,IL,9013,7751,-1262,0.46235981865903125
CENTRALIA,KS,24,28,4,0.5384615384615384
CENTRALIA,MO,2775,2936,161,0.5140956049728594
CENTRALIA,WA,11440,10673,-767,0.4826572604350382
CENTRALIA,WV,33,29,-4,0.46774193548387094
CENTRE,AL,3011,3574,563,0.5427486712224753
CENTRE HALL,PA,1485,1358,-127,0.47766443897291594
CENTREVILLE,AL,1630,1561,-69,0.4891883422124726
CENTREVILLE,IL,497,355,-142,0.4166666666666667
CENTREVILLE,MD,2984,3447,463,0.535997512051003
CENTREVILLE,MI,1064,1016,-48,0.48846153846153845
CENTREVILLE,MS,194,223,29,0.5347721822541966
CENTREVILLE,VA,28242,26663,-1579,0.48562061743010654
CENTURIA,WI,983,672,-311,0.4060422960725076
CENTURY,FL,1153,1317,164,0.5331983805668016
CENTURY CITY,CA,875,907,32,0.5089786756453423
CEREDO,WV,261,229,-32,0.4673469387755102
CERES,CA,12222,10956,-1266,0.4726896194667357
CERESCO,MI,387,473,86,0.55
CERESCO,NE,344,218,-126,0.3879003558718861
CERRILLOS,NM,468,463,-5,0.49731471535982813
CERRITOS,CA,11796,11998,202,0.5042447675884677
CERRO GORDO,IL,558,345,-213,0.38205980066445183
CERRO GORDO,NC,91,105,14,0.5357142857142857
CERULEAN,KY,0,63,63,1
CEYLON,MN,66,12,-54,0.15384615384615385
CHADBOURN,NC,1716,1672,-44,0.4935064935064935
CHADDS FORD,PA,3427,3555,128,0.5091664279576052
CHADRON,NE,3212,2355,-857,0.42302856116400217
CHADWICK,IL,106,49,-57,0.3161290322580645
CHADWICK,MO,11,23,12,0.6764705882352942
CHADWICKS,NY,152,80,-72,0.3448275862068966
CHAFFEE,MO,2350,1880,-470,0.4444444444444444
CHAFFEE,NY,157,242,85,0.606516290726817
CHAGRIN FALLS,OH,10369,11616,1247,0.528360245622015
CHALFONT,PA,4895,5478,583,0.528101802757158
CHALK HILL,PA,11,0,-11,0
CHALLENGE,CA,0,11,11,1
CHALLIS,ID,1158,1160,2,0.5004314063848145
CHALMERS,IN,60,38,-22,0.3877551020408163
CHALMETTE,LA,6850,6799,-51,0.49813173126236354
CHAMA,NM,476,525,49,0.5244755244755245
CHAMBERLAIN,ME,62,13,-49,0.17333333333333334
CHAMBERLAIN,SD,1455,1156,-299,0.44274224435082343
CHAMBERS,AZ,82,44,-38,0.3492063492063492
CHAMBERS,NE,11,0,-11,0
CHAMBERSBURG,PA,23254,21513,-1741,0.4805548730091362
CHAMBLEE,GA,5287,5000,-287,0.486050354816759
CHAMOIS,MO,61,102,41,0.6257668711656442
CHAMPAIGN,IL,48920,40570,-8350,0.4533467426528104
CHAMPION,MI,385,255,-130,0.3984375
CHAMPION,NE,0,11,11,1
CHAMPION,PA,277,285,8,0.5071174377224199
CHAMPIONS GATE,FL,369,523,154,0.5863228699551569
CHAMPIONS GT,FL,366,398,32,0.5209424083769634
CHAMPLAIN,NY,2410,1655,-755,0.4071340713407134
CHAMPLIN,MN,8794,8118,-676,0.48001419110690635
CHANA,IL,0,11,11,1
CHANCE,MD,0,24,24,1
CHANCELLOR,AL,178,367,189,0.673394495412844
CHANCELLOR,SD,12,13,1,0.52
CHANDLER,AZ,144851,151544,6693,0.5112906762934597
CHANDLER,IN,2318,2308,-10,0.4989191526156507
CHANDLER,MN,49,11,-38,0.18333333333333332
CHANDLER,OK,2939,2550,-389,0.46456549462561486
CHANDLER,TX,3957,4472,515,0.5305492941036897
CHANDLER HEIGHTS,AZ,66,87,21,0.5686274509803921
CHANDLER HTS,AZ,0,15,15,1
CHANDLERSVILLE,OH,127,142,15,0.5278810408921933
CHANDLERVILLE,IL,73,72,-1,0.496551724137931
CHANHASSEN,MN,8038,8205,167,0.5051406759835005
CHANNAHON,IL,3567,4061,494,0.5323807026743577
CHANNELVIEW,TX,7303,6833,-470,0.4833757781550651
CHANNING,MI,97,21,-76,0.17796610169491525
CHANTILLY,VA,17052,18121,1069,0.5151963153555283
CHANUTE,KS,5300,4797,-503,0.4750916113697138
CHAPARRAL,NM,2031,2659,628,0.5669509594882729
CHAPEL HILL,NC,45756,44826,-930,0.4948665297741273
CHAPEL HILL,TN,2528,3146,618,0.5544589354952415
CHAPIN,IL,35,25,-10,0.4166666666666667
CHAPIN,SC,6980,10184,3204,0.5933348869727336
CHAPLIN,CT,799,847,48,0.5145808019441069
CHAPLIN,KY,0,23,23,1
CHAPMAN,KS,1388,1070,-318,0.435313262815297
CHAPMAN,ME,16,43,27,0.7288135593220338
CHAPMAN,NE,46,11,-35,0.19298245614035087
CHAPMANSBORO,TN,1188,948,-240,0.4438202247191011
CHAPMANVILLE,WV,1354,1415,61,0.5110148067894547
CHAPPAQUA,NY,2970,3681,711,0.5534506089309879
CHAPPELL,NE,415,351,-64,0.45822454308093996
CHAPPELL HILL,TX,432,719,287,0.6246741963509991
CHAPPELLS,SC,11,80,69,0.8791208791208791
CHAPTICO,MD,115,182,67,0.6127946127946128
CHARDON,OH,6527,6949,422,0.515657465123182
CHARITON,IA,3132,2712,-420,0.46406570841889117
CHARLEMONT,MA,595,564,-31,0.48662640207075064
CHARLEROI,PA,3861,3494,-367,0.4750509857239973
CHARLES CITY,IA,5527,4326,-1201,0.43905409519943167
CHARLES CITY,VA,1035,1121,86,0.5199443413729128
CHARLES TOWN,WV,6380,7158,778,0.5287339341113901
CHARLESTON,AR,1442,1548,106,0.5177257525083612
CHARLESTON,IL,10976,9815,-1161,0.47207926506661535
CHARLESTON,ME,157,206,49,0.5674931129476584
CHARLESTON,MO,1614,1598,-16,0.4975093399750934
CHARLESTON,MS,630,607,-23,0.49070331447049315
CHARLESTON,OR,323,296,-27,0.4781906300484653
CHARLESTON,SC,103328,92820,-10508,0.47321410363602995
CHARLESTON,TN,1614,1549,-65,0.489724944672779
CHARLESTON,WV,30534,28498,-2036,0.482755115869359
CHARLESTON AFB,SC,1113,1386,273,0.5546218487394958
CHARLESTOWN,IN,6925,7311,386,0.5135571789828604
CHARLESTOWN,MA,11512,9516,-1996,0.4525394711812821
CHARLESTOWN,MD,68,22,-46,0.24444444444444444
CHARLESTOWN,NH,2170,1911,-259,0.46826758147512865
CHARLESTOWN,RI,4278,4505,227,0.5129226915632472
CHARLEVOIX,MI,6195,6158,-37,0.49850238808386627
CHARLO,MT,265,386,121,0.5929339477726574
CHARLOTT HALL,MD,174,225,51,0.5639097744360902
CHARLOTTE,AR,22,12,-10,0.35294117647058826
CHARLOTTE,IA,24,12,-12,0.3333333333333333
CHARLOTTE,ME,85,118,33,0.5812807881773399
CHARLOTTE,MI,8276,7551,-725,0.47709610159853416
CHARLOTTE,NC,501017,481295,-19722,0.48996143791381963
CHARLOTTE,TN,1822,2138,316,0.5398989898989899
CHARLOTTE,TX,145,375,230,0.7211538461538461
CHARLOTTE,VT,1683,1940,257,0.5354678443279051
CHARLOTTE C H,VA,13,0,-13,0
CHARLOTTE COURT HOUSE,VA,729,664,-65,0.4766690595836324
CHARLOTTE HALL,MD,955,1182,227,0.5531118390266729
CHARLOTTESVILLE,VA,64969,55958,-9011,0.4627419848338254
CHARLOTTESVLE,VA,157,191,34,0.5488505747126436
CHARLTON,MA,3562,3871,309,0.520785685456747
CHARLTON CITY,MA,92,27,-65,0.226890756302521
CHARLTON HEIGHTS,WV,11,0,-11,0
CHARMCO,WV,13,0,-13,0
CHARTER OAK,IA,79,77,-2,0.4935897435897436
CHAS AFB,SC,24,13,-11,0.35135135135135137
CHASE,KS,12,13,1,0.52
CHASE,MI,360,275,-85,0.4330708661417323
CHASE CITY,VA,1463,1625,162,0.5262305699481865
CHASE MILLS,NY,86,28,-58,0.24561403508771928
CHASEBURG,WI,24,36,12,0.6
CHASKA,MN,11577,11681,104,0.5022357898357555
CHASSELL,MI,1269,1065,-204,0.45629820051413883
CHATEAUGAY,NY,1215,917,-298,0.4301125703564728
CHATFIELD,MN,1311,1403,92,0.5169491525423728
CHATFIELD,OH,11,0,-11,0
CHATHAM,IL,5762,5781,19,0.5008230096162176
CHATHAM,LA,470,298,-172,0.3880208333333333
CHATHAM,MA,3228,3839,611,0.5432290929673128
CHATHAM,MI,35,40,5,0.5333333333333333
CHATHAM,NH,53,45,-8,0.45918367346938777
CHATHAM,NJ,4718,4752,34,0.5017951425554382
CHATHAM,NY,1505,1557,52,0.508491182233834
CHATHAM,VA,1996,2006,10,0.5012493753123438
CHATHAM TWP,NJ,663,723,60,0.5216450216450217
CHATOM,AL,271,232,-39,0.46123260437375746
CHATSWORTH,CA,13855,14229,374,0.5066585956416465
CHATSWORTH,GA,9584,9532,-52,0.4986398828206738
CHATSWORTH,IL,832,560,-272,0.40229885057471265
CHATSWORTH,NJ,25,12,-13,0.32432432432432434
CHATTAHOOCHEE,FL,1212,1198,-14,0.4970954356846473
CHATTAHOOCHEE HILLS,GA,321,318,-3,0.49765258215962443
CHATTANOOGA,OK,28,24,-4,0.46153846153846156
CHATTANOOGA,TN,112994,102510,-10484,0.47567562551043135
CHATTAROY,WA,2216,2274,58,0.5064587973273942
CHAUMONT,NY,1146,1161,15,0.5032509752925878
CHAUNCEY,OH,215,135,-80,0.38571428571428573
CHAUTAUQUA,NY,2559,1950,-609,0.4324683965402528
CHAUVIN,LA,1547,1232,-315,0.4433249370277078
CHAVIES,KY,38,26,-12,0.40625
CHAZY,NY,1074,779,-295,0.42039935240151105
CHEBANSE,IL,829,647,-182,0.4383468834688347
CHEBEAGUE ISLAND,ME,98,282,184,0.7421052631578947
CHEBOYGAN,MI,7750,6960,-790,0.47314751869476546
CHECK,VA,100,154,54,0.6062992125984252
CHECOTAH,OK,3665,3650,-15,0.4989747095010253
CHEDAPEAKE,VA,306,351,45,0.5342465753424658
CHEEKTOWAGA,NY,6228,5636,-592,0.4750505731625084
CHEHALIS,WA,9569,9843,274,0.5070574902122399
CHELAN,WA,3970,3709,-261,0.4830055996874593
CHELMSFORD,MA,7975,8550,575,0.5173978819969742
CHELSEA,AL,3900,5051,1151,0.5642944922355044
CHELSEA,IA,33,37,4,0.5285714285714286
CHELSEA,MA,16286,12711,-3575,0.4383556919681346
CHELSEA,ME,271,308,37,0.531951640759931
CHELSEA,MI,4536,4738,202,0.510890662065991
CHELSEA,OK,2160,1985,-175,0.47889022919179736
CHELSEA,VT,376,348,-28,0.48066298342541436
CHELTENHAM,MD,671,954,283,0.587076923076923
CHELTENHAM,PA,1512,1680,168,0.5263157894736842
CHEMULT,OR,74,25,-49,0.25252525252525254
CHEMUNG,NY,101,50,-51,0.33112582781456956
CHENANGO FKS,NY,66,25,-41,0.27472527472527475
CHENANGO FORKS,NY,622,655,33,0.5129209083790133
CHENEGA BAY,AK,24,0,-24,0
CHENEY,KS,1403,1358,-45,0.49185077870336835
CHENEY,WA,11696,10961,-735,0.4837798472878139
CHENEYVILLE,LA,46,61,15,0.5700934579439252
CHENOA,IL,1329,1013,-316,0.43253629376601194
CHEPACHET,RI,1909,2295,386,0.5459086584205518
CHERAW,SC,3949,3547,-402,0.4731856990394877
CHERITON,VA,76,39,-37,0.3391304347826087
CHEROKEE,AL,1157,1227,70,0.5146812080536913
CHEROKEE,IA,3317,2955,-362,0.4711415816326531
CHEROKEE,KS,119,73,-46,0.3802083333333333
CHEROKEE,NC,1044,1207,163,0.5362061306086184
CHEROKEE,OK,626,625,-1,0.49960031974420466
CHEROKEE,TX,22,0,-22,0
CHEROKEE VILLAGE,AR,2547,2585,38,0.5037022603273578
CHEROKEE VLG,AR,59,39,-20,0.3979591836734694
CHERRY,IL,28,0,-28,0
CHERRY CREEK,NY,285,175,-110,0.3804347826086957
CHERRY GROVE,NY,648,435,-213,0.40166204986149584
CHERRY HILL,NJ,24133,25094,961,0.5097609035691795
CHERRY HILLS VILLAGE,CO,114,160,46,0.583941605839416
CHERRY LOG,GA,312,464,152,0.5979381443298969
CHERRY TREE,PA,584,501,-83,0.46175115207373274
CHERRY VALLEY,AR,709,470,-239,0.3986429177268872
CHERRY VALLEY,CA,2058,2468,410,0.5452938577110031
CHERRY VALLEY,IL,1520,1508,-12,0.49801849405548215
CHERRY VALLEY,MA,770,725,-45,0.48494983277591974
CHERRY VALLEY,NY,879,604,-275,0.40728253540121373
CHERRYFIELD,ME,284,455,171,0.6156968876860622
CHERRYHILL,NJ,180,194,14,0.5187165775401069
CHERRYVALE,KS,1529,1257,-272,0.45118449389806176
CHERRYVILLE,MO,13,11,-2,0.4583333333333333
CHERRYVILLE,NC,3959,4045,86,0.5053723138430785
CHERRYVILLE,PA,0,15,15,1
CHESANING,MI,2258,2208,-50,0.49440214957456335
CHESAPEAK BCH,MD,61,64,3,0.512
CHESAPEAKE,OH,2280,2131,-149,0.48311040580367265
CHESAPEAKE,VA,94246,96180,1934,0.5050780880762081
CHESAPEAKE,WV,95,71,-24,0.42771084337349397
CHESAPEAKE BEACH,MD,4107,3751,-356,0.47734792568083484
CHESAPEAKE CITY,MD,1034,1100,66,0.5154639175257731
CHESHIRE,CT,6652,7595,943,0.5330946866006878
CHESHIRE,MA,1009,1028,19,0.5046637211585665
CHESHIRE,OH,64,36,-28,0.36
CHESHIRE,OR,269,304,35,0.5305410122164049
CHESILHURST,NJ,425,305,-120,0.4178082191780822
CHESNEE,SC,4303,4920,617,0.533448986230077
CHESTER,AR,37,30,-7,0.44776119402985076
CHESTER,CA,1823,1173,-650,0.39152202937249664
CHESTER,CT,1268,1416,148,0.5275707898658718
CHESTER,GA,45,70,25,0.6086956521739131
CHESTER,IA,0,12,12,1
CHESTER,ID,32,0,-32,0
CHESTER,IL,2634,2014,-620,0.43330464716006883
CHESTER,MA,214,134,-80,0.3850574712643678
CHESTER,MD,3177,3545,368,0.5273728057125855
CHESTER,ME,500,498,-2,0.49899799599198397
CHESTER,MT,335,168,-167,0.33399602385685884
CHESTER,NH,1337,1440,103,0.518545192653943
CHESTER,NJ,2299,2606,307,0.5312945973496432
CHESTER,NY,3394,3301,-93,0.49305451829723673
CHESTER,OK,0,11,11,1
CHESTER,PA,11399,9952,-1447,0.466113999344293
CHESTER,SC,5389,5445,56,0.5025844563411482
CHESTER,SD,115,28,-87,0.1958041958041958
CHESTER,TX,28,14,-14,0.3333333333333333
CHESTER,VA,20924,22626,1702,0.519540757749713
CHESTER,VT,2158,2074,-84,0.4900756143667297
CHESTER,WV,2105,1387,-718,0.3971935853379152
CHESTER GAP,VA,13,0,-13,0
CHESTER SPRGS,PA,882,1127,245,0.5609756097560976
CHESTER SPRINGS,PA,2608,3544,936,0.576072821846554
CHESTERBROOK,PA,472,445,-27,0.48527808069792805
CHESTERFIELD,IN,285,285,0,0.5
CHESTERFIELD,MA,58,24,-34,0.2926829268292683
CHESTERFIELD,MI,10335,10203,-132,0.49678644463920535
CHESTERFIELD,MO,22601,23352,751,0.5081713925097382
CHESTERFIELD,NH,47,72,25,0.6050420168067226
CHESTERFIELD,NJ,942,1221,279,0.5644937586685159
CHESTERFIELD,SC,1533,1518,-15,0.4975417895771878
CHESTERFIELD,VA,15608,19397,3789,0.5541208398800171
CHESTERHILL,OH,109,108,-1,0.4976958525345622
CHESTERLAND,OH,2534,2733,199,0.5188912094171255
CHESTERTON,IN,10614,10753,139,0.5032526793653765
CHESTERTOWN,MD,4435,4894,459,0.5246007074713259
CHESTERTOWN,NY,1891,1460,-431,0.43569083855565505
CHESTERVILLE,ME,828,791,-37,0.48857319332921556
CHESTNUT,IL,0,13,13,1
CHESTNUT HILL,MA,7570,7243,-327,0.48896239789374196
CHESTNUT HILL COVE,MD,198,193,-5,0.4936061381074169
CHESTNUT MOUND,TN,23,12,-11,0.34285714285714286
CHESTNUT MOUNTAIN,GA,0,24,24,1
CHESTNUT MTN,GA,11,11,0,0.5
CHESTNUT RIDGE,NY,742,506,-236,0.40544871794871795
CHESTNUTRIDGE,MO,0,12,12,1
CHESWICK,PA,2420,2475,55,0.5056179775280899
CHESWOLD,DE,55,220,165,0.8
CHETEK,WI,3420,3152,-268,0.4796104686548996
CHETOPA,KS,410,400,-10,0.49382716049382713
CHEVERLY,MD,3925,3341,-584,0.45981282686485
CHEVIOT,OH,705,647,-58,0.47855029585798814
CHEVY CHASE,DC,337,343,6,0.5044117647058823
CHEVY CHASE,MD,13541,12880,-661,0.4874910109382688
CHEWELAH,WA,2518,2672,154,0.5148362235067437
CHEYENNE,OK,386,344,-42,0.4712328767123288
CHEYENNE,WY,50699,48222,-2477,0.48747990820958137
CHEYENNE WELLS,CO,209,56,-153,0.21132075471698114
CHICAGO,IL,1237295,1050168,-187127,0.4590972619010668
CHICAGO HEIGHTS,IL,7747,7432,-315,0.48962382238619145
CHICAGO HTS,IL,24,35,11,0.5932203389830508
CHICAGO PARK,CA,63,0,-63,0
CHICAGO RIDGE,IL,6110,4423,-1687,0.41991835184657744
CHICHESTER,NH,728,826,98,0.5315315315315315
CHICHESTER,NY,26,51,25,0.6623376623376623
CHICKALOON,AK,89,110,21,0.5527638190954773
CHICKAMAUGA,GA,4253,4717,464,0.5258639910813824
CHICKASAW,AL,2496,2165,-331,0.4644925981549024
CHICKASHA,OK,9013,8349,-664,0.48087777905771223
CHICO,CA,58948,51136,-7812,0.46451800443297847
CHICO,TX,1358,1503,145,0.5253407899335897
CHICOPEE,MA,24090,21093,-2997,0.46683487152247527
CHICORA,PA,1278,1184,-94,0.4809098294069862
CHIDESTER,AR,105,112,7,0.5161290322580645
CHIEFLAND,FL,4095,4665,570,0.5325342465753424
CHILCOOT,CA,0,28,28,1
CHILDERSBURG,AL,2885,2659,-226,0.4796176046176046
CHILDRESS,TX,1969,1978,9,0.5011401064099316
CHILHOWEE,MO,61,107,46,0.6369047619047619
CHILHOWIE,VA,2317,1986,-331,0.46153846153846156
CHILI,WI,100,51,-49,0.33774834437086093
CHILLICOTHE,IL,4508,3729,-779,0.4527133665169358
CHILLICOTHE,MO,5997,5510,-487,0.4788389675849483
CHILLICOTHE,OH,21453,19144,-2309,0.47156193807424196
CHILLICOTHE,TX,12,11,-1,0.4782608695652174
CHILLUM,MD,850,659,-191,0.4367130550033135
CHILMARK,MA,857,1475,618,0.6325042881646655
CHILOQUIN,OR,1850,1830,-20,0.49728260869565216
CHILTON,TX,195,76,-119,0.28044280442804426
CHILTON,WI,2676,2526,-150,0.4855824682814302
CHIMACUM,WA,972,996,24,0.5060975609756098
CHIMAYO,NM,12,64,52,0.8421052631578947
CHINA,ME,323,280,-43,0.46434494195688225
CHINA,MI,651,596,-55,0.47794707297514033
CHINA,TX,111,66,-45,0.3728813559322034
CHINA GROVE,NC,3580,4032,452,0.5296899632159747
CHINA GROVE,TX,180,197,17,0.5225464190981433
CHINA SPRING,TX,1635,1940,305,0.5426573426573427
CHINA VILLAGE,ME,51,50,-1,0.49504950495049505
CHINCOTEAGUE,VA,21,41,20,0.6612903225806451
CHINCOTEAGUE ISLAND,VA,1876,1926,50,0.5065754865860074
CHINESE CAMP,CA,11,0,-11,0
CHINLE,AZ,835,1000,165,0.5449591280653951
CHINO,CA,26426,28536,2110,0.5191950802372548
CHINO HILLS,CA,26677,25088,-1589,0.4846517917511832
CHINO VALLEY,AZ,8096,9516,1420,0.5403134226663638
CHINOOK,MT,583,414,-169,0.4152457372116349
CHINOOK,WA,85,73,-12,0.4620253164556962
CHINQUAPIN,NC,272,376,104,0.5802469135802469
CHIPLEY,FL,5542,5958,416,0.5180869565217391
CHIPPEWA BAY,NY,70,113,43,0.6174863387978142
CHIPPEWA FALLS,WI,15094,13767,-1327,0.47701049859672223
CHIPPEWA LAKE,MI,57,52,-5,0.47706422018348627
CHIPPEWA LAKE,OH,676,878,202,0.564993564993565
CHIRENO,TX,81,107,26,0.5691489361702128
CHIRIACO SUMMIT,CA,465,466,1,0.5005370569280344
CHISAGO CITY,MN,2716,2793,77,0.5069885641677255
CHISHOLM,MN,2598,2187,-411,0.4570532915360502
CHITTENANGO,NY,3117,3060,-57,0.4953861097620204
CHITTENDEN,VT,57,66,9,0.5365853658536586
CHIVINGTON,CO,11,0,-11,0
CHLOE,WV,120,68,-52,0.3617021276595745
CHLORIDE,AZ,59,115,56,0.6609195402298851
CHOCORUA,NH,115,72,-43,0.3850267379679144
CHOCOWINITY,NC,2285,2550,265,0.5274043433298863
CHOCTAW,OK,7274,7832,558,0.518469482324904
CHOKIO,MN,75,11,-64,0.12790697674418605
CHOKOLOSKEE,FL,533,500,-33,0.484027105517909
CHOTEAU,MT,896,893,-3,0.4991615427613192
CHOUDRANT,LA,1260,1231,-29,0.4941790445604175
CHOUTEAU,OK,1826,1643,-183,0.4736235226289997
CHOWCHILLA,CA,6122,5634,-488,0.4792446410343654
CHRISMAN,IL,640,572,-68,0.47194719471947194
CHRISNEY,IN,186,125,-61,0.40192926045016075
CHRISTIANA,DE,449,389,-60,0.46420047732696895
CHRISTIANA,PA,1024,841,-183,0.4509383378016086
CHRISTIANA,TN,2399,3422,1023,0.5878714997423123
CHRISTIANSBRG,VA,323,329,6,0.504601226993865
CHRISTIANSBURG,VA,14060,13656,-404,0.4927117910232357
CHRISTMAS,FL,998,1393,395,0.5826014219991635
CHRISTMAS,MI,122,112,-10,0.47863247863247865
CHRISTMAS VALLEY,OR,319,290,-29,0.47619047619047616
CHRISTOPHER,IL,1687,1305,-382,0.43616310160427807
CHRISTOVAL,TX,381,494,113,0.5645714285714286
CHROMO,CO,0,16,16,1
CHUALAR,CA,34,25,-9,0.423728813559322
CHUBBUCK,ID,1533,1597,64,0.5102236421725239
CHUCKEY,TN,2369,3047,678,0.5625923190546529
CHUGIAK,AK,2852,2726,-126,0.4887056292577985
CHUGWATER,WY,38,13,-25,0.2549019607843137
CHULA,GA,103,135,32,0.5672268907563025
CHULA VISTA,CA,97478,93216,-4262,0.48882502857981897
CHULUOTA,FL,2301,2526,225,0.5233064014916097
CHUNCHULA,AL,1248,1321,73,0.514207862981705
CHUNKY,MS,48,50,2,0.5102040816326531
CHURCH CREEK,MD,11,0,-11,0
CHURCH HILL,MD,631,629,-2,0.4992063492063492
CHURCH HILL,TN,5055,5173,118,0.5057684786859601
CHURCH POINT,LA,3145,3369,224,0.5171937365673933
CHURCH ROAD,VA,262,276,14,0.5130111524163569
CHURCH ROCK,NM,146,60,-86,0.2912621359223301
CHURCHTON,MD,884,863,-21,0.4939896966227819
CHURCHVILLE,MD,732,818,86,0.5277419354838709
CHURCHVILLE,NY,2594,2610,16,0.5015372790161414
CHURCHVILLE,PA,516,484,-32,0.484
CHURCHVILLE,VA,917,863,-54,0.4848314606741573
CHURDAN,IA,96,73,-23,0.4319526627218935
CHURUBUSCO,IN,2276,2304,28,0.503056768558952
CHURUBUSCO,NY,0,13,13,1
CIBECUE,AZ,11,0,-11,0
CIBOLO,TX,12006,13915,1909,0.5368234250221828
CICERO,IL,15648,12414,-3234,0.442377592473808
CICERO,IN,2659,2832,173,0.5157530504461847
CICERO,NY,5976,5882,-94,0.4960364311013662
CIMARRON,CO,155,180,25,0.5373134328358209
CIMARRON,KS,727,703,-24,0.4916083916083916
CIMARRON,NM,36,139,103,0.7942857142857143
CINCINNATI,IA,27,12,-15,0.3076923076923077
CINCINNATI,OH,306635,283464,-23171,0.48036685369743043
CINCINNATUS,NY,910,875,-35,0.49019607843137253
CINEBAR,WA,33,35,2,0.5147058823529411
CINNAMINSON,NJ,4005,4425,420,0.5249110320284698
CIRCLE,MT,141,44,-97,0.23783783783783785
CIRCLE PINES,MN,7755,7646,-109,0.49646126874878255
CIRCLEVILLE,KS,12,0,-12,0
CIRCLEVILLE,NY,90,162,72,0.6428571428571429
CIRCLEVILLE,OH,9632,9288,-344,0.4909090909090909
CISCO,IL,12,0,-12,0
CISCO,TX,2318,2384,66,0.5070182900893236
CISNE,IL,462,326,-136,0.4137055837563452
CISSNA PARK,IL,294,307,13,0.5108153078202995
CITRA,FL,2822,3627,805,0.5624127771747558
CITRONELLE,AL,2179,2064,-115,0.4864482677350931
CITRUS HEIGHTS,CA,40732,36425,-4307,0.4720893762069546
CITRUS HILLS,FL,388,193,-195,0.33218588640275387
CITRUS HTS,CA,1227,1014,-213,0.4524765729585007
CITRUS SPGS,FL,76,112,36,0.5957446808510638
CITRUS SPRINGS,FL,4912,6182,1270,0.5572381467459888
CITY CENTER,NV,25,17,-8,0.40476190476190477
CITY INDUSTRY,CA,940,1003,63,0.5162120432321153
CITY OF INDUSTRY,CA,3017,3019,2,0.5001656726308814
CITY OF SPOKANE VALLEY,WA,1917,2061,144,0.5180995475113123
CITY OF SUNRISE,FL,2629,2163,-466,0.45137729549248745
CKENZIE BRIDGE,OR,58,60,2,0.5084745762711864
CLACKAMAS,OR,11643,11691,48,0.5010285420416559
CLAFLIN,KS,64,42,-22,0.39622641509433965
CLAIRTON,PA,6106,5095,-1011,0.45487010088384966
CLALLAM BAY,WA,80,35,-45,0.30434782608695654
CLAM GULCH,AK,28,69,41,0.711340206185567
CLANCY,MT,1404,1750,346,0.5548509828788839
CLANTON,AL,6513,6784,271,0.5101902684816124
CLARA CITY,MN,627,518,-109,0.4524017467248908
CLARCONA,FL,1327,604,-723,0.3127912998446401
CLARE,MI,4276,3548,-728,0.4534764826175869
CLAREMONT,CA,10791,11527,736,0.5164889327000627
CLAREMONT,IL,11,0,-11,0
CLAREMONT,MN,244,175,-69,0.41766109785202865
CLAREMONT,NC,2717,2881,164,0.5146480886030725
CLAREMONT,NH,8177,6933,-1244,0.4588352084712111
CLAREMORE,OK,16296,17737,1441,0.521170628507625
CLARENCE,IA,433,425,-8,0.49533799533799533
CLARENCE,IL,92,51,-41,0.35664335664335667
CLARENCE,MO,560,273,-287,0.3277310924369748
CLARENCE,NY,3376,3609,233,0.5166785969935577
CLARENCE,PA,11,0,-11,0
CLARENCE CENTER,NY,2374,2635,261,0.5260531044120583
CLARENCE CTR,NY,29,71,42,0.71
CLARENDON,AR,771,750,-21,0.4930966469428008
CLARENDON,NC,147,298,151,0.6696629213483146
CLARENDON,PA,718,577,-141,0.44555984555984557
CLARENDON,TX,461,528,67,0.5338725985844287
CLARENDON HILLS,IL,3121,3188,67,0.5053098747820574
CLARIDGE,PA,12,97,85,0.8899082568807339
CLARINDA,IA,3116,2793,-323,0.47266881028938906
CLARINGTON,OH,171,145,-26,0.4588607594936709
CLARINGTON,PA,25,11,-14,0.3055555555555556
CLARION,IA,1576,1313,-263,0.45448251990308064
CLARION,PA,3971,3760,-211,0.48635364118484026
CLARISSA,MN,320,246,-74,0.43462897526501765
CLARK,CO,320,405,85,0.5586206896551724
CLARK,MO,339,365,26,0.5184659090909091
CLARK,NJ,3526,3607,81,0.5056778354128698
CLARK,SD,621,572,-49,0.47946353730092206
CLARK FORK,ID,1132,1034,-98,0.4773776546629732
CLARK MILLS,NY,437,243,-194,0.3573529411764706
CLARKDALE,AZ,2218,2612,394,0.5407867494824017
CLARKDALE,GA,12,121,109,0.9097744360902256
CLARKESVILLE,GA,4358,5042,684,0.5363829787234042
CLARKFIELD,MN,338,222,-116,0.3964285714285714
CLARKLAKE,MI,1001,965,-36,0.4908443540183113
CLARKRANGE,TN,906,1013,107,0.5278791036998437
CLARKRIDGE,AR,40,0,-40,0
CLARKS,LA,12,0,-12,0
CLARKS,NE,38,69,31,0.6448598130841121
CLARKS GROVE,MN,177,216,39,0.549618320610687
CLARKS HILL,IN,160,176,16,0.5238095238095238
CLARKS HILL,SC,50,93,43,0.6503496503496503
CLARKS MILLS,PA,12,11,-1,0.4782608695652174
CLARKS SUMMIT,PA,3462,4048,586,0.5390146471371504
CLARKSBORO,NJ,736,1151,415,0.6099629040805511
CLARKSBURG,CA,38,34,-4,0.4722222222222222
CLARKSBURG,MA,154,116,-38,0.42962962962962964
CLARKSBURG,MD,7694,10684,2990,0.581347263031886
CLARKSBURG,MO,79,24,-55,0.23300970873786409
CLARKSBURG,NJ,45,41,-4,0.47674418604651164
CLARKSBURG,OH,389,245,-144,0.3864353312302839
CLARKSBURG,PA,61,11,-50,0.1527777777777778
CLARKSBURG,WV,10122,8453,-1669,0.4550740242261104
CLARKSDALE,MO,0,11,11,1
CLARKSDALE,MS,6115,5390,-725,0.46849196001738375
CLARKSON,KY,1788,1939,151,0.5202575798229139
CLARKSON,NE,45,22,-23,0.3283582089552239
CLARKSON,NY,0,12,12,1
CLARKSTON,GA,17738,11265,-6473,0.38840809571423646
CLARKSTON,MI,16016,16045,29,0.5004522628738967
CLARKSTON,UT,14,0,-14,0
CLARKSTON,WA,10438,8901,-1537,0.4602616474481617
CLARKSVILLE,AR,6870,6690,-180,0.49336283185840707
CLARKSVILLE,FL,105,137,32,0.5661157024793388
CLARKSVILLE,IA,690,546,-144,0.441747572815534
CLARKSVILLE,IN,11790,10527,-1263,0.47170318591208493
CLARKSVILLE,MD,2432,3440,1008,0.5858310626702997
CLARKSVILLE,MI,460,531,71,0.5358224016145308
CLARKSVILLE,MO,303,161,-142,0.34698275862068967
CLARKSVILLE,NH,40,59,19,0.5959595959595959
CLARKSVILLE,OH,1096,1277,181,0.5381373788453434
CLARKSVILLE,PA,470,530,60,0.53
CLARKSVILLE,TN,115580,109578,-6002,0.4866715817337159
CLARKSVILLE,TX,1663,1798,135,0.5195030338052586
CLARKSVILLE,VA,1511,1667,156,0.5245437382001259
CLARKTON,MO,535,455,-80,0.4595959595959596
CLARKTON,NC,1257,1048,-209,0.4546637744034707
CLARYVILLE,NY,23,46,23,0.6666666666666666
CLATONIA,NE,16,0,-16,0
CLATSKANIE,OR,2112,2316,204,0.5230352303523035
CLAUDE,TX,206,338,132,0.6213235294117647
CLAUDVILLE,VA,35,58,23,0.6236559139784946
CLAVERACK,NY,315,311,-4,0.4968051118210863
CLAWSON,MI,4933,3941,-992,0.4441063781834573
CLAXTON,GA,2829,2875,46,0.5040322580645161
CLAY,KY,836,738,-98,0.46886912325285895
CLAY,MI,2620,2398,-222,0.47787963332004785
CLAY,NY,3435,3364,-71,0.4947786439182233
CLAY,WV,439,296,-143,0.40272108843537413
CLAY CENTER,KS,2380,2084,-296,0.4668458781362007
CLAY CENTER,NE,178,90,-88,0.3358208955223881
CLAY CITY,IL,607,355,-252,0.369022869022869
CLAY CITY,IN,691,742,51,0.5177948360083741
CLAY CITY,KY,2571,2629,58,0.505576923076923
CLAY HILL,FL,0,12,12,1
CLAY SPRINGS,AZ,12,32,20,0.7272727272727273
CLAYHOLE,KY,15,0,-15,0
CLAYMONT,DE,6843,7895,1052,0.5356900529244131
CLAYPOOL,AZ,569,394,-175,0.4091381100726895
CLAYPOOL,IN,1104,1008,-96,0.4772727272727273
CLAYSBURG,PA,1475,1312,-163,0.4707570864729099
CLAYSVILLE,PA,1409,1166,-243,0.45281553398058255
CLAYTON,AL,707,770,63,0.5213270142180095
CLAYTON,CA,3099,3556,457,0.5343350864012021
CLAYTON,DE,2427,3026,599,0.5549238951036127
CLAYTON,GA,3842,3929,87,0.5055977351692189
CLAYTON,ID,11,13,2,0.5416666666666666
CLAYTON,IL,129,125,-4,0.4921259842519685
CLAYTON,IN,1505,1595,90,0.5145161290322581
CLAYTON,LA,117,62,-55,0.3463687150837989
CLAYTON,MI,411,352,-59,0.4613368283093054
CLAYTON,MO,1435,1407,-28,0.49507389162561577
CLAYTON,NC,29115,37243,8128,0.5612435576720215
CLAYTON,NJ,2355,2532,177,0.518109269490485
CLAYTON,NM,1139,1114,-25,0.4944518419884598
CLAYTON,NY,3530,3307,-223,0.4836916776363902
CLAYTON,OH,1165,1153,-12,0.497411561691113
CLAYTON,OK,773,456,-317,0.371033360455655
CLAYTON,WA,498,587,89,0.5410138248847927
CLAYTON,WI,768,712,-56,0.4810810810810811
CLAYVILLE,NY,207,241,34,0.5379464285714286
CLE ELUM,WA,3916,4168,252,0.5155863433943593
CLEAR BROOK,VA,613,727,114,0.5425373134328358
CLEAR LAKE,IA,5662,4838,-824,0.46076190476190476
CLEAR LAKE,MN,2648,2433,-215,0.4788427474906514
CLEAR LAKE,SD,673,573,-100,0.45987158908507225
CLEAR LAKE,WI,1081,1058,-23,0.4946236559139785
CLEAR LAKE SHORES,TX,169,175,6,0.5087209302325582
CLEAR LK SHRS,TX,105,121,16,0.5353982300884956
CLEAR SPRING,MD,1265,1370,105,0.5199240986717267
CLEARBROOK,MN,358,383,25,0.5168690958164642
CLEARFIELD,IA,34,24,-10,0.41379310344827586
CLEARFIELD,KY,1633,1516,-117,0.48142267386471893
CLEARFIELD,PA,5274,4987,-287,0.486015008283793
CLEARFIELD,UT,23298,22188,-1110,0.4877984434771138
CLEARLAKE,CA,5755,4985,-770,0.46415270018621974
CLEARLAKE,WA,246,164,-82,0.4
CLEARLAKE OAKS,CA,1578,1587,9,0.5014218009478673
CLEARLAKE OKS,CA,71,83,12,0.538961038961039
CLEARLAKE PARK,CA,130,0,-130,0
CLEARVILLE,PA,298,182,-116,0.37916666666666665
CLEARWATER,FL,117286,117044,-242,0.49948363419109804
CLEARWATER,ID,161,125,-36,0.4370629370629371
CLEARWATER,KS,1776,1720,-56,0.4919908466819222
CLEARWATER,MN,1996,1810,-186,0.47556489753021547
CLEARWATER,NE,38,28,-10,0.42424242424242425
CLEARWATER,SC,94,84,-10,0.47191011235955055
CLEARWATER BEACH,FL,6235,7019,784,0.529575977063528
CLEBURNE,TX,16449,17319,870,0.5128820184790334
CLEMENTON,NJ,11201,10242,-959,0.4776383901506319
CLEMENTS,CA,117,120,3,0.5063291139240507
CLEMENTS,MD,36,49,13,0.5764705882352941
CLEMMONS,NC,9351,11228,1877,0.5456047426988678
CLEMSON,SC,7116,4761,-2355,0.4008588027279616
CLENDENIN,WV,1167,1187,20,0.5042480883602379
CLEO SPRINGS,OK,12,12,0,0.5
CLERMONT,FL,52935,60950,8015,0.5351890064538789
CLERMONT,GA,1294,1616,322,0.5553264604810997
CLERMONT,IA,186,115,-71,0.38205980066445183
CLERMONT,IN,410,467,57,0.5324971493728621
CLEVE,OH,91,65,-26,0.4166666666666667
CLEVELAND,AL,953,1065,112,0.5277502477700694
CLEVELAND,AR,14,56,42,0.8
CLEVELAND,GA,8465,9558,1093,0.5303223658658381
CLEVELAND,IL,46,57,11,0.5533980582524272
CLEVELAND,MN,413,394,-19,0.4882280049566295
CLEVELAND,MO,436,547,111,0.5564598168870803
CLEVELAND,MS,5799,4924,-875,0.4591998507880257
CLEVELAND,NC,1479,1764,285,0.543940795559667
CLEVELAND,NY,1122,884,-238,0.4406779661016949
CLEVELAND,OH,257586,231097,-26489,0.4728975634511534
CLEVELAND,OK,3616,2642,-974,0.4221796100990732
CLEVELAND,SC,255,515,260,0.6688311688311688
CLEVELAND,TN,39360,38605,-755,0.49515808375553133
CLEVELAND,TX,11810,17418,5608,0.5959354044067333
CLEVELAND,UT,11,26,15,0.7027027027027027
CLEVELAND,VA,224,95,-129,0.29780564263322884
CLEVELAND,WI,605,531,-74,0.46742957746478875
CLEVELAND HEIGHTS,OH,12534,10763,-1771,0.4619908142679315
CLEVELAND HTS,OH,689,627,-62,0.4764437689969605
CLEVER,MO,2060,2219,159,0.5185791072680532
CLEVERDALE,NY,59,37,-22,0.3854166666666667
CLEVES,OH,4597,4757,160,0.5085524909129784
CLEWISTON,FL,5219,5652,433,0.5199153711710054
CLIFFORD,IN,26,0,-26,0
CLIFFORD,MI,206,95,-111,0.31561461794019935
CLIFFORD TOWNSHIP,PA,277,256,-21,0.4803001876172608
CLIFFORD TWP,PA,34,44,10,0.5641025641025641
CLIFFSIDE PARK,NJ,9703,8450,-1253,0.46548779816008373
CLIFFWOOD,NJ,1438,1379,-59,0.4895278665246716
CLIFTON,AZ,829,562,-267,0.40402588066139467
CLIFTON,CO,9280,7314,-1966,0.4407617211040135
CLIFTON,IL,576,562,-14,0.4938488576449912
CLIFTON,KS,23,0,-23,0
CLIFTON,LA,0,17,17,1
CLIFTON,ME,221,225,4,0.5044843049327354
CLIFTON,NJ,25931,23968,-1963,0.480330267139622
CLIFTON,TN,569,690,121,0.5480540111199365
CLIFTON,TX,2537,2886,349,0.5321777613866864
CLIFTON,VA,3565,4128,563,0.5365917067463928
CLIFTON FORGE,VA,2392,2101,-291,0.467616292009793
CLIFTON HEIGHTS,PA,3801,2121,-1680,0.35815602836879434
CLIFTON HTS,PA,358,195,-163,0.352622061482821
CLIFTON PARK,NY,13943,13225,-718,0.4867859246171967
CLIFTON SPGS,NY,49,46,-3,0.4842105263157895
CLIFTON SPRINGS,NY,1946,1923,-23,0.4970276557249935
CLIFTON TOWNSHIP,PA,289,288,-1,0.49913344887348354
CLIMAX,GA,500,484,-16,0.491869918699187
CLIMAX,MI,570,502,-68,0.46828358208955223
CLIMAX,NC,626,759,133,0.548014440433213
CLIMAX SPRGS,MO,28,39,11,0.582089552238806
CLIMAX SPRINGS,MO,491,486,-5,0.49744114636642783
CLINCHCO,VA,166,114,-52,0.40714285714285714
CLINT,TX,1087,1196,109,0.5238720981165134
CLINTON,AR,2637,2921,284,0.5255487585462396
CLINTON,CT,4566,4914,348,0.5183544303797468
CLINTON,IA,14736,12489,-2247,0.458732782369146
CLINTON,IL,4234,3777,-457,0.4714767195106728
CLINTON,IN,4128,3863,-265,0.4834188462019772
CLINTON,KY,1506,1271,-235,0.45768815268275115
CLINTON,LA,1072,1222,150,0.5326939843068875
CLINTON,MA,7139,6171,-968,0.4636363636363636
CLINTON,MD,9851,10988,1137,0.5272805796823264
CLINTON,ME,1363,1282,-81,0.48468809073724006
CLINTON,MI,1724,1313,-411,0.43233454066513005
CLINTON,MN,148,46,-102,0.23711340206185566
CLINTON,MO,8168,7043,-1125,0.46302018276247453
CLINTON,MS,8733,7627,-1106,0.46619804400977993
CLINTON,MT,935,896,-39,0.4893500819224468
CLINTON,NC,6489,6283,-206,0.49193548387096775
CLINTON,NJ,2016,1822,-194,0.4747264200104221
CLINTON,NY,3947,3842,-105,0.4932597252535627
CLINTON,OH,1351,1344,-7,0.4987012987012987
CLINTON,OK,5389,3822,-1567,0.4149386602974704
CLINTON,PA,1274,1261,-13,0.49743589743589745
CLINTON,SC,4868,4539,-329,0.4825130222174976
CLINTON,TN,9040,9256,216,0.5059029296020988
CLINTON,UT,550,518,-32,0.4850187265917603
CLINTON,WA,2892,2898,6,0.5005181347150259
CLINTON,WI,1290,1198,-92,0.4815112540192926
CLINTON CORNERS,NY,819,1007,188,0.5514786418400877
CLINTON TOWNSHIP,MI,42992,37021,-5971,0.46268731331158686
CLINTON TWP,MI,1134,927,-207,0.4497816593886463
CLINTONDALE,NY,385,309,-76,0.4452449567723343
CLINTONVILLE,PA,126,23,-103,0.15436241610738255
CLINTONVILLE,WI,3470,3479,9,0.5006475751906749
CLINTONVILLE,WV,14,0,-14,0
CLINTWOOD,VA,1590,1626,36,0.5055970149253731
CLIO,AL,250,192,-58,0.4343891402714932
CLIO,CA,75,156,81,0.6753246753246753
CLIO,MI,8344,7780,-564,0.4825105432895063
CLIO,SC,170,190,20,0.5277777777777778
CLIPPER MILLS,CA,29,11,-18,0.275
CLITHERALL,MN,339,351,12,0.508695652173913
CLIVE,IA,7044,7428,384,0.5132669983416253
CLOPTON,AL,11,0,-11,0
CLOQUET,MN,7171,6446,-725,0.47337886465447604
CLOSTER,NJ,2177,2502,325,0.5347296430861295
CLOUDCROFT,NM,1333,1330,-3,0.49943672549755913
CLOUDLAND,GA,48,52,4,0.52
CLOVER,SC,13725,16835,3110,0.5508835078534031
CLOVER,VA,104,129,25,0.5536480686695279
CLOVERDALE,CA,3936,3588,-348,0.4768740031897927
CLOVERDALE,IN,2359,2307,-52,0.4944277753964852
CLOVERDALE,OH,194,92,-102,0.32167832167832167
CLOVERDALE,OR,1150,866,-284,0.42956349206349204
CLOVERDALE,VA,391,284,-107,0.42074074074074075
CLOVERPORT,KY,476,433,-43,0.47634763476347636
CLOVIS,CA,45130,46816,1686,0.5091684249450764
CLOVIS,NM,22552,20361,-2191,0.4744716053410388
CLUTE,TX,7950,6378,-1572,0.445142378559464
CLUTIER,IA,24,0,-24,0
CLYDE,KS,42,34,-8,0.4473684210526316
CLYDE,MI,1235,1344,109,0.521132221791392
CLYDE,NC,3685,3976,291,0.518992298655528
CLYDE,NY,1622,1495,-127,0.47962784728906
CLYDE,OH,3698,3352,-346,0.4754609929078014
CLYDE,TX,3271,3294,23,0.5017517136329017
CLYDE PARK,MT,67,70,3,0.5109489051094891
CLYMAN,WI,175,29,-146,0.14215686274509803
CLYMER,NY,831,616,-215,0.4257083621285418
CLYMER,PA,1221,1026,-195,0.45660881174899864
CLYO,GA,269,507,238,0.6533505154639175
CMBRLND FRNCE,TN,26,40,14,0.6060606060606061
CNTRY CLB HLS,IL,127,143,16,0.5296296296296297
COACHELLA,CA,5895,5668,-227,0.49018420825045406
COAHOMA,MS,12,0,-12,0
COAHOMA,TX,202,213,11,0.5132530120481927
COAL CENTER,PA,202,149,-53,0.42450142450142453
COAL CITY,IL,3000,2476,-524,0.45215485756026297
COAL CITY,IN,104,111,7,0.5162790697674419
COAL CITY,WV,111,94,-17,0.4585365853658537
COAL GROVE,OH,661,555,-106,0.4564144736842105
COAL HILL,AR,146,206,60,0.5852272727272727
COAL TOWNSHIP,PA,2197,2309,112,0.51242787394585
COAL VALLEY,IL,1861,2000,139,0.518000518000518
COALDALE,CO,0,13,13,1
COALDALE,PA,1137,1019,-118,0.47263450834879406
COALFIELD,TN,0,12,12,1
COALGATE,OK,1398,1432,34,0.5060070671378092
COALINGA,CA,4407,3850,-557,0.4662710427516047
COALMONT,IN,23,0,-23,0
COALMONT,TN,167,176,9,0.5131195335276968
COALPORT,PA,354,311,-43,0.46766917293233085
COALTON,OH,13,0,-13,0
COALTON,WV,29,29,0,0.5
COALVILLE,UT,1140,1281,141,0.5291201982651796
COARSEGOLD,CA,3907,4170,263,0.5162807973257397
COATESVILLE,IN,1723,1953,230,0.5312840043525572
COATESVILLE,PA,18984,15676,-3308,0.4522792844777842
COATOPA,AL,37,25,-12,0.4032258064516129
COATS,NC,1612,1726,114,0.5170760934691432
COBB,CA,724,538,-186,0.42630744849445323
COBB,GA,86,90,4,0.5113636363636364
COBB,WI,23,12,-11,0.34285714285714286
COBB ISLAND,MD,23,28,5,0.5490196078431373
COBBS CREEK,VA,132,310,178,0.7013574660633484
COBBTOWN,GA,449,475,26,0.5140692640692641
COBDEN,IL,720,716,-4,0.4986072423398329
COBLESKILL,NY,3093,3130,37,0.5029728426803792
COBURN,PA,0,13,13,1
COCHECTON,NY,244,234,-10,0.4895397489539749
COCHISE,AZ,179,250,71,0.5827505827505828
COCHITI LAKE,NM,11,13,2,0.5416666666666666
COCHRAN,GA,4349,3808,-541,0.4668382983940174
COCHRANE,WI,535,527,-8,0.4962335216572505
COCHRANTON,PA,1743,1609,-134,0.48001193317422436
COCHRANVILLE,PA,1242,1341,99,0.519163763066202
COCKEYSVILLE,MD,15383,12272,-3111,0.4437533899837281
COCO RIVER,FL,318,803,485,0.7163247100802854
COCOA,FL,32391,33782,1391,0.5105103289861423
COCOA BEACH,FL,13116,14060,944,0.5173682661171622
COCOLALLA,ID,572,581,9,0.5039028620988725
COCONUT CREEK,FL,28849,28431,-418,0.49635125698324023
COCONUT GROVE,FL,2336,1955,-381,0.4556047541365649
CODELL,KS,18,24,6,0.5714285714285714
CODEN,AL,907,865,-42,0.4881489841986456
CODY,WY,9662,9083,-579,0.4845558815684182
COEBURN,VA,2103,1868,-235,0.47041047595064217
COEUR D ALENE,ID,34857,34363,-494,0.49643166714822307
COEYMANS,NY,23,47,24,0.6714285714285714
COEYMANS HOLLOW,NY,0,11,11,1
COFFEE SPGS,AL,11,13,2,0.5416666666666666
COFFEE SPRINGS,AL,105,141,36,0.573170731707317
COFFEEN,IL,197,93,-104,0.32068965517241377
COFFEEVILLE,AL,0,11,11,1
COFFEEVILLE,MS,1086,887,-199,0.44956918398378104
COFFEY,MO,0,12,12,1
COFFEYVILLE,KS,7396,4753,-2643,0.3912256152769775
COFFMAN COVE,AK,13,24,11,0.6486486486486487
COGAN STATION,PA,1271,1331,60,0.5115295926210607
COGGON,IA,250,280,30,0.5283018867924528
COHASSET,MA,2884,3271,387,0.5314378554021121
COHASSET,MN,1359,1357,-2,0.4996318114874816
COHOAMA,TX,14,0,-14,0
COHOCTON,NY,515,494,-21,0.489593657086224
COHOES,NY,12273,11661,-612,0.48721484081223365
COHUTTA,GA,2232,1853,-379,0.4536107711138311
COILA,MS,12,11,-1,0.4782608695652174
COIN,IA,0,11,11,1
COINJOCK,NC,50,46,-4,0.4791666666666667
COKATO,MN,2022,1788,-234,0.4692913385826772
COKEBURG,PA,72,36,-36,0.3333333333333333
COKEDALE,CO,99,122,23,0.5520361990950227
COKER,AL,836,917,81,0.5231032515687393
COKEVILLE,WY,25,0,-25,0
COLBERT,GA,1958,2175,217,0.5262521171062182
COLBERT,OK,1012,1131,119,0.5277648156789547
COLBERT,WA,3499,3836,337,0.5229720518064076
COLBY,KS,3399,2636,-763,0.4367854183927092
COLBY,WI,1026,934,-92,0.47653061224489796
COLCHESTER,CT,5596,5736,140,0.5061771973173315
COLCHESTER,IL,798,734,-64,0.47911227154047
COLCHESTER,VT,8510,8188,-322,0.4903581267217631
COLCORD,OK,1317,1473,156,0.5279569892473118
COLD BAY,AK,0,18,18,1
COLD BROOK,NY,678,650,-28,0.4894578313253012
COLD SPG HBR,NY,39,38,-1,0.4935064935064935
COLD SPRGS HIGHLAND HTS,KY,119,90,-29,0.430622009569378
COLD SPRING,KY,1425,1312,-113,0.4793569601753745
COLD SPRING,MN,2743,2763,20,0.5018162005085361
COLD SPRING,NY,1823,2040,217,0.5280869790318405
COLD SPRING HARBOR,NY,901,1014,113,0.5295039164490861
COLDEN,NY,471,570,99,0.547550432276657
COLDSPRING,TX,2307,2938,631,0.5601525262154433
COLDWATER,KS,74,72,-2,0.4931506849315068
COLDWATER,MI,12072,10789,-1283,0.47193911027514107
COLDWATER,MS,2617,2995,378,0.5336778332145403
COLDWATER,OH,1661,1272,-389,0.4336856460961473
COLE CAMP,MO,1023,1117,94,0.52196261682243
COLEBROOK,CT,204,317,113,0.6084452975047985
COLEBROOK,NH,1602,1439,-163,0.47319960539296285
COLEHARBOR,ND,76,23,-53,0.23232323232323232
COLEMAN,FL,70,89,19,0.559748427672956
COLEMAN,MI,1795,1690,-105,0.48493543758967
COLEMAN,OK,23,35,12,0.603448275862069
COLEMAN,TX,2408,2213,-195,0.4789006708504653
COLEMAN,WI,665,627,-38,0.4852941176470588
COLERAIN,NC,299,377,78,0.5576923076923077
COLERAIN TOWNSHIP,OH,391,404,13,0.5081761006289308
COLERAINE,MN,344,269,-75,0.43882544861337686
COLERIDGE,NE,26,12,-14,0.3157894736842105
COLESBURG,IA,104,48,-56,0.3157894736842105
COLESVILLE,MD,1104,997,-107,0.4745359352689196
COLEVILLE,CA,636,477,-159,0.42857142857142855
COLFAX,CA,2929,2947,18,0.5015316541865215
COLFAX,IA,1367,1243,-124,0.4762452107279693
COLFAX,IL,633,280,-353,0.3066812705366922
COLFAX,IN,209,252,43,0.5466377440347071
COLFAX,LA,1333,1348,15,0.5027974636329727
COLFAX,NC,1567,2265,698,0.5910751565762005
COLFAX,ND,13,13,0,0.5
COLFAX,WA,1857,1706,-151,0.4788099915801291
COLFAX,WI,1755,1753,-2,0.499714937286203
COLGATE,WI,1146,1344,198,0.5397590361445783
COLLBRAN,CO,486,274,-212,0.3605263157894737
COLLEGE CORNER,OH,112,38,-74,0.25333333333333335
COLLEGE GROVE,TN,1564,2869,1305,0.6471915181592601
COLLEGE PARK,GA,15962,15499,-463,0.49264168335399383
COLLEGE PARK,MD,13331,9807,-3524,0.4238482150574812
COLLEGE PLACE,WA,5464,4376,-1088,0.44471544715447153
COLLEGE POINT,NY,7743,5604,-2139,0.4198696336255338
COLLEGE STA,TX,877,806,-71,0.47890671420083186
COLLEGE STATION,TX,63316,50520,-12796,0.44379633859236095
COLLEGEDALE,TN,531,196,-335,0.2696011004126547
COLLEGEVILLE,PA,8396,9416,1020,0.528632382663373
COLLETTSVILLE,NC,0,36,36,1
COLLEYVILLE,TX,6563,8449,1886,0.562816413535838
COLLIERS,WV,335,383,48,0.5334261838440112
COLLIERVILLE,TN,15836,18248,2412,0.5353831709893205
COLLINGDALE,PA,1592,1341,-251,0.4572110467098534
COLLINGSWOOD,NJ,6476,6046,-430,0.4828302188148858
COLLINS,GA,853,873,20,0.5057937427578215
COLLINS,IA,229,108,-121,0.32047477744807124
COLLINS,MO,164,322,158,0.6625514403292181
COLLINS,MS,2422,1998,-424,0.45203619909502263
COLLINS,NY,351,320,-31,0.47690014903129657
COLLINS,OH,195,195,0,0.5
COLLINSTON,LA,160,261,101,0.6199524940617577
COLLINSVILLE,AL,1214,1313,99,0.519588444796201
COLLINSVILLE,CT,1076,1060,-16,0.49625468164794007
COLLINSVILLE,IL,11912,10810,-1102,0.4757503740867881
COLLINSVILLE,MS,1191,1293,102,0.5205314009661836
COLLINSVILLE,OK,6572,7448,876,0.5312410841654779
COLLINSVILLE,TX,1259,1435,176,0.5326651818856719
COLLINSVILLE,VA,2356,2325,-31,0.4966887417218543
COLLINWOOD,TN,634,659,25,0.5096674400618716
COLMAN,SD,210,162,-48,0.43548387096774194
COLMAR,PA,337,689,352,0.6715399610136452
COLMAR MANOR,MD,124,103,-21,0.45374449339207046
COLMESNEIL,TX,999,1012,13,0.5032322227747389
COLO,IA,207,215,8,0.509478672985782
COLO CITY,CO,46,131,85,0.7401129943502824
COLO SPGS,CO,14227,16005,1778,0.529405927494046
COLO SPRINGS,CO,510,503,-7,0.49654491609081935
COLOGNE,MN,900,956,56,0.5150862068965517
COLOMA,MI,3603,3382,-221,0.48418038654259127
COLOMA,WI,395,506,111,0.5615982241953386
COLOME,SD,61,51,-10,0.45535714285714285
COLON,MI,1318,1174,-144,0.471107544141252
COLONA,IL,2469,2258,-211,0.4776814046964248
COLONIA,NJ,3478,3731,253,0.5175475100568734
COLONIAL BCH,VA,80,89,9,0.5266272189349113
COLONIAL BEACH,VA,3990,4046,56,0.5034843205574913
COLONIAL HEIGHTS,VA,11999,9460,-2539,0.4408406729111329
COLONIE,NY,852,838,-14,0.4958579881656805
COLONY,KS,35,49,14,0.5833333333333334
COLORA,MD,272,368,96,0.575
COLORAD SPRINGS,CO,0,16,16,1
COLORADO CITY,AZ,207,403,196,0.660655737704918
COLORADO CITY,CO,728,764,36,0.5120643431635389
COLORADO CITY,TX,2395,2342,-53,0.4944057420308212
COLORADO SPGS,CO,5474,5941,467,0.5204555409548839
COLORADO SPRINGS,CO,348519,322046,-26473,0.48026067569885095
COLP,IL,15,13,-2,0.4642857142857143
COLQUITT,GA,1828,1845,17,0.5023141845902532
COLRAIN,MA,487,476,-11,0.49428868120456904
COLSTRIP,MT,645,356,-289,0.35564435564435565
COLT,AR,667,655,-12,0.49546142208774585
COLTON,CA,17911,16407,-1504,0.47808730112477416
COLTON,NY,801,873,72,0.521505376344086
COLTON,OR,870,897,27,0.5076400679117148
COLTON,SD,160,147,-13,0.4788273615635179
COLTON,WA,42,0,-42,0
COLTONS POINT,MD,12,13,1,0.52
COLTS NECK,NJ,2547,3118,571,0.5503971756398941
COLUMBIA,AL,720,700,-20,0.49295774647887325
COLUMBIA,CA,1080,1023,-57,0.4864479315263909
COLUMBIA,CT,1564,1733,169,0.5256293600242645
COLUMBIA,IL,3781,3942,161,0.510423410591739
COLUMBIA,KY,6483,6297,-186,0.49272300469483565
COLUMBIA,LA,2475,2185,-290,0.4688841201716738
COLUMBIA,MD,45822,42992,-2830,0.48406782714436913
COLUMBIA,ME,42,28,-14,0.4
COLUMBIA,MO,85341,73053,-12288,0.4612106519186333
COLUMBIA,MS,4926,4275,-651,0.4646234104988588
COLUMBIA,NC,1227,955,-272,0.4376718606782768
COLUMBIA,NJ,974,1062,88,0.5216110019646365
COLUMBIA,PA,8274,7185,-1089,0.4647777993401902
COLUMBIA,SC,157495,141902,-15593,0.47395932490973525
COLUMBIA,TN,25385,26930,1545,0.5147663194112587
COLUMBIA,VA,189,372,183,0.6631016042780749
COLUMBIA CITY,IN,10314,8889,-1425,0.4628964224339947
COLUMBIA CITY,OR,734,614,-120,0.45548961424332346
COLUMBIA CROSS ROADS,PA,684,616,-68,0.47384615384615386
COLUMBIA FALLS,ME,43,79,36,0.6475409836065574
COLUMBIA FALLS,MT,7287,7363,76,0.5025938566552901
COLUMBIA HEIGHTS,MN,2100,1668,-432,0.4426751592356688
COLUMBIA HTS,MN,613,476,-137,0.43709825528007346
COLUMBIA STA,OH,52,55,3,0.514018691588785
COLUMBIA STATION,OH,2028,2697,669,0.5707936507936507
COLUMBIA TOWNSHIP,OH,152,242,90,0.6142131979695431
COLUMBIANA,AL,3008,2777,-231,0.48003457216940365
COLUMBIANA,OH,3702,3828,126,0.5083665338645418
COLUMBIAVILLE,MI,2109,2038,-71,0.49143959488787076
COLUMBUS,GA,88825,77235,-11590,0.46510297482837526
COLUMBUS,IL,0,11,11,1
COLUMBUS,IN,37211,31882,-5329,0.4614360354883997
COLUMBUS,KS,2250,2131,-119,0.48641862588450124
COLUMBUS,MI,1113,1410,297,0.558858501783591
COLUMBUS,MN,478,514,36,0.5181451612903226
COLUMBUS,MS,18512,16744,-1768,0.4749262536873156
COLUMBUS,MT,1560,1683,123,0.5189639222941721
COLUMBUS,NC,2482,2663,181,0.5175898931000972
COLUMBUS,NE,14157,11861,-2296,0.45587670074563763
COLUMBUS,NJ,2259,2519,260,0.527208036835496
COLUMBUS,NM,683,253,-430,0.2702991452991453
COLUMBUS,OH,421976,373010,-48966,0.4692032312518711
COLUMBUS,PA,22,13,-9,0.37142857142857144
COLUMBUS,TX,2415,2223,-192,0.4793014230271669
COLUMBUS,WI,2775,2738,-37,0.49664429530201343
COLUMBUS GROVE,OH,1318,1081,-237,0.45060441850771155
COLUMBUS GRV,OH,35,37,2,0.5138888888888888
COLUMBUS JCT,IA,99,110,11,0.5263157894736842
COLUMBUS JUNCTION,IA,1070,936,-134,0.4666001994017946
COLUSA,CA,2125,2065,-60,0.4928400954653938
COLVER,PA,144,49,-95,0.2538860103626943
COLVILLE,WA,6071,5878,-193,0.49192401037743744
COLWICH,KS,887,897,10,0.5028026905829597
COMANCHE,OK,1776,1593,-183,0.4728406055209261
COMANCHE,TX,2717,2866,149,0.5133440802435967
COMBES,TX,11,82,71,0.8817204301075269
COMBINE,TX,106,150,44,0.5859375
COMBINED LCKS,WI,82,115,33,0.583756345177665
COMBINED LOCKS,WI,764,809,45,0.5143038779402416
COMBS,KY,0,11,11,1
COMER,GA,1846,1671,-175,0.4751208416263861
COMFORT,TX,1560,1722,162,0.5246800731261426
COMFORT,WV,32,11,-21,0.2558139534883721
COMFREY,MN,73,12,-61,0.1411764705882353
COMINS,MI,125,49,-76,0.28160919540229884
COMMACK,NY,6883,7482,599,0.5208492864601462
COMMERCE,CA,3417,2744,-673,0.44538224314234703
COMMERCE,GA,7659,7147,-512,0.4827097122788059
COMMERCE,OK,1061,750,-311,0.41413583655438985
COMMERCE,TX,6352,4497,-1855,0.4145082496082588
COMMERCE CITY,CO,24208,26980,2772,0.5270766585918575
COMMERCE TOWNSHIP,MI,9344,9051,-293,0.49203587931503123
COMMERCE TWP,MI,139,100,-39,0.41841004184100417
COMMERCIAL POINT,OH,510,1114,604,0.6859605911330049
COMMERCIAL PT,OH,21,61,40,0.7439024390243902
COMMISKEY,IN,102,82,-20,0.44565217391304346
COMMODORE,PA,207,90,-117,0.30303030303030304
COMO,CO,314,179,-135,0.3630831643002028
COMO,MS,954,1064,110,0.5272547076313181
COMO,NC,11,25,14,0.6944444444444444
COMO,TX,438,474,36,0.5197368421052632
COMPTCHE,CA,0,12,12,1
COMPTON,AR,11,0,-11,0
COMPTON,CA,23267,19784,-3483,0.45954797797960556
COMPTON,IL,11,0,-11,0
COMSTOCK,MI,0,27,27,1
COMSTOCK,NY,0,11,11,1
COMSTOCK,WI,109,123,14,0.5301724137931034
COMSTOCK PARK,MI,9672,6911,-2761,0.4167520955195079
CONCAN,TX,0,75,75,1
CONCHO,AZ,1097,1554,457,0.5861938890984534
CONCHO,OK,31,0,-31,0
CONCORD,AR,38,82,44,0.6833333333333333
CONCORD,CA,44995,41063,-3932,0.4771549420158498
CONCORD,GA,802,973,171,0.548169014084507
CONCORD,MA,6901,7288,387,0.5136373246881387
CONCORD,MI,1044,927,-117,0.4703196347031963
CONCORD,NC,51171,55164,3993,0.5187755677810693
CONCORD,NH,19295,17322,-1973,0.4730589616844635
CONCORD,TN,289,356,67,0.5519379844961241
CONCORD,VA,1202,1274,72,0.5145395799676898
CONCORD,VT,221,248,27,0.5287846481876333
CONCORD FARR,TN,297,342,45,0.5352112676056338
CONCORD TOWNSHIP,OH,1664,1628,-36,0.4945321992709599
CONCORD TWP,ME,59,34,-25,0.3655913978494624
CONCORDIA,KS,2993,2915,-78,0.49339878131347326
CONCORDIA,MO,1619,1373,-246,0.4588903743315508
CONCRETE,WA,2313,1790,-523,0.4362661467219108
CONDON,MT,199,328,129,0.6223908918406073
CONDON,OR,85,43,-42,0.3359375
CONEHATTA,MS,97,157,60,0.6181102362204725
CONEMAUGH,PA,423,487,64,0.5351648351648352
CONESTOGA,PA,1187,1095,-92,0.47984224364592465
CONESUS,NY,1187,1025,-162,0.46338155515370705
CONESVILLE,IA,137,23,-114,0.14375
CONESVILLE,OH,36,22,-14,0.3793103448275862
CONEWANGO VALLEY,NY,131,50,-81,0.27624309392265195
CONFLUENCE,PA,983,804,-179,0.44991606043648574
CONGERS,NY,2177,2077,-100,0.48824635637047487
CONGERVILLE,IL,27,38,11,0.5846153846153846
CONGRESS,AZ,2020,1980,-40,0.495
CONIFER,CO,3641,3802,161,0.5108155313717587
CONKLIN,MI,290,339,49,0.5389507154213037
CONKLIN,NY,1457,1207,-250,0.4530780780780781
CONLEY,GA,3815,3280,-535,0.46229739252995067
CONNEAUT,OH,5951,5486,-465,0.4796712424586867
CONNEAUT LAKE,PA,2763,2370,-393,0.46171829339567505
CONNEAUTVILLE,PA,904,938,34,0.509229098805646
CONNELL,WA,645,726,81,0.5295404814004376
CONNELLSVILLE,PA,6584,5711,-873,0.46449776331842213
CONNELLY,NY,12,38,26,0.76
CONNELLY SPRINGS,NC,2928,2919,-9,0.49923037455105185
CONNER,MT,15,36,21,0.7058823529411765
CONNERSVILLE,IN,12970,10379,-2591,0.4445158250888689
CONNOR TWP,ME,76,83,7,0.5220125786163522
CONOVER,NC,6833,6920,87,0.5031629462662692
CONOVER,OH,0,57,57,1
CONOVER,WI,1127,915,-212,0.44809010773751223
CONOWINGO,MD,970,1007,37,0.5093576125442589
CONRAD,IA,515,372,-143,0.41939120631341603
CONRAD,MT,1395,1365,-30,0.4945652173913043
CONRATH,WI,15,24,9,0.6153846153846154
CONROE,TX,70698,79986,9288,0.530819463247591
CONROY,IA,11,0,-11,0
CONSHOHOCKEN,PA,10470,8733,-1737,0.45477269176691143
CONSTABLE,NY,777,769,-8,0.4974126778783959
CONSTABLEVILLE,NY,58,11,-47,0.15942028985507245
CONSTANTIA,NY,897,881,-16,0.4955005624296963
CONSTANTINE,MI,2010,1707,-303,0.45924132364810333
CONTINENTAL,OH,625,666,41,0.5158791634391944
CONTOOCOOK,NH,1169,1259,90,0.5185337726523888
CONVENT,LA,120,107,-13,0.4713656387665198
CONVENT STA,NJ,12,0,-12,0
CONVERSE,IN,725,630,-95,0.46494464944649444
CONVERSE,LA,415,521,106,0.5566239316239316
CONVERSE,TX,23664,28972,5308,0.5504217645717759
CONVOY,OH,707,633,-74,0.47238805970149256
CONWAY,AR,37538,35859,-1679,0.4885622028148289
CONWAY,MA,134,275,141,0.6723716381418093
CONWAY,MI,168,34,-134,0.16831683168316833
CONWAY,MO,990,1040,50,0.5123152709359606
CONWAY,NC,318,315,-3,0.4976303317535545
CONWAY,NH,1655,1419,-236,0.4616135328562134
CONWAY,PA,522,457,-65,0.466802860061287
CONWAY,SC,26952,32707,5755,0.5482324544494545
CONWAY,WA,41,12,-29,0.22641509433962265
CONWAY SPRINGS,KS,498,429,-69,0.4627831715210356
CONYERS,GA,37377,37909,532,0.5035331934224159
CONYNGHAM,PA,330,288,-42,0.46601941747572817
COOK,MN,1747,1441,-306,0.45200752823086576
COOK,NE,13,0,-13,0
COOKE CITY,MT,84,114,30,0.5757575757575758
COOKEVILLE,TN,31772,31020,-752,0.4940119760479042
COOKS,MI,27,11,-16,0.2894736842105263
COOKSON,OK,251,407,156,0.6185410334346505
COOKSTOWN,NJ,71,83,12,0.538961038961039
COOKSVILLE,IL,22,0,-22,0
COOKSVILLE,MD,22,49,27,0.6901408450704225
COOKVILLE,TX,164,239,75,0.5930521091811415
COOL,CA,1387,1525,138,0.523695054945055
COOL RIDGE,WV,346,387,41,0.5279672578444747
COOLEEMEE,NC,660,102,-558,0.13385826771653545
COOLIDGE,AZ,8907,9288,381,0.5104699093157461
COOLIDGE,GA,705,451,-254,0.39013840830449825
COOLIDGE,TX,51,105,54,0.6730769230769231
COOLIN,ID,313,446,133,0.5876152832674572
COOLVILLE,OH,1081,972,-109,0.47345348270823184
COON RAPIDS,IA,549,595,46,0.5201048951048951
COON RAPIDS,MN,11337,9440,-1897,0.4543485585021899
COON VALLEY,WI,412,436,24,0.5141509433962265
COOPER,ME,43,11,-32,0.2037037037037037
COOPER,TX,1259,1341,82,0.5157692307692308
COOPER CITY,FL,6302,6887,585,0.5221775722192736
COOPER LANDING,AK,170,159,-11,0.48328267477203646
COOPER LNDG,AK,0,38,38,1
COOPERSBURG,PA,3477,4117,640,0.5421385304187516
COOPERSTOWN,ND,374,368,-6,0.49595687331536387
COOPERSTOWN,NY,2853,2727,-126,0.48870967741935484
COOPERSTOWN,PA,138,132,-6,0.4888888888888889
COOPERSVILLE,MI,2747,2598,-149,0.4860617399438728
COOS BAY,OR,16186,13969,-2217,0.463239927043608
COOSADA,AL,188,142,-46,0.4303030303030303
COOTER,MO,0,11,11,1
COPAKE,NY,948,907,-41,0.4889487870619946
COPAKE FALLS,NY,36,126,90,0.7777777777777778
COPALIS BEACH,WA,128,184,56,0.5897435897435898
COPAN,OK,297,363,66,0.55
COPE,SC,226,391,165,0.6337115072933549
COPELAND,KS,36,25,-11,0.4098360655737705
COPEMISH,MI,350,393,43,0.5289367429340511
COPENHAGEN,NY,859,639,-220,0.4265687583444593
COPIAGUE,NY,6752,5817,-935,0.4628053146630599
COPLAY,PA,2100,2034,-66,0.49201741654571846
COPLEY,OH,5483,5606,123,0.5055460366128596
COPPELL,TX,18243,20061,1818,0.5237312030075187
COPPER CENTER,AK,304,197,-107,0.3932135728542914
COPPER HARBOR,MI,0,34,34,1
COPPER HILL,VA,365,475,110,0.5654761904761905
COPPERAS COVE,TX,24186,22778,-1408,0.48500979473639383
COPPERHILL,TN,648,816,168,0.5573770491803278
COPPEROPOLIS,CA,1973,2268,295,0.534779533128979
COPPERTON,UT,12,25,13,0.6756756756756757
COQUILLE,OR,3227,3164,-63,0.4950711938663746
CORA,WY,100,74,-26,0.42528735632183906
CORAL,MI,359,141,-218,0.282
CORAL GABLES,FL,32703,30165,-2538,0.4798148501622447
CORAL SPRINGS,FL,60282,60193,-89,0.49963062876115377
CORALVILLE,IA,15156,13466,-1690,0.470477255258193
CORAM,MT,49,34,-15,0.40963855421686746
CORAM,NY,12427,11091,-1336,0.4715962241687218
CORAOPOLIS,PA,14154,13303,-851,0.48450304111884035
CORAPEAKE,NC,164,231,67,0.5848101265822785
CORBETT,OR,1221,1113,-108,0.4768637532133676
CORBIN,KY,11544,11497,-47,0.4989800789896272
CORBIN CITY,NJ,107,99,-8,0.48058252427184467
CORCORAN,CA,3959,3762,-197,0.487242585157363
CORCORAN,MN,438,591,153,0.5743440233236151
CORDELE,GA,7044,6867,-177,0.4936381281000647
CORDELL,OK,1824,1418,-406,0.43738433066008636
CORDER,MO,12,11,-1,0.4782608695652174
CORDESVILLE,SC,12,0,-12,0
CORDILLERA,CO,137,173,36,0.5580645161290323
CORDOVA,AK,1887,890,-997,0.3204897371263954
CORDOVA,AL,1576,1566,-10,0.49840865690642905
CORDOVA,IL,240,102,-138,0.2982456140350877
CORDOVA,MD,276,412,136,0.5988372093023255
CORDOVA,NC,12,27,15,0.6923076923076923
CORDOVA,SC,1108,1018,-90,0.47883349012229537
CORDOVA,TN,39313,35891,-3422,0.47724855060901017
CORE,WV,202,212,10,0.5120772946859904
COREA,ME,66,63,-3,0.4883720930232558
CORFU,NY,1279,1210,-69,0.48613901165126555
CORINNA,ME,889,877,-12,0.49660249150622876
CORINNE,UT,155,238,83,0.6055979643765903
CORINTH,KY,1010,1094,84,0.5199619771863118
CORINTH,ME,1014,1049,35,0.508482792050412
CORINTH,MS,9725,9315,-410,0.4892331932773109
CORINTH,NY,2296,2455,159,0.5167333193011997
CORINTH,TX,7711,8227,516,0.5161877274438449
CORINTH,VT,49,141,92,0.7421052631578947
CORN,OK,59,38,-21,0.3917525773195876
CORNELIA,GA,3831,3730,-101,0.4933209892871313
CORNELIUS,NC,16222,16453,231,0.5035348125478194
CORNELIUS,OR,4093,4667,574,0.5327625570776255
CORNELL,IL,91,50,-41,0.3546099290780142
CORNELL,MI,76,83,7,0.5220125786163522
CORNELL,WI,1399,1212,-187,0.4641899655304481
CORNERSVILLE,TN,717,935,218,0.5659806295399515
CORNETTSVILLE,KY,0,25,25,1
CORNING,AR,2099,1914,-185,0.4769499127834538
CORNING,CA,6689,5498,-1191,0.45113645688028225
CORNING,IA,1182,1078,-104,0.47699115044247786
CORNING,NY,9567,8553,-1014,0.47201986754966885
CORNING,OH,659,601,-58,0.476984126984127
CORNISH,ME,457,722,265,0.6123833757421544
CORNISH,NH,188,188,0,0.5
CORNISH FLAT,NH,12,0,-12,0
CORNUCOPIA,WI,29,77,48,0.7264150943396226
CORNVILLE,AZ,3110,3352,242,0.5187248529866915
CORNVILLE,ME,213,164,-49,0.4350132625994695
CORNWALL,CT,0,11,11,1
CORNWALL,NY,2226,2216,-10,0.4988743809095002
CORNWALL,PA,0,11,11,1
CORNWALL,VT,246,257,11,0.510934393638171
CORNWALL BRIDGE,CT,172,356,184,0.6742424242424242
CORNWALL HDSN,NY,114,131,17,0.5346938775510204
CORNWALL ON HUDSON,NY,1064,1039,-25,0.4940561103185925
CORNWALLVILLE,NY,12,27,15,0.6923076923076923
COROLLA,NC,1164,1435,271,0.5521354367064255
CORONA,CA,59829,61214,1385,0.505721107375065
CORONA,NY,18247,11689,-6558,0.39046632816675575
CORONA DEL MAR,CA,6262,6386,124,0.5049019607843137
CORONA DL MAR,CA,136,163,27,0.5451505016722408
CORONADO,CA,11241,12588,1347,0.5282638801460405
CORP CHRISTI,TX,4159,4083,-76,0.49538946857558847
CORPUS CHRISTI,TX,124617,118025,-6592,0.4864162016468707
CORRAL DE TIERRA,CA,272,319,47,0.5397631133671743
CORRALES,NM,2665,3412,747,0.5614612473259832
CORRECTIONVILLE,IA,442,285,-157,0.3920220082530949
CORRIGAN,TX,1014,1093,79,0.5187470336971998
CORRY,PA,4420,4024,-396,0.4765513974419706
CORRYTON,TN,3588,3941,353,0.5234426882720149
CORSICA,PA,250,329,79,0.5682210708117443
CORSICA,SD,66,15,-51,0.18518518518518517
CORSICANA,TX,10911,11534,623,0.5138783693472934
CORTARO,AZ,1640,838,-802,0.33817594834543985
CORTE MADERA,CA,4047,4248,201,0.512115732368897
CORTEZ,CO,7400,7103,-297,0.4897607391574157
CORTEZ,FL,1625,1716,91,0.5136186770428015
CORTLAND,IL,1587,1569,-18,0.49714828897338403
CORTLAND,NE,23,39,16,0.6290322580645161
CORTLAND,NY,13054,12128,-926,0.4816138511635295
CORTLAND,OH,5493,5637,144,0.5064690026954178
CORTLANDT MANOR,NY,3588,4182,594,0.5382239382239382
CORTLANDT MNR,NY,277,309,32,0.5273037542662116
CORUNNA,IN,359,128,-231,0.26283367556468173
CORUNNA,MI,2615,2409,-206,0.4794984076433121
CORVALLIS,MT,2294,2844,550,0.5535227715064227
CORVALLIS,OR,43677,34161,-9516,0.4388730440144916
CORY,CO,64,0,-64,0
CORYDON,IA,1065,1001,-64,0.48451113262342693
CORYDON,IN,6783,6406,-377,0.48570778679202364
CORYDON,KY,856,702,-154,0.45057766367137353
COS COB,CT,2613,2737,124,0.511588785046729
COSBY,MO,0,11,11,1
COSBY,TN,2273,2409,136,0.5145237078171722
COSHOCTON,OH,8324,8317,-7,0.49978967610119585
COSMOPOLIS,WA,784,733,-51,0.4831905075807515
COSMOS,MN,140,35,-105,0.2
COSSAYUNA,NY,14,43,29,0.7543859649122807
COSTA MESA,CA,56361,48568,-7793,0.46286536610469936
COTATI,CA,4048,3763,-285,0.4817564972474715
COTO DE CAZA,CA,2558,2873,315,0.5290001841281532
COTOPAXI,CO,1246,1405,159,0.5299886835156544
COTTAGE CITY,MD,74,63,-11,0.45985401459854014
COTTAGE GROVE,MN,11836,13156,1320,0.5264084507042254
COTTAGE GROVE,OR,7698,7948,250,0.5079892624312924
COTTAGE GROVE,TN,99,38,-61,0.2773722627737226
COTTAGE GROVE,WI,3930,4362,432,0.5260492040520984
COTTAGE HILLS,IL,1715,1305,-410,0.43211920529801323
COTTAGEVILLE,SC,1429,1359,-70,0.48744619799139166
COTTAGEVILLE,WV,299,314,15,0.5122349102773246
COTTEKILL,NY,11,0,-11,0
COTTER,AR,411,465,54,0.5308219178082192
COTTLE,WV,27,30,3,0.5263157894736842
COTTLEVILLE,MO,215,334,119,0.6083788706739527
COTTON,MN,121,103,-18,0.45982142857142855
COTTON PLANT,AR,66,73,7,0.5251798561151079
COTTON VALLEY,LA,301,366,65,0.5487256371814093
COTTONDALE,AL,3984,3574,-410,0.4728764223339508
COTTONDALE,FL,1828,1948,120,0.5158898305084746
COTTONPORT,LA,1203,1125,-78,0.4832474226804124
COTTONTOWN,TN,1648,1893,245,0.5345947472465405
COTTONWD FLS,KS,0,27,27,1
COTTONWD HTS,UT,151,141,-10,0.4828767123287671
COTTONWOOD,AL,1926,1369,-557,0.41547799696509863
COTTONWOOD,AZ,14356,13170,-1186,0.478456731817191
COTTONWOOD,CA,6099,6189,90,0.503662109375
COTTONWOOD,ID,642,594,-48,0.48058252427184467
COTTONWOOD,MN,472,528,56,0.528
COTTONWOOD,UT,330,326,-4,0.4969512195121951
COTTONWOOD FALLS,KS,220,167,-53,0.4315245478036176
COTTONWOOD HEIGHTS,UT,1580,1486,-94,0.4846705805609915
COTTONWOOD HEIGHTS CITY,UT,841,740,-101,0.46805819101834284
COTTONWOOD SHORES,TX,2282,2685,403,0.540567747131065
COTTRELLVILLE,MI,496,380,-116,0.4337899543378995
COTUIT,MA,2286,2194,-92,0.48973214285714284
COTULLA,TX,1295,1194,-101,0.4797107271996786
COUCIL BLUFFS,IA,362,259,-103,0.4170692431561997
COUDERAY,WI,108,98,-10,0.47572815533980584
COUDERSPORT,PA,2714,2526,-188,0.4820610687022901
COUGAR,WA,52,67,15,0.5630252100840336
COULEE CITY,WA,347,320,-27,0.47976011994003
COULEE DAM,WA,397,295,-102,0.4263005780346821
COULTERVILLE,CA,810,796,-14,0.49564134495641343
COULTERVILLE,IL,791,671,-120,0.45896032831737343
COUNCE,TN,1149,1316,167,0.5338742393509128
COUNCIL,ID,798,871,73,0.5218693828639904
COUNCIL,NC,41,12,-29,0.22641509433962265
COUNCIL BLUFFS,IA,38046,30381,-7665,0.44399140690078476
COUNCIL GROVE,KS,1617,1531,-86,0.4863405336721728
COUNCIL HILL,OK,60,60,0,0.5
COUNTRY CLUB,MO,291,282,-9,0.49214659685863876
COUNTRY CLUB HILLS,IL,5766,5183,-583,0.47337656406977807
COUPEVILLE,WA,4673,3814,-859,0.44939318958406976
COUPLAND,TX,165,557,392,0.7714681440443213
COURTDALE,PA,248,281,33,0.5311909262759924
COURTLAND,AL,358,474,116,0.5697115384615384
COURTLAND,CA,13,0,-13,0
COURTLAND,MN,39,92,53,0.7022900763358778
COURTLAND,MS,504,679,175,0.5739644970414202
COURTLAND,VA,1381,1234,-147,0.47189292543021033
COUSHATTA,LA,1710,1749,39,0.5056374674761491
COVE,AR,648,530,-118,0.44991511035653653
COVE,OR,568,560,-8,0.49645390070921985
COVE,TX,338,371,33,0.5232722143864598
COVE,UT,24,27,3,0.5294117647058824
COVE CITY,NC,437,473,36,0.5197802197802198
COVELO,CA,444,333,-111,0.42857142857142855
COVENTRY,CT,3585,3827,242,0.5163248785752833
COVENTRY,RI,10851,11166,315,0.5071535631557433
COVENTRY,VT,12,0,-12,0
COVENTRY TOWNSHIP,OH,2725,2368,-357,0.4649518947575103
COVERT,MI,880,713,-167,0.4475831763967357
COVINA,CA,21369,20855,-514,0.4939134141720349
COVINGTON,GA,34243,37370,3127,0.5218326281541061
COVINGTON,IN,2058,2017,-41,0.4949693251533742
COVINGTON,KY,23522,21800,-1722,0.4810026035920745
COVINGTON,LA,19699,22118,2419,0.5289236434942727
COVINGTON,OH,1432,1482,50,0.5085792724776939
COVINGTON,PA,637,265,-372,0.29379157427937913
COVINGTON,TN,5002,5098,96,0.5047524752475248
COVINGTON,TX,354,614,260,0.6342975206611571
COVINGTON,VA,5195,4507,-688,0.4645433931148217
COVINGTON,WA,6743,7182,439,0.5157630161579893
COVINGTON TOWNSHIP,PA,473,566,93,0.5447545717035611
COVINGTON TWP,PA,75,55,-20,0.4230769230769231
COWAN,TN,720,774,54,0.5180722891566265
COWANSVILLE,PA,23,58,35,0.7160493827160493
COWARD,SC,587,562,-25,0.48912097476066146
COWARTS,AL,569,671,102,0.5411290322580645
COWDEN,IL,277,118,-159,0.29873417721518986
COWEN,WV,626,615,-11,0.49556809024979853
COWETA,OK,6241,5806,-435,0.4819457126255499
COWGILL,MO,35,0,-35,0
COWICHE,WA,78,37,-41,0.3217391304347826
COWLESVILLE,NY,42,78,36,0.65
COWLEY,WY,29,68,39,0.7010309278350515
COWPENS,SC,2476,2498,22,0.5022114997989545
COXS CREEK,KY,1559,1769,210,0.5315504807692307
COXS MILLS,WV,11,0,-11,0
COXSACKIE,NY,1553,1351,-202,0.4652203856749311
COY,AL,11,0,-11,0
COYLE,OK,62,139,77,0.6915422885572139
COYOTE,CA,0,11,11,1
COZAD,NE,2893,2212,-681,0.43330068560235063
CP,MI,78,99,21,0.559322033898305
CPE CANAVERAL,FL,1660,1295,-365,0.43824027072758037
CPE GIRARDEAU,MO,3414,2649,-765,0.43691241959426025
CRAB ORCHARD,KY,1607,1506,-101,0.48377770639254736
CRAB ORCHARD,TN,68,123,55,0.643979057591623
CRAB ORCHARD,WV,477,400,-77,0.45610034207525657
CRABTREE,OR,0,11,11,1
CRABTREE,PA,18,0,-18,0
CRAFTON,PA,753,645,-108,0.4613733905579399
CRAFTSBRY CMN,VT,13,0,-13,0
CRAFTSBURY,VT,218,226,8,0.509009009009009
CRAFTSBURY COMMON,VT,63,49,-14,0.4375
CRAGFORD,AL,12,0,-12,0
CRAGSMOOR,NY,0,12,12,1
CRAIG,AK,1123,458,-665,0.28969006957621757
CRAIG,CO,7103,5792,-1311,0.4491663435440093
CRAIG,MO,209,59,-150,0.22014925373134328
CRAIG,MT,48,0,-48,0
CRAIG,NE,28,0,-28,0
CRAIGMONT,ID,93,85,-8,0.47752808988764045
CRAIGSVILLE,VA,614,571,-43,0.48185654008438816
CRAIGSVILLE,WV,978,910,-68,0.4819915254237288
CRAMERTON,NC,1407,1453,46,0.5080419580419581
CRANBERRY,PA,61,28,-33,0.3146067415730337
CRANBERRY ISLES,ME,0,11,11,1
CRANBERRY LAKE,NY,119,122,3,0.5062240663900415
CRANBERRY TOWNSHIP,PA,11752,12519,767,0.5158007498660954
CRANBERRY TWP,PA,945,1013,68,0.517364657814096
CRANBURY,NJ,1987,2053,66,0.5081683168316832
CRANDALL,GA,748,809,61,0.5195889531149647
CRANDALL,IN,27,11,-16,0.2894736842105263
CRANDALL,TX,2013,3773,1760,0.6520912547528517
CRANDON,WI,1855,1709,-146,0.47951739618406286
CRANE,IN,36,0,-36,0
CRANE,MO,1481,1461,-20,0.4966009517335146
CRANE,TX,1128,905,-223,0.4451549434333497
CRANE HILL,AL,962,1158,196,0.5462264150943397
CRANE LAKE,MN,30,117,87,0.7959183673469388
CRANESVILLE,PA,231,175,-56,0.43103448275862066
CRANFILLS GAP,TX,13,0,-13,0
CRANFORD,NJ,5770,6605,835,0.5337373737373737
CRANSTON,RI,29705,29267,-438,0.4962863731940582
CRARYVILLE,NY,665,665,0,0.5
CRAWFORD,CO,970,844,-126,0.4652701212789416
CRAWFORD,GA,594,729,135,0.5510204081632653
CRAWFORD,ME,0,12,12,1
CRAWFORD,MS,0,75,75,1
CRAWFORD,NE,470,442,-28,0.48464912280701755
CRAWFORD,TN,83,341,258,0.8042452830188679
CRAWFORD,TX,752,876,124,0.538083538083538
CRAWFORDSVILLE,AR,129,69,-60,0.3484848484848485
CRAWFORDSVILLE,IA,41,0,-41,0
CRAWFORDSVILLE,IN,14182,12267,-1915,0.46379825324208857
CRAWFORDVILLE,FL,8486,10448,1962,0.5518115559311292
CRAWFORDVILLE,GA,123,145,22,0.5410447761194029
CRAWLEY,WV,137,208,71,0.6028985507246377
CREAL SPRINGS,IL,901,886,-15,0.49580302182428654
CREAM RIDGE,NJ,1127,1361,234,0.5470257234726688
CREEDE,CO,804,1040,236,0.5639913232104121
CREEDMOOR,NC,4135,4442,307,0.5178967004780226
CREEDMOOR,TX,371,441,70,0.5431034482758621
CREEKSIDE,PA,179,248,69,0.5807962529274004
CREIGHTON,MO,163,92,-71,0.3607843137254902
CREIGHTON,NE,491,395,-96,0.445823927765237
CREIGHTON,PA,116,122,6,0.5126050420168067
CREIGHTON,SD,12,0,-12,0
CRENSHAW,MS,150,191,41,0.5601173020527859
CREOLA,AL,778,437,-341,0.3596707818930041
CREOLE,LA,35,0,-35,0
CRESCENT,IA,326,320,-6,0.4953560371517028
CRESCENT,OK,1011,1200,189,0.5427408412483039
CRESCENT,OR,175,247,72,0.5853080568720379
CRESCENT,PA,614,549,-65,0.472055030094583
CRESCENT CITY,CA,9000,8734,-266,0.4925002819442878
CRESCENT CITY,FL,3430,3674,244,0.5171734234234234
CRESCENT CITY,IL,57,24,-33,0.2962962962962963
CRESCENT LAKE,OR,175,153,-22,0.46646341463414637
CRESCENT MILLS,CA,30,71,41,0.7029702970297029
CRESCENT PARK,KY,260,281,21,0.5194085027726433
CRESCENT SPGS,KY,1124,1223,99,0.5210907541542394
CRESCENT SPRINGS,KY,1878,1983,105,0.5135975135975136
CRESCENT VALLEY,NV,0,60,60,1
CRESCO,IA,2490,2174,-316,0.46612349914236706
CRESCO,PA,1765,1664,-101,0.4852726742490522
CRESSKILL,NJ,2328,2668,340,0.5340272217774219
CRESSON,PA,1814,1432,-382,0.44115834873690696
CRESSON,TX,1731,1742,11,0.501583645263461
CRESSONA,PA,432,341,-91,0.4411384217335058
CREST HILL,IL,8434,6189,-2245,0.4232373657936128
CRESTED BUTTE,CO,4251,3199,-1052,0.4293959731543624
CRESTLINE,CA,4741,3367,-1374,0.41526887025160336
CRESTLINE,OH,2707,2579,-128,0.487892546348846
CRESTON,CA,225,332,107,0.5960502692998204
CRESTON,IA,5566,4487,-1079,0.44633442753406943
CRESTON,IL,37,0,-37,0
CRESTON,LA,0,14,14,1
CRESTON,NC,171,212,41,0.5535248041775457
CRESTON,OH,1208,1013,-195,0.45610085547050877
CRESTON,WA,37,13,-24,0.26
CRESTONE,CO,893,957,64,0.5172972972972973
CRESTVIEW,FL,26694,40554,13860,0.603051391862955
CRESTVIEW HILLS,KY,278,276,-2,0.4981949458483754
CRESTWOOD,IL,3241,2995,-246,0.48027581783194356
CRESTWOOD,KY,5898,6386,488,0.5198632367307066
CRESWELL,NC,296,252,-44,0.45985401459854014
CRESWELL,OR,4165,4112,-53,0.49679835689259394
CRETE,IL,4497,4698,201,0.5109298531810766
CRETE,NE,4505,2701,-1804,0.3748265334443519
CREVE COEUR,IL,2588,2056,-532,0.4427217915590009
CREVE COEUR,MO,2823,2837,14,0.5012367491166078
CREWE,VA,1764,1655,-109,0.48405966656917226
CRIDERSVILLE,OH,650,699,49,0.5181616011860638
CRIMORA,VA,901,852,-49,0.4860239589275528
CRIPPLE CREEK,CO,1754,1307,-447,0.426984645540673
CRISFIELD,MD,1887,1859,-28,0.49626268019220504
CRITTENDEN,KY,3575,2502,-1073,0.41171630738851406
CRIVITZ,WI,2761,2912,151,0.5133086550326106
CRKD RVR RNCH,OR,105,105,0,0.5
CROCKER,MO,1295,1239,-56,0.4889502762430939
CROCKETT,CA,1790,1302,-488,0.42108667529107374
CROCKETT,TX,3538,3776,238,0.5162701668033908
CROFTON,KY,1163,1138,-25,0.494567579313342
CROFTON,MD,9395,9170,-225,0.4939402100727175
CROFTON,NE,535,416,-119,0.4374342797055731
CROGHAN,NY,592,475,-117,0.4451733833177132
CROMBERG,CA,34,0,-34,0
CROMPOND,NY,76,41,-35,0.3504273504273504
CROMWELL,CT,4626,4958,332,0.5173205342237062
CROMWELL,IN,1709,1179,-530,0.4082409972299169
CROMWELL,KY,142,120,-22,0.4580152671755725
CROMWELL,MN,165,164,-1,0.49848024316109424
CROOKED RIVER RANCH,OR,273,382,109,0.583206106870229
CROOKS,SD,214,233,19,0.5212527964205816
CROOKSTON,MN,4465,3707,-758,0.45362212432697013
CROOKSVILLE,OH,1468,1608,140,0.5227568270481144
CROPSEYVILLE,NY,338,305,-33,0.47433903576982894
CROPWELL,AL,1419,1692,273,0.5438765670202508
CROSBY,MN,1887,1602,-285,0.4591573516766982
CROSBY,ND,414,248,-166,0.37462235649546827
CROSBY,TX,9268,10025,757,0.5196185144871197
CROSBYTON,TX,402,419,17,0.510353227771011
CROSS,SC,1536,1482,-54,0.49105367793240556
CROSS CITY,FL,1301,1385,84,0.5156366344005957
CROSS HILL,SC,883,1069,186,0.5476434426229508
CROSS JCT,VA,124,120,-4,0.4918032786885246
CROSS JUNCTION,VA,1181,1375,194,0.5379499217527387
CROSS LAKE TWP,ME,39,55,16,0.5851063829787234
CROSS LANES,WV,1704,1495,-209,0.4673335417317912
CROSS PLAINS,TN,1209,1581,372,0.5666666666666667
CROSS PLAINS,TX,405,499,94,0.5519911504424779
CROSS PLAINS,WI,2095,2001,-94,0.488525390625
CROSS RIVER,NY,360,263,-97,0.42215088282504015
CROSS TIMBERS,MO,24,46,22,0.6571428571428571
CROSS VILLAGE,MI,11,0,-11,0
CROSSETT,AR,4733,4354,-379,0.47914603279410145
CROSSLAKE,MN,3406,3257,-149,0.48881885036770223
CROSSVILLE,AL,1660,1606,-54,0.49173300673606857
CROSSVILLE,IL,455,234,-221,0.33962264150943394
CROSSVILLE,TN,25423,26969,1546,0.5147541609406017
CROSSWICKS,NJ,274,355,81,0.5643879173290938
CROSWELL,MI,2362,2196,-166,0.4817902588854761
CROTHERSVILLE,IN,1352,1241,-111,0.47859622059390666
CROTON,OH,103,77,-26,0.42777777777777776
CROTON FALLS,NY,0,12,12,1
CROTON HDSN,NY,477,498,21,0.5107692307692308
CROTON ON HUDSON,NY,3222,3582,360,0.5264550264550265
CROUSE,NC,676,894,218,0.5694267515923567
CROW AGENCY,MT,418,213,-205,0.3375594294770206
CROWELL,TX,197,145,-52,0.4239766081871345
CROWLEY,LA,6001,5591,-410,0.48231538992408557
CROWLEY,TX,11552,15316,3764,0.5700461515557541
CROWN CITY,OH,876,787,-89,0.47324113048707156
CROWN POINT,IN,20753,21824,1071,0.5125772130492989
CROWN POINT,NY,900,756,-144,0.45652173913043476
CROWNPOINT,NM,374,384,10,0.5065963060686016
CROWNSVILLE,MD,2460,2996,536,0.5491202346041055
CROWS LANDING,CA,130,130,0,0.5
CROYDON,NH,161,156,-5,0.4921135646687697
CROYDON,PA,3166,3015,-151,0.4877851480342987
CROZET,VA,3461,4538,1077,0.5673209151143893
CROZIER,VA,14,81,67,0.8526315789473684
CRUCIBLE,PA,24,0,-24,0
CRUM,WV,11,0,-11,0
CRUM LYNNE,PA,998,937,-61,0.4842377260981912
CRUMP,TN,22,59,37,0.7283950617283951
CRUMPLER,NC,293,293,0,0.5
CRUMPTON,MD,15,11,-4,0.4230769230769231
CRYSTAL,ME,40,63,23,0.6116504854368932
CRYSTAL,MI,1349,1123,-226,0.45428802588996764
CRYSTAL,MN,6644,5721,-923,0.46267691063485644
CRYSTAL,NV,73,93,20,0.5602409638554217
CRYSTAL BAY,MN,12,12,0,0.5
CRYSTAL BAY,NV,173,174,1,0.5014409221902018
CRYSTAL BEACH,FL,579,1497,918,0.7210982658959537
CRYSTAL BEACH,TX,1195,817,-378,0.40606361829025844
CRYSTAL CITY,MO,1747,1638,-109,0.48389955686853764
CRYSTAL CITY,TX,1870,1859,-11,0.49852507374631266
CRYSTAL FALLS,MI,1993,1958,-35,0.495570741584409
CRYSTAL LAKE,IL,17956,18459,503,0.5069064945764108
CRYSTAL RIVER,FL,13450,15015,1565,0.527489899877042
CRYSTAL SPRINGS,FL,26,58,32,0.6904761904761905
CRYSTAL SPRINGS,MS,2813,2846,33,0.5029157094893091
CRYSTAL SPRINGS,ND,14,0,-14,0
CTR MORICHES,NY,88,66,-22,0.42857142857142855
CTR OSSIPEE,NH,49,50,1,0.5050505050505051
CTR SANDWICH,NH,0,23,23,1
CTR TUFTNBORO,NH,13,17,4,0.5666666666666667
CUB RUN,KY,205,321,116,0.6102661596958175
CUBA,AL,105,111,6,0.5138888888888888
CUBA,IL,984,751,-233,0.4328530259365994
CUBA,MO,3944,3805,-139,0.49103110078719836
CUBA,NM,427,435,8,0.5046403712296984
CUBA,NY,2288,2071,-217,0.4751089699472356
CUBA CITY,WI,1337,1325,-12,0.4977460555972953
CUDAHY,CA,5333,4193,-1140,0.44016376233466303
CUDAHY,WI,8135,7216,-919,0.4700670966060843
CUDDEBACKVILLE,NY,486,368,-118,0.4309133489461358
CUDDY,PA,116,37,-79,0.24183006535947713
CUERO,TX,3850,3765,-85,0.4944189100459619
CULBERTSON,MT,302,177,-125,0.3695198329853862
CULBERTSON,NE,92,59,-33,0.39072847682119205
CULDESAC,ID,153,116,-37,0.4312267657992565
CULLEN,LA,29,0,-29,0
CULLEOKA,TN,1527,1747,220,0.5335980452046426
CULLMAN,AL,15626,16707,1081,0.5167166671821359
CULLODEN,GA,78,120,42,0.6060606060606061
CULLODEN,WV,1830,1576,-254,0.46271285965942455
CULLOM,IL,177,52,-125,0.22707423580786026
CULLOWHEE,NC,3777,3118,-659,0.4522117476432197
CULPEPER,VA,13153,13175,22,0.500417806137952
CULVER,IN,1881,1720,-161,0.4776450985837267
CULVER,MN,99,82,-17,0.4530386740331492
CULVER,OR,1622,1356,-266,0.45533915379449297
CULVER CITY,CA,21936,20264,-1672,0.48018957345971564
CUMB,TX,16,36,20,0.6923076923076923
CUMB FORESIDE,ME,65,74,9,0.5323741007194245
CUMB GAP,TN,25,0,-25,0
CUMBERLAND,IA,51,12,-39,0.19047619047619047
CUMBERLAND,KY,1070,969,-101,0.47523295733202553
CUMBERLAND,MD,14167,11984,-2183,0.4582616343543268
CUMBERLAND,ME,426,491,65,0.5354416575790621
CUMBERLAND,NC,208,70,-138,0.2517985611510791
CUMBERLAND,OH,319,343,24,0.5181268882175226
CUMBERLAND,RI,11000,11640,640,0.5141342756183745
CUMBERLAND,VA,1332,1448,116,0.520863309352518
CUMBERLAND,WI,2713,2377,-336,0.4669941060903733
CUMBERLAND CENTER,ME,1514,1882,368,0.5541813898704359
CUMBERLAND CITY,TN,662,541,-121,0.44970906068162925
CUMBERLAND FORESIDE,ME,851,842,-9,0.49734199645599525
CUMBERLAND FURNACE,TN,1090,1215,125,0.527114967462039
CUMBERLAND GAP,TN,859,666,-193,0.4367213114754098
CUMBERLAND GP,TN,11,12,1,0.5217391304347826
CUMBOLA,PA,38,0,-38,0
CUMBY,TX,794,865,71,0.5213984327908379
CUMMAQUID,MA,105,58,-47,0.3558282208588957
CUMMING,GA,51095,65013,13918,0.5599355772212078
CUMMING,IA,367,472,105,0.5625744934445769
CUMMINGTON,MA,178,190,12,0.5163043478260869
CUNNINGHAM,KS,60,28,-32,0.3181818181818182
CUNNINGHAM,KY,155,70,-85,0.3111111111111111
CUNNINGHAM,TN,719,851,132,0.5420382165605095
CUPERTINO,CA,26558,24699,-1859,0.48186589148799186
CURLEW,WA,259,259,0,0.5
CURRIE,MN,28,0,-28,0
CURRIE,NC,658,633,-25,0.4903175832687839
CURRITUCK,NC,372,429,57,0.5355805243445693
CURRYVILLE,MO,189,132,-57,0.411214953271028
CURTICE,OH,1085,971,-114,0.4722762645914397
CURTIS,MI,515,363,-152,0.4134396355353075
CURTIS,NE,476,296,-180,0.38341968911917096
CURTIS,WA,0,14,14,1
CURTIS BAY,MD,869,856,-13,0.49623188405797103
CURTISS,WI,22,28,6,0.56
CURWENSVILLE,PA,1573,1441,-132,0.4781021897810219
CUSHING,ME,624,705,81,0.5304740406320542
CUSHING,MN,635,600,-35,0.48582995951417
CUSHING,OK,5189,4291,-898,0.45263713080168777
CUSHING,TX,525,705,180,0.573170731707317
CUSHING,WI,65,77,12,0.5422535211267606
CUSHMAN,AR,0,12,12,1
CUSICK,WA,379,396,17,0.5109677419354839
CUSSETA,AL,643,661,18,0.5069018404907976
CUSSETA,GA,797,904,107,0.5314520870076426
CUSTAR,OH,17,56,39,0.7671232876712328
CUSTER,KY,25,40,15,0.6153846153846154
CUSTER,MI,499,469,-30,0.484504132231405
CUSTER,MT,11,11,0,0.5
CUSTER,SD,3275,3359,84,0.5063310220078384
CUSTER,WA,1184,1250,66,0.5135579293344289
CUSTER,WI,253,343,90,0.575503355704698
CUSTER CITY,OK,11,28,17,0.717948717948718
CUSTER CITY,PA,0,26,26,1
CUSTER PARK,IL,70,83,13,0.5424836601307189
CUT BANK,MT,1981,1862,-119,0.48451730418943534
CUT OFF,LA,2414,2027,-387,0.4564287322675073
CUTCHOGUE,NY,1603,1881,278,0.5398966704936854
CUTHBERT,GA,1450,1360,-90,0.48398576512455516
CUTLER,CA,754,631,-123,0.4555956678700361
CUTLER,IL,77,27,-50,0.25961538461538464
CUTLER,ME,36,74,38,0.6727272727272727
CUTLER,OH,126,144,18,0.5333333333333333
CUTLER BAY,FL,14827,14128,-699,0.487929545847004
CUTTEN,CA,0,39,39,1
CUTTINGSVILLE,VT,150,120,-30,0.4444444444444444
CUTTYHUNK,MA,0,15,15,1
CUYAHOGA FALLS,OH,18994,16988,-2006,0.47212495136457117
CUYAHOGA FLS,OH,1901,1544,-357,0.4481857764876633
CUYLER,NY,24,15,-9,0.38461538461538464
CYCLONE,PA,11,0,-11,0
CYCLONE,WV,187,57,-130,0.2336065573770492
CYGNET,OH,192,145,-47,0.43026706231454004
CYNTHIANA,IN,51,23,-28,0.3108108108108108
CYNTHIANA,KY,6554,6374,-180,0.49303836633663367
CYPRESS,CA,15795,15021,-774,0.48744158878504673
CYPRESS,IL,11,0,-11,0
CYPRESS,TX,56246,69835,13589,0.5538899596291273
CYPRESS INN,TN,57,24,-33,0.2962962962962963
CYPRESS MILL,TX,11,0,-11,0
CYR PLT,ME,28,27,-1,0.4909090909090909
CYRIL,OK,184,223,39,0.547911547911548
CYRUS,MN,24,0,-24,0
D HANIS,TX,0,54,54,1
D LO,MS,12,0,-12,0
DACONO,CO,2521,2531,10,0.5009897070467142
DACULA,GA,15594,18527,2933,0.5429793968523783
DADE CITY,FL,17315,22284,4969,0.5627414833707922
DADEVILLE,AL,2835,3178,343,0.5285215366705471
DADEVILLE,MO,32,33,1,0.5076923076923077
DAFTER,MI,152,89,-63,0.36929460580912865
DAGGETT,CA,32,34,2,0.5151515151515151
DAGGETT,MI,162,146,-16,0.474025974025974
DAGSBORO,DE,2204,2834,630,0.5625248114331084
DAHINDA,IL,373,369,-4,0.4973045822102426
DAHLGREN,IL,92,71,-21,0.43558282208588955
DAHLGREN,VA,720,506,-214,0.41272430668841764
DAHLONEGA,GA,9620,9610,-10,0.499739989599584
DAINGERFIELD,TX,1676,1761,85,0.5123654349723596
DAISETTA,TX,125,70,-55,0.358974358974359
DAISY,OK,12,13,1,0.52
DAISYTOWN,PA,0,22,22,1
DAKOTA,IL,64,41,-23,0.3904761904761905
DAKOTA CITY,IA,248,101,-147,0.28939828080229224
DAKOTA CITY,NE,839,658,-181,0.4395457581830327
DALBO,MN,11,14,3,0.56
DALE,IN,1069,1086,17,0.5039443155452437
DALE,TX,2169,2408,239,0.5261088048940354
DALE,WI,0,23,23,1
DALE CITY,VA,2333,2205,-128,0.48589687086822386
DALEVILLE,AL,5352,4547,-805,0.45933932720476817
DALEVILLE,IN,1006,1109,103,0.5243498817966903
DALEVILLE,VA,1732,2213,481,0.5609632446134347
DALHART,TX,3863,2996,-867,0.436798367108908
DALLAS,GA,34274,39579,5305,0.5359159411262914
DALLAS,NC,6433,6908,475,0.5178022636983735
DALLAS,OR,10986,10432,-554,0.48706695303016156
DALLAS,PA,4105,4482,377,0.5219517875858857
DALLAS,TX,670036,602595,-67441,0.47350331714377536
DALLAS,WI,172,111,-61,0.392226148409894
DALLAS 75252,TX,13,0,-13,0
DALLAS CENTER,IA,836,838,2,0.5005973715651135
DALLAS CITY,IL,578,357,-221,0.38181818181818183
DALLASTOWN,PA,3935,3128,-807,0.44287130114682144
DALLESPORT,WA,126,56,-70,0.3076923076923077
DALMATIA,PA,162,131,-31,0.447098976109215
DALTON,GA,24369,20985,-3384,0.46269347797327687
DALTON,MA,2116,2206,90,0.5104118463674225
DALTON,MN,256,165,-91,0.3919239904988123
DALTON,NE,13,0,-13,0
DALTON,NH,122,157,35,0.5627240143369175
DALTON,NY,115,33,-82,0.22297297297297297
DALTON,OH,1564,1472,-92,0.48484848484848486
DALTON,PA,1264,1381,117,0.522117202268431
DALTON,WI,115,54,-61,0.31952662721893493
DALTON CITY,IL,117,38,-79,0.24516129032258063
DALTON GARDENS,ID,1656,1889,233,0.5328631875881523
DALTON GDNS,ID,448,462,14,0.5076923076923077
DALY CITY,CA,37232,28185,-9047,0.43085130776403685
DALZELL,IL,0,11,11,1
DALZELL,SC,2727,2939,212,0.5187080833039182
DAMAR,KS,12,0,-12,0
DAMARISCOTTA,ME,1380,1351,-29,0.49469058952764555
DAMASCUS,AR,1007,742,-265,0.42424242424242425
DAMASCUS,GA,22,0,-22,0
DAMASCUS,MD,3876,3892,16,0.5010298661174047
DAMASCUS,OH,93,0,-93,0
DAMASCUS,OR,4117,4190,73,0.5043938846755748
DAMASCUS,PA,341,380,39,0.5270457697642164
DAMASCUS,VA,1132,1111,-21,0.49531876950512704
DAMERON,MD,12,13,1,0.52
DAMES QUARTER,MD,11,12,1,0.5217391304347826
DAMIANSVILLE,IL,83,52,-31,0.3851851851851852
DAMMERON VALLEY,UT,128,168,40,0.5675675675675675
DAMMERON VLY,UT,11,0,-11,0
DAMON,TX,293,461,168,0.6114058355437666
DANA,IN,298,151,-147,0.3363028953229399
DANA,KY,11,0,-11,0
DANA,NC,337,16,-321,0.0453257790368272
DANA POINT,CA,14328,14719,391,0.5067304713051262
DANBORO,PA,13,0,-13,0
DANBURY,CT,31022,28299,-2723,0.4770485999898855
DANBURY,IA,45,35,-10,0.4375
DANBURY,NC,49,108,59,0.6878980891719745
DANBURY,NH,424,379,-45,0.47198007471980075
DANBURY,TX,789,775,-14,0.4955242966751918
DANBURY,WI,2633,2428,-205,0.4797470855562142
DANBY,VT,266,234,-32,0.468
DANDRIDGE,TN,6639,7407,768,0.5273387441264417
DANE,WI,292,199,-93,0.40529531568228105
DANFORTH,IL,55,101,46,0.6474358974358975
DANFORTH,ME,290,330,40,0.532258064516129
DANIA,FL,7374,7291,-83,0.4971701329696556
DANIA BEACH,FL,4152,4014,-138,0.49155033063923587
DANIEL,WY,89,37,-52,0.29365079365079366
DANIEL ISLAND,SC,11337,13410,2073,0.541883864710874
DANIELS,WV,1546,1652,106,0.5165728580362726
DANIELSON,CT,5445,4680,-765,0.4622222222222222
DANIELSVILLE,GA,2095,2557,462,0.5496560619088564
DANIELSVILLE,PA,550,656,106,0.5439469320066335
DANNEBROG,NE,45,13,-32,0.22413793103448276
DANNEMORA,NY,485,216,-269,0.30813124108416545
DANSVILLE,MI,637,571,-66,0.472682119205298
DANSVILLE,NY,3994,3768,-226,0.48544189641844887
DANTE,VA,169,58,-111,0.2555066079295154
DANUBE,MN,166,35,-131,0.17412935323383086
DANVERS,IL,373,302,-71,0.4474074074074074
DANVERS,MA,10143,10020,-123,0.4969498586519863
DANVILLE,AL,1803,1465,-338,0.4482864137086903
DANVILLE,AR,1439,1279,-160,0.47056659308314935
DANVILLE,CA,15044,17120,2076,0.53227210545952
DANVILLE,GA,53,193,140,0.7845528455284553
DANVILLE,IA,498,513,15,0.5074183976261127
DANVILLE,IL,20557,18406,-2151,0.47239688935656904
DANVILLE,IN,5958,6567,609,0.524311377245509
DANVILLE,KY,11695,10504,-1191,0.47317446731834767
DANVILLE,NH,1225,1385,160,0.5306513409961686
DANVILLE,OH,1446,1272,-174,0.46799116997792495
DANVILLE,PA,6859,6516,-343,0.48717757009345797
DANVILLE,VA,21057,20581,-476,0.49428406743839765
DANVILLE,VT,528,622,94,0.5408695652173913
DANVILLE,WA,0,11,11,1
DANVILLE,WV,1107,750,-357,0.40387722132471726
DAPHNE,AL,17780,20441,2661,0.5348107061563016
DARBY,MT,1382,1463,81,0.5142355008787346
DARBY,PA,5919,5112,-807,0.4634212673375034
DARDANELLE,AR,3674,3481,-193,0.486512928022362
DARDEN,TN,71,59,-12,0.45384615384615384
DARDENNE PR,MO,222,217,-5,0.49430523917995445
DARDENNE PRAIRIE,MO,813,938,125,0.5356938892061679
DARIEN,CT,6232,7455,1223,0.544677431139037
DARIEN,GA,2409,2158,-251,0.4725202539960587
DARIEN,IL,6600,6691,91,0.5034233691972011
DARIEN,WI,738,848,110,0.5346784363177806
DARIEN CENTER,NY,476,453,-23,0.4876210979547901
DARLINGTON,ID,0,13,13,1
DARLINGTON,IN,543,471,-72,0.46449704142011833
DARLINGTON,MD,907,972,65,0.5172964342735498
DARLINGTON,PA,748,623,-125,0.45441283734500365
DARLINGTON,SC,6939,6748,-191,0.49302257616716594
DARLINGTON,WI,1734,1375,-359,0.4422643936957221
DARMSTADT,IN,196,245,49,0.5555555555555556
DARRINGTON,WA,760,832,72,0.5226130653266332
DARROW,LA,131,258,127,0.6632390745501285
DARTMOUTH,MA,2056,2306,250,0.5286565795506648
DARWIN,MN,243,161,-82,0.39851485148514854
DASSEL,MN,1633,1546,-87,0.4863164517143756
DATELAND,AZ,0,12,12,1
DATIL,NM,149,130,-19,0.4659498207885305
DAUBERVILLE,PA,61,80,19,0.5673758865248227
DAUFUSKIE ISLAND,SC,60,231,171,0.7938144329896907
DAUPHIN,PA,1219,1103,-116,0.47502153316106804
DAUPHIN ISL,AL,15,32,17,0.6808510638297872
DAUPHIN ISLAND,AL,957,1553,596,0.6187250996015936
DAVENPORT,CA,237,36,-201,0.13186813186813187
DAVENPORT,FL,56678,71960,15282,0.5593992443912374
DAVENPORT,IA,62045,49588,-12457,0.4442055664543639
DAVENPORT,NE,24,28,4,0.5384615384615384
DAVENPORT,NY,299,221,-78,0.425
DAVENPORT,OK,24,78,54,0.7647058823529411
DAVENPORT,WA,1663,1781,118,0.5171312427409989
DAVENPORT CENTER,NY,16,0,-16,0
DAVID,KY,35,14,-21,0.2857142857142857
DAVID CITY,NE,1299,1252,-47,0.49078792630341045
DAVIDSON,NC,7513,9279,1766,0.5525845640781324
DAVIDSON,OK,13,14,1,0.5185185185185185
DAVIDSONVILLE,MD,1707,2149,442,0.5573132780082988
DAVIDSVILLE,PA,201,347,146,0.6332116788321168
DAVIE,FL,40124,38959,-1165,0.4926343209033547
DAVIS,CA,37838,29649,-8189,0.43932905596633426
DAVIS,IL,1334,1223,-111,0.47829487680876026
DAVIS,OK,2563,1976,-587,0.4353381802159066
DAVIS,WV,469,516,47,0.5238578680203045
DAVIS CITY,IA,36,11,-25,0.23404255319148937
DAVIS JCT,IL,14,17,3,0.5483870967741935
DAVIS JUNCTION,IL,663,752,89,0.5314487632508834
DAVIS MONTHAN AFB,AZ,0,33,33,1
DAVISBORO,GA,39,23,-16,0.3709677419354839
DAVISBURG,MI,1980,2129,149,0.5181309321002677
DAVISON,MI,17022,14576,-2446,0.46129501867206785
DAVISTON,AL,162,72,-90,0.3076923076923077
DAVISVILLE,MO,11,0,-11,0
DAVISVILLE,WV,454,478,24,0.5128755364806867
DAWN,MO,11,0,-11,0
DAWSON,AL,183,272,89,0.5978021978021978
DAWSON,GA,2970,2434,-536,0.45040710584752036
DAWSON,IA,13,0,-13,0
DAWSON,IL,178,182,4,0.5055555555555555
DAWSON,MN,691,639,-52,0.48045112781954885
DAWSON,ND,30,35,5,0.5384615384615384
DAWSON,PA,206,142,-64,0.40804597701149425
DAWSON,TX,532,589,57,0.5254237288135594
DAWSON SPRINGS,KY,2901,2549,-352,0.4677064220183486
DAWSONVILLE,GA,11431,14024,2593,0.5509330190532312
DAYKIN,NE,11,0,-11,0
DAYS CREEK,OR,26,46,20,0.6388888888888888
DAYTON,IA,186,184,-2,0.4972972972972973
DAYTON,ID,0,26,26,1
DAYTON,IN,608,365,-243,0.3751284686536485
DAYTON,KY,2505,2500,-5,0.4995004995004995
DAYTON,MD,221,393,172,0.6400651465798045
DAYTON,ME,1355,1441,86,0.515379113018598
DAYTON,MN,1550,2653,1103,0.6312157982393528
DAYTON,MT,130,93,-37,0.4170403587443946
DAYTON,NJ,2084,2196,112,0.5130841121495328
DAYTON,NV,7210,8022,812,0.5266544117647058
DAYTON,OH,160131,152224,-7907,0.48734292711818283
DAYTON,OR,1769,1616,-153,0.4774002954209749
DAYTON,PA,563,527,-36,0.4834862385321101
DAYTON,TN,7669,7617,-52,0.4982990972131362
DAYTON,TX,7939,9392,1453,0.5419191044948358
DAYTON,VA,1358,1352,-6,0.4988929889298893
DAYTON,WA,1768,1675,-93,0.48649433633459194
DAYTON,WY,133,271,138,0.6707920792079208
DAYTONA BEACH,FL,62374,64251,1877,0.5074116485686081
DAYTONA BEACH SHORES,FL,0,12,12,1
DAYVILLE,CT,2609,2694,85,0.5080143315104658
DAZEY,ND,12,0,-12,0
DE BEQUE,CO,151,185,34,0.5505952380952381
DE BERRY,TX,482,662,180,0.5786713286713286
DE GRAFF,MN,42,41,-1,0.4939759036144578
DE GRAFF,OH,1008,822,-186,0.4491803278688525
DE KALB,MO,35,17,-18,0.3269230769230769
DE KALB,MS,656,687,31,0.5115413253909159
DE KALB,TX,1800,1906,106,0.5143011332973556
DE KALB JCT,NY,0,19,19,1
DE KALB JUNCTION,NY,209,259,50,0.5534188034188035
DE LAND,IL,82,11,-71,0.11827956989247312
DE LEON,TX,1150,1255,105,0.5218295218295218
DE LEON SPGS,FL,370,231,-139,0.3843594009983361
DE LEON SPRINGS,FL,3320,2031,-1289,0.3795552233227434
DE MOSSVILLE,KY,220,275,55,0.5555555555555556
DE PERE,WI,19690,19154,-536,0.4931006075584389
DE QUEEN,AR,3191,2740,-451,0.46197943011296577
DE RUYTER,NY,666,478,-188,0.4178321678321678
DE SMET,SD,557,422,-135,0.4310520939734423
DE SOTO,GA,22,0,-22,0
DE SOTO,IA,240,165,-75,0.4074074074074074
DE SOTO,IL,1827,1148,-679,0.38588235294117645
DE SOTO,KS,2100,2384,284,0.5316681534344335
DE SOTO,MO,7367,6769,-598,0.47884833050367853
DE SOTO,WI,363,259,-104,0.41639871382636656
DE TOUR VILLAGE,MI,392,327,-65,0.45479833101529904
DE VALLS BLUFF,AR,206,173,-33,0.45646437994722955
DE WITT,AR,1507,1477,-30,0.4949731903485255
DE WITT,IA,3001,2639,-362,0.46790780141843974
DE WITT,MI,374,452,78,0.5472154963680388
DE WITT,NE,88,39,-49,0.30708661417322836
DE WITT,NY,115,136,21,0.5418326693227091
DEAD RIVER TWP,ME,15,0,-15,0
DEADWOOD,OR,0,11,11,1
DEADWOOD,SD,1604,1247,-357,0.4373903893370747
DEAL,NJ,778,789,11,0.5035098915124442
DEAL ISLAND,MD,27,37,10,0.578125
DEALE,MD,762,811,49,0.5155753337571519
DEANE,KY,14,0,-14,0
DEANSBORO,NY,99,111,12,0.5285714285714286
DEARBORN,MI,31458,25401,-6057,0.4467366643803092
DEARBORN,MO,307,385,78,0.5563583815028902
DEARBORN HEIGHTS,MI,18878,16540,-2338,0.46699418374837653
DEARBORN HTS,MI,1179,1020,-159,0.4638472032742155
DEARING,GA,948,1019,71,0.518047788510422
DEARING,KS,11,0,-11,0
DEARY,ID,366,432,66,0.5413533834586466
DEATH VALLEY,CA,513,134,-379,0.2071097372488408
DEATSVILLE,AL,4024,4246,222,0.5134220072551391
DEAVER,WY,11,0,-11,0
DEBARY,FL,9572,11921,2349,0.554645698599544
DEBLOIS,ME,0,14,14,1
DEBORD,KY,11,0,-11,0
DECATUR,AL,23510,22402,-1108,0.48793343788116394
DECATUR,AR,1560,1100,-460,0.41353383458646614
DECATUR,GA,85566,83165,-2401,0.49288512484368613
DECATUR,IL,46298,34844,-11454,0.4294200290848143
DECATUR,IN,7061,6170,-891,0.4663290756556572
DECATUR,MI,2056,1925,-131,0.4835468475257473
DECATUR,MS,1051,890,-161,0.4585265327150953
DECATUR,NE,49,63,14,0.5625
DECATUR,TN,3743,3883,140,0.509179124049305
DECATUR,TX,6867,8267,1400,0.5462534690101758
DECATURVILLE,TN,1130,1113,-17,0.49621043245653146
DECHERD,TN,1951,2075,124,0.5153999006458023
DECKER,MI,76,0,-76,0
DECKERVILLE,MI,1361,1074,-287,0.44106776180698154
DECLO,ID,156,264,108,0.6285714285714286
DECORAH,IA,4895,4272,-623,0.46601941747572817
DEDHAM,IA,22,0,-22,0
DEDHAM,MA,8575,8210,-365,0.48912719690199585
DEDHAM,ME,342,327,-15,0.48878923766816146
DEEP GAP,NC,697,661,-36,0.48674521354933725
DEEP RIVER,CT,1601,1601,0,0.5
DEEP RIVER,IA,55,23,-32,0.2948717948717949
DEEP RUN,NC,523,580,57,0.5258386219401632
DEEPWATER,MO,671,754,83,0.5291228070175439
DEEPWATER,NJ,89,11,-78,0.11
DEER,TX,191,189,-2,0.49736842105263157
DEER CREEK,IL,273,150,-123,0.3546099290780142
DEER CREEK,MN,172,146,-26,0.4591194968553459
DEER HARBOR,WA,153,165,12,0.5188679245283019
DEER ISLAND,OR,327,257,-70,0.4400684931506849
DEER ISLE,ME,1425,1254,-171,0.46808510638297873
DEER LODGE,MT,1895,2103,208,0.5260130065032517
DEER LODGE,TN,481,807,326,0.6265527950310559
DEER MEADOWS,WA,120,148,28,0.5522388059701493
DEER PARK,CA,23,0,-23,0
DEER PARK,IL,2226,2888,662,0.5647242862729761
DEER PARK,NY,8244,7970,-274,0.49155051190329346
DEER PARK,OH,190,180,-10,0.4864864864864865
DEER PARK,TX,9457,9061,-396,0.48930770061561724
DEER PARK,WA,5718,6087,369,0.5156289707750953
DEER PARK,WI,173,120,-53,0.40955631399317405
DEER RIVER,MN,2072,2113,41,0.5048984468339307
DEER TRAIL,CO,586,922,336,0.6114058355437666
DEERBROOK,WI,594,591,-3,0.49873417721518987
DEERFIELD,IL,8199,9837,1638,0.5454091816367266
DEERFIELD,KS,218,35,-183,0.1383399209486166
DEERFIELD,MA,339,221,-118,0.39464285714285713
DEERFIELD,MI,415,209,-206,0.3349358974358974
DEERFIELD,NH,1334,1561,227,0.5392055267702937
DEERFIELD,NY,318,326,8,0.5062111801242236
DEERFIELD,OH,732,737,5,0.5017018379850239
DEERFIELD,WI,1456,1488,32,0.5054347826086957
DEERFIELD BCH,FL,2192,2319,127,0.5140767013965861
DEERFIELD BEACH,FL,46536,45581,-955,0.49481637482766483
DEERING,NH,142,189,47,0.5709969788519638
DEERWOOD,MN,2023,1965,-58,0.49272818455366096
DEFERIET,NY,37,0,-37,0
DEFIANCE,IA,12,14,2,0.5384615384615384
DEFIANCE,MO,711,1057,346,0.5978506787330317
DEFIANCE,OH,11226,10094,-1132,0.47345215759849907
DEFOE,KY,24,22,-2,0.4782608695652174
DEFORD,MI,180,209,29,0.5372750642673522
DEFOREST,WI,5467,6185,718,0.5308101613456917
DEFUNIAK SPGS,FL,360,453,93,0.5571955719557196
DEFUNIAK SPRINGS,FL,7966,9511,1545,0.5442009498197631
DEKALB,IL,23392,19431,-3961,0.4537514886859865
DEL CITY,OK,4559,4002,-557,0.4674687536502745
DEL HAVEN,NJ,284,277,-7,0.49376114081996436
DEL MAR,CA,6823,7434,611,0.5214280704215473
DEL NORTE,CO,1399,1456,57,0.5099824868651489
DEL REY,CA,688,267,-421,0.27958115183246074
DEL RIO,TN,733,791,58,0.5190288713910761
DEL RIO,TX,13907,12557,-1350,0.47449365175332525
DEL SUR,CA,579,498,-81,0.4623955431754875
DEL VALLE,TX,5846,7145,1299,0.5499961511815873
DELAFIELD,WI,2912,2987,75,0.5063570096626547
DELANCEY,NY,68,99,31,0.592814371257485
DELANCO,NJ,5411,5035,-376,0.4820026804518476
DELAND,FL,34566,38520,3954,0.527050324275511
DELANO,CA,7530,7160,-370,0.4874063989108237
DELANO,MN,2797,3100,303,0.525691029336951
DELANO,TN,535,627,92,0.5395869191049913
DELANSON,NY,1224,1338,114,0.522248243559719
DELAPLAINE,AR,11,0,-11,0
DELAPLANE,VA,126,139,13,0.5245283018867924
DELAVAN,IL,1229,1051,-178,0.46096491228070174
DELAVAN,WI,6775,6291,-484,0.48147864686973824
DELAWARE,AR,143,163,20,0.5326797385620915
DELAWARE,OH,20679,24070,3391,0.5378891148405551
DELAWARE,OK,37,28,-9,0.4307692307692308
DELAWARE CITY,DE,663,582,-81,0.4674698795180723
DELAWARE WATER GAP,PA,284,46,-238,0.1393939393939394
DELBARTON,WV,691,686,-5,0.49818445896877267
DELCAMBRE,LA,763,616,-147,0.4467005076142132
DELCO,NC,298,509,211,0.630731102850062
DELEVAN,NY,1710,1560,-150,0.47706422018348627
DELHI,CA,2716,2092,-624,0.435108153078203
DELHI,IA,482,449,-33,0.4822771213748657
DELHI,LA,2025,1785,-240,0.468503937007874
DELHI,NY,1768,1842,74,0.5102493074792244
DELIGHT,AR,543,490,-53,0.4743465634075508
DELL CITY,TX,0,11,11,1
DELL RAPIDS,SD,1835,1641,-194,0.47209436133486765
DELLROSE,TN,11,0,-11,0
DELLROY,OH,247,164,-83,0.39902676399026765
DELLSLOW,WV,570,132,-438,0.18803418803418803
DELMAR,DE,1972,2421,449,0.5511040291372639
DELMAR,IA,38,50,12,0.5681818181818182
DELMAR,MD,3128,2886,-242,0.47988027934818756
DELMAR,NY,6359,6285,-74,0.4970737108509965
DELMONT,PA,1572,1713,141,0.5214611872146119
DELMONT,SD,11,0,-11,0
DELOIT,IA,0,13,13,1
DELONG,IL,11,0,-11,0
DELPHI,IN,2983,2941,-42,0.49645509790681974
DELPHOS,KS,64,0,-64,0
DELPHOS,OH,3459,2940,-519,0.45944678856071264
DELRAN,NJ,1345,1315,-30,0.4943609022556391
DELRAY BEACH,FL,95459,103705,8246,0.5207015324054548
DELTA,AL,306,391,85,0.5609756097560976
DELTA,CO,7125,6654,-471,0.48290877422164163
DELTA,IA,11,0,-11,0
DELTA,LA,0,14,14,1
DELTA,MO,27,12,-15,0.3076923076923077
DELTA,OH,2506,2302,-204,0.47878535773710484
DELTA,PA,1539,1569,30,0.5048262548262549
DELTA,UT,1145,1267,122,0.525290215588723
DELTA JCT,AK,44,29,-15,0.3972602739726027
DELTA JUNCTION,AK,1239,1005,-234,0.44786096256684493
DELTAVILLE,VA,685,858,173,0.5560596241088788
DELTON,MI,2856,2658,-198,0.4820457018498368
DELTONA,FL,43883,44678,795,0.5044884317024424
DEMAREST,NJ,1221,1478,257,0.5476102260096332
DEMING,NM,8774,8680,-94,0.49730720751690155
DEMING,WA,976,1008,32,0.5080645161290323
DEMOPOLIS,AL,3083,2657,-426,0.46289198606271775
DEMOREST,GA,2279,2463,184,0.5194010965837199
DEMOSSVILLE,KY,38,102,64,0.7285714285714285
DEMOTTE,IN,5325,4789,-536,0.4735020763298398
DENAIR,CA,1895,1748,-147,0.47982432061487784
DENALI NATIONAL PARK,AK,355,341,-14,0.4899425287356322
DENALI PARK,AK,62,43,-19,0.4095238095238095
DENDRON,VA,25,26,1,0.5098039215686274
DENHAM SPGS,LA,1425,1424,-1,0.49982449982449983
DENHAM SPRINGS,LA,23162,24391,1229,0.5129224234012576
DENISON,IA,3554,3275,-279,0.47957241177331966
DENISON,KS,11,0,-11,0
DENISON,TX,14777,14924,147,0.5024746641527221
DENMARK,IA,66,0,-66,0
DENMARK,ME,473,603,130,0.5604089219330854
DENMARK,SC,1140,1141,1,0.5002192021043402
DENMARK,TN,117,150,33,0.5617977528089888
DENMARK,WI,1698,1620,-78,0.488245931283906
DENNARD,AR,14,26,12,0.65
DENNIS,MA,2460,2570,110,0.510934393638171
DENNIS,MS,163,83,-80,0.33739837398373984
DENNIS PORT,MA,2914,2840,-74,0.49356969064998263
DENNIS TWP,NJ,30,52,22,0.6341463414634146
DENNISON,IL,13,22,9,0.6285714285714286
DENNISON,MN,30,25,-5,0.45454545454545453
DENNISON,OH,1627,1667,40,0.5060716454159077
DENNISPORT,MA,191,276,85,0.5910064239828694
DENNISVILLE,NJ,22,13,-9,0.37142857142857144
DENNYSVILLE,ME,13,0,-13,0
DENT,MN,992,1065,73,0.5177442877977637
DENTON,GA,12,0,-12,0
DENTON,KY,0,12,12,1
DENTON,MD,3434,3331,-103,0.4923872875092387
DENTON,MT,11,0,-11,0
DENTON,NC,2231,2558,327,0.5341407391939862
DENTON,NE,47,195,148,0.8057851239669421
DENTON,TX,68211,63487,-4724,0.48206502756306097
DENVER,CO,593976,541465,-52511,0.4768763854748948
DENVER,IA,1007,1009,2,0.5004960317460317
DENVER,IN,116,155,39,0.5719557195571956
DENVER,KY,11,12,1,0.5217391304347826
DENVER,NC,8791,13344,4553,0.6028461712220465
DENVER,NY,166,191,25,0.5350140056022409
DENVER,PA,4214,4272,58,0.5034173933537591
DENVER CITY,TX,1297,1082,-215,0.4548129466162253
DENVILLE,NJ,4953,5287,334,0.51630859375
DEPAUVILLE,NY,12,0,-12,0
DEPAUW,IN,724,710,-14,0.49511854951185497
DEPEW,NY,8482,7505,-977,0.46944392318758993
DEPEW,OK,193,355,162,0.6478102189781022
DEPOE BAY,OR,2227,2092,-135,0.48437138226441306
DEPORT,TX,193,155,-38,0.4454022988505747
DEPOSIT,NY,1541,1354,-187,0.4677029360967185
DEPTFORD,NJ,2919,2914,-5,0.49957140408023315
DEPUE,IL,268,74,-194,0.21637426900584794
DEPUTY,IN,426,493,67,0.5364526659412405
DEQUINCY,LA,2270,2226,-44,0.4951067615658363
DERBY,CT,4617,4446,-171,0.49056603773584906
DERBY,IN,0,11,11,1
DERBY,KS,13313,13150,-163,0.4969202282432075
DERBY,NY,2116,1897,-219,0.4727136805382507
DERBY,VT,1317,1280,-37,0.4928763958413554
DERBY LINE,VT,797,562,-235,0.41353936718175127
DERIDDER,LA,9284,8373,-911,0.4742028657189783
DERMOTT,AR,1207,1181,-26,0.4945561139028476
DERRY,NH,14674,12939,-1735,0.4685836381414551
DERRY,PA,2182,1998,-184,0.4779904306220096
DERWOOD,MD,4948,5238,290,0.5142352248183781
DES ALLEMANDS,LA,887,1001,114,0.5301906779661016
DES ARC,AR,616,620,4,0.5016181229773463
DES MOINES,IA,132489,107503,-24986,0.4479440981366046
DES MOINES,NM,11,0,-11,0
DES MOINES,WA,17383,16040,-1343,0.47990904466983814
DES PERES,MO,693,706,13,0.5046461758398856
DES PLAINES,IL,27549,24480,-3069,0.4705068327279017
DESCANSO,CA,986,794,-192,0.4460674157303371
DESDEMONA,TX,0,12,12,1
DESERET,UT,44,38,-6,0.4634146341463415
DESERT AIRE,WA,28,47,19,0.6266666666666667
DESERT CENTER,CA,200,172,-28,0.46236559139784944
DESERT HILLS,AZ,367,427,60,0.5377833753148614
DESERT HOT SPRINGS,CA,19563,21226,1663,0.5203853980239771
DESHA,AR,0,15,15,1
DESHLER,NE,356,107,-249,0.23110151187904968
DESHLER,OH,750,780,30,0.5098039215686274
DESLOGE,MO,4968,4001,-967,0.44609209499386776
DESOTO,TX,21621,20877,-744,0.49124664690103065
DESTIN,FL,15849,18574,2725,0.5395810940359643
DESTREHAN,LA,3100,2739,-361,0.46908717246103787
DETROIT,AL,51,23,-28,0.3108108108108108
DETROIT,ME,77,155,78,0.6681034482758621
DETROIT,MI,225498,207281,-18217,0.47895346123541116
DETROIT,OR,58,11,-47,0.15942028985507245
DETROIT,TX,688,492,-196,0.41694915254237286
DETROIT LAKES,MN,10161,9375,-786,0.47988329238329236
DEVALLE,TX,0,14,14,1
DEVENS,MA,98,162,64,0.6230769230769231
DEVERS,TX,11,0,-11,0
DEVILLE,LA,1986,2055,69,0.5085374907201188
DEVILS LAKE,ND,5293,4243,-1050,0.44494546979865773
DEVILS TOWER,WY,11,11,0,0.5
DEVINE,TX,3045,3339,294,0.5230263157894737
DEVON,PA,3266,2993,-273,0.47819140437769614
DEWAR,OK,13,0,-13,0
DEWEY,AZ,6728,7201,473,0.5169789647498025
DEWEY,IL,0,31,31,1
DEWEY,OK,1743,1730,-13,0.49812841923409157
DEWEY BEACH,DE,411,322,-89,0.4392905866302865
DEWEYVILLE,TX,0,22,22,1
DEWITT,AR,271,240,-31,0.46966731898238745
DEWITT,MI,6334,6392,58,0.5022787993085023
DEWITT,VA,194,271,77,0.5827956989247312
DEWITTVILLE,NY,566,435,-131,0.43456543456543456
DEWY ROSE,GA,382,479,97,0.5563298490127758
DEXTER,GA,610,590,-20,0.49166666666666664
DEXTER,IA,288,228,-60,0.4418604651162791
DEXTER,KS,11,0,-11,0
DEXTER,KY,180,145,-35,0.4461538461538462
DEXTER,ME,2350,2307,-43,0.49538329396607256
DEXTER,MI,4239,4519,280,0.5159853847910482
DEXTER,MN,104,24,-80,0.1875
DEXTER,MO,6675,6395,-280,0.4892884468247896
DEXTER,NM,913,765,-148,0.45589988081048866
DEXTER,NY,1927,1718,-209,0.47133058984910836
DEXTER,OR,880,1037,157,0.5409494001043297
DEXTER CITY,OH,53,47,-6,0.47
DEYRPIT,MI,58,53,-5,0.4774774774774775
DFW,TX,0,15,15,1
DIABLO,CA,49,75,26,0.6048387096774194
DIABLO GRANDE,CA,466,478,12,0.5063559322033898
DIAGONAL,IA,13,11,-2,0.4583333333333333
DIAMOND,IL,847,741,-106,0.46662468513853905
DIAMOND,MO,730,786,56,0.5184696569920845
DIAMOND,OH,664,684,20,0.5074183976261127
DIAMOND BAR,CA,14009,14693,684,0.5119155459549857
DIAMOND CITY,AR,64,69,5,0.518796992481203
DIAMOND POINT,NY,517,574,57,0.5261228230980751
DIAMOND SPGS,CA,230,228,-2,0.4978165938864629
DIAMOND SPRINGS,CA,1840,2029,189,0.5244249159989661
DIAMONDHEAD,MS,3732,4256,524,0.5327991987981973
DIAMONDVILLE,WY,0,12,12,1
DIANA,TX,1510,1881,371,0.5547036272485992
DIANA,WV,24,0,-24,0
DIBERVILLE,MS,6428,6393,-35,0.49863505186802903
DIBOLL,TX,2506,2243,-263,0.47230995999157716
DICKERSON,MD,344,401,57,0.538255033557047
DICKERSON RUN,PA,12,0,-12,0
DICKEYVILLE,WI,303,145,-158,0.3236607142857143
DICKINSON,ND,15685,13785,-1900,0.4677638276213098
DICKINSON,TX,16538,16724,186,0.5027959834044856
DICKINSON CENTER,NY,33,15,-18,0.3125
DICKSON,TN,11654,11428,-226,0.49510441036305347
DICKSON CITY,PA,698,698,0,0.5
DICKSON CTY,PA,242,309,67,0.5607985480943739
DIERKS,AR,478,363,-115,0.43162901307966706
DIETERICH,IL,343,315,-28,0.4787234042553192
DIGHTON,KS,166,186,20,0.5284090909090909
DIGHTON,MA,949,976,27,0.507012987012987
DIKE,IA,424,319,-105,0.42934051144010765
DIKE,TX,35,68,33,0.6601941747572816
DILL CITY,OK,48,64,16,0.5714285714285714
DILLARD,GA,872,1030,158,0.5415352260778128
DILLARD,OR,11,34,23,0.7555555555555555
DILLER,NE,28,29,1,0.5087719298245614
DILLEY,TX,967,992,25,0.5063808065339459
DILLINER,PA,85,80,-5,0.48484848484848486
DILLINGHAM,AK,1216,578,-638,0.3221850613154961
DILLON,CO,5290,3949,-1341,0.4274272107370928
DILLON,MT,4741,4411,-330,0.48197115384615385
DILLON,SC,4318,4146,-172,0.4898393194706994
DILLONVALE,OH,569,576,7,0.503056768558952
DILLSBORO,IN,1656,1526,-130,0.4795725958516656
DILLSBORO,NC,291,14,-277,0.04590163934426229
DILLSBURG,PA,5353,5530,177,0.5081319489111458
DILLWYN,VA,1862,1723,-139,0.4806136680613668
DILWORTH,MN,2053,1949,-104,0.48700649675162416
DIME BOX,TX,332,114,-218,0.2556053811659193
DIMMITT,TX,1555,1064,-491,0.4062619320351279
DIMONDALE,MI,2071,2056,-15,0.4981826992973104
DINGMANS FERRY,PA,2643,2819,176,0.5161113145367997
DINGMANS FRY,PA,110,123,13,0.5278969957081545
DINOSAUR,CO,0,11,11,1
DINUBA,CA,5872,5813,-59,0.49747539580658967
DINWIDDIE,VA,898,1071,173,0.5439309294057897
DISCOVERY BAY,CA,5479,5744,265,0.5118061124476522
DISNEY,OK,49,69,20,0.5847457627118644
DISPUTANTA,VA,1716,1904,188,0.5259668508287293
DISTRICT HEIGHTS,MD,13483,11844,-1639,0.46764322659612273
DISTRICT HTS,MD,810,702,-108,0.4642857142857143
DITTMER,MO,1461,1465,4,0.5006835269993165
DIVERNON,IL,429,293,-136,0.40581717451523547
DIVIDE,CO,2801,2398,-403,0.4612425466435853
DIX,IL,388,177,-211,0.31327433628318585
DIX,NE,27,12,-15,0.3076923076923077
DIX HILLS,NY,3207,3344,137,0.5104564188673485
DIXFIELD,ME,875,866,-9,0.4974152785755313
DIXIE,GA,13,50,37,0.7936507936507936
DIXIE,ID,13,0,-13,0
DIXMONT,ME,535,378,-157,0.4140197152245345
DIXMOOR,IL,592,553,-39,0.4829694323144105
DIXON,CA,6802,7166,364,0.5130297823596792
DIXON,IA,29,13,-16,0.30952380952380953
DIXON,IL,9616,8477,-1139,0.46852373846238876
DIXON,KY,611,540,-71,0.46915725456125107
DIXON,MO,2940,2989,49,0.5041322314049587
DIXON,MT,12,0,-12,0
DIXON,NM,0,13,13,1
DIXON SPRINGS,TN,554,376,-178,0.4043010752688172
DIXONS MILLS,AL,24,37,13,0.6065573770491803
DOBBINS,CA,199,102,-97,0.3388704318936877
DOBBS FERRY,NY,3689,3685,-4,0.49972877678329264
DOBSON,NC,2106,1882,-224,0.4719157472417252
DOCENA,AL,15,11,-4,0.4230769230769231
DOCKWEILER,CA,199,99,-100,0.33221476510067116
DODD CITY,TX,23,116,93,0.8345323741007195
DODDRIDGE,AR,0,85,85,1
DODGE,NE,80,184,104,0.696969696969697
DODGE CENTER,MN,1491,1367,-124,0.47830650804758573
DODGE CITY,KS,13074,9751,-3323,0.4272070098576123
DODGEVILLE,WI,2896,2870,-26,0.4977454040929587
DODSON,LA,203,136,-67,0.40117994100294985
DODSON,MT,14,0,-14,0
DOE RUN,MO,93,42,-51,0.3111111111111111
DOERUN,GA,659,716,57,0.5207272727272727
DOLAN SPRINGS,AZ,845,862,17,0.50497949619215
DOLAND,SD,27,0,-27,0
DOLGEVILLE,NY,1520,1245,-275,0.45027124773960214
DOLLAR BAY,MI,136,92,-44,0.40350877192982454
DOLOMITE,AL,357,261,-96,0.4223300970873786
DOLORES,CO,2744,2553,-191,0.4819709269397772
DOLTON,IL,8075,7758,-317,0.4899892629318512
DOLTON,SD,11,0,-11,0
DONA ANA,NM,63,88,25,0.5827814569536424
DONAHUE,IA,0,39,39,1
DONALD,OR,211,100,-111,0.3215434083601286
DONALDS,SC,411,573,162,0.5823170731707317
DONALDSON,AR,259,235,-24,0.4757085020242915
DONALDSON,PA,29,28,-1,0.49122807017543857
DONALDSONVILLE,LA,2527,2279,-248,0.4741989180191427
DONALSONVILLE,GA,2884,2702,-182,0.48370927318295737
DONEGAL,PA,39,26,-13,0.4
DONGOLA,IL,633,578,-55,0.4772914946325351
DONIE,TX,11,24,13,0.6857142857142857
DONIPHAN,MO,4150,3875,-275,0.48286604361370716
DONIPHAN,NE,280,335,55,0.5447154471544715
DONNA,TX,7777,11281,3504,0.591929898205478
DONNELLSON,IA,831,685,-146,0.45184696569920846
DONNELLY,ID,1607,1579,-28,0.4956057752667922
DONORA,PA,2102,1868,-234,0.47052896725440807
DONOVAN,IL,71,25,-46,0.2604166666666667
DOON,IA,14,12,-2,0.46153846153846156
DORA,AL,1998,2125,127,0.5154014067426631
DORA,MO,50,99,49,0.6644295302013423
DORAL,FL,46503,43070,-3433,0.4808368593214473
DORAN,VA,13,0,-13,0
DORAVILLE,GA,4087,3331,-756,0.4490428686977622
DORCHESTER,MA,39575,30867,-8708,0.4381902842054456
DORCHESTER,NE,86,25,-61,0.22522522522522523
DORCHESTER,NH,67,29,-38,0.3020833333333333
DORCHESTER,NJ,0,23,23,1
DORCHESTER,SC,563,617,54,0.5228813559322034
DORCHESTER,TX,51,30,-21,0.37037037037037035
DORCHESTER,WI,505,389,-116,0.43512304250559286
DORCHESTER CENTER,MA,14557,11812,-2745,0.4479502446054079
DORENA,OR,79,129,50,0.6201923076923077
DORNSIFE,PA,11,64,53,0.8533333333333334
DOROTHY,NJ,38,38,0,0.5
DORR,MI,2304,2300,-4,0.49956559513466553
DORRIS,CA,219,61,-158,0.21785714285714286
DORSET,OH,269,247,-22,0.4786821705426357
DORSET,VT,1231,1302,71,0.5140150019739439
DORSEY,IL,0,25,25,1
DOS PALOS,CA,2685,2357,-328,0.4674732249107497
DOSS,TX,0,13,13,1
DOSWELL,VA,245,445,200,0.644927536231884
DOTHAN,AL,38034,36421,-1613,0.48916795379759587
DOUBLE OAK,TX,288,315,27,0.5223880597014925
DOUBLE SPRINGS,AL,1348,1336,-12,0.4977645305514158
DOUDS,IA,81,52,-29,0.39097744360902253
DOUGLAS,AK,1382,1076,-306,0.4377542717656631
DOUGLAS,AZ,6116,4967,-1149,0.4481638545520166
DOUGLAS,GA,11945,10172,-1773,0.4599177103585477
DOUGLAS,MA,2167,2477,310,0.5333763996554695
DOUGLAS,MI,1019,1037,18,0.5043774319066148
DOUGLAS,WY,4842,4499,-343,0.4816400813617386
DOUGLAS CITY,CA,92,37,-55,0.2868217054263566
DOUGLASS,KS,1049,1049,0,0.5
DOUGLASS,TX,133,126,-7,0.4864864864864865
DOUGLASS HILLS,KY,101,125,24,0.5530973451327433
DOUGLASS HLS,KY,120,132,12,0.5238095238095238
DOUGLASSVILLE,PA,3940,4535,595,0.5351032448377581
DOUGLASSVILLE,TX,28,72,44,0.72
DOUGLASTON,NY,1965,2013,48,0.5060331825037707
DOUGLASVILLE,GA,51943,46380,-5563,0.4717105865362123
DOUSMAN,WI,2104,2193,89,0.5103560623690947
DOVE CANYON,CA,630,750,120,0.5434782608695652
DOVE CREEK,CO,488,355,-133,0.4211150652431791
DOVER,AR,2983,2961,-22,0.4981493943472409
DOVER,DE,31216,30975,-241,0.4980624206074834
DOVER,FL,4119,4909,790,0.5437527691626052
DOVER,ID,169,245,76,0.5917874396135265
DOVER,KY,112,40,-72,0.2631578947368421
DOVER,MA,1572,1953,381,0.5540425531914893
DOVER,MN,120,76,-44,0.3877551020408163
DOVER,NC,480,405,-75,0.4576271186440678
DOVER,NH,18422,17204,-1218,0.4829057429966878
DOVER,NJ,7081,5692,-1389,0.44562749549831676
DOVER,OH,6687,5890,-797,0.4683151785004373
DOVER,OK,131,78,-53,0.37320574162679426
DOVER,PA,7636,8538,902,0.5278842586867812
DOVER,TN,3117,2920,-197,0.4836839489812821
DOVER AFB,DE,162,307,145,0.6545842217484008
DOVER AIR FORCE BASE,DE,42,112,70,0.7272727272727273
DOVER FOXCROFT,ME,2396,2409,13,0.5013527575442248
DOVER PLAINS,NY,1386,1419,33,0.5058823529411764
DOW,IL,13,39,26,0.75
DOW CITY,IA,186,98,-88,0.34507042253521125
DOWAGIAC,MI,6944,5843,-1101,0.4569484632830218
DOWELL,IL,11,0,-11,0
DOWELL,MD,239,0,-239,0
DOWELLTOWN,TN,580,544,-36,0.48398576512455516
DOWLING,MI,428,327,-101,0.433112582781457
DOWLING PARK,FL,473,416,-57,0.46794150731158607
DOWNER,IL,167,161,-6,0.49085365853658536
DOWNERS GROVE,IL,18530,18416,-114,0.49845720781681374
DOWNEY,CA,30479,25171,-5308,0.4523090745732255
DOWNEY,ID,130,186,56,0.5886075949367089
DOWNING,MO,25,0,-25,0
DOWNING,WI,13,33,20,0.717391304347826
DOWNINGTOWN,PA,13623,15761,2138,0.5363803430438334
DOWNS,IL,350,383,33,0.5225102319236017
DOWNS,KS,159,134,-25,0.45733788395904434
DOWNSVILLE,LA,1343,1267,-76,0.4854406130268199
DOWNSVILLE,NY,255,141,-114,0.3560606060606061
DOWS,IA,172,127,-45,0.42474916387959866
DOYLE,CA,87,66,-21,0.43137254901960786
DOYLE,TN,246,396,150,0.616822429906542
DOYLESTOWN,OH,2188,2242,54,0.5060948081264108
DOYLESTOWN,PA,14032,14880,848,0.5146651909241837
DOYLINE,LA,1928,1171,-757,0.377863827040981
DOZIER,AL,235,370,135,0.6115702479338843
DRACUT,MA,9488,9379,-109,0.49711135845656435
DRAFFIN,KY,18,13,-5,0.41935483870967744
DRAGOON,AZ,24,11,-13,0.3142857142857143
DRAIN,OR,1166,920,-246,0.44103547459252157
DRAKE,CO,339,283,-56,0.454983922829582
DRAKE,ND,13,0,-13,0
DRAKES BRANCH,VA,412,304,-108,0.4245810055865922
DRAKESBORO,KY,1195,844,-351,0.4139283962726827
DRAPER,UT,21515,21103,-412,0.4951663616312356
DRAPER,VA,484,478,-6,0.4968814968814969
DRASCO,AR,293,436,143,0.598079561042524
DRAVOSBURG,PA,560,413,-147,0.4244604316546763
DRAYDEN,MD,12,23,11,0.6571428571428571
DRAYTON,ND,568,253,-315,0.3081607795371498
DRAYTON,SC,645,613,-32,0.4872813990461049
DRAYTON PLAINS,MI,14,51,37,0.7846153846153846
DRESDEN,ME,394,605,211,0.6056056056056056
DRESDEN,NY,45,0,-45,0
DRESDEN,OH,1823,1590,-233,0.4658658072077351
DRESDEN,TN,2655,2362,-293,0.470799282439705
DRESHER,PA,1596,2469,873,0.607380073800738
DRESSER,WI,842,852,10,0.5029515938606848
DREW,MS,688,554,-134,0.44605475040257647
DREXEL,MO,631,655,24,0.5093312597200622
DREXEL,NC,168,194,26,0.5359116022099447
DREXEL HILL,PA,10161,9376,-785,0.479909914521165
DRIFTWOOD,TX,1542,2194,652,0.5872591006423983
DRIGGS,ID,2592,2683,91,0.5086255924170616
DRIPPING SPGS,TX,622,993,371,0.61486068111455106
DRIPPING SPRINGS,TX,6268,9541,3273,0.6035169839964577
DRISCOLL,ND,12,0,-12,0
DRUMMOND,MT,156,77,-79,0.33047210300429186
DRUMMOND,WI,90,137,47,0.6035242290748899
DRUMMOND IS,MI,11,42,31,0.7924528301886793
DRUMMOND ISLAND,MI,845,760,-85,0.4735202492211838
DRUMMONDS,TN,1460,1531,71,0.5118689401537947
DRUMORE,PA,105,50,-55,0.3225806451612903
DRUMRIGHT,OK,1277,1216,-61,0.4877657440834336
DRUMS,PA,2532,3130,598,0.5528081949841046
DRURY,MO,0,11,11,1
DRY BRANCH,GA,200,349,149,0.6357012750455373
DRY CREEK,LA,11,25,14,0.6944444444444444
DRY FORK,VA,928,916,-12,0.4967462039045553
DRY PRONG,LA,1660,1612,-48,0.49266503667481665
DRY RIDGE,KY,4113,4381,268,0.5157758417706616
DRYDEN,MI,1452,1486,34,0.505786249149081
DRYDEN,NY,2051,1763,-288,0.46224436287362347
DRYDEN,VA,406,444,38,0.5223529411764706
DRYDEN,WA,34,14,-20,0.2916666666666667
DRYHILL,KY,17,27,10,0.6136363636363636
DSRT HOT SPGS,CA,399,462,63,0.5365853658536586
DU BOIS,IL,38,0,-38,0
DU BOIS,PA,7696,6998,-698,0.47624880903770245
DU PONT,GA,11,12,1,0.5217391304347826
DU QUION,IL,90,97,7,0.5187165775401069
DU QUOIN,IL,3701,3211,-490,0.46455439814814814
DUANESBURG,NY,730,647,-83,0.4698620188816267
DUARTE,CA,5804,6102,298,0.512514698471359
DUBACH,LA,1284,1182,-102,0.4793187347931874
DUBBERLY,LA,236,97,-139,0.2912912912912913
DUBLIN,CA,29577,29556,-21,0.49982243417381156
DUBLIN,GA,10630,9796,-834,0.4795848428473514
DUBLIN,IN,152,62,-90,0.2897196261682243
DUBLIN,NH,585,650,65,0.5263157894736842
DUBLIN,OH,42247,40481,-1766,0.4893264674596267
DUBLIN,PA,1034,896,-138,0.46424870466321244
DUBLIN,TX,2649,2854,205,0.5186262038887879
DUBLIN,VA,3403,3420,17,0.5012457863110069
DUBOIS,ID,37,0,-37,0
DUBOIS,IN,474,319,-155,0.40226986128625475
DUBOIS,WY,1386,1275,-111,0.4791431792559188
DUBUQUE,IA,34905,29322,-5583,0.45653697043299546
DUCHESNE,UT,1044,1163,119,0.5269596737652923
DUCK,NC,88,91,3,0.5083798882681564
DUCK,WV,96,109,13,0.5317073170731708
DUCK CREEK VILLAGE,UT,110,206,96,0.6518987341772152
DUCK HILL,MS,416,418,2,0.5011990407673861
DUCK KEY,FL,384,792,408,0.673469387755102
DUCK RIVER,TN,83,127,44,0.6047619047619047
DUCKTOWN,TN,12,25,13,0.6756756756756757
DUCOR,CA,36,15,-21,0.29411764705882354
DUDLEY,GA,99,168,69,0.6292134831460674
DUDLEY,MA,3440,3309,-131,0.4902948584975552
DUDLEY,MO,24,39,15,0.6190476190476191
DUDLEY,NC,3645,2858,-787,0.43948946640012304
DUE WEST,SC,209,121,-88,0.36666666666666664
DUENWEG,MO,425,517,92,0.5488322717622081
DUFF,TN,106,71,-35,0.4011299435028249
DUFFIELD,VA,1254,1274,20,0.5039556962025317
DUFUR,OR,312,213,-99,0.4057142857142857
DUGGER,IN,463,346,-117,0.4276885043263288
DUGSPUR,VA,35,90,55,0.72
DUGWAY,UT,256,125,-131,0.32808398950131235
DUKE,OK,23,23,0,0.5
DUKE CENTER,PA,97,93,-4,0.48947368421052634
DULAC,LA,314,217,-97,0.4086629001883239
DULCE,NM,514,49,-465,0.08703374777975133
DULLES,VA,5425,5523,98,0.5044757033248082
DULUTH,GA,57947,55512,-2435,0.4892692514476595
DULUTH,KS,0,13,13,1
DULUTH,MN,52975,46249,-6726,0.46610699024429575
DULZURA,CA,165,103,-62,0.3843283582089552
DUMAS,AR,1758,1611,-147,0.4781834372217275
DUMAS,MS,45,72,27,0.6153846153846154
DUMAS,TX,4801,4286,-515,0.4716628150104545
DUMFRIES,VA,13983,15346,1363,0.5232363871935627
DUMMER,NH,69,63,-6,0.4772727272727273
DUMMERSTON,VT,974,988,14,0.5035677879714577
DUMONT,CO,134,35,-99,0.20710059171597633
DUMONT,IA,212,171,-41,0.4464751958224543
DUMONT,NJ,4107,4009,-98,0.49396254312469196
DUNBAR,PA,1136,1048,-88,0.47985347985347987
DUNBAR,WV,4260,3546,-714,0.45426594926979247
DUNBARTON,NH,666,746,80,0.5283286118980169
DUNCAN,AZ,1154,848,-306,0.42357642357642356
DUNCAN,OK,13921,11882,-2039,0.4604890904158431
DUNCAN,SC,6772,8367,1595,0.5526785124512847
DUNCAN FALLS,OH,332,224,-108,0.4028776978417266
DUNCANNON,PA,2708,2776,68,0.5061998541210795
DUNCANSVILLE,PA,3596,3334,-262,0.4810966810966811
DUNCANVILLE,AL,1228,1052,-176,0.4614035087719298
DUNCANVILLE,TX,12598,11557,-1041,0.4784516663216725
DUNCOMBE,IA,193,80,-113,0.29304029304029305
DUNDALK,MD,19368,18357,-1011,0.4866003976143141
DUNDAS,MN,780,871,91,0.5275590551181102
DUNDAS,VA,11,0,-11,0
DUNDEE,FL,2844,3651,807,0.5621247113163972
DUNDEE,IL,1719,1600,-119,0.4820729135281711
DUNDEE,MI,3157,3264,107,0.5083320355084878
DUNDEE,MN,15,0,-15,0
DUNDEE,MS,49,35,-14,0.4166666666666667
DUNDEE,NY,2285,2079,-206,0.47639780018331807
DUNDEE,OH,757,605,-152,0.44419970631424377
DUNDEE,OR,1568,1525,-43,0.49304881991593924
DUNEDIN,FL,29257,30296,1039,0.5087233220828505
DUNELLEN,NJ,3287,3028,-259,0.47949326999208236
DUNFERMLINE,IL,14,0,-14,0
DUNGANNON,VA,67,64,-3,0.48854961832061067
DUNKERTON,IA,376,327,-49,0.465149359886202
DUNKIRK,IN,1866,1511,-355,0.4474385549304116
DUNKIRK,MD,1685,2040,355,0.5476510067114094
DUNKIRK,NY,7933,7296,-637,0.47908595442904983
DUNKIRK,OH,190,129,-61,0.4043887147335423
DUNLAP,CA,36,76,40,0.6785714285714286
DUNLAP,IA,520,563,43,0.5198522622345337
DUNLAP,IL,3466,3583,117,0.5082990495105689
DUNLAP,TN,4862,5477,615,0.5297417545217139
DUNLEVY,PA,0,25,25,1
DUNMOR,KY,37,58,21,0.6105263157894737
DUNMORE,PA,3390,3038,-352,0.47261978842563784
DUNMORE,WV,16,0,-16,0
DUNN,NC,6895,6964,69,0.5024893570964716
DUNN LORING,VA,729,733,4,0.5013679890560876
DUNNEGAN,MO,24,26,2,0.52
DUNNELLON,FL,14859,17462,2603,0.5402679372544167
DUNNIGAN,CA,39,206,167,0.8408163265306122
DUNNING,NE,11,0,-11,0
DUNNSVILLE,VA,347,414,67,0.5440210249671484
DUNNVILLE,KY,111,68,-43,0.37988826815642457
DUNSEITH,ND,777,438,-339,0.36049382716049383
DUNSMUIR,CA,1221,1116,-105,0.47753530166880614
DUNSTABLE,MA,730,864,134,0.5420326223337516
DUNWOODY,GA,13769,13041,-728,0.4864229765013055
DUPLESSIS,LA,16,13,-3,0.4482758620689655
DUPO,IL,1733,1528,-205,0.4685679239497087
DUPONT,CO,87,27,-60,0.23684210526315788
DUPONT,IN,111,107,-4,0.4908256880733945
DUPONT,PA,593,583,-10,0.4957482993197279
DUPONT,WA,7084,6168,-916,0.4654391789918503
DUPREE,SD,28,0,-28,0
DUQUESNE,PA,2251,1896,-355,0.4571979744393537
DURAND,IL,695,695,0,0.5
DURAND,MI,4283,3684,-599,0.4624074306514372
DURAND,WI,1547,1422,-125,0.4789491411249579
DURANGO,CO,24379,24203,-176,0.4981886295335721
DURANGO,IA,60,49,-11,0.44954128440366975
DURANT,FL,46,74,28,0.6166666666666667
DURANT,IA,673,685,12,0.5044182621502209
DURANT,MS,920,778,-142,0.4581861012956419
DURANT,OK,14506,12334,-2172,0.4595380029806259
DURBIN,WV,36,15,-21,0.29411764705882354
DURHAM,CA,1789,1508,-281,0.45738550197148925
DURHAM,CT,1761,1909,148,0.5201634877384196
DURHAM,ME,969,1184,215,0.5499303297724106
DURHAM,NC,148356,142428,-5928,0.4898068669527897
DURHAM,NH,3038,3062,24,0.5019672131147541
DURHAMVILLE,NY,323,217,-106,0.40185185185185185
DURYEA,PA,1183,1221,38,0.5079034941763727
DUSHORE,PA,795,838,43,0.51316595223515
DUSON,LA,3288,3336,48,0.5036231884057971
DUSTIN,OK,39,66,27,0.6285714285714286
DUTCH HARBOR,AK,235,96,-139,0.29003021148036257
DUTCH JOHN,UT,37,12,-25,0.24489795918367346
DUTTON,AL,786,793,7,0.5022165927802407
DUTTON,VA,0,23,23,1
DUVALL,WA,3894,4297,403,0.5246001709193017
DUXBURY,MA,5089,5265,176,0.5084991307707166
DWALE,KY,0,14,14,1
DWIGHT,IL,2167,1776,-391,0.45041846309916306
DWIGHT,KS,14,0,-14,0
DYER,AR,16,11,-5,0.4074074074074074
DYER,IN,5279,6390,1111,0.5476047647613335
DYER,TN,1468,1324,-144,0.47421203438395415
DYER BROOK,ME,56,38,-18,0.40425531914893614
DYERSBURG,TN,11987,11455,-532,0.4886528453203652
DYERSVILLE,IA,1721,1812,91,0.5128785734503255
DYESS,AR,11,0,-11,0
DYESS AFB,TX,2116,2478,362,0.5393992163691772
DYKE,VA,55,24,-31,0.3037974683544304
DYSART,IA,669,589,-80,0.4682034976152623
DYSART,PA,11,0,-11,0
E ATLANTC BCH,NY,367,351,-16,0.48885793871866295
E ATLANTIC BEACH,NY,336,401,65,0.5440976933514247
E BERNSTADT,KY,84,84,0,0.5
E BRIDGEWATER,MA,187,190,3,0.5039787798408488
E BROOKFIELD,MA,105,98,-7,0.4827586206896552
E CLEVELAND,OH,762,587,-175,0.4351371386212009
E DUBLIN,GA,227,241,14,0.5149572649572649
E FAIRFIELD,VT,0,37,37,1
E FALMOUTH,MA,2527,2453,-74,0.49257028112449797
E FAYETTEVILLE,NC,884,781,-103,0.4690690690690691
E GALESBURG,IL,0,13,13,1
E GLACIER PAR,MT,11,0,-11,0
E GLACIER PARK,MT,11,0,-11,0
E GRAND FORKS,MN,327,238,-89,0.42123893805309737
E GREENBUSH,NY,317,331,14,0.5108024691358025
E GREENWICH,RI,265,394,129,0.5978755690440061
E HAMPSTEAD,NH,44,77,33,0.6363636363636364
E HARWICH,MA,166,140,-26,0.45751633986928103
E HAZEL CREST,IL,104,101,-3,0.4926829268292683
E LIVERPOOL,OH,173,143,-30,0.4525316455696203
E MCKEESPORT,PA,22,16,-6,0.42105263157894735
E MIDDLEBURY,VT,0,12,12,1
E MILLSTONE,NJ,0,54,54,1
E MONTPELIER,VT,15,28,13,0.6511627906976745
E NEW MARKET,MD,33,12,-21,0.26666666666666666
E NORTHPORT,NY,521,667,146,0.5614478114478114
E PALESTINE,OH,143,136,-7,0.4874551971326165
E PENNSBORO,PA,113,125,12,0.5252100840336135
E PETERSBURG,PA,52,74,22,0.5873015873015873
E PINEVILLE,KY,73,54,-19,0.4251968503937008
E RNCHO DMNGZ,CA,184,104,-80,0.3611111111111111
E ROCHESTER,NY,648,496,-152,0.43356643356643354
E RUTHERFORD,NJ,289,328,39,0.5316045380875203
E SAINT LOUIS,IL,583,462,-121,0.4421052631578947
E SANDWICH,MA,227,415,188,0.6464174454828661
E SPRINGFIELD,PA,28,11,-17,0.28205128205128205
E STROUDSBURG,PA,219,210,-9,0.48951048951048953
E TOWN,KY,13,34,21,0.723404255319149
E WAKEFIELD,NH,11,44,33,0.8
E WAREHAM,MA,263,318,55,0.5473321858864028
E WATERBORO,ME,63,69,6,0.5227272727272727
E WENATCHEE,WA,1272,1341,69,0.513203214695752
EADS,CO,168,195,27,0.5371900826446281
EADS,TN,1465,1940,475,0.5697503671071953
EAGAN,MN,14839,14080,-759,0.48687713959680484
EAGAR,AZ,2132,1917,-215,0.4734502346258335
EAGLE,CO,2710,2743,33,0.5030258573262424
EAGLE,ID,15964,19090,3126,0.544588349403777
EAGLE,MI,731,971,240,0.5705052878965923
EAGLE,NE,553,722,169,0.5662745098039216
EAGLE,WI,1349,1517,168,0.5293091416608514
EAGLE BAY,NY,262,287,25,0.5227686703096539
EAGLE BEND,MN,375,341,-34,0.4762569832402235
EAGLE BRIDGE,NY,121,235,114,0.6601123595505618
EAGLE BUTTE,SD,1223,478,-745,0.2810111699000588
EAGLE CREEK,IN,22,32,10,0.5925925925925926
EAGLE CREEK,OR,1263,1236,-27,0.49459783913565425
EAGLE GROVE,IA,1903,1529,-374,0.44551282051282054
EAGLE HARBOR,MI,143,69,-74,0.32547169811320753
EAGLE LAKE,FL,2034,2628,594,0.5637065637065637
EAGLE LAKE,ME,414,361,-53,0.46580645161290324
EAGLE LAKE,MN,1597,1293,-304,0.44740484429065747
EAGLE LAKE,TX,1235,1126,-109,0.4769165607793308
EAGLE MOUNTAIN,UT,10784,15609,4825,0.591406812412382
EAGLE MTN,UT,243,330,87,0.5759162303664922
EAGLE NEST,NM,161,281,120,0.6357466063348416
EAGLE PASS,TX,8055,8248,193,0.5059191559835613
EAGLE POINT,OR,6876,6828,-48,0.4982486865148862
EAGLE RIVER,AK,12432,11716,-716,0.48517475567334767
EAGLE RIVER,MI,66,0,-66,0
EAGLE RIVER,WI,5837,5620,-217,0.49052980710482674
EAGLE ROCK,CA,1660,1449,-211,0.4660662592473464
EAGLE ROCK,MO,333,482,149,0.5914110429447853
EAGLE ROCK,VA,363,343,-20,0.48583569405099153
EAGLE SPRINGS,NC,223,91,-132,0.2898089171974522
EAGLES MERE,PA,175,197,22,0.5295698924731183
EAGLETOWN,OK,145,107,-38,0.4246031746031746
EAGLEVILLE,MO,0,11,11,1
EAGLEVILLE,PA,0,26,26,1
EAGLEVILLE,TN,707,962,255,0.5763930497303775
EARL,NC,16,0,-16,0
EARL PARK,IN,34,28,-6,0.45161290322580644
EARLE,AR,763,662,-101,0.46456140350877195
EARLEVILLE,MD,856,1134,278,0.5698492462311557
EARLHAM,IA,698,636,-62,0.4767616191904048
EARLIMART,CA,739,568,-171,0.4345830145371079
EARLING,IA,28,12,-16,0.3
EARLINGTON,KY,546,549,3,0.5013698630136987
EARLSBORO,OK,340,459,119,0.574468085106383
EARLTON,NY,508,421,-87,0.45317545748116256
EARLVILLE,IA,69,67,-2,0.49264705882352944
EARLVILLE,IL,1212,1061,-151,0.4667839859216894
EARLVILLE,NY,1024,910,-114,0.4705274043433299
EARLY,IA,158,68,-90,0.3008849557522124
EARLY,TX,1945,2206,261,0.5314382076608046
EARLY BRANCH,SC,58,126,68,0.6847826086956522
EARLYSVILLE,VA,1414,1861,447,0.5682442748091603
EARP,CA,808,841,33,0.5100060642813826
EARTH,TX,78,39,-39,0.3333333333333333
EARTH CITY,MO,13,29,16,0.6904761904761905
EASLEY,SC,21017,22162,1145,0.5132587600453924
EAST ALTON,IL,4433,3515,-918,0.4422496225465526
EAST AMHERST,NY,7033,7379,346,0.5120038856508465
EAST ARLINGTON,VT,11,0,-11,0
EAST ATLANTIC BEACH,NY,301,234,-67,0.4373831775700935
EAST AURORA,NY,4940,5480,540,0.525911708253359
EAST BALDWIN,ME,0,47,47,1
EAST BANK,WV,27,43,16,0.6142857142857143
EAST BARRE,VT,264,128,-136,0.32653061224489793
EAST BEND,NC,1590,1793,203,0.5300029559562518
EAST BERLIN,CT,283,541,258,0.6565533980582524
EAST BERLIN,PA,2557,2325,-232,0.47623924621056946
EAST BERNARD,TX,1006,1249,243,0.553880266075388
EAST BERNE,NY,484,511,27,0.5135678391959799
EAST BERNSTADT,KY,1484,1635,151,0.5242064764347547
EAST BETHANY,NY,173,97,-76,0.3592592592592593
EAST BETHEL,MN,297,398,101,0.5726618705035971
EAST BOOTHBAY,ME,989,988,-1,0.49974709155285785
EAST BOSTON,MA,17936,15089,-2847,0.45689629068887205
EAST BRADY,PA,637,614,-23,0.4908073541167066
EAST BRAINTREE,MA,229,253,24,0.524896265560166
EAST BRANCH,NY,64,65,1,0.5038759689922481
EAST BRIDGEWATER,MA,3117,3174,57,0.5045302813543157
EAST BROOKFIELD,MA,608,656,48,0.5189873417721519
EAST BRUNSWICK,NJ,13019,13127,108,0.5020653254799969
EAST BURKE,VT,496,371,-125,0.4279123414071511
EAST BUTLER,PA,37,0,-37,0
EAST CALAIS,VT,239,269,30,0.5295275590551181
EAST CANAAN,CT,22,18,-4,0.45
EAST CANTON,OH,1523,1557,34,0.5055194805194805
EAST CARBON,UT,265,294,29,0.5259391771019678
EAST CARONDELET,IL,348,183,-165,0.3446327683615819
EAST CHATHAM,NY,347,516,169,0.5979142526071842
EAST CHICAGO,IN,9161,7963,-1198,0.4650198551740248
EAST CHINA,MI,1625,1510,-115,0.48165869218500795
EAST CLEVELAND,OH,1727,1477,-250,0.46098626716604246
EAST CONCORD,NY,234,160,-74,0.40609137055837563
EAST CORINTH,VT,23,22,-1,0.4888888888888889
EAST DENNIS,MA,949,730,-219,0.43478260869565216
EAST DERRY,NH,28,0,-28,0
EAST DORSET,VT,37,11,-26,0.22916666666666666
EAST DOUGLAS,MA,180,187,7,0.5095367847411444
EAST DOVER,VT,22,0,-22,0
EAST DUBLIN,GA,2573,2540,-33,0.4967729317426169
EAST DUBUQUE,IL,1379,1247,-132,0.47486671744097486
EAST DUMMERSTON,VT,129,136,7,0.5132075471698113
EAST DUNDEE,IL,1336,1452,116,0.5208034433285509
EAST DURHAM,NY,459,479,20,0.5106609808102346
EAST EARL,PA,1200,1155,-45,0.49044585987261147
EAST ELLIJAY,GA,88,88,0,0.5
EAST ELMHURST,NY,13803,10699,-3104,0.4366582319810628
EAST FAIRFIELD,VT,119,138,19,0.5369649805447471
EAST FALMOUTH,MA,5675,6106,431,0.5182921653509889
EAST FLAT ROCK,NC,1063,964,-99,0.4755796743956586
EAST FREEDOM,PA,812,645,-167,0.4426904598490048
EAST FREETOWN,MA,1344,1230,-114,0.47785547785547783
EAST FULTONHAM,OH,47,0,-47,0
EAST GADSDEN,AL,153,132,-21,0.4631578947368421
EAST GALESBURG,IL,66,38,-28,0.36538461538461536
EAST GARRISON,CA,1295,1328,33,0.5062905070529927
EAST GLACIER PARK,MT,120,98,-22,0.44954128440366975
EAST GRANBY,CT,1771,1699,-72,0.48962536023054753
EAST GRAND FORKS,MN,5288,3833,-1455,0.42023900888060517
EAST GREENBUSH,NY,3307,3221,-86,0.4934129901960784
EAST GREENVILLE,PA,1614,1576,-38,0.49404388714733544
EAST GREENWICH,RI,7136,7519,383,0.5130672125554419
EAST HADDAM,CT,1401,1633,232,0.538233355306526
EAST HAMPSTEAD,NH,999,1009,10,0.5024900398406374
EAST HAMPTON,CT,4165,4517,352,0.5202718267680257
EAST HAMPTON,NY,8875,11623,2748,0.5670309298468144
EAST HANOVER,NJ,2310,2551,241,0.5247891380374409
EAST HARDWICK,VT,128,241,113,0.6531165311653117
EAST HARTFORD,CT,21288,19877,-1411,0.4828616543179886
EAST HARTLAND,CT,199,180,-19,0.47493403693931396
EAST HAVEN,CT,7210,7105,-105,0.4963325183374083
EAST HAZEL CREST,IL,220,203,-17,0.4799054373522459
EAST HELENA,MT,3472,3625,153,0.5107792024799211
EAST ISLIP,NY,3738,3680,-58,0.4960905904556484
EAST JEWETT,NY,0,11,11,1
EAST JORDAN,MI,3776,3111,-665,0.4517206330768114
EAST KILLINGLY,CT,25,0,-25,0
EAST KINGSTON,NH,473,623,150,0.5684306569343066
EAST KINGSTON,NY,0,12,12,1
EAST LANSDOWNE,PA,193,191,-2,0.4973958333333333
EAST LANSING,MI,26184,20386,-5798,0.4377496242216019
EAST LEROY,MI,627,658,31,0.5120622568093385
EAST LIBERTY,OH,40,70,30,0.6363636363636364
EAST LIBERTY,PA,1059,868,-191,0.4504411001556824
EAST LIVERPOOL,OH,8588,7666,-922,0.4716377507075181
EAST LONGMEADOW,MA,4912,5175,263,0.5130365817388718
EAST LOS ANGELES,CA,1305,1161,-144,0.4708029197080292
EAST LYME,CT,2707,3145,438,0.5374231032125769
EAST LYNN,MA,253,260,7,0.50682261208577
EAST LYNN,WV,0,35,35,1
EAST LYNNE,MO,17,0,-17,0
EAST MACHIAS,ME,464,499,35,0.5181723779854621
EAST MARION,NY,442,509,67,0.5352260778128286
EAST MC KEESPORT,PA,848,626,-222,0.42469470827679784
EAST MEADOW,NY,9613,9153,-460,0.48774379196419054
EAST MEREDITH,NY,151,231,80,0.6047120418848168
EAST MIDDLEBURY,VT,114,0,-114,0
EAST MILLINOCKET,ME,456,445,-11,0.4938956714761376
EAST MILLSTONE,NJ,11,38,27,0.7755102040816326
EAST MOLINE,IL,11119,8918,-2201,0.4450766082746918
EAST MONTPELIER,VT,473,442,-31,0.4830601092896175
EAST MORICHES,NY,1927,1952,25,0.5032224800206239
EAST NASSAU,NY,336,328,-8,0.4939759036144578
EAST NEW MARKET,MD,691,718,27,0.5095812633073101
EAST NEWARK,NJ,1516,1343,-173,0.4697446659671214
EAST NICOLAUS,CA,11,12,1,0.5217391304347826
EAST NORCROSS,GA,478,378,-100,0.441588785046729
EAST NORRITON,PA,2360,2160,-200,0.4778761061946903
EAST NORTHPORT,NY,5810,6526,716,0.5290207522697795
EAST NORWICH,NY,1324,1160,-164,0.4669887278582931
EAST OLYMPIA,WA,190,237,47,0.5550351288056206
EAST ORANGE,NJ,24191,21628,-2563,0.47203125341015734
EAST ORLAND,ME,68,11,-57,0.13924050632911392
EAST ORLEANS,MA,952,679,-273,0.41630901287553645
EAST OTIS,MA,430,556,126,0.563894523326572
EAST OTTO,NY,82,175,93,0.6809338521400778
EAST PALATKA,FL,1692,1663,-29,0.49567809239940386
EAST PALESTINE,OH,2116,2169,53,0.5061843640606768
EAST PALO ALTO,CA,6184,4949,-1235,0.4445342674930387
EAST PATCHOGUE,NY,7553,7298,-255,0.4914147195475052
EAST PEMBROKE,NY,12,22,10,0.6470588235294118
EAST PENNSBORO,PA,387,449,62,0.5370813397129187
EAST PEORIA,IL,10274,9046,-1228,0.46821946169772255
EAST PETERSBURG,PA,1635,1664,29,0.5043952712943316
EAST PITTSBURGH,PA,2112,1206,-906,0.36347197106690776
EAST POINT,GA,5284,5311,27,0.5012741859367627
EAST POINT,KY,25,108,83,0.8120300751879699
EAST PRAIRIE,MO,2301,2220,-81,0.49104180491041804
EAST PROSPECT,PA,18,0,-18,0
EAST PROVIDENCE,RI,8099,7779,-320,0.4899231641264643
EAST QUOGUE,NY,2427,2391,-36,0.4962640099626401
EAST RANCHO DOMINGUEZ,CA,192,166,-26,0.46368715083798884
EAST RANDOLPH,VT,14,23,9,0.6216216216216216
EAST RIDGE,TN,271,189,-82,0.4108695652173913
EAST ROCHESTER,NY,3024,2665,-359,0.46844788187730707
EAST ROCHESTER,OH,178,197,19,0.5253333333333333
EAST ROCKAWAY,NY,2804,2913,109,0.5095329718383768
EAST RUTHERFORD,NJ,4293,3910,-383,0.47665488236011216
EAST RYEGATE,VT,15,11,-4,0.4230769230769231
EAST SAINT LOUIS,IL,14141,11011,-3130,0.43777830788804073
EAST SANDWICH,MA,1942,1974,32,0.5040858018386108
EAST SCHODACK,NY,12,25,13,0.6756756756756757
EAST SETAUKET,NY,2165,2089,-76,0.4910672308415609
EAST SPARTA,OH,1320,847,-473,0.39086294416243655
EAST SPENCER,NC,12,0,-12,0
EAST SPRINGFIELD,PA,292,234,-58,0.4448669201520912
EAST STONE GAP,VA,11,0,-11,0
EAST STROUDSBURG,PA,15517,13879,-1638,0.47213906653966525
EAST SYRACUSE,NY,6051,5978,-73,0.49696566630642613
EAST TAUNTON,MA,1779,1832,53,0.5073386873442259
EAST TAWAKONI,TX,117,155,38,0.5698529411764706
EAST TAWAS,MI,3186,2655,-531,0.45454545454545453
EAST TEMPLETON,MA,56,12,-44,0.17647058823529413
EAST THETFORD,VT,123,150,27,0.5494505494505495
EAST TROY,WI,3901,3751,-150,0.49019864087820175
EAST VANDERGRIFT,PA,120,28,-92,0.1891891891891892
EAST WAKEFIELD,NH,1254,1261,7,0.5013916500994036
EAST WALLINGFORD,VT,50,90,40,0.6428571428571429
EAST WALPOLE,MA,1371,1457,86,0.5152050919377652
EAST WAREHAM,MA,1542,1636,94,0.5147891755821271
EAST WATERBORO,ME,527,614,87,0.5381244522348817
EAST WATERFORD,PA,40,35,-5,0.4666666666666667
EAST WATERTOWN,MA,261,241,-20,0.4800796812749004
EAST WENATCHEE,WA,9031,9364,333,0.509051372655613
EAST WEYMOUTH,MA,5037,4386,-651,0.4654568608723337
EAST WILLISTON,NY,488,460,-28,0.48523206751054854
EAST WINDSOR,CT,2233,2220,-13,0.4985403099034359
EAST WINDSOR,NJ,6131,5996,-135,0.4944339078090212
EAST WINTHROP,ME,11,34,23,0.7555555555555555
EASTABOGA,AL,1343,1124,-219,0.4556141062018646
EASTAMPTON,NJ,431,502,71,0.5380493033226152
EASTAMPTON TOWNSHIP,NJ,523,496,-27,0.4867517173699706
EASTANOLLEE,GA,856,852,-4,0.49882903981264637
EASTBOROUGH,KS,190,212,22,0.527363184079602
EASTBROOK,ME,174,155,-19,0.47112462006079026
EASTCHESTER,NY,2260,2372,112,0.5120898100172712
EASTFORD,CT,314,495,181,0.6118665018541409
EASTHAM,MA,2957,3398,441,0.5346970889063729
EASTHAMPTON,MA,8059,6918,-1141,0.4619082593309742
EASTLAKE,CO,546,343,-203,0.3858267716535433
EASTLAKE,MI,22,0,-22,0
EASTLAKE,OH,4585,4488,-97,0.49465446930452994
EASTLAND,TX,2484,2584,100,0.5098658247829518
EASTMAN,GA,4505,4608,103,0.505651267420169
EASTMAN,WI,190,153,-37,0.446064139941691
EASTON,CT,1789,2348,559,0.5675610345661107
EASTON,IL,11,25,14,0.6944444444444444
EASTON,KS,57,134,77,0.7015706806282722
EASTON,MA,41,12,-29,0.22641509433962265
EASTON,MD,8844,9362,518,0.5142260793145117
EASTON,ME,194,227,33,0.5391923990498813
EASTON,MO,36,69,33,0.6571428571428571
EASTON,NH,49,23,-26,0.3194444444444444
EASTON,PA,32266,31200,-1066,0.4916018025399426
EASTON,WA,220,191,-29,0.46472019464720193
EASTOVER,NC,1083,1086,3,0.5006915629322268
EASTOVER,SC,1270,1346,76,0.514525993883792
EASTPOINT,FL,1679,2024,345,0.546583850931677
EASTPOINTE,MI,19145,13722,-5423,0.4175008367055101
EASTPORT,ME,1021,982,-39,0.49026460309535697
EASTPORT,MI,601,309,-292,0.3395604395604396
EASTPORT,NY,1186,935,-251,0.4408297972654408
EASTSOUND,WA,2881,2638,-243,0.4779851422359123
EASTVALE,CA,15340,16543,1203,0.5188658532760405
EASTVIEW,KY,412,460,48,0.5275229357798165
EASTVILLE,VA,57,11,-46,0.16176470588235295
EASTWAREHAM,MA,44,54,10,0.5510204081632653
EATON,CO,3009,3221,212,0.5170144462279294
EATON,IN,1044,842,-202,0.44644750795334043
EATON,NY,438,411,-27,0.4840989399293286
EATON,OH,5367,5033,-334,0.48394230769230767
EATON PARK,FL,346,513,167,0.5972060535506403
EATON RAPIDS,MI,5668,5488,-180,0.49193259232699893
EATONTON,GA,6739,7689,950,0.532922095924591
EATONTOWN,NJ,6113,6000,-113,0.4953355898621316
EATONVILLE,WA,3631,3913,282,0.5186903499469777
EAU CLAIRE,MI,1073,979,-94,0.4770955165692008
EAU CLAIRE,WI,46558,37916,-8642,0.4488481662996898
EAU GALLIE,FL,196,282,86,0.5899581589958159
EBEEMEE TWP,ME,96,50,-46,0.3424657534246575
EBENSBURG,PA,2473,2367,-106,0.4890495867768595
ECCLES,WV,22,0,-22,0
ECHO,MN,22,13,-9,0.37142857142857144
ECHO,OR,37,0,-37,0
ECKERMAN,MI,70,102,32,0.5930232558139535
ECKERT,CO,841,770,-71,0.47796399751707014
ECKERTY,IN,11,28,17,0.717948717948718
ECKLEY,CO,12,11,-1,0.4782608695652174
ECLECTIC,AL,1886,1961,75,0.5097478554717962
ECONOMY,IN,0,11,11,1
ECORSE,MI,3032,2967,-65,0.4945824304050675
ECRU,MS,1412,1067,-345,0.43041549011698266
ECTOR,TX,192,240,48,0.5555555555555556
EDCOUCH,TX,1290,1384,94,0.5175766641735228
EDDINGTON,ME,780,812,32,0.5100502512562815
EDDY,TX,781,807,26,0.5081863979848866
EDDYSTONE,PA,341,280,-61,0.45088566827697263
EDDYVILLE,IA,629,312,-317,0.33156216790648246
EDDYVILLE,KY,2499,2277,-222,0.47675879396984927
EDDYVILLE,OR,0,24,24,1
EDELSTEIN,IL,35,84,49,0.7058823529411765
EDEN,GA,22,38,16,0.6333333333333333
EDEN,ID,42,58,16,0.58
EDEN,MD,754,806,52,0.5166666666666667
EDEN,NC,9370,8276,-1094,0.46900147342173865
EDEN,NY,1970,1928,-42,0.49461262185736277
EDEN,TX,98,176,78,0.6423357664233577
EDEN,UT,2320,2494,174,0.5180722891566265
EDEN,VT,144,188,44,0.5662650602409639
EDEN,WI,263,422,159,0.6160583941605839
EDEN MILLS,VT,13,0,-13,0
EDEN PRAIRIE,MN,31914,30187,-1727,0.486095231960838
EDEN VALLEY,MN,846,614,-232,0.42054794520547945
EDENBURG,IL,31,25,-6,0.44642857142857145
EDENTON,NC,4062,4415,353,0.5208210451810782
EDGAR,NE,87,11,-76,0.11224489795918367
EDGAR,WI,958,972,14,0.5036269430051813
EDGAR SPRINGS,MO,264,391,127,0.5969465648854961
EDGARD,LA,24,14,-10,0.3684210526315789
EDGARTOWN,MA,3173,3673,500,0.5365176745544844
EDGECLIFF VILLAGE,TX,640,528,-112,0.4520547945205479
EDGECOMB,ME,505,579,74,0.5341328413284133
EDGEFIELD,SC,1374,1581,207,0.5350253807106599
EDGELEY,ND,133,58,-75,0.3036649214659686
EDGEMERE,MD,126,192,66,0.6037735849056604
EDGEMONT,AR,13,108,95,0.8925619834710744
EDGEMONT,SD,509,546,37,0.5175355450236967
EDGEMOOR,SC,310,526,216,0.6291866028708134
EDGERTON,KS,829,746,-83,0.47365079365079366
EDGERTON,MN,326,244,-82,0.4280701754385965
EDGERTON,MO,111,228,117,0.672566371681416
EDGERTON,OH,1140,1122,-18,0.4960212201591512
EDGERTON,WI,4918,4988,70,0.5035332121946295
EDGEWATER,CO,3060,2781,-279,0.4761171032357473
EDGEWATER,FL,16259,16478,219,0.5033448391728014
EDGEWATER,MD,6790,7312,522,0.5185080130477946
EDGEWATER,NJ,9490,8285,-1205,0.4661040787623066
EDGEWATER PARK,NJ,743,724,-19,0.49352419904567146
EDGEWATER PRK,NJ,290,294,4,0.5034246575342466
EDGEWOOD,IA,455,411,-44,0.4745958429561201
EDGEWOOD,IL,239,151,-88,0.3871794871794872
EDGEWOOD,KY,3893,3850,-43,0.49722329846312796
EDGEWOOD,MD,10554,9613,-941,0.4766698071106263
EDGEWOOD,NM,4006,4637,631,0.5365035288672915
EDGEWOOD,TX,1403,1664,261,0.5425497228562113
EDGEWOOD,WA,5700,5711,11,0.5004819910612567
EDINA,MN,14667,13960,-707,0.4876515177978831
EDINA,MO,635,624,-11,0.49563145353455124
EDINBORO,PA,4018,3611,-407,0.4733254686066326
EDINBURG,IL,407,352,-55,0.463768115942029
EDINBURG,ME,12,12,0,0.5
EDINBURG,PA,645,643,-2,0.49922360248447206
EDINBURG,TX,30195,30436,241,0.5019874321716613
EDINBURG,VA,2156,2209,53,0.5060710194730813
EDINBURGH,IN,2831,2796,-35,0.49688999466856226
EDISON,CA,22,0,-22,0
EDISON,GA,231,247,16,0.5167364016736402
EDISON,NE,22,0,-22,0
EDISON,NJ,34706,30604,-4102,0.46859592711682746
EDISON,OH,250,248,-2,0.4979919678714859
EDISTO ISLAND,SC,1664,1770,106,0.5154338963308096
EDMESTON,NY,333,220,-113,0.39783001808318263
EDMON,PA,17,12,-5,0.41379310344827586
EDMOND,OK,67645,74753,7108,0.5249582157052768
EDMONDS,WA,21588,21741,153,0.5017655611715017
EDMONTON,KY,2294,2481,187,0.5195811518324608
EDMORE,MI,1596,1364,-232,0.4608108108108108
EDMORE,ND,13,12,-1,0.48
EDMUNDS TWP,ME,12,15,3,0.5555555555555556
EDNA,KS,83,53,-30,0.3897058823529412
EDNA,TX,2868,2674,-194,0.482497293395886
EDNEYVILLE,NC,188,24,-164,0.11320754716981132
EDOM,TX,38,46,8,0.5476190476190477
EDON,OH,785,654,-131,0.45448227936066715
EDWALL,WA,11,12,1,0.5217391304347826
EDWARD,NC,11,0,-11,0
EDWARDS,CA,2670,2055,-615,0.43492063492063493
EDWARDS,CO,3548,3851,303,0.5204757399648601
EDWARDS,IL,699,764,65,0.5222146274777854
EDWARDS,MO,837,984,147,0.5403624382207578
EDWARDS,MS,663,808,145,0.549286199864038
EDWARDS,NY,410,238,-172,0.36728395061728397
EDWARDSBURG,MI,4296,3542,-754,0.45190099515182447
EDWARDSPORT,IN,75,0,-75,0
EDWARDSVILLE,IL,12399,11701,-698,0.4855186721991701
EDWARDSVILLE,KS,1639,1620,-19,0.4970849953973612
EDWARDSVILLE,PA,474,458,-16,0.49141630901287553
EFFIE,LA,23,64,41,0.735632183908046
EFFIE,MN,72,43,-29,0.3739130434782609
EFFINGHAM,IL,8573,7583,-990,0.4693612280267393
EFFINGHAM,KS,103,101,-2,0.4950980392156863
EFFINGHAM,NH,509,555,46,0.5216165413533834
EFFINGHAM,SC,2219,2351,132,0.5144420131291029
EFFORT,PA,2314,2403,89,0.5094339622641509
EFLAND,NC,975,1200,225,0.5517241379310345
EGAN,LA,95,233,138,0.7103658536585366
EGG HARBOR,NJ,93,114,21,0.5507246376811594
EGG HARBOR,WI,1910,1618,-292,0.45861678004535145
EGG HARBOR CITY,NJ,3771,4085,314,0.5199847250509165
EGG HARBOR CY,NJ,59,79,20,0.572463768115942
EGG HARBOR TOWNSHIP,NJ,11853,13207,1354,0.5270151636073424
EGG HARBOR TWP,NJ,248,293,45,0.5415896487985212
EGG HBR CITY,NJ,395,445,50,0.5297619047619048
EGLIN AFB,FL,4383,4690,307,0.5169183291083435
EGREMONT,MA,53,72,19,0.576
EHRENBERG,AZ,1163,748,-415,0.39141810570381996
EHRHARDT,SC,76,77,1,0.5032679738562091
EIDSON,TN,11,47,36,0.8103448275862069
EIELSON AFB,AK,2066,2065,-1,0.49987896393125153
EIGHT MILE,AL,3225,2986,-239,0.4807599420383191
EIGHTY FOUR,PA,1197,1547,350,0.5637755102040817
EKALAKA,MT,109,13,-96,0.10655737704918032
EKRON,KY,962,973,11,0.5028423772609819
EL CAJON,CA,73295,66663,-6632,0.476307177867646
EL CAMPO,TX,6008,4758,-1250,0.4419468697752183
EL CENIZO,TX,205,192,-13,0.4836272040302267
EL CENTRO,CA,15934,14007,-1927,0.4678200460906449
EL CERRITO,CA,10909,10388,-521,0.4877682302671738
EL DORADO,AR,11581,10237,-1344,0.4691997433311944
EL DORADO,CA,1629,1720,91,0.5135861451179456
EL DORADO,KS,9015,7399,-1616,0.4507737297429024
EL DORADO HILLS,CA,14368,18630,4262,0.5645796714952421
EL DORADO HLS,CA,209,283,74,0.5752032520325203
EL DORADO SPRINGS,MO,4222,3721,-501,0.4684627974317009
EL GRANADA,CA,985,1062,77,0.5188080117244749
EL JOBEAN,FL,0,16,16,1
EL LAGO,TX,2777,2555,-222,0.47918229557389347
EL MACERO,CA,141,144,3,0.5052631578947369
EL MIRAGE,AZ,13523,15386,1863,0.5322217994396209
EL MONTE,CA,23243,19744,-3499,0.4593016493358457
EL NIDO,CA,36,12,-24,0.25
EL PASO,AR,190,287,97,0.6016771488469602
EL PASO,IL,1302,1307,5,0.5009582215408203
EL PASO,TX,240529,220481,-20048,0.4782564369536453
EL PORTAL,CA,136,14,-122,0.09333333333333334
EL PORTAL,FL,2429,2089,-340,0.4623727312970341
EL PRADO,NM,1440,1613,173,0.5283327874222077
EL RENO,OK,10332,7955,-2377,0.4350084759665336
EL RITO,NM,0,11,11,1
EL SEGUNDO,CA,9556,9158,-398,0.4893662498664102
EL SOBRANTE,CA,7469,7371,-98,0.49669811320754714
EL TORO,CA,1547,1645,98,0.5153508771929824
EL VERANO,CA,54,0,-54,0
ELAINE,AR,13,19,6,0.59375
ELAND,WI,26,45,19,0.6338028169014085
ELBA,AL,2627,2401,-226,0.4775258552108194
ELBA,ID,37,24,-13,0.39344262295081966
ELBA,NE,22,11,-11,0.3333333333333333
ELBA,NY,437,370,-67,0.45848822800495664
ELBE,WA,19,0,-19,0
ELBERFELD,IN,590,647,57,0.52303961196443
ELBERON,IA,12,0,-12,0
ELBERON,VA,0,35,35,1
ELBERT,CO,1494,1772,278,0.5425597060624617
ELBERT,TX,0,12,12,1
ELBERTA,AL,3323,3669,346,0.5247425629290617
ELBERTA,MI,43,34,-9,0.44155844155844154
ELBERTON,GA,4496,4766,270,0.5145756855970632
ELBING,KS,14,0,-14,0
ELBOW LAKE,MN,830,796,-34,0.48954489544895446
ELBRIDGE,NY,987,966,-21,0.4946236559139785
ELBURN,IL,2992,3354,362,0.5285219035612985
ELCHO,WI,694,438,-256,0.3869257950530035
ELDERSBURG,MD,1775,2028,253,0.5332632132526952
ELDERTON,PA,30,0,-30,0
ELDON,IA,376,253,-123,0.40222575516693165
ELDON,MO,4922,4956,34,0.5017209961530674
ELDORA,IA,1812,1515,-297,0.45536519386834984
ELDORADO,IL,2330,2030,-300,0.46559633027522934
ELDORADO,OH,81,23,-58,0.22115384615384615
ELDORADO,OK,14,11,-3,0.44
ELDORADO,TX,340,357,17,0.5121951219512195
ELDORADO,WI,61,50,-11,0.45045045045045046
ELDRED,IL,24,0,-24,0
ELDRED,NY,160,191,31,0.5441595441595442
ELDRED,PA,1091,994,-97,0.4767386091127098
ELDRIDGE,AL,23,45,22,0.6617647058823529
ELDRIDGE,CA,12,0,-12,0
ELDRIDGE,IA,3780,3444,-336,0.47674418604651164
ELDRIDGE,MO,45,67,22,0.5982142857142857
ELEANOR,WV,295,188,-107,0.38923395445134573
ELECTRA,TX,1200,1219,19,0.5039272426622571
ELECTRIC CITY,WA,174,293,119,0.6274089935760171
ELEELE,HI,138,142,4,0.5071428571428571
ELEPHANT BTTE,NM,50,114,64,0.6951219512195121
ELEPHANT BUTTE,NM,1097,1319,222,0.5459437086092715
ELEVA,WI,828,901,73,0.5211104684788895
ELFERS,FL,1210,888,-322,0.4232602478551001
ELFIN COVE,AK,0,12,12,1
ELFRIDA,AZ,369,333,-36,0.47435897435897434
ELGIN,AZ,80,111,31,0.581151832460733
ELGIN,IA,304,289,-15,0.4873524451939292
ELGIN,IL,43155,38916,-4239,0.4741747998684066
ELGIN,MN,541,368,-173,0.40484048404840484
ELGIN,ND,119,50,-69,0.2958579881656805
ELGIN,NE,197,164,-33,0.45429362880886426
ELGIN,OK,2890,3131,241,0.5200132868294304
ELGIN,OR,1291,1252,-39,0.49233189146677153
ELGIN,SC,9118,11817,2699,0.5644614282302365
ELGIN,TX,7410,9327,1917,0.5572683276572863
ELIDA,NM,0,13,13,1
ELIDA,OH,636,559,-77,0.46778242677824267
ELIOT,ME,2729,2483,-246,0.4764006139677667
ELIZABETH,AR,37,53,16,0.5888888888888889
ELIZABETH,CO,5151,6344,1193,0.5518921270117443
ELIZABETH,IL,489,471,-18,0.490625
ELIZABETH,IN,1498,1302,-196,0.465
ELIZABETH,LA,34,39,5,0.5342465753424658
ELIZABETH,NJ,36403,29110,-7293,0.4443392914383405
ELIZABETH,PA,2539,2298,-241,0.47508786437874717
ELIZABETH,WV,920,1032,112,0.5286885245901639
ELIZABETH CITY,NC,14283,14840,557,0.509562888438691
ELIZABETH LAKE,CA,75,57,-18,0.4318181818181818
ELIZABETHPORT,NJ,6078,4867,-1211,0.44467793513019643
ELIZABETHTON,TN,11667,12349,682,0.5141988674217188
ELIZABETHTOWN,IL,294,250,-44,0.45955882352941174
ELIZABETHTOWN,IN,810,703,-107,0.4646397884996695
ELIZABETHTOWN,KY,24836,24610,-226,0.4977146786393237
ELIZABETHTOWN,NC,2829,2916,87,0.5075718015665797
ELIZABETHTOWN,NY,609,481,-128,0.44128440366972477
ELIZABETHTOWN,PA,9796,10054,258,0.5064987405541562
ELIZABETHVILLE,PA,1139,1382,243,0.5481951606505355
ELIZABETHVLE,PA,11,24,13,0.6857142857142857
ELIZAVILLE,NY,498,573,75,0.5350140056022409
ELK,CA,11,11,0,0.5
ELK,SD,28,16,-12,0.36363636363636365
ELK,WA,2193,1621,-572,0.42501310959622446
ELK CITY,ID,68,114,46,0.6263736263736264
ELK CITY,KS,38,72,34,0.6545454545454545
ELK CITY,OK,7283,6068,-1215,0.45449779042768335
ELK CREEK,MO,11,0,-11,0
ELK CREEK,VA,67,64,-3,0.48854961832061067
ELK GARDEN,WV,11,15,4,0.5769230769230769
ELK GROVE,CA,51667,56062,4395,0.5203984071141475
ELK GROVE VILLAGE,IL,11176,10898,-278,0.49370299900335235
ELK GROVE VLG,IL,160,173,13,0.5195195195195195
ELK HORN,IA,61,115,54,0.6534090909090909
ELK HORN,KY,229,106,-123,0.3164179104477612
ELK MOUND,WI,1449,1529,80,0.5134318334452653
ELK PARK,NC,395,456,61,0.535840188014101
ELK POINT,SD,1243,1017,-226,0.45
ELK RAPIDS,MI,1917,1783,-134,0.4818918918918919
ELK RIDGE,UT,439,537,98,0.5502049180327869
ELK RIVER,MN,14607,15866,1259,0.5206576313457815
ELK RUN HEIGHTS,IA,127,131,4,0.5077519379844961
ELKA PARK,NY,0,11,11,1
ELKADER,IA,648,582,-66,0.47317073170731705
ELKHART,IA,246,384,138,0.6095238095238096
ELKHART,IL,47,50,3,0.5154639175257731
ELKHART,IN,46935,38813,-8122,0.45264029481737184
ELKHART,KS,286,225,-61,0.44031311154598823
ELKHART,TX,1682,1872,190,0.5267304445694991
ELKHART LAKE,WI,1287,1183,-104,0.4789473684210526
ELKHORN,NE,11910,15925,4015,0.5721214298544998
ELKHORN,WI,7418,7167,-251,0.49139526911210146
ELKHORN CITY,KY,953,975,22,0.5057053941908713
ELKIN,NC,3177,3280,103,0.5079758401734552
ELKINS,AR,2407,2530,123,0.5124569576665992
ELKINS,NH,40,36,-4,0.47368421052631576
ELKINS,WV,6284,5426,-858,0.46336464560204954
ELKINS PARK,PA,7436,6448,-988,0.46441947565543074
ELKLAND,MO,765,888,123,0.5372050816696915
ELKLAND,PA,1053,818,-235,0.43719935863174775
ELKMONT,AL,2542,2681,139,0.5133065288148574
ELKO,GA,51,353,302,0.8737623762376238
ELKO,MN,107,103,-4,0.49047619047619045
ELKO,NV,14475,12169,-2306,0.45672571685933044
ELKO NEW MARKET,MN,1359,1571,212,0.5361774744027303
ELKO NEW MRKT,MN,26,19,-7,0.4222222222222222
ELKRIDGE,MD,14702,14415,-287,0.49507160765188724
ELKTON,FL,2118,2308,190,0.5214640759150474
ELKTON,KY,2169,2180,11,0.5012646585421936
ELKTON,MD,18145,15645,-2500,0.46300680674755845
ELKTON,MI,400,357,-43,0.4715984147952444
ELKTON,OR,259,220,-39,0.4592901878914405
ELKTON,SD,332,170,-162,0.3386454183266932
ELKTON,VA,3077,3086,9,0.5007301638812267
ELKVIEW,WV,2476,2530,54,0.50539352776668
ELKVILLE,IL,563,411,-152,0.4219712525667351
ELKWOOD,VA,11,11,0,0.5
ELLABELL,GA,2689,2730,41,0.5037829857907363
ELLAVILLE,GA,1233,1142,-91,0.4808421052631579
ELLENBORO,NC,1966,2199,233,0.5279711884753902
ELLENBORO,WV,18,27,9,0.6
ELLENBURG CENTER,NY,156,102,-54,0.3953488372093023
ELLENBURG DEPOT,NY,599,467,-132,0.43808630393996245
ELLENDALE,DE,910,1001,91,0.5238095238095238
ELLENDALE,MN,453,473,20,0.5107991360691144
ELLENDALE,ND,515,453,-62,0.46797520661157027
ELLENDALE,TN,14,0,-14,0
ELLENSBURG,WA,21840,16291,-5549,0.4272376806273111
ELLENTON,FL,11643,12331,688,0.5143488779511137
ELLENVILLE,NY,3345,2892,-453,0.4636844636844637
ELLENWOOD,GA,14882,14699,-183,0.49690679828268147
ELLERBE,NC,914,944,30,0.5080731969860065
ELLERSLIE,GA,461,848,387,0.6478227654698243
ELLERSLIE,MD,70,0,-70,0
ELLETTSVILLE,IN,2810,3174,364,0.5304144385026738
ELLICOTT CITY,MD,28167,30363,2196,0.5187596104561764
ELLICOTTVILLE,NY,949,870,-79,0.4782847718526663
ELLIJAY,GA,9510,10818,1308,0.532172373081464
ELLINGER,TX,11,0,-11,0
ELLINGTON,CT,5593,5844,251,0.5109731572964938
ELLINGTON,MO,1025,988,-37,0.49080973671137607
ELLINWOOD,KS,1164,949,-215,0.4491244675816375
ELLIOTT,IA,43,23,-20,0.3484848484848485
ELLIOTT,IL,11,0,-11,0
ELLIOTTSBURG,PA,303,241,-62,0.4430147058823529
ELLIS,KS,1027,958,-69,0.4826196473551637
ELLIS GROVE,IL,37,0,-37,0
ELLISON BAY,WI,1017,1035,18,0.5043859649122807
ELLISTON,VA,979,1111,132,0.531578947368421
ELLISVILLE,IL,0,13,13,1
ELLISVILLE,MO,1383,1352,-31,0.4943327239488117
ELLISVILLE,MS,3338,3308,-30,0.49774300331026183
ELLOREE,SC,873,1010,137,0.5363781200212427
ELLSINORE,MO,1314,1069,-245,0.44859420898027697
ELLSTON,IA,102,24,-78,0.19047619047619047
ELLSWORTH,IA,57,22,-35,0.27848101265822783
ELLSWORTH,IL,11,13,2,0.5416666666666666
ELLSWORTH,KS,1501,1272,-229,0.4587089794446448
ELLSWORTH,ME,7736,7515,-221,0.4927545734705921
ELLSWORTH,MI,583,398,-185,0.4057084607543323
ELLSWORTH,MN,15,85,70,0.85
ELLSWORTH,PA,40,48,8,0.5454545454545454
ELLSWORTH,WI,2478,2280,-198,0.4791929382093317
ELLSWORTH AFB,SD,2439,2850,411,0.5388542257515598
ELLWOOD CITY,PA,4974,4937,-37,0.4981333871455958
ELM CITY,NC,1837,1983,146,0.5191099476439791
ELM CREEK,NE,603,357,-246,0.371875
ELM GROVE,LA,469,552,83,0.5406464250734574
ELM GROVE,WI,2395,2553,158,0.5159660468876314
ELM GROVE,WV,291,262,-29,0.47377938517179025
ELM MOTT,TX,1544,1335,-209,0.46370267453977076
ELM SPRINGS,AR,0,12,12,1
ELMA,IA,113,107,-6,0.4863636363636364
ELMA,NY,2666,2619,-47,0.49555345316934724
ELMA,WA,4182,3738,-444,0.471969696969697
ELMENDORF,TX,2377,2697,320,0.5315333070555774
ELMENDORF AFB,AK,76,72,-4,0.4864864864864865
ELMER,LA,155,156,1,0.5016077170418006
ELMER,NJ,3000,2884,-116,0.49014276002719237
ELMER CITY,WA,11,11,0,0.5
ELMHURST,IL,13271,13843,572,0.5105480563546507
ELMHURST,NY,25589,17969,-7620,0.41253041921116673
ELMHURST TOWNSHIP,PA,71,70,-1,0.49645390070921985
ELMIRA,CA,122,50,-72,0.29069767441860467
ELMIRA,MI,856,894,38,0.5108571428571429
ELMIRA,NY,22754,20663,-2091,0.47591957067508117
ELMIRA,OR,937,980,43,0.5112154407929056
ELMIRA HEIGHTS,NY,357,378,21,0.5142857142857142
ELMIRA HTS,NY,75,43,-32,0.3644067796610169
ELMO,MT,0,11,11,1
ELMONT,NY,10709,9146,-1563,0.4606396373709393
ELMORA,PA,13,11,-2,0.4583333333333333
ELMORE,AL,1644,1348,-296,0.4505347593582888
ELMORE,MN,104,115,11,0.5251141552511416
ELMORE,OH,870,757,-113,0.46527350952673635
ELMORE,VT,161,188,27,0.5386819484240688
ELMORE CITY,OK,992,798,-194,0.44581005586592176
ELMSFORD,NY,4643,4240,-403,0.4773162219970731
ELMWOOD,IL,914,842,-72,0.479498861047836
ELMWOOD,NE,36,79,43,0.6869565217391305
ELMWOOD,TN,325,275,-50,0.4583333333333333
ELMWOOD,WI,552,473,-79,0.46146341463414636
ELMWOOD PARK,IL,8250,7437,-813,0.47408682348441383
ELMWOOD PARK,NJ,6469,5848,-621,0.47479093935211497
ELNORA,IN,342,142,-200,0.29338842975206614
ELOADORE,IL,15,19,4,0.5588235294117647
ELON,NC,2713,3158,445,0.5378981434167944
ELORA,TN,135,347,212,0.7199170124481328
ELOY,AZ,5043,6935,1892,0.5789781265653698
ELROD,AL,42,12,-30,0.2222222222222222
ELROY,WI,1128,955,-173,0.4584733557369179
ELSA,TX,409,467,58,0.5331050228310502
ELSAH,IL,74,127,53,0.6318407960199005
ELSBERRY,MO,1825,1590,-235,0.465592972181552
ELSIE,MI,1011,917,-94,0.4756224066390041
ELSINORE,UT,185,189,4,0.5053475935828877
ELSMERE,KY,2942,2809,-133,0.48843679360111286
ELSMORE,KS,0,13,13,1
ELTON,LA,372,410,38,0.5242966751918159
ELTOPIA,WA,91,70,-21,0.43478260869565216
ELVERSON,PA,1534,1638,104,0.5163934426229508
ELVERTA,CA,2204,1873,-331,0.45940642629384354
ELWELL,MI,299,213,-86,0.416015625
ELWOOD,IA,13,30,17,0.6976744186046512
ELWOOD,IL,1246,1170,-76,0.48427152317880795
ELWOOD,IN,5460,5122,-338,0.48402948402948404
ELWOOD,KS,106,27,-79,0.20300751879699247
ELWOOD,NE,483,468,-15,0.4921135646687697
ELY,IA,979,929,-50,0.4868972746331237
ELY,MN,3816,3820,4,0.500261917234154
ELY,NV,2814,2696,-118,0.48929219600725954
ELYRIA,OH,25956,24486,-1470,0.48542880932556204
ELYSBURG,PA,1056,1074,18,0.504225352112676
ELYSIAN,MN,578,487,-91,0.4572769953051643
EMBARRASS,MN,211,249,38,0.5413043478260869
EMBDEN,ME,223,273,50,0.5504032258064516
EMDEN,IL,22,0,-22,0
EMELLE,AL,0,13,13,1
EMERADO,ND,439,150,-289,0.2546689303904924
EMERALD,WI,130,165,35,0.559322033898305
EMERALD HILLS,CA,890,773,-117,0.46482260974143114
EMERALD ISLE,NC,2756,3266,510,0.5423447359681169
EMERSON,AR,407,366,-41,0.47347994825355755
EMERSON,GA,576,474,-102,0.4514285714285714
EMERSON,IA,128,60,-68,0.3191489361702128
EMERSON,NE,239,126,-113,0.3452054794520548
EMERSON,NJ,1406,1560,154,0.5259608900876601
EMERY,SD,0,739,739,1
EMERYVILLE,CA,26424,19919,-6505,0.4298168008113415
EMIGRANT,MT,692,648,-44,0.4835820895522388
EMIGSVILLE,PA,172,36,-136,0.17307692307692307
EMILY,MN,877,584,-293,0.3997262149212868
EMINENCE,KY,1735,1603,-132,0.48022768124625526
EMINENCE,MO,462,580,118,0.5566218809980806
EMLENTON,PA,992,935,-57,0.4852101712506487
EMMALENA,KY,11,49,38,0.8166666666666667
EMMAUS,PA,6212,6614,402,0.5156712926867301
EMMET,AR,155,54,-101,0.2583732057416268
EMMETSBURG,IA,2180,1872,-308,0.46199407699901285
EMMETT,ID,7690,7735,45,0.5014586709886548
EMMETT,MI,431,441,10,0.5057339449541285
EMMITSBURG,MD,1532,1363,-169,0.4708117443868739
EMMONS,MN,13,75,62,0.8522727272727273
EMORY,TX,2451,2990,539,0.5495313361514428
EMPIRE,AL,854,798,-56,0.4830508474576271
EMPIRE,CA,1141,731,-410,0.390491452991453
EMPIRE,CO,112,75,-37,0.40106951871657753
EMPIRE,MI,1014,1085,71,0.5169128156264888
EMPORIA,KS,17696,12736,-4960,0.4185068349106204
EMPORIA,VA,4033,3793,-240,0.4846664962944033
EMPORIUM,PA,1752,1487,-265,0.45909231244211174
EMSWORTH,PA,328,264,-64,0.44594594594594594
ENCAMPMENT,WY,277,244,-33,0.46833013435700577
ENCINITAS,CA,22385,23132,747,0.5082057253333919
ENCINO,CA,21635,20542,-1093,0.48704270099817437
ENDEAVOR,WI,112,147,35,0.5675675675675675
ENDERLIN,ND,350,318,-32,0.47604790419161674
ENDICOTT,NY,17921,17194,-727,0.4896482984479567
ENDICOTT,WA,22,13,-9,0.37142857142857144
ENDWELL,NY,907,706,-201,0.43769373837569747
ENERGY,IL,419,399,-20,0.4877750611246944
ENFIELD,CT,15216,14360,-856,0.48552880714092506
ENFIELD,IL,137,92,-45,0.4017467248908297
ENFIELD,ME,64,73,9,0.5328467153284672
ENFIELD,NC,1310,1386,76,0.5140949554896143
ENFIELD,NH,2334,2254,-80,0.49128160418482997
ENGADINE,MI,255,222,-33,0.46540880503144655
ENGELHARD,NC,282,201,-81,0.4161490683229814
ENGLAND,AR,1924,1672,-252,0.4649610678531702
ENGLEVALE,ND,24,0,-24,0
ENGLEWD CLFS,NJ,728,824,96,0.5309278350515464
ENGLEWOOD,CO,52022,49320,-2702,0.4866689033174794
ENGLEWOOD,FL,40963,47862,6899,0.5388347875035182
ENGLEWOOD,NJ,10560,10022,-538,0.4869303274706054
ENGLEWOOD,OH,7460,7562,102,0.5033950206364
ENGLEWOOD,TN,2043,2113,70,0.5084215591915303
ENGLEWOOD CLIFFS,NJ,1341,1694,353,0.558154859967051
ENGLISH,IN,1354,1265,-89,0.48300878197785413
ENGLISHTOWN,NJ,2437,2305,-132,0.486081822016027
ENID,MS,25,36,11,0.5901639344262295
ENID,OK,25601,21598,-4003,0.45759444056018134
ENIGMA,GA,639,760,121,0.5432451751250893
ENKA,NC,594,252,-342,0.2978723404255319
ENNICE,NC,104,209,105,0.6677316293929713
ENNIS,MT,1958,1854,-104,0.4863588667366212
ENNIS,TX,9293,9877,584,0.5152321335419927
ENOLA,AR,25,76,51,0.7524752475247525
ENOLA,PA,5893,6465,572,0.5231429033824243
ENON,OH,1922,1737,-185,0.47471986881661654
ENON VALLEY,PA,254,200,-54,0.44052863436123346
ENOREE,SC,1120,1348,228,0.546191247974068
ENOSBURG FALLS,VT,1789,1906,117,0.5158322056833559
ENSLEY,AL,103,71,-32,0.40804597701149425
ENTERPRISE,AL,18112,17531,-581,0.49184973206520216
ENTERPRISE,FL,472,551,79,0.5386119257086999
ENTERPRISE,KS,271,173,-98,0.38963963963963966
ENTERPRISE,MS,478,424,-54,0.4700665188470067
ENTERPRISE,OR,1783,1772,-11,0.49845288326300985
ENTERPRISE,UT,180,433,253,0.7063621533442088
ENTIAT,WA,542,877,335,0.6180408738548273
ENUMCLAW,WA,8878,9342,464,0.5127332601536773
ENVILLE,TN,73,110,37,0.6010928961748634
EOLIA,KY,0,12,12,1
EOLIA,MO,221,348,127,0.6115992970123023
EPHRAIM,UT,2334,1754,-580,0.42906066536203524
EPHRAIM,WI,682,460,-222,0.4028021015761821
EPHRATA,PA,11950,10823,-1127,0.47525578535985596
EPHRATA,WA,5009,4591,-418,0.47822916666666665
EPPING,ND,37,26,-11,0.4126984126984127
EPPING,NH,2748,2821,73,0.5065541389836595
EPPS,LA,85,51,-34,0.375
EPSOM,NH,1768,1870,102,0.514018691588785
EPWORTH,GA,369,400,31,0.5201560468140443
EPWORTH,IA,584,381,-203,0.39481865284974094
EQUALITY,AL,26,90,64,0.7758620689655172
EQUALITY,IL,74,75,1,0.5033557046979866
EQUINUNK,PA,371,301,-70,0.4479166666666667
ERATH,LA,2931,2025,-906,0.4085956416464891
ERDENHEIM,PA,228,225,-3,0.4966887417218543
ERHARD,MN,146,172,26,0.5408805031446541
ERICK,OK,327,233,-94,0.4160714285714286
ERIE,CO,11177,15472,4295,0.580584637322226
ERIE,IL,972,813,-159,0.45546218487394957
ERIE,KS,602,536,-66,0.4710017574692443
ERIE,MI,1646,1606,-40,0.49384993849938497
ERIE,PA,76770,67010,-9760,0.4660592571984977
ERIEVILLE,NY,255,245,-10,0.49
ERIN,NY,386,342,-44,0.4697802197802198
ERIN,TN,2422,1965,-457,0.44791429222703444
ERLANGER,KY,8673,8285,-388,0.48855997169477533
ERLANGER,OH,23,28,5,0.5490196078431373
ERNEST,PA,14,0,-14,0
ERNUL,NC,24,22,-2,0.4782608695652174
EROS,LA,720,769,49,0.5164539959704499
ERROL,NH,75,87,12,0.5370370370370371
ERSKINE,MN,456,363,-93,0.4432234432234432
ERVING,MA,212,168,-44,0.4421052631578947
ERWIN,NC,1962,2198,236,0.5283653846153846
ERWIN,TN,4165,4329,164,0.5096538733223451
ERWINNA,PA,82,96,14,0.5393258426966292
ERWINVILLE,LA,0,25,25,1
ESCALANTE,UT,107,94,-13,0.46766169154228854
ESCALON,CA,3443,3365,-78,0.4942714453584019
ESCANABA,MI,7730,6956,-774,0.47364837259975484
ESCATAWPA,MS,0,12,12,1
ESCONDIDO,CA,65884,62569,-3315,0.48709644772796273
ESKO,MN,1273,1264,-9,0.49822625147812377
ESKRIDGE,KS,120,125,5,0.5102040816326531
ESMOND,ND,0,11,11,1
ESMONT,VA,64,114,50,0.6404494382022472
ESOPUS,NY,0,12,12,1
ESPANOLA,NM,2200,2273,73,0.5081600715403533
ESPARTO,CA,1267,1057,-210,0.45481927710843373
ESPERANCE,NY,361,503,142,0.5821759259259259
ESPYVILLE,PA,140,144,4,0.5070422535211268
ESSEX,CT,1912,2243,331,0.5398315282791817
ESSEX,IA,318,352,34,0.5253731343283582
ESSEX,IL,46,126,80,0.7325581395348837
ESSEX,MA,1293,1315,22,0.504217791411043
ESSEX,MD,18031,16937,-1094,0.4843571265156715
ESSEX,MO,439,296,-143,0.40272108843537413
ESSEX,MT,29,57,28,0.6627906976744186
ESSEX,NY,574,381,-193,0.39895287958115183
ESSEX,VT,174,26,-148,0.13
ESSEX FELLS,NJ,448,474,26,0.5140997830802603
ESSEX JCT,VT,632,703,71,0.5265917602996255
ESSEX JUNCTION,VT,9012,8670,-342,0.49032914828639296
ESSEXVILLE,MI,4736,4340,-396,0.47818422212428385
ESSINGTON,PA,1414,1198,-216,0.45865237366003064
ESTACADA,CA,18,39,21,0.6842105263157895
ESTACADA,OR,4677,4999,322,0.5166391070690368
ESTANCIA,NM,375,514,139,0.578177727784027
ESTELL MANOR,NJ,66,90,24,0.5769230769230769
ESTELLINE,SD,384,251,-133,0.3952755905511811
ESTER,AK,175,23,-152,0.11616161616161616
ESTERO,FL,39856,45957,6101,0.5355482269586194
ESTES PARK,CO,8149,6908,-1241,0.45878993159327885
ESTHERVILLE,IA,3525,2809,-716,0.443479633722766
ESTHERWOOD,LA,67,11,-56,0.14102564102564102
ESTILL,KY,13,0,-13,0
ESTILL,SC,532,574,42,0.5189873417721519
ESTILL SPGS,TN,202,194,-8,0.4898989898989899
ESTILL SPRINGS,TN,2256,2533,277,0.5289204426811442
ETHAN,SD,13,11,-2,0.4583333333333333
ETHEL,LA,544,597,53,0.523225241016652
ETHEL,MO,23,11,-12,0.3235294117647059
ETHEL,MS,95,105,10,0.525
ETHEL,WA,0,41,41,1
ETHELSVILLE,AL,114,156,42,0.5777777777777777
ETHRIDGE,TN,2423,1697,-726,0.41189320388349515
ETIWANDA,CA,509,443,-66,0.4653361344537815
ETNA,CA,544,464,-80,0.4603174603174603
ETNA,ME,82,140,58,0.6306306306306306
ETNA,NH,106,236,130,0.6900584795321637
ETNA,NY,11,12,1,0.5217391304347826
ETNA,OH,4076,4704,628,0.5357630979498861
ETNA,PA,672,544,-128,0.4473684210526316
ETNA,WY,195,333,138,0.6306818181818182
ETNA GREEN,IN,534,362,-172,0.40401785714285715
ETOILE,TX,173,201,28,0.5374331550802139
ETON,GA,0,24,24,1
ETOWAH,NC,1242,1341,99,0.519163763066202
ETOWAH,TN,3368,3362,-6,0.49955423476968797
ETTA,MS,48,128,80,0.7272727272727273
ETTERS,PA,3446,3109,-337,0.47429443173150265
ETTRICK,WI,516,378,-138,0.4228187919463087
EUBANK,KY,1778,1707,-71,0.4898134863701578
EUCHA,OK,587,609,22,0.5091973244147158
EUCLID,OH,19847,18777,-1070,0.48614850869925436
EUDORA,AR,987,820,-167,0.45379081350304373
EUDORA,KS,2940,2741,-199,0.48248547790881885
EUFAULA,AL,5120,4624,-496,0.4745484400656814
EUFAULA,OK,4225,4442,217,0.5125187492788739
EUGENE,MO,68,65,-3,0.48872180451127817
EUGENE,OR,122768,108710,-14058,0.46963426329932
EUHARLEE,GA,664,668,4,0.5015015015015015
EULESS,TX,44006,40234,-3772,0.47761158594491926
EUNICE,LA,5563,5151,-412,0.48077282060854953
EUNICE,NM,648,297,-351,0.3142857142857143
EUPORA,MS,1491,1659,168,0.5266666666666666
EURE,NC,149,121,-28,0.44814814814814813
EUREKA,CA,22625,19532,-3093,0.46331570083260193
EUREKA,IL,2478,2200,-278,0.47028644719965795
EUREKA,KS,1754,1526,-228,0.4652439024390244
EUREKA,MO,4463,5673,1210,0.5596882399368587
EUREKA,MT,2044,2596,552,0.5594827586206896
EUREKA,NC,61,56,-5,0.47863247863247865
EUREKA,NV,315,233,-82,0.4251824817518248
EUREKA,SD,259,195,-64,0.42951541850220265
EUREKA,UT,34,0,-34,0
EUREKA SPGS,AR,76,71,-5,0.48299319727891155
EUREKA SPRINGS,AR,4183,4101,-82,0.4950507001448576
EUSTACE,TX,1982,1960,-22,0.4972095383054287
EUSTIS,FL,15827,16598,771,0.5118889745566693
EUSTIS,ME,30,23,-7,0.4339622641509434
EUSTIS,NE,123,62,-61,0.33513513513513515
EUTAW,AL,970,803,-167,0.45290468133107725
EUTAWVILLE,SC,1186,1406,220,0.5424382716049383
EVA,AL,555,575,20,0.5088495575221239
EVA,TN,0,25,25,1
EVADALE,TX,75,34,-41,0.3119266055045872
EVANS,CO,13007,10631,-2376,0.44974194094255016
EVANS,GA,17125,19780,2655,0.5359707356726731
EVANS,WA,124,159,35,0.5618374558303887
EVANS,WV,327,284,-43,0.46481178396072015
EVANS CITY,PA,1680,2019,339,0.545823195458232
EVANS MILLS,NY,4703,3154,-1549,0.40142548046328114
EVANSDALE,IA,2769,2721,-48,0.49562841530054647
EVANSTON,IL,37528,32100,-5428,0.4610214281610846
EVANSTON,IN,24,11,-13,0.3142857142857143
EVANSTON,WY,7687,5738,-1949,0.42741154562383615
EVANSVILLE,IL,140,22,-118,0.13580246913580246
EVANSVILLE,IN,89182,82563,-6619,0.48073015226061894
EVANSVILLE,MN,371,307,-64,0.4528023598820059
EVANSVILLE,WI,3066,2892,-174,0.48539778449144005
EVANSVILLE,WY,1733,1784,51,0.5072504975831674
EVANT,TX,247,361,114,0.59375
EVART,MI,3017,2951,-66,0.494470509383378
EVARTS,KY,660,679,19,0.5070948469006722
EVELETH,MN,2440,2255,-185,0.4802981895633653
EVENING SHADE,AR,485,562,77,0.5367717287488061
EVENSVILLE,TN,794,920,126,0.5367561260210035
EVEREST,KS,11,0,-11,0
EVERETT,MA,19840,15552,-4288,0.4394213381555154
EVERETT,PA,2858,2606,-252,0.4769399707174231
EVERETT,WA,86987,79395,-7592,0.4771850320347153
EVERGLADES CITY,FL,533,651,118,0.549831081081081
EVERGREEN,AL,1888,1909,21,0.5027653410587306
EVERGREEN,CO,11398,11279,-119,0.4973761961458747
EVERGREEN,LA,11,0,-11,0
EVERGREEN,NC,113,120,7,0.5150214592274678
EVERGREEN PARK,IL,4119,4218,99,0.5059373875494783
EVERGREEN PK,IL,59,71,12,0.5461538461538461
EVERLY,IA,146,74,-72,0.33636363636363636
EVERMAN,TX,686,726,40,0.5141643059490085
EVERSON,PA,147,61,-86,0.2932692307692308
EVERSON,WA,2810,2730,-80,0.4927797833935018
EVERTON,AR,450,337,-113,0.42820838627700125
EVERTON,MO,403,463,60,0.5346420323325635
EVINGTON,VA,1999,2041,42,0.5051980198019802
EWA BEACH,HI,29403,27401,-2002,0.4823780015491867
EWEN,MI,11,26,15,0.7027027027027027
EWING,IL,30,33,3,0.5238095238095238
EWING,KY,981,953,-28,0.49276111685625645
EWING,MO,213,204,-9,0.4892086330935252
EWING,NE,49,59,10,0.5462962962962963
EWING,NJ,9654,9595,-59,0.49846745285469374
EWING,VA,542,539,-3,0.49861239592969475
EXCELSIOR,MN,7733,8091,358,0.5113119312436805
EXCELSIOR SPG,MO,252,275,23,0.5218216318785579
EXCELSIOR SPRINGS,MO,5895,5975,80,0.5033698399326032
EXELAND,WI,163,127,-36,0.4379310344827586
EXETER,CA,4435,4275,-160,0.4908151549942595
EXETER,IL,14,12,-2,0.46153846153846156
EXETER,ME,71,49,-22,0.4083333333333333
EXETER,MO,737,727,-10,0.49658469945355194
EXETER,NE,0,41,41,1
EXETER,NH,6379,6844,465,0.5175829993193678
EXETER,PA,1555,1540,-15,0.4975767366720517
EXETER,RI,1677,1899,222,0.5310402684563759
EXIRA,IA,239,228,-11,0.48822269807280516
EXMORE,VA,910,959,49,0.5131086142322098
EXPERIMENT,GA,75,222,147,0.7474747474747475
EXPORT,PA,2555,2635,80,0.5077071290944123
EXTON,PA,9473,10551,1078,0.5269176987614862
EYNON,PA,527,533,6,0.5028301886792453
EYOTA,MN,943,891,-52,0.48582333696837515
EZEL,KY,11,80,69,0.8791208791208791
F V,NC,71,98,27,0.5798816568047337
FABENS,TX,731,824,93,0.5299035369774919
FABER,VA,172,187,15,0.520891364902507
FABIUS,NY,311,289,-22,0.4816666666666667
FACTORYVILLE,PA,1311,1275,-36,0.49303944315545245
FAIR BLUFF,NC,130,159,29,0.5501730103806228
FAIR GROVE,MO,1950,1998,48,0.506079027355623
FAIR HAVEN,MI,173,180,7,0.509915014164306
FAIR HAVEN,NJ,1168,1415,247,0.5478126209833527
FAIR HAVEN,NY,206,232,26,0.5296803652968036
FAIR HAVEN,VT,1603,1500,-103,0.4834031582339671
FAIR LAWN,NJ,8386,8982,596,0.5171579917088899
FAIR OAKS,CA,16893,17595,702,0.5101774530271399
FAIR OAKS,IN,35,39,4,0.527027027027027
FAIR OAKS,TX,122,227,105,0.6504297994269341
FAIR OAKS RANCH,TX,1168,1678,510,0.5895994378074491
FAIR PLAY,MO,562,604,42,0.5180102915951973
FAIR PLAY,SC,1313,1429,116,0.5211524434719184
FAIRACRES,NM,216,317,101,0.5947467166979362
FAIRBANK,IA,308,341,33,0.5254237288135594
FAIRBANKS,AK,29728,23125,-6603,0.43753429322838816
FAIRBANKS,IN,11,0,-11,0
FAIRBANKS,MT,0,15,15,1
FAIRBORN,OH,22623,18351,-4272,0.4478693805828086
FAIRBURN,GA,17082,19189,2107,0.5290452427559207
FAIRBURY,IL,1834,1615,-219,0.4682516671498985
FAIRBURY,NE,2671,2244,-427,0.4565615462868769
FAIRCHANCE,PA,975,884,-91,0.4755244755244755
FAIRCHILD,WI,345,365,20,0.5140845070422535
FAIRCHILD AFB,WA,697,607,-90,0.46549079754601225
FAIRCHILD AIR FORCE BASE,WA,1979,1475,-504,0.42704111175448756
FAIRDALE,KY,4396,3726,-670,0.4587540014774686
FAIRDALE,ND,11,0,-11,0
FAIRDALE,WV,24,0,-24,0
FAIRDEALING,MO,385,455,70,0.5416666666666666
FAIRFAX,CA,3173,3229,56,0.5043736332396126
FAIRFAX,IA,1042,1227,185,0.5407668576465403
FAIRFAX,MN,936,653,-283,0.41095028319697924
FAIRFAX,MO,158,154,-4,0.4935897435897436
FAIRFAX,OK,208,303,95,0.5929549902152642
FAIRFAX,SC,456,525,69,0.5351681957186545
FAIRFAX,VA,80588,74853,-5735,0.4815524861523022
FAIRFAX,VT,1661,1907,246,0.5344730941704036
FAIRFAX STA,VA,234,316,82,0.5745454545454546
FAIRFAX STATION,VA,3710,4659,949,0.5566973354044689
FAIRFIELD,AL,3425,2969,-456,0.4643415702220832
FAIRFIELD,CA,40064,37704,-2360,0.4848266639234647
FAIRFIELD,CT,15377,17351,1974,0.5301576631630408
FAIRFIELD,FL,0,16,16,1
FAIRFIELD,IA,8340,6941,-1399,0.4542241999869118
FAIRFIELD,ID,96,176,80,0.6470588235294118
FAIRFIELD,IL,3961,3400,-561,0.4618937644341801
FAIRFIELD,ME,2869,2552,-317,0.4707618520568161
FAIRFIELD,MT,361,431,70,0.5441919191919192
FAIRFIELD,NE,11,13,2,0.5416666666666666
FAIRFIELD,NJ,2469,2722,253,0.5243691003660181
FAIRFIELD,OH,19949,18438,-1511,0.4803188579467007
FAIRFIELD,PA,2042,2075,33,0.5040077726499879
FAIRFIELD,TX,2232,2514,282,0.5297092288242731
FAIRFIELD,UT,25,0,-25,0
FAIRFIELD,VA,495,410,-85,0.4530386740331492
FAIRFIELD,VT,136,132,-4,0.4925373134328358
FAIRFIELD,WA,107,135,28,0.5578512396694215
FAIRFIELD BAY,AR,1288,1254,-34,0.49331235247836347
FAIRFIELD TOWNSHIP,OH,5131,5231,100,0.5048253232966609
FAIRGROVE,MI,522,498,-24,0.48823529411764705
FAIRHAVEN,MA,5311,5282,-29,0.4986311715283678
FAIRHOPE,AL,14624,16295,1671,0.5270222193473268
FAIRLAND,IN,1551,1483,-68,0.488793671720501
FAIRLAND,OK,1208,983,-225,0.44865358283888634
FAIRLAWN,OH,4818,5305,487,0.5240541341499555
FAIRLEE,VT,823,770,-53,0.48336472065285624
FAIRLESS HILLS,PA,3197,3070,-127,0.48986756023615763
FAIRMONT,MN,6062,5277,-785,0.4653849545815328
FAIRMONT,NC,1975,2161,186,0.5224854932301741
FAIRMONT,NE,76,72,-4,0.4864864864864865
FAIRMONT,WV,14806,12615,-2191,0.4600488676561759
FAIRMONT CITY,IL,64,47,-17,0.42342342342342343
FAIRMOUNT,GA,1201,1305,104,0.5207501995211492
FAIRMOUNT,IL,388,122,-266,0.23921568627450981
FAIRMOUNT,IN,1653,1622,-31,0.4952671755725191
FAIRMOUNT,ND,160,120,-40,0.42857142857142855
FAIRMOUNT CITY,PA,116,124,8,0.5166666666666667
FAIRMOUNT HEIGHTS,MD,283,269,-14,0.48731884057971014
FAIRPLAY,CO,2332,1502,-830,0.3917579551382368
FAIRPLAY,MD,37,62,25,0.6262626262626263
FAIRPORT,NY,14723,14871,148,0.5025005068594985
FAIRPORT HARBOR,OH,3970,3903,-67,0.4957449510986917
FAIRVIEW,IL,11,0,-11,0
FAIRVIEW,KS,11,13,2,0.5416666666666666
FAIRVIEW,MI,475,437,-38,0.4791666666666667
FAIRVIEW,MO,230,167,-63,0.42065491183879095
FAIRVIEW,MT,771,585,-186,0.4314159292035398
FAIRVIEW,NC,3384,3605,221,0.5158105594505652
FAIRVIEW,NJ,4102,3181,-921,0.43677056158176575
FAIRVIEW,OK,1851,1430,-421,0.4358427308747333
FAIRVIEW,OR,7389,5957,-1432,0.44635096658174733
FAIRVIEW,PA,2708,3035,327,0.5284694410586801
FAIRVIEW,TN,3969,4542,573,0.5336623193514276
FAIRVIEW,UT,752,1116,364,0.5974304068522484
FAIRVIEW,WV,538,550,12,0.5055147058823529
FAIRVIEW HEIGHTS,IL,6584,6358,-226,0.49126873744398086
FAIRVIEW PARK,OH,2969,2923,-46,0.49609640190088256
FAIRWAY,KS,1534,1494,-40,0.49339498018494055
FAISON,NC,654,580,-74,0.4700162074554295
FAITH,NC,26,56,30,0.6829268292682927
FAITH,SD,36,24,-12,0.4
FALCON,MO,25,87,62,0.7767857142857143
FALCON HEIGHTS,MN,461,480,19,0.51009564293305
FALCONER,NY,1671,1671,0,0.5
FALFURRIAS,TX,1882,1841,-41,0.49449368788611336
FALKNER,MS,141,222,81,0.6115702479338843
FALKVILLE,AL,2065,2141,76,0.5090347123157394
FALL BRANCH,TN,1126,1338,212,0.5430194805194806
FALL CITY,WA,1764,1760,-4,0.49943246311010214
FALL CREEK,OR,209,100,-109,0.32362459546925565
FALL CREEK,WI,1321,1262,-59,0.4885791715060008
FALL RIVER,KS,64,26,-38,0.28888888888888886
FALL RIVER,MA,41111,38081,-3030,0.48086927972522475
FALL RIVER,WI,817,884,67,0.5196942974720753
FALL RIVER MILLS,CA,272,395,123,0.5922038980509745
FALLBROOK,CA,17099,18774,1675,0.5233462492682519
FALLENTIMBER,PA,14,59,45,0.8082191780821918
FALLING WATERS,WV,4346,5175,829,0.5435353429261632
FALLON,NV,11714,11338,-376,0.49184452542078777
FALLS,PA,208,137,-71,0.39710144927536234
FALLS CHURCH,VA,54955,48314,-6641,0.4678461106430778
FALLS CITY,NE,2219,2097,-122,0.48586654309545874
FALLS CITY,OR,437,469,32,0.5176600441501104
FALLS CITY,TX,47,150,103,0.7614213197969543
FALLS CREEK,PA,662,501,-161,0.4307824591573517
FALLS MILLS,VA,45,11,-34,0.19642857142857142
FALLS OF ROUGH,KY,667,825,158,0.5529490616621984
FALLS VILLAGE,CT,283,600,317,0.6795016987542469
FALLSBURG,NY,81,43,-38,0.3467741935483871
FALLSINGTON,PA,280,263,-17,0.4843462246777164
FALLSTON,MD,2478,3039,561,0.5508428493746601
FALLSTON,NC,11,0,-11,0
FALMOUTH,IN,11,0,-11,0
FALMOUTH,KY,2697,2659,-38,0.4964525765496639
FALMOUTH,MA,5095,5692,597,0.5276721980161305
FALMOUTH,ME,5113,5754,641,0.5294929603386399
FALMOUTH,MI,225,212,-13,0.4851258581235698
FALMOUTH,VA,461,543,82,0.5408366533864541
FANCY FARM,KY,320,271,-49,0.45854483925549916
FANCY GAP,VA,796,950,154,0.54410080183276055
FANNETTSBURG,PA,54,29,-25,0.3493975903614458
FANNIN,TX,11,0,-11,0
FANNING SPGS,FL,342,419,77,0.5505913272010512
FANNING SPRINGS,FL,266,248,-18,0.48249027237354086
FANWOOD,NJ,1675,1712,37,0.5054620608207854
FAR HILLS,NJ,1063,1413,350,0.5706785137318255
FAR ROCKAWAY,NY,13401,11098,-2303,0.4529980815543492
FARBER,MO,88,25,-63,0.22123893805309736
FARGO,ND,104217,76581,-27636,0.42357216340888726
FARGO,OK,41,38,-3,0.4810126582278481
FARIBAULT,MN,12185,10957,-1228,0.4734681531414744
FARINA,IL,283,168,-115,0.37250554323725055
FARLEY,IA,435,433,-2,0.4988479262672811
FARMDALE,OH,95,90,-5,0.4864864864864865
FARMER CITY,IL,938,873,-65,0.4820541137493098
FARMERS BRANCH,TX,9580,11309,1729,0.5413854181626694
FARMERS BRNCH,TX,1320,1495,175,0.5310834813499112
FARMERSBURG,IA,0,11,11,1
FARMERSBURG,IN,984,951,-33,0.49147286821705427
FARMERSVILLE,CA,2181,1940,-241,0.47075952438728463
FARMERSVILLE,IL,271,163,-108,0.37557603686635943
FARMERSVILLE,OH,425,433,8,0.5046620046620046
FARMERSVILLE,TX,3744,4355,611,0.5377207062600321
FARMERSVILLE STATION,NY,11,0,-11,0
FARMERVILLE,LA,2807,2882,75,0.5065916681314818
FARMINGDALE,ME,1094,1046,-48,0.48878504672897194
FARMINGDALE,NJ,2249,2450,201,0.521387529261545
FARMINGDALE,NY,9766,8237,-1529,0.45753485530189414
FARMINGTN HLS,MI,12,22,10,0.6470588235294118
FARMINGTON,AR,4631,5087,456,0.5234616176167936
FARMINGTON,CA,12,25,13,0.6756756756756757
FARMINGTON,CT,8022,8136,114,0.5035276643148905
FARMINGTON,IA,225,138,-87,0.38016528925619836
FARMINGTON,IL,1382,1246,-136,0.4741248097412481
FARMINGTON,KY,111,79,-32,0.41578947368421054
FARMINGTON,ME,3568,3280,-288,0.47897196261682246
FARMINGTON,MI,6518,5725,-793,0.46761414685942987
FARMINGTON,MN,10051,10173,122,0.5030162183544303
FARMINGTON,MO,12039,12079,40,0.500829256157227
FARMINGTON,NH,2804,2822,18,0.5015997156061145
FARMINGTON,NM,20327,17989,-2338,0.4694905522497129
FARMINGTON,NY,6312,6195,-117,0.4953226193331734
FARMINGTON,PA,619,537,-82,0.46453287197231835
FARMINGTON,UT,6957,7270,313,0.511000210866662
FARMINGTON,WV,343,154,-189,0.30985915492957744
FARMINGTON HILLS,MI,33564,30138,-3426,0.47310916454742397
FARMINGTON HLS,MI,2159,2003,-156,0.4812590100913023
FARMINGVILLE,NY,4925,4745,-180,0.4906928645294726
FARMLAND,IN,1108,873,-235,0.44068652195860675
FARMVILLE,NC,2528,2704,176,0.5168195718654435
FARMVILLE,VA,5463,5107,-356,0.4831598864711448
FARNAM,NE,12,11,-1,0.4782608695652174
FARNHAM,VA,196,295,99,0.6008146639511202
FARNHAMVILLE,IA,45,11,-34,0.19642857142857142
FARR WEST,UT,502,467,-35,0.48194014447884415
FARRAGUT,IA,57,104,47,0.6459627329192547
FARRAGUT,TN,5186,5967,781,0.5350130009862817
FARRELL,PA,2337,1818,-519,0.4375451263537906
FARSON,WY,31,0,-31,0
FARWELL,MI,3466,2805,-661,0.4472970818051347
FARWELL,MN,45,46,1,0.5054945054945055
FARWELL,TX,218,190,-28,0.46568627450980393
FATE,TX,2457,3493,1036,0.5870588235294117
FAUCETT,MO,81,128,47,0.6124401913875598
FAULKNER,MD,0,12,12,1
FAULKTON,SD,164,95,-69,0.3667953667953668
FAWN GROVE,PA,272,330,58,0.5481727574750831
FAWNSKIN,CA,200,67,-133,0.250936329588015
FAYETTE,AL,3084,3017,-67,0.49450909686936567
FAYETTE,IA,570,399,-171,0.4117647058823529
FAYETTE,ME,299,375,76,0.5563798219584569
FAYETTE,MO,1565,1458,-107,0.4823023486602713
FAYETTE,MS,249,315,66,0.5585106382978723
FAYETTE,OH,1168,842,-326,0.41890547263681593
FAYETTE CITY,PA,400,290,-110,0.42028985507246375
FAYETTEVILLE,AR,64210,53558,-10652,0.45477549079546226
FAYETTEVILLE,GA,22002,24371,2369,0.5255428805554957
FAYETTEVILLE,NC,146054,127202,-18852,0.46550487454987266
FAYETTEVILLE,NY,5417,5219,-198,0.4906919894697255
FAYETTEVILLE,OH,1015,1064,49,0.5117845117845118
FAYETTEVILLE,PA,3888,4120,232,0.5144855144855145
FAYETTEVILLE,TN,9329,9089,-240,0.4934846345965903
FAYETTEVILLE,TX,225,469,244,0.6757925072046109
FAYETTEVILLE,WV,2148,1802,-346,0.4562025316455696
FAYVILLE,MA,22,0,-22,0
FBX,AK,232,217,-15,0.48329621380846327
FEASTERVILLE TREVOSE,PA,7495,7439,-56,0.49812508370162045
FEDERAL DAM,MN,47,51,4,0.5204081632653061
FEDERAL HEIGHTS,CO,1114,992,-122,0.4710351377018044
FEDERAL HGTS,CO,269,262,-7,0.4934086629001883
FEDERAL WAY,WA,54407,47446,-6961,0.46582820339116177
FEDERALSBURG,MD,2351,1906,-445,0.44773314540756404
FEEDING HILLS,MA,3238,3270,32,0.5024585125998771
FELCH,MI,65,143,78,0.6875
FELDA,FL,14,68,54,0.8292682926829268
FELICITY,CA,18,90,72,0.8333333333333334
FELICITY,OH,1289,1234,-55,0.48910027744748313
FELLOWS,CA,0,24,24,1
FELLSMERE,FL,1684,1456,-228,0.4636942675159236
FELTON,CA,3380,2962,-418,0.467045096184169
FELTON,DE,3857,4637,780,0.5459147633623734
FELTON,PA,1494,1386,-108,0.48125
FELTS MILLS,NY,61,23,-38,0.27380952380952384
FENCE,WI,23,0,-23,0
FENCE LAKE,NM,0,12,12,1
FENELTON,PA,167,176,9,0.5131195335276968
FENNIMORE,WI,1403,1300,-103,0.4809470958194599
FENNVILLE,MI,3642,3449,-193,0.48639120011281906
FENTON,MI,17087,15743,-1344,0.4795309168443497
FENTON,MO,14768,14907,139,0.5023420387531592
FENWICK,MI,942,849,-93,0.474036850921273
FENWICK ISLAND,DE,334,379,45,0.5315568022440392
FENWICK ISLE,DE,18,0,-18,0
FERDINAND,ID,18,0,-18,0
FERDINAND,IN,976,1064,88,0.5215686274509804
FERGUS FALLS,MN,8576,8204,-372,0.4889153754469607
FERGUSON,KY,337,341,4,0.5029498525073747
FERGUSON,MO,183,151,-32,0.45209580838323354
FERGUSON,NC,77,139,62,0.6435185185185185
FERN PARK,FL,3691,3271,-420,0.4698362539500144
FERNANDINA,FL,3057,3612,555,0.5416104363472785
FERNANDINA BCH,FL,3504,4990,1486,0.5874735107134448
FERNANDINA BEACH,FL,15414,17202,1788,0.5274098601913172
FERNDALE,CA,734,907,173,0.5527117611212675
FERNDALE,MD,569,392,-177,0.40790842872008326
FERNDALE,MI,11103,9774,-1329,0.46817071418307227
FERNDALE,NY,464,200,-264,0.30120481927710846
FERNDALE,WA,11207,10949,-258,0.4941776493951977
FERNLEY,NV,13075,11908,-1167,0.47664411800024015
FERNWOOD,ID,0,74,74,1
FERRELVIEW,MO,246,323,77,0.5676625659050967
FERRIDAY,LA,2386,1941,-445,0.4485786919343656
FERRIS,TX,1902,2066,164,0.5206653225806451
FERRISBURGH,VT,241,255,14,0.5141129032258065
FERRON,UT,244,208,-36,0.46017699115044247
FERRUM,VA,1117,1197,80,0.517286084701815
FERRYVILLE,WI,107,138,31,0.563265306122449
FERTILE,IA,22,0,-22,0
FERTILE,MN,597,576,-21,0.49104859335038364
FESSENDEN,ND,95,11,-84,0.10377358490566038
FESTUS,MO,9286,10083,797,0.520574113273788
FEURA BUSH,NY,161,150,-11,0.48231511254019294
FIBRE,MI,21,22,1,0.5116279069767442
FIDDLETOWN,CA,113,111,-2,0.4955357142857143
FIELDALE,VA,849,723,-126,0.4599236641221374
FIELDING,UT,37,157,120,0.8092783505154639
FIELDON,IL,41,12,-29,0.22641509433962265
FIFE,WA,7263,5459,-1804,0.42909919823927056
FIFE LAKE,MI,1784,1715,-69,0.49014004001143185
FIFIELD,WI,40,40,0,0.5
FIFTY LAKES,MN,266,304,38,0.5333333333333333
FILER,ID,2165,2443,278,0.5301649305555556
FILLMORE,CA,3623,4045,422,0.5275169535732916
FILLMORE,IN,620,667,47,0.5182595182595182
FILLMORE,NY,1029,799,-230,0.43708971553610504
FILLMORE,UT,1148,1078,-70,0.48427672955974843
FINCASTLE,VA,1226,1340,114,0.5222135619641465
FINCHVILLE,KY,11,99,88,0.9
FINDLAY,IL,170,130,-40,0.43333333333333335
FINDLAY,OH,25957,22876,-3081,0.46845370958163535
FINDLEY LAKE,NY,59,52,-7,0.46846846846846846
FINE,NY,0,11,11,1
FINEVIEW,NY,0,102,102,1
FINGER,TN,347,483,136,0.5819277108433735
FINKSBURG,MD,2243,2641,398,0.5407452907452908
FINLAND,MN,28,13,-15,0.3170731707317073
FINLAYSON,MN,649,745,96,0.5344332855093257
FINLEY,ND,121,13,-108,0.09701492537313433
FINLEY,TN,27,34,7,0.5573770491803278
FINLEYVILLE,PA,1849,1909,60,0.5079829696647152
FIRCREST,WA,3300,3127,-173,0.4865411545044344
FIRE IS PINES,NY,107,70,-37,0.3954802259887006
FIREBAUGH,CA,1663,1577,-86,0.4867283950617284
FIRESTONE,CO,4085,3319,-766,0.4482712047541869
FIRTH,ID,609,583,-26,0.4890939597315436
FIRTH,NE,214,340,126,0.6137184115523465
FISCHER,TX,462,1069,607,0.6982364467668191
FISH CREEK,WI,1514,1151,-363,0.4318949343339587
FISH HAVEN,ID,231,224,-7,0.49230769230769234
FISHER,AR,0,36,36,1
FISHER,IL,1085,1006,-79,0.4811095169775227
FISHER,MN,70,39,-31,0.3577981651376147
FISHER,PA,13,26,13,0.6666666666666666
FISHER,WV,36,55,19,0.6043956043956044
FISHERS,IN,36485,38899,2414,0.5160113551947363
FISHERS ISLAND,NY,423,388,-35,0.4784217016029593
FISHERS ISLE,NY,51,0,-51,0
FISHERS LANDING,NY,214,173,-41,0.4470284237726098
FISHERSVILLE,VA,2548,2946,398,0.5362213323625774
FISHERTOWN,PA,13,37,24,0.74
FISHERVILLE,KY,1424,2018,594,0.5862870424171993
FISHKILL,NY,5640,5848,208,0.5090529247910863
FISHS EDDY,NY,11,0,-11,0
FISHTAIL,MT,34,60,26,0.6382978723404256
FISK,MO,292,301,9,0.5075885328836425
FISKDALE,MA,1290,1313,23,0.5044179792547061
FITCHBURG,MA,21006,19636,-1370,0.483145514492397
FITCHBURG,WI,12591,11405,-1186,0.4752875479246541
FITHIAN,IL,42,42,0,0.5
FITZGERALD,GA,6669,6538,-131,0.49504050882107975
FITZPATRICK,AL,12,0,-12,0
FITZWILLIAM,NH,1050,1046,-4,0.49904580152671757
FIVE POINTS,AL,77,241,164,0.7578616352201258
FIVE POINTS,CA,31,0,-31,0
FIVE POINTS,TN,11,11,0,0.5
FLA CITY,FL,17,22,5,0.5641025641025641
FLAG POND,TN,28,50,22,0.6410256410256411
FLAGLER,CO,129,173,44,0.5728476821192053
FLAGLER BEACH,FL,5839,7174,1335,0.5512948589871667
FLAGSTAFF,AZ,52201,42927,-9274,0.4512551509545034
FLAGTOWN,NJ,20,0,-20,0
FLANAGAN,IL,336,359,23,0.516546762589928
FLANDERS,NJ,4034,4051,17,0.5010513296227582
FLANDREAU,SD,1267,1086,-181,0.46153846153846156
FLASHER,ND,28,22,-6,0.44
FLAT LICK,KY,312,492,180,0.6119402985074627
FLAT ROCK,AL,850,891,41,0.5117748420448018
FLAT ROCK,IL,113,88,-25,0.43781094527363185
FLAT ROCK,IN,170,250,80,0.5952380952380952
FLAT ROCK,MI,7176,7003,-173,0.49389942873263276
FLAT ROCK,NC,3803,4467,664,0.5401451027811366
FLAT TOP,WV,26,17,-9,0.3953488372093023
FLATGAP,KY,215,269,54,0.5557851239669421
FLATONIA,TX,514,712,198,0.5807504078303426
FLATWOODS,KY,3125,2953,-172,0.4858506087528792
FLATWOODS,WV,12,0,-12,0
FLEETWOOD,NC,806,1006,200,0.5551876379690949
FLEETWOOD,NY,502,469,-33,0.48300720906282185
FLEETWOOD,PA,3693,3826,133,0.5088442612049474
FLEISCHMANNS,NY,397,321,-76,0.44707520891364905
FLEMING,CO,33,23,-10,0.4107142857142857
FLEMING,GA,27,23,-4,0.46
FLEMING,OH,175,197,22,0.5295698924731183
FLEMING ISLAND,FL,11488,12503,1015,0.5211537659955817
FLEMINGSBURG,KY,2879,2833,-46,0.4959733893557423
FLEMINGTON,MO,486,454,-32,0.4829787234042553
FLEMINGTON,NJ,8220,9352,1132,0.5322103346232643
FLEMINGTON,WV,166,130,-36,0.4391891891891892
FLETCHER,NC,6285,7156,871,0.5324008630310245
FLETCHER,OH,57,68,11,0.544
FLETCHER,OK,1045,1163,118,0.5267210144927537
FLINT,MI,72486,61266,-11220,0.4580567019558586
FLINT,TX,5040,5625,585,0.5274261603375527
FLINT HILL,VA,252,162,-90,0.391304347826087
FLINTON,PA,321,316,-5,0.49607535321821034
FLINTSTONE,GA,1487,1519,32,0.5053226879574185
FLINTSTONE,MD,131,169,38,0.5633333333333334
FLINTVILLE,TN,844,1009,165,0.5445223961144091
FLIPPIN,AR,2179,2208,29,0.5033052199680875
FLOMATON,AL,1411,1111,-300,0.44052339413164154
FLOODWOOD,MN,199,237,38,0.5435779816513762
FLORA,IL,2429,2370,-59,0.4938528860179204
FLORA,IN,1632,1288,-344,0.4410958904109589
FLORA,MS,1092,1344,252,0.5517241379310345
FLORA VISTA,NM,835,731,-104,0.466794380587484
FLORAHOME,FL,598,647,49,0.5196787148594377
FLORAL,AR,106,153,47,0.5907335907335908
FLORAL CITY,FL,4863,5521,658,0.5316833590138675
FLORAL PARK,NY,8166,7376,-790,0.47458499549607513
FLORALA,AL,1347,1379,32,0.5058694057226706
FLORENCE,AL,24120,22961,-1159,0.4876914254157728
FLORENCE,AZ,17728,20962,3234,0.5417937451537865
FLORENCE,CO,3070,3005,-65,0.49465020576131685
FLORENCE,IN,152,269,117,0.6389548693586699
FLORENCE,KS,26,22,-4,0.4583333333333333
FLORENCE,KY,24631,23742,-889,0.49081098960163727
FLORENCE,MA,3828,3863,35,0.5022753868157587
FLORENCE,MO,0,14,14,1
FLORENCE,MS,5368,5509,141,0.5064815666084398
FLORENCE,MT,2537,2605,68,0.5066122131466355
FLORENCE,NJ,1795,1902,107,0.5144711928590749
FLORENCE,OR,8541,9279,738,0.5207070707070707
FLORENCE,SC,31366,31299,-67,0.4994654113141307
FLORENCE,SD,23,13,-10,0.3611111111111111
FLORENCE,TX,1563,1912,349,0.5502158273381295
FLORENCE,WI,1742,1697,-45,0.49345740040709507
FLORENCE VILL,FL,15,14,-1,0.4827586206896552
FLORESVILLE,TX,6029,7205,1176,0.5444310110321898
FLORHAM PARK,NJ,4783,5596,813,0.5391656228923788
FLORIDA,NY,1127,1119,-8,0.4982190560997329
FLORIDA CITY,FL,2807,3583,776,0.5607198748043819
FLORIEN,LA,821,798,-23,0.4928968499073502
FLORISSANT,CO,3562,3239,-323,0.47625349213350976
FLORISSANT,MO,31856,31228,-628,0.49502250966964684
FLOSSMOOR,IL,2979,3335,356,0.5281913208742477
FLOURTOWN,PA,1262,1637,375,0.5646774749913763
FLOVILLA,GA,271,505,234,0.6507731958762887
FLOWER MOUND,TX,22880,27149,4269,0.5426652541525915
FLOWERMOUND,TX,146,157,11,0.5181518151815182
FLOWERY BR,GA,937,1183,246,0.5580188679245283
FLOWERY BRANCH,GA,12470,15238,2768,0.5499494730763679
FLOWOOD,MS,4798,4596,-202,0.4892484564615712
FLOYD,IA,49,34,-15,0.40963855421686746
FLOYD,VA,2403,2638,235,0.5233088672882364
FLOYDADA,TX,964,953,-11,0.49713093375065204
FLOYDS KNOBS,IN,2799,3146,347,0.529184188393608
FLUSHING,MI,9174,9171,-3,0.4999182338511856
FLUSHING,NY,67714,55356,-12358,0.4497928008450475
FLUSHING,OH,433,382,-51,0.4687116564417178
FLY CREEK,NY,163,118,-45,0.4199288256227758
FOGELSVILLE,PA,975,1307,332,0.5727432077125328
FOLCROFT,PA,2499,2194,-305,0.46750479437460046
FOLEY,AL,17331,20852,3521,0.5461069062148076
FOLEY,MN,2227,2063,-164,0.4808857808857809
FOLEY,MO,1268,1214,-54,0.48912167606768736
FOLKSTON,GA,3018,2918,-100,0.4915768194070081
FOLLANSBEE,WV,2190,1910,-280,0.4658536585365854
FOLLETT,TX,32,0,-32,0
FOLLY BEACH,SC,1176,1224,48,0.51
FOLSOM,CA,31114,35137,4023,0.5303618058595342
FOLSOM,LA,1717,2008,291,0.5390604026845638
FOLSOM,PA,1978,1838,-140,0.48165618448637315
FOMBELL,PA,174,178,4,0.5056818181818182
FOND DU LAC,WI,27890,23286,-4604,0.45501797717680165
FONDA,IA,206,71,-135,0.2563176895306859
FONDA,NY,1014,952,-62,0.4842319430315361
FONTANA,CA,54064,54580,516,0.5023747284709694
FONTANA,KS,38,0,-38,0
FONTANA,WI,1837,1902,65,0.5086921636801284
FONTANELLE,IA,149,116,-33,0.4377358490566038
FOOSLAND,IL,0,13,13,1
FOOTHILL RANCH,CA,4321,5148,827,0.5436688140247122
FOOTVILLE,WI,45,0,-45,0
FORBES,ND,14,0,-14,0
FORBESTOWN,CA,26,0,-26,0
FORD,VA,76,114,38,0.6
FORD,WA,244,292,48,0.5447761194029851
FORD CITY,PA,2479,2391,-88,0.49096509240246405
FORD HEIGHTS,IL,2709,2488,-221,0.4787377333076775
FORDLAND,MO,1335,1397,62,0.5113469985358712
FORDOCHE,LA,24,11,-13,0.3142857142857143
FORDS,NJ,4661,3659,-1002,0.43978365384615387
FORDSVILLE,KY,609,472,-137,0.4366327474560592
FORDYCE,AR,1642,1516,-126,0.48005066497783405
FORDYCE,NE,17,0,-17,0
FOREMAN,AR,813,700,-113,0.46265697290152014
FOREST,IN,13,13,0,0.5
FOREST,MS,3365,3121,-244,0.48119025593586184
FOREST,OH,986,894,-92,0.475531914893617
FOREST,VA,8997,9635,638,0.5171210820094461
FOREST CITY,IA,2745,2124,-621,0.43622920517560076
FOREST CITY,IL,50,23,-27,0.3150684931506849
FOREST CITY,MO,12,0,-12,0
FOREST CITY,NC,6258,6297,39,0.5015531660692951
FOREST CITY,PA,1039,972,-67,0.4833416210840378
FOREST CITY TWP,ME,28,11,-17,0.28205128205128205
FOREST FALLS,CA,416,239,-177,0.3648854961832061
FOREST GROVE,OR,10620,10197,-423,0.4898400345871163
FOREST HEIGHTS,MD,273,270,-3,0.4972375690607735
FOREST HILL,LA,380,328,-52,0.4632768361581921
FOREST HILL,MD,4425,4643,218,0.5120202911336568
FOREST HILL,TX,3291,3054,-237,0.4813238770685579
FOREST HILL,WV,0,23,23,1
FOREST HILLS,KY,11,0,-11,0
FOREST HILLS,NY,23571,19389,-4182,0.4513268156424581
FOREST JUNCTION,WI,14,0,-14,0
FOREST KNOLLS,CA,46,28,-18,0.3783783783783784
FOREST LAKE,MN,10649,10455,-194,0.49540371493555724
FOREST LAKES,AZ,217,242,25,0.5272331154684096
FOREST PARK,GA,13077,10363,-2714,0.4421075085324232
FOREST PARK,IL,8053,7032,-1021,0.46615843553198544
FOREST PARK,OK,91,168,77,0.6486486486486487
FOREST RANCH,CA,429,487,58,0.5316593886462883
FORESTBURG,TX,11,61,50,0.8472222222222222
FORESTBURGH,NY,58,175,117,0.7510729613733905
FORESTDALE,AL,137,145,8,0.5141843971631206
FORESTDALE,MA,1609,1545,-64,0.489854153455929
FORESTDALE,RI,0,11,11,1
FORESTHILL,CA,2261,2256,-5,0.49944653531104716
FORESTON,MN,383,441,58,0.5351941747572816
FORESTPORT,NY,463,457,-6,0.4967391304347826
FORESTVILLE,CA,2225,2121,-104,0.4880349746893695
FORESTVILLE,MD,2475,2174,-301,0.4676274467627447
FORESTVILLE,NY,1055,856,-199,0.4479330193615908
FORESTVILLE,WI,138,92,-46,0.4
FORISTELL,MO,1659,2156,497,0.5651376146788991
FORK,SC,0,13,13,1
FORK UNION,VA,73,34,-39,0.3177570093457944
FORKED RIVER,NJ,7061,7649,588,0.5199864038069341
FORKLAND,AL,58,26,-32,0.30952380952380953
FORKS,WA,2548,1764,-784,0.4090909090909091
FORKS TOWNSHIP,PA,249,289,40,0.5371747211895911
FORKS TWP,PA,98,102,4,0.51
FORKSTON TOWNSHIP,PA,45,39,-6,0.4642857142857143
FORKSTON TWP,PA,15,11,-4,0.4230769230769231
FORKSVILLE,PA,68,28,-40,0.2916666666666667
FORMAN,ND,96,33,-63,0.2558139534883721
FORNEY,TX,21179,34257,13078,0.617955840969767
FORREST,IL,417,336,-81,0.44621513944223107
FORREST CITY,AR,4885,5032,147,0.5074115155793083
FORRESTON,IL,572,477,-95,0.4547187797902765
FORRESTON,TX,0,13,13,1
FORSYTH,GA,4176,5340,1164,0.5611601513240857
FORSYTH,IL,1201,1276,75,0.5151392813887767
FORSYTH,MO,2530,2896,366,0.5337265020272761
FORSYTH,MT,1006,803,-203,0.4438916528468767
FORT A P HILL,VA,54,56,2,0.509090909090909
FORT ANN,NY,1419,1289,-130,0.4759970457902511
FORT APACHE,AZ,12,93,81,0.8857142857142857
FORT ASHBY,WV,512,675,163,0.5686604886267902
FORT ATKINSON,IA,46,71,25,0.6068376068376068
FORT ATKINSON,WI,7904,6908,-996,0.4663786119362679
FORT BELVOIR,VA,6532,6072,-460,0.48175182481751827
FORT BENNING,GA,8347,6991,-1356,0.4557960620680662
FORT BENTON,MT,836,615,-221,0.4238456237077877
FORT BLACKMORE,VA,37,0,-37,0
FORT BLISS,TX,842,748,-94,0.47044025157232705
FORT BRAGG,CA,5376,5290,-86,0.49596849803112697
FORT BRAGG,NC,13578,7456,-6122,0.3544737092326709
FORT BRANCH,IN,1718,1648,-70,0.48960190136660725
FORT BRIDGER,WY,48,63,15,0.5675675675675675
FORT CALHOUN,NE,686,768,82,0.5281980742778541
FORT CAMPBELL,KY,13604,8555,-5049,0.3860733787625795
FORT CARSON,CO,628,582,-46,0.4809917355371901
FORT COBB,OK,361,438,77,0.5481852315394243
FORT COLLINS,CO,130248,111620,-18628,0.46149139199894157
FORT COVINGTON,NY,401,309,-92,0.4352112676056338
FORT DAVIS,TX,493,413,-80,0.45584988962472406
FORT DEFIANCE,AZ,291,332,41,0.5329052969502408
FORT DEFIANCE,VA,36,37,1,0.5068493150684932
FORT DENAUD,FL,485,1050,565,0.6840390879478827
FORT DEPOSIT,AL,1353,391,-962,0.22419724770642202
FORT DETRICK,MD,394,380,-14,0.4909560723514212
FORT DICK,CA,13,0,-13,0
FORT DIX,NJ,312,285,-27,0.47738693467336685
FORT DODGE,IA,15602,13222,-2380,0.4587149597557591
FORT DRUM,NY,8279,4399,-3880,0.34697901877267706
FORT DUCHESNE,UT,272,176,-96,0.39285714285714285
FORT EDWARD,NY,3855,3592,-263,0.4823418826373036
FORT EUSTIS,VA,2651,2053,-598,0.436437074829932
FORT FAIRFIELD,ME,1360,1247,-113,0.4783275795934024
FORT GAINES,GA,514,562,48,0.5223048327137546
FORT GARLAND,CO,487,476,-11,0.49428868120456904
FORT GAY,WV,730,735,5,0.5017064846416383
FORT GEORGE G MEADE,MD,5888,5003,-885,0.459370122119181
FORT GIBSON,OK,2852,3084,232,0.5195417789757413
FORT GORDON,GA,2861,2261,-600,0.4414291292463881
FORT GRATIOT,MI,6433,5910,-523,0.47881390261686785
FORT GREELY,AK,303,82,-221,0.21298701298701297
FORT HALL,ID,469,22,-447,0.04480651731160896
FORT HANCOCK,TX,12,12,0,0.5
FORT HARRISON,MT,0,11,11,1
FORT HOOD,TX,16729,11250,-5479,0.40208727974552344
FORT HOWARD,MD,12,0,-12,0
FORT HUACHUCA,AZ,3167,2489,-678,0.4400636492220651
FORT HUNT,VA,52,52,0,0.5
FORT HUNTER,NY,12,0,-12,0
FORT IRWIN,CA,5598,4144,-1454,0.4253746663929378
FORT JENNINGS,OH,447,397,-50,0.4703791469194313
FORT JOHNSON,NY,234,204,-30,0.4657534246575342
FORT JONES,CA,833,740,-93,0.47043865225683407
FORT KENT,ME,1821,1681,-140,0.480011422044546
FORT KNOX,KY,7573,5274,-2299,0.4105238577099712
FORT LARAMIE,WY,23,29,6,0.5576923076923077
FORT LAUDERDALE,FL,153255,159845,6590,0.5105237943149153
FORT LAWN,SC,776,949,173,0.5501449275362319
FORT LEAVENWORTH,KS,4803,4101,-702,0.46057951482479786
FORT LEE,NJ,18607,17676,-931,0.4871703001405617
FORT LEE,VA,4069,3736,-333,0.4786675208199872
FORT LEONARD WOOD,MO,5973,4312,-1661,0.4192513368983957
FORT LESLEY J MCNAIR,DC,295,299,4,0.5033670033670034
FORT LORAMIE,OH,604,398,-206,0.3972055888223553
FORT LOUDON,PA,468,409,-59,0.4663625997719498
FORT LUPTON,CO,4222,4908,686,0.5375684556407448
FORT MADISON,IA,7612,5395,-2217,0.4147766587222265
FORT MC COY,FL,3455,4048,593,0.5395175263228043
FORT MCCOY,FL,60,136,76,0.6938775510204082
FORT MCCOY,WI,444,243,-201,0.3537117903930131
FORT MCDOWELL,AZ,28,23,-5,0.45098039215686275
FORT MEADE,FL,3875,3560,-315,0.47881640887693344
FORT MEADE,MD,633,534,-99,0.45758354755784064
FORT MILL,SC,35619,45731,10112,0.5621511985248925
FORT MITCHELL,AL,3453,3669,216,0.5151642796967144
FORT MITCHELL,KY,326,366,40,0.5289017341040463
FORT MOHAVE,AZ,8635,10018,1383,0.5370717846995121
FORT MONROE,VA,52,155,103,0.748792270531401
FORT MONTGOMERY,NY,411,345,-66,0.45634920634920634
FORT MORGAN,CO,5658,5111,-547,0.4746030272077259
FORT MYER,VA,118,13,-105,0.09923664122137404
FORT MYERS,FL,225906,253798,27892,0.5290720944582492
FORT MYERS BEACH,FL,23021,23336,315,0.503397545138814
FORT OGDEN,FL,204,74,-130,0.26618705035971224
FORT OGLETHORPE,GA,3485,2967,-518,0.4598574085554867
FORT PAYNE,AL,7973,6446,-1527,0.4470490325265275
FORT PECK,MT,48,0,-48,0
FORT PIERCE,FL,51686,56444,4758,0.5220012947378156
FORT PIERRE,SD,1348,1234,-114,0.47792408985282725
FORT PLAIN,NY,2406,2249,-157,0.4831364124597207
FORT POLK,LA,6567,5178,-1389,0.4408684546615581
FORT RECOVERY,OH,722,463,-259,0.39071729957805906
FORT RICHARDSON,AK,290,270,-20,0.48214285714285715
FORT RILEY,KS,9720,7148,-2572,0.4237609675124496
FORT RIPLEY,MN,327,357,30,0.5219298245614035
FORT ROCK,OR,15,0,-15,0
FORT RUCKER,AL,4900,3386,-1514,0.4086410813420227
FORT SAM HOUSTON,TX,849,842,-7,0.4979302188054406
FORT SCOTT,KS,5811,5186,-625,0.47158315904337544
FORT SHAW,MT,24,16,-8,0.4
FORT SHAWNEE,OH,149,146,-3,0.49491525423728816
FORT SILL,OK,4791,3884,-907,0.4477233429394813
FORT SMITH,AR,57442,43572,-13870,0.4313461500386085
FORT SMITH,MT,24,11,-13,0.3142857142857143
FORT STEWART,GA,6553,4945,-1608,0.430074795616629
FORT STOCKTON,TX,4121,3250,-871,0.4409171075837742
FORT SUMNER,NM,184,225,41,0.5501222493887531
FORT THOMAS,AZ,57,31,-26,0.3522727272727273
FORT THOMAS,KY,5975,4908,-1067,0.45097859046218874
FORT THOMPSON,SD,232,95,-137,0.290519877675841
FORT TOTTEN,ND,130,62,-68,0.3229166666666667
FORT TOWSON,OK,459,356,-103,0.4368098159509202
FORT VALLEY,GA,5289,4817,-472,0.4766475361171581
FORT VALLEY,VA,163,280,117,0.6320541760722348
FORT WAINWRIGHT,AK,3592,2829,-763,0.44058557857031616
FORT WALTON BEACH,FL,33395,31879,-1516,0.4883874130587983
FORT WASHAKIE,WY,429,336,-93,0.4392156862745098
FORT WASHINGTON,MD,14716,15059,343,0.50575986565911
FORT WASHINGTON,PA,1895,2387,492,0.5574497898178421
FORT WAYNE,IN,161431,141261,-20170,0.4666823041243244
FORT WHITE,FL,3342,3875,533,0.5369267008452265
FORT WORTH,TX,351289,346281,-5008,0.49641039608928134
FORT YATES,ND,715,705,-10,0.4964788732394366
FORTESCUE,NJ,14,0,-14,0
FORTINE,MT,38,27,-11,0.4153846153846154
FORTSON,GA,2682,3106,424,0.5366275051831375
FORTUNA,CA,5295,4945,-350,0.48291015625
FORTUNA,MO,0,12,12,1
FORTVILLE,IN,4365,5997,1632,0.5787492762015055
FOSS,OK,351,399,48,0.532
FOSSIL,OR,38,24,-14,0.3870967741935484
FOSSTON,MN,1134,966,-168,0.46
FOSTER,KY,108,215,107,0.6656346749226006
FOSTER,NE,13,0,-13,0
FOSTER,OK,17,23,6,0.575
FOSTER,OR,162,313,151,0.6589473684210526
FOSTER,RI,1275,1518,243,0.5435016111707841
FOSTER,WV,12,25,13,0.6756756756756757
FOSTER CITY,CA,20350,18540,-1810,0.47672923630753405
FOSTERS,AL,273,382,109,0.583206106870229
FOSTORIA,IA,12,0,-12,0
FOSTORIA,MI,532,509,-23,0.48895292987512007
FOSTORIA,OH,8114,7392,-722,0.47671868953953306
FOUKE,AR,1362,1490,128,0.5224403927068724
FOUNTAIN,CO,17954,16426,-1528,0.4777777777777778
FOUNTAIN,FL,1642,1997,355,0.5487771365759824
FOUNTAIN,MI,791,814,23,0.5071651090342679
FOUNTAIN,MN,23,28,5,0.5490196078431373
FOUNTAIN,NC,123,190,67,0.6070287539936102
FOUNTAIN CITY,IN,576,504,-72,0.4666666666666667
FOUNTAIN CITY,WI,847,812,-35,0.48945147679324896
FOUNTAIN GREEN,UT,66,86,20,0.5657894736842105
FOUNTAIN HILL,AR,12,25,13,0.6756756756756757
FOUNTAIN HILL,PA,1106,1012,-94,0.47780925401322
FOUNTAIN HILLS,AZ,18358,21780,3422,0.54262793362898
FOUNTAIN INN,SC,8102,8252,150,0.5045860339977987
FOUNTAIN RUN,KY,296,256,-40,0.463768115942029
FOUNTAIN VALLEY,CA,16311,15751,-560,0.49126692034183767
FOUNTAIN VLY,CA,1102,1041,-61,0.4857676154923005
FOUNTAINTOWN,IN,734,641,-93,0.4661818181818182
FOUNTAINVILLE,PA,91,166,75,0.6459143968871596
FOUR OAKS,NC,3337,3950,613,0.5420612048854124
FOUR SEASONS,MO,130,98,-32,0.4298245614035088
FOWLER,CA,1976,2294,318,0.5372365339578454
FOWLER,CO,971,821,-150,0.45814732142857145
FOWLER,IL,52,48,-4,0.48
FOWLER,IN,1288,1322,34,0.5065134099616858
FOWLER,KS,96,48,-48,0.3333333333333333
FOWLER,MI,241,147,-94,0.3788659793814433
FOWLER,OH,128,193,65,0.6012461059190031
FOWLERVILLE,MI,4078,4249,171,0.5102678035306834
FOX,AR,12,11,-1,0.4782608695652174
FOX,MT,0,40,40,1
FOX ISLAND,WA,1653,1654,1,0.5001511944360447
FOX LAKE,IL,5302,5230,-72,0.49658184580326625
FOX LAKE,WI,1321,1292,-29,0.49445082280903174
FOX POINT,WI,806,1017,211,0.557871640153593
FOX RIVER GROVE,IL,1653,1525,-128,0.47986154814348647
FOX RIVER GRV,IL,274,116,-158,0.29743589743589743
FOXBORO,MA,6223,6367,144,0.5057188244638602
FOXBORO,WI,23,106,83,0.8217054263565892
FOXBOROUGH,MA,146,184,38,0.5575757575757576
FOXCROFT SQUARE,PA,2722,2780,58,0.5052708106143221
FOXFIELD,CO,448,502,54,0.5284210526315789
FOXFIRE VILLAGE,NC,117,158,41,0.5745454545454546
FOXWORTH,MS,1421,1464,43,0.5074523396880416
FRACKVILLE,PA,1938,2006,68,0.5086206896551724
FRAKES,KY,0,13,13,1
FRAMETOWN,WV,113,115,2,0.5043859649122807
FRAMINGHAM,MA,31231,27262,-3969,0.46607286341955445
FRANCESTOWN,NH,334,484,150,0.5916870415647921
FRANCESVILLE,IN,801,476,-325,0.3727486296006265
FRANCIS,OK,11,11,0,0.5
FRANCISCO,IN,139,122,-17,0.4674329501915709
FRANCONIA,NH,887,723,-164,0.44906832298136645
FRANKENMUTH,MI,2566,2501,-65,0.49358594829287544
FRANKFORD,DE,2456,3500,1044,0.587642713230356
FRANKFORD,MO,162,188,26,0.5371428571428571
FRANKFORD,WV,170,178,8,0.5114942528735632
FRANKFORT,IL,8325,8916,591,0.5171393770662954
FRANKFORT,IN,9477,8626,-851,0.47649560846268574
FRANKFORT,KS,146,83,-63,0.3624454148471616
FRANKFORT,KY,23324,24008,684,0.5072255556494549
FRANKFORT,ME,313,277,-36,0.4694915254237288
FRANKFORT,MI,3221,3044,-177,0.4858739026336792
FRANKFORT,NY,2360,2319,-41,0.4956187219491344
FRANKFORT,OH,1514,1489,-25,0.4958374958374958
FRANKLIN,AR,24,0,-24,0
FRANKLIN,GA,2659,2926,267,0.5239033124440465
FRANKLIN,ID,150,436,286,0.7440273037542662
FRANKLIN,IL,273,216,-57,0.44171779141104295
FRANKLIN,IN,15489,14514,-975,0.48375162483751627
FRANKLIN,KS,40,39,-1,0.4936708860759494
FRANKLIN,KY,8642,8562,-80,0.49767495931178796
FRANKLIN,LA,3015,2886,-129,0.48906964921199797
FRANKLIN,MA,9871,10597,726,0.517735000977135
FRANKLIN,ME,894,914,20,0.5055309734513275
FRANKLIN,MI,1226,1189,-37,0.49233954451345757
FRANKLIN,MN,81,75,-6,0.4807692307692308
FRANKLIN,MO,0,11,11,1
FRANKLIN,NC,13240,14355,1115,0.5202029353143686
FRANKLIN,NE,358,383,25,0.5168690958164642
FRANKLIN,NH,5064,4178,-886,0.45206665223977494
FRANKLIN,NJ,2112,1814,-298,0.46204788588894546
FRANKLIN,NY,565,481,-84,0.4598470363288719
FRANKLIN,OH,9321,9883,562,0.5146323682566132
FRANKLIN,PA,5996,5866,-130,0.49452031697858706
FRANKLIN,TN,47861,52790,4929,0.5244855987521236
FRANKLIN,TX,1632,1952,320,0.5446428571428571
FRANKLIN,VA,5309,5065,-244,0.4882398303450935
FRANKLIN,VT,487,496,9,0.5045778229908443
FRANKLIN,WI,11616,12035,419,0.5088579764069172
FRANKLIN,WV,661,482,-179,0.4216972878390201
FRANKLIN FURNACE,OH,916,909,-7,0.4980821917808219
FRANKLIN GROVE,IL,274,219,-55,0.44421906693711966
FRANKLIN GRV,IL,16,0,-16,0
FRANKLIN LAKES,NJ,3022,3906,884,0.5637990762124712
FRANKLIN LKS,NJ,32,40,8,0.5555555555555556
FRANKLIN PARK,IL,5151,4667,-484,0.475351395396211
FRANKLIN PARK,NJ,3954,3302,-652,0.45507166482910694
FRANKLIN SPRINGS,GA,39,0,-39,0
FRANKLIN SQ,NY,301,289,-12,0.48983050847457626
FRANKLIN SQUARE,NY,4625,4791,166,0.5088147833474936
FRANKLINTON,LA,4945,4861,-84,0.4957169080155007
FRANKLINTON,NC,4426,6586,2160,0.5980748274609516
FRANKLINTOWN,PA,14,12,-2,0.46153846153846156
FRANKLINVILLE,NC,1197,1146,-51,0.48911651728553135
FRANKLINVILLE,NJ,2353,2456,103,0.5107090871283011
FRANKLINVILLE,NY,1592,1434,-158,0.47389292795769994
FRANKSTON,TX,1886,2258,372,0.5448841698841699
FRANKSVILLE,WI,1564,1844,280,0.5410798122065728
FRANKTON,IN,849,784,-65,0.48009797917942437
FRANKTOWN,CO,1883,2011,128,0.5164355418592707
FRASER,CO,2408,1520,-888,0.3869653767820774
FRASER,MI,5450,4641,-809,0.45991477554256266
FRAZEE,MN,2455,2178,-277,0.4701057630045327
FRAZEYSBURG,OH,1454,1446,-8,0.4986206896551724
FRAZIER PARK,CA,1762,1630,-132,0.4805424528301887
FRAZIERS BOTTOM,WV,280,326,46,0.5379537953795379
FRED,TX,28,89,61,0.7606837606837606
FREDERIC,MI,818,874,56,0.516548463356974
FREDERIC,WI,1707,1650,-57,0.4915102770330652
FREDERICA,DE,1906,2012,106,0.5135273098519653
FREDERICK,CO,3300,4176,876,0.5585874799357945
FREDERICK,MD,57925,62735,4810,0.5199320404442235
FREDERICK,OK,1393,1317,-76,0.4859778597785978
FREDERICK,SD,48,67,19,0.5826086956521739
FREDERICKSBRG,IN,13,17,4,0.5666666666666667
FREDERICKSBRG,OH,33,12,-21,0.26666666666666666
FREDERICKSBRG,PA,58,95,37,0.6209150326797386
FREDERICKSBRG,VA,5823,6255,432,0.5178837555886736
FREDERICKSBURG,IA,570,374,-196,0.3961864406779661
FREDERICKSBURG,IN,140,80,-60,0.36363636363636365
FREDERICKSBURG,OH,647,503,-144,0.4373913043478261
FREDERICKSBURG,PA,836,857,21,0.5062020082693444
FREDERICKSBURG,TX,9335,10219,884,0.5226040707783574
FREDERICKSBURG,VA,66971,70301,3330,0.5121292033335276
FREDERICKTOWN,MO,5135,5110,-25,0.4987798926305515
FREDERICKTOWN,OH,2493,2606,113,0.5110806040400079
FREDERICKTOWN,PA,345,256,-89,0.4259567387687188
FREDONIA,AZ,292,334,42,0.5335463258785943
FREDONIA,KS,1716,1479,-237,0.4629107981220657
FREDONIA,KY,186,217,31,0.5384615384615384
FREDONIA,NY,5134,4761,-373,0.4811520970186963
FREDONIA,PA,420,394,-26,0.48402948402948404
FREDONIA,WI,1200,1139,-61,0.48696023941855493
FREE SOIL,MI,543,562,19,0.5085972850678733
FREE UNION,VA,137,120,-17,0.4669260700389105
FREEBORN,MN,14,0,-14,0
FREEBURG,IL,1519,1607,88,0.5140754958413307
FREEBURG,MO,118,66,-52,0.358695652173913
FREEBURG,PA,51,54,3,0.5142857142857142
FREEBURN,KY,140,0,-140,0
FREEDOM,CA,1505,1428,-77,0.48687350835322196
FREEDOM,IN,180,248,68,0.5794392523364486
FREEDOM,ME,316,370,54,0.5393586005830904
FREEDOM,NH,1173,1266,93,0.5190651906519065
FREEDOM,NY,504,374,-130,0.42596810933940776
FREEDOM,PA,2322,2175,-147,0.4836557705136758
FREEDOM,WI,1076,975,-101,0.47537786445636276
FREEDOM,WY,109,101,-8,0.48095238095238096
FREEHOLD,NJ,13889,14446,557,0.5098288335980237
FREEHOLD,NY,474,423,-51,0.47157190635451507
FREELAND,MD,444,574,130,0.5638506876227898
FREELAND,MI,3994,4083,89,0.5055094713383682
FREELAND,PA,2777,2757,-20,0.4981929887965305
FREELAND,WA,2956,3289,333,0.5266613290632506
FREELANDVILLE,IN,42,23,-19,0.35384615384615387
FREEMAN,MO,226,289,63,0.5611650485436893
FREEMAN,SD,565,629,64,0.5268006700167505
FREEMAN,VA,179,37,-142,0.1712962962962963
FREEMANSBURG,PA,583,523,-60,0.472875226039783
FREEPORT,FL,6645,8800,2155,0.5697636775655552
FREEPORT,IL,14869,12093,-2776,0.44852013945553
FREEPORT,ME,3444,3788,344,0.5237831858407079
FREEPORT,MI,320,367,47,0.5342066957787481
FREEPORT,MN,198,192,-6,0.49230769230769234
FREEPORT,NY,13571,12202,-1369,0.473441198153106
FREEPORT,OH,376,384,8,0.5052631578947369
FREEPORT,PA,1496,1228,-268,0.45080763582966227
FREEPORT,TX,7318,6305,-1013,0.4628202304925494
FREER,TX,201,116,-85,0.3659305993690852
FREESOIL,MI,0,11,11,1
FREESTONE,CA,218,260,42,0.5439330543933054
FREETOWN,IN,483,522,39,0.5194029850746269
FREEVILLE,NY,2401,2212,-189,0.4795144157814871
FREMONT,CA,92273,88265,-4008,0.4888998438001972
FREMONT,IA,330,171,-159,0.3413173652694611
FREMONT,IN,3627,3467,-160,0.48872286439244433
FREMONT,MI,4605,4097,-508,0.4708113077453459
FREMONT,NC,843,1018,175,0.5470177324019344
FREMONT,NE,14730,13036,-1694,0.469495065907945
FREMONT,NH,1273,1351,78,0.5148628048780488
FREMONT,OH,10146,9630,-516,0.4869538834951456
FREMONT,UT,12,12,0,0.5
FREMONT,WI,1424,1385,-39,0.49305802776788893
FRENCH CAMP,CA,1185,1470,285,0.5536723163841808
FRENCH CREEK,WV,678,624,-54,0.4792626728110599
FRENCH GULCH,CA,12,0,-12,0
FRENCH LICK,IN,1929,1755,-174,0.4763843648208469
FRENCH SETTLEMENT,LA,520,377,-143,0.42028985507246375
FRENCH VILLAGE,MO,395,442,47,0.5280764635603346
FRENCHBURG,KY,1102,1127,25,0.5056078959174518
FRENCHTOWN,MT,1084,1119,35,0.5079437131184749
FRENCHTOWN,NJ,1254,1481,227,0.5414990859232176
FRENCHTOWN TWP,ME,50,12,-38,0.1935483870967742
FRENCHTWN TWP,ME,27,26,-1,0.49056603773584906
FRENCHVILLE,ME,112,77,-35,0.4074074074074074
FRENCHVILLE,PA,83,50,-33,0.37593984962406013
FRESH MEADOWS,NY,13471,11914,-1557,0.4693322828441993
FRESNO,CA,203393,185236,-18157,0.47663967434236765
FRESNO,OH,661,636,-25,0.49036237471087124
FRESNO,TX,7011,7088,77,0.5027306901198667
FREWSBURG,NY,1284,1227,-57,0.4886499402628435
FRIANT,CA,795,894,99,0.5293072824156305
FRIARS POINT,MS,12,0,-12,0
FRIDAY HARBOR,WA,5127,5112,-15,0.4992675065924407
FRIDLEY,MN,6155,4904,-1251,0.44343973234469664
FRIEDENS,PA,925,882,-43,0.48810182623132264
FRIEDENSBURG,PA,11,0,-11,0
FRIEND,NE,336,279,-57,0.45365853658536587
FRIENDLY,WV,68,66,-2,0.4925373134328358
FRIENDSHIP,MD,22,23,1,0.5111111111111111
FRIENDSHIP,ME,607,594,-13,0.4945878434637802
FRIENDSHIP,NY,1530,1407,-123,0.4790602655771195
FRIENDSHIP,TN,730,841,111,0.5353278166772756
FRIENDSHIP,WI,2387,2377,-10,0.4989504617968094
FRIENDSVILLE,MD,509,440,-69,0.4636459430979979
FRIENDSVILLE,PA,239,197,-42,0.4518348623853211
FRIENDSVILLE,TN,2001,2185,184,0.521978021978022
FRIENDSWOOD,TX,15168,15786,618,0.5099825547586742
FRIERSON,LA,412,525,113,0.5602988260405549
FRIES,VA,964,848,-116,0.46799116997792495
FRIONA,TX,1101,708,-393,0.3913764510779436
FRIPP ISLAND,SC,195,326,131,0.6257197696737045
FRISCO,CO,3166,3228,62,0.5048482952768221
FRISCO,NC,162,278,116,0.6318181818181818
FRISCO,TX,85326,106292,20966,0.5547078040685113
FRISCO CITY,AL,1127,939,-188,0.45450145208131654
FRITCH,TX,1967,1563,-404,0.44277620396600564
FRITZ CREEK,AK,141,97,-44,0.40756302521008403
FROHNA,MO,15,0,-15,0
FROID,MT,13,0,-13,0
FROMBERG,MT,67,39,-28,0.36792452830188677
FRONT ROYAL,VA,12622,13759,1137,0.5215496000909746
FRONTENAC,KS,1590,1351,-239,0.4593675620537232
FRONTENAC,MN,13,26,13,0.6666666666666666
FRONTENAC,MO,68,96,28,0.5853658536585366
FRONTENAC,NY,43,128,85,0.7485380116959064
FROST,MN,12,0,-12,0
FROST,TX,193,332,139,0.6323809523809524
FROSTBURG,MD,4396,4107,-289,0.48300599788310006
FROSTPROOF,FL,9098,10807,1709,0.5429289123335845
FRUIT COVE,FL,2207,3575,1368,0.6182981667243168
FRUIT HEIGHTS,UT,971,1174,203,0.5473193473193473
FRUITA,CO,7145,7503,358,0.5122200983069362
FRUITDALE,AL,0,23,23,1
FRUITHURST,AL,302,150,-152,0.33185840707964603
FRUITLAND,IA,23,23,0,0.5
FRUITLAND,ID,3366,3959,593,0.5404778156996587
FRUITLAND,MD,3082,2262,-820,0.42327844311377244
FRUITLAND,NM,156,248,92,0.6138613861386139
FRUITLAND,WA,44,52,8,0.5416666666666666
FRUITLAND PARK,FL,6786,7375,589,0.5207965539156839
FRUITPORT,MI,2674,2173,-501,0.4483185475551888
FRUITVALE,ID,14,23,9,0.6216216216216216
FRUITVALE,TX,534,489,-45,0.4780058651026393
FRYE ISLAND,ME,505,186,-319,0.2691751085383502
FRYEBURG,ME,1549,1740,191,0.5290361812100942
FT CAMPBELL,KS,356,369,13,0.5089655172413793
FT CAMPBELL,KY,191,130,-61,0.40498442367601245
FT CARSON,CO,0,13,13,1
FT FAIRFIELD,ME,36,35,-1,0.49295774647887325
FT LAUDERDALE,FL,10770,10757,-13,0.49969805360709807
FT LEAVNWRTH,KS,65,45,-20,0.4090909090909091
FT LEONARD WD,MO,146,120,-26,0.45112781954887216
FT LOUDON,PA,0,18,18,1
FT MITCHELL,KY,3779,3850,71,0.5046532966312754
FT MYER,VA,11,0,-11,0
FT MYERS,FL,28,42,14,0.6
FT MYERS BCH,FL,55,55,0,0.5
FT OGLETHORPE,GA,860,807,-53,0.48410317936412717
FT RICHARDSON,AK,58,55,-3,0.48672566371681414
FT RILEY,KS,484,388,-96,0.44495412844036697
FT SM HOUSTON,TX,227,192,-35,0.45823389021479716
FT SMITH,AR,340,260,-80,0.43333333333333335
FT TOWSON,OK,0,15,15,1
FT WAINWRIGHT,AK,788,582,-206,0.4248175182481752
FT WALTON,FL,451,466,15,0.5081788440567067
FT WALTON BCH,FL,1716,1512,-204,0.4684014869888476
FT WASHINGTON,MD,1418,1438,20,0.5035014005602241
FT WASHINGTON,PA,132,138,6,0.5111111111111111
FT WAYNE,IN,340,283,-57,0.45425361155698235
FT WORTH,TX,23269,22482,-787,0.4913990951017464
FT WRIGHT,KY,566,526,-40,0.4816849816849817
FULDA,MN,686,666,-20,0.492603550295858
FULKS RUN,VA,133,183,50,0.5791139240506329
FULLERTON,CA,49925,45114,-4811,0.474689338061217
FULLERTON,NE,580,438,-142,0.4302554027504912
FULSHEAR,TX,5483,10433,4950,0.6555038954511184
FULTON,AR,29,12,-17,0.2926829268292683
FULTON,CA,73,83,10,0.532051282051282
FULTON,IL,2097,1920,-177,0.47796863330843914
FULTON,IN,13,0,-13,0
FULTON,KS,0,11,11,1
FULTON,KY,2398,1956,-442,0.4492420762517226
FULTON,MD,1817,2536,719,0.5825867218010568
FULTON,MI,69,37,-32,0.3490566037735849
FULTON,MO,8403,8142,-261,0.49211242067089755
FULTON,MS,3497,3597,100,0.5070482097547223
FULTON,NY,12535,10887,-1648,0.4648194005635727
FULTON,TX,1393,2169,776,0.6089275687815834
FULTONDALE,AL,3670,3216,-454,0.46703456288120826
FULTONVILLE,NY,915,780,-135,0.46017699115044247
FUNKSTOWN,MD,515,188,-327,0.267425320056899
FUQUAY VARINA,NC,17946,25936,7990,0.591039606216672
FURLONG,PA,1477,1622,145,0.5233946434333656
FYFFE,AL,1396,1421,25,0.5044373446929358
GAASTRA,MI,14,0,-14,0
GABLE,SC,11,12,1,0.5217391304347826
GABRIELS,NY,12,18,6,0.6
GACKLE,ND,11,0,-11,0
GADSDEN,AL,18827,18784,-43,0.49942835872484115
GADSDEN,AZ,188,161,-27,0.46131805157593125
GADSDEN,SC,126,147,21,0.5384615384615384
GADSDEN,TN,214,364,150,0.629757785467128
GAFFNEY,SC,13863,11744,-2119,0.4586245948373492
GAGE,OK,51,44,-7,0.4631578947368421
GAGETOWN,MI,128,120,-8,0.4838709677419355
GAHANNA,OH,6034,5724,-310,0.4868174859670012
GAINES,MI,952,910,-42,0.48872180451127817
GAINES,PA,0,41,41,1
GAINESBORO,TN,2344,2498,154,0.5159025196199918
GAINESVILLE,AL,13,11,-2,0.4583333333333333
GAINESVILLE,FL,109844,96583,-13261,0.46787968628134885
GAINESVILLE,GA,42502,43764,1262,0.5073145851204415
GAINESVILLE,MO,1216,1264,48,0.5096774193548387
GAINESVILLE,NY,117,124,7,0.5145228215767634
GAINESVILLE,TX,13617,11660,-1957,0.4612889187799185
GAINESVILLE,VA,12284,12891,607,0.5120556107249256
GAITHERSBURG,MD,57360,53120,-4240,0.48081100651701664
GAKONA,AK,95,57,-38,0.375
GALATIA,IL,695,443,-252,0.38927943760984185
GALATIA,KS,11,0,-11,0
GALAX,VA,5461,5385,-76,0.49649640420431496
GALENA,AK,13,0,-13,0
GALENA,IL,3286,3349,63,0.5047475508666164
GALENA,KS,2304,1947,-357,0.4580098800282287
GALENA,MD,463,543,80,0.5397614314115308
GALENA,MO,1841,1881,40,0.5053734551316497
GALENA,OH,2720,4041,1321,0.5976926490164177
GALENA PARK,TX,1793,1423,-370,0.44247512437810943
GALES CREEK,OR,12,0,-12,0
GALES FERRY,CT,2341,2328,-13,0.498607838937674
GALESBURG,IL,17537,13274,-4263,0.43082016163058645
GALESBURG,MI,2734,2654,-80,0.49257609502598365
GALESBURG,ND,0,23,23,1
GALESVILLE,MD,0,24,24,1
GALESVILLE,WI,1526,1422,-104,0.48236092265943015
GALETON,PA,956,827,-129,0.4638250140213124
GALIEN,MI,838,443,-395,0.34582357533177205
GALION,OH,7671,6789,-882,0.4695020746887967
GALIPOLIS FRY,WV,0,11,11,1
GALISTEO,NM,26,56,30,0.6829268292682927
GALIVANTS FERRY,SC,1808,2171,363,0.5456144759989947
GALLANT,AL,52,18,-34,0.2571428571428571
GALLATIN,MO,1390,1459,69,0.512109512109512
GALLATIN,TN,26795,29231,2436,0.5217399064719952
GALLATIN GATEWAY,MT,1176,1425,249,0.5478662053056517
GALLATIN GTWY,MT,78,90,12,0.5357142857142857
GALLIANO,LA,1315,1208,-107,0.47879508521601266
GALLION,AL,260,264,4,0.5038167938931297
GALLIPOLIS,OH,5936,5604,-332,0.4856152512998267
GALLIPOLIS FERRY,WV,523,325,-198,0.38325471698113206
GALLITZIN,PA,706,624,-82,0.4691729323308271
GALLOWAY,NJ,8996,8855,-141,0.4960506414206487
GALLOWAY,OH,12990,11152,-1838,0.4619335597713528
GALLUP,NM,6318,4917,-1401,0.43765020026702267
GALT,CA,8828,9034,206,0.5057664315306236
GALVA,IA,91,28,-63,0.23529411764705882
GALVA,IL,1354,1049,-305,0.43653766125676235
GALVA,KS,267,211,-56,0.44142259414225943
GALVESTON,IN,1136,1157,21,0.5045791539467946
GALVESTON,TX,28683,25493,-3190,0.4705589190785588
GALVIN,WA,11,11,0,0.5
GALWAY,NY,1058,1168,110,0.5247079964061097
GAMALIEL,AR,166,243,77,0.5941320293398533
GAMALIEL,KY,148,101,-47,0.40562248995983935
GAMBIER,OH,4466,663,-3803,0.12926496393059075
GAMBRILLS,MD,4203,5341,1138,0.5596186085498742
GAMERCO,NM,97,0,-97,0
GANADO,AZ,50,240,190,0.8275862068965517
GANADO,TX,457,596,139,0.5660018993352327
GANDEEVILLE,WV,56,77,21,0.5789473684210527
GANNETT,ID,23,21,-2,0.4772727272727273
GANS,OK,137,172,35,0.5566343042071198
GANSEVOORT,NY,6240,6178,-62,0.49750362377194396
GAP,PA,1630,1382,-248,0.4588313413014608
GAP MILLS,WV,86,77,-9,0.4723926380368098
GARBER,OK,59,87,28,0.5958904109589042
GARBERVILLE,CA,1114,705,-409,0.3875755909840572
GARCIASVILLE,TX,52,11,-41,0.1746031746031746
GARDEN,ID,20,24,4,0.5454545454545454
GARDEN,MI,292,260,-32,0.47101449275362317
GARDEN CITY,GA,1636,1551,-85,0.48666457483526826
GARDEN CITY,ID,7959,8688,729,0.5218958370877635
GARDEN CITY,KS,15969,12084,-3885,0.43075606886963963
GARDEN CITY,MI,8099,7930,-169,0.49472830494728304
GARDEN CITY,MN,12,131,119,0.916083916083916
GARDEN CITY,MO,1475,1400,-75,0.48695652173913045
GARDEN CITY,NY,7248,8230,982,0.531722444760305
GARDEN CITY,TX,13,0,-13,0
GARDEN CITY,UT,466,496,30,0.5155925155925156
GARDEN CITY PARK,NY,408,377,-31,0.4802547770700637
GARDEN CITY SOUTH,NY,502,519,17,0.5083251714005876
GARDEN CTY,GA,0,38,38,1
GARDEN GROVE,CA,49034,43307,-5727,0.46898993946351025
GARDEN GROVE,IA,11,11,0,0.5
GARDEN PLAIN,KS,310,381,71,0.5513748191027497
GARDEN PR,IL,0,12,12,1
GARDEN PRAIRIE,IL,61,149,88,0.7095238095238096
GARDEN RIDGE,TX,733,1098,365,0.5996723102129984
GARDEN VALLEY,CA,1007,1131,124,0.528999064546305
GARDEN VALLEY,ID,1650,1286,-364,0.4380108991825613
GARDENA,CA,22920,21399,-1521,0.4828403167941515
GARDENDALE,AL,5559,5872,313,0.5136908406963521
GARDENDALE,TX,1230,1141,-89,0.48123154787009703
GARDINER,ME,2846,3106,260,0.5218413978494624
GARDINER,MT,1194,756,-438,0.38769230769230767
GARDINER,NY,1237,1318,81,0.5158512720156556
GARDNER,CO,119,137,18,0.53515625
GARDNER,IL,930,813,-117,0.4664371772805508
GARDNER,KS,10860,10350,-510,0.48797736916548795
GARDNER,MA,10007,9135,-872,0.4772228607251071
GARDNER,ND,25,12,-13,0.32432432432432434
GARDNERS,PA,900,1034,134,0.5346432264736298
GARDNERVILLE,NV,9611,10239,628,0.5158186397984886
GARFIELD,AR,1977,1955,-22,0.4972024415055951
GARFIELD,GA,60,101,41,0.6273291925465838
GARFIELD,KY,70,47,-23,0.4017094017094017
GARFIELD,MN,268,310,42,0.5363321799307958
GARFIELD,NJ,12416,9087,-3329,0.42259219643770635
GARFIELD,OH,260,287,27,0.5246800731261426
GARFIELD,WA,40,75,35,0.6521739130434783
GARFIELD HEIGHTS,OH,3248,3219,-29,0.4977578475336323
GARFIELD HTS,OH,473,456,-17,0.4908503767491927
GARFIELD PLT,ME,77,34,-43,0.3063063063063063
GARIBALDI,OR,991,612,-379,0.3817841547099189
GARLAND,ME,70,169,99,0.7071129707112971
GARLAND,NC,421,515,94,0.5502136752136753
GARLAND,NE,22,0,-22,0
GARLAND,TX,86656,77476,-9180,0.47203470377501033
GARLAND,UT,1154,1307,153,0.531084924827306
GARNAVILLO,IA,170,130,-40,0.43333333333333335
GARNER,IA,1843,1512,-331,0.45067064083457525
GARNER,NC,21574,24328,2754,0.5299986928674132
GARNERVILLE,NY,3216,2607,-609,0.4477073673364245
GARNET VALLEY,PA,1933,2246,313,0.5374491505144772
GARNETT,KS,2022,1900,-122,0.4844467108618052
GARRETSON,SD,826,798,-28,0.49137931034482757
GARRETT,IN,3774,3452,-322,0.47771934680321065
GARRETT,KY,138,101,-37,0.4225941422594142
GARRETT,PA,118,38,-80,0.24358974358974358
GARRETT PARK,MD,26,30,4,0.5357142857142857
GARRETTSVILLE,OH,2237,2436,199,0.5212925315643056
GARRISON,IA,36,40,4,0.5263157894736842
GARRISON,KY,445,436,-9,0.4948921679909194
GARRISON,MN,883,861,-22,0.49369266055045874
GARRISON,ND,956,996,40,0.5102459016393442
GARRISON,NY,1307,1379,72,0.5134028294862248
GARRISON,TX,888,1040,152,0.5394190871369294
GARRISONVILLE,VA,169,222,53,0.5677749360613811
GARVIN,MN,12,13,1,0.52
GARVIN,OK,93,77,-16,0.45294117647058824
GARWIN,IA,95,104,9,0.5226130653266332
GARWOOD,NJ,1364,1405,41,0.5074033947273384
GARWOOD,TX,37,66,29,0.6407766990291263
GARY,IN,30878,29275,-1603,0.4866756437750403
GARY,SD,123,79,-44,0.3910891089108911
GARY,TX,530,510,-20,0.49038461538461536
GARYSBURG,NC,495,506,11,0.5054945054945055
GARYVILLE,LA,177,238,61,0.5734939759036145
GAS,KS,0,13,13,1
GAS CITY,IN,2934,2932,-2,0.49982952608250936
GASBURG,VA,38,46,8,0.5476190476190477
GASCONADE,MO,0,11,11,1
GASPORT,NY,1472,1457,-15,0.49743939911232504
GASQUET,CA,45,34,-11,0.43037974683544306
GASSAWAY,WV,892,782,-110,0.46714456391875747
GASSVILLE,AR,1438,1667,229,0.5368760064412238
GASTON,IN,969,763,-206,0.4405311778290993
GASTON,NC,453,460,7,0.5038335158817087
GASTON,OR,1378,1440,62,0.511000709723208
GASTON,SC,6497,6288,-209,0.4918263590144701
GASTONIA,NC,42504,42736,232,0.5013608634443923
GATE CITY,VA,2182,2290,108,0.5120751341681574
GATES,NC,892,898,6,0.5016759776536313
GATES,NY,224,195,-29,0.46539379474940334
GATES,OR,245,134,-111,0.35356200527704484
GATES,TN,364,426,62,0.5392405063291139
GATES MILLS,OH,971,1202,231,0.55315232397607
GATESVILLE,NC,77,150,73,0.6607929515418502
GATESVILLE,TX,8430,7364,-1066,0.4662530074711916
GATEWAY,CO,12,0,-12,0
GATEWOOD,MO,11,0,-11,0
GATLINBURG,TN,3420,2825,-595,0.45236188951160927
GAULEY BRIDGE,WV,14,0,-14,0
GAUSE,TX,67,54,-13,0.4462809917355372
GAUTIER,MS,7525,7405,-120,0.4959812458137977
GAY,GA,152,275,123,0.6440281030444965
GAYLESVILLE,AL,406,507,101,0.5553121577217963
GAYLORD,MI,12633,11118,-1515,0.46810660603764054
GAYLORD,MN,1400,1017,-383,0.4207695490277203
GAYLORDSVILLE,CT,116,148,32,0.5606060606060606
GAYS,IL,15,16,1,0.5161290322580645
GAYS MILLS,WI,404,422,18,0.5108958837772397
GAYVILLE,SD,12,0,-12,0
GEARHART,OR,1518,1610,92,0.5147058823529411
GEARY,OK,528,382,-146,0.4197802197802198
GEDDES,SD,0,13,13,1
GEFF,IL,37,11,-26,0.22916666666666666
GEISMAR,LA,1929,2303,374,0.5441871455576559
GENESEE,ID,305,377,72,0.5527859237536656
GENESEE,MI,445,99,-346,0.18198529411764705
GENESEE,PA,325,271,-54,0.4546979865771812
GENESEO,IL,3286,3550,264,0.5193095377413692
GENESEO,NY,3166,3000,-166,0.4865390853065196
GENEVA,AL,2270,1940,-330,0.46080760095011875
GENEVA,FL,2330,2199,-131,0.4855376462795319
GENEVA,IL,8972,9280,308,0.5084374315143546
GENEVA,IN,1053,829,-224,0.4404888416578108
GENEVA,MN,11,11,0,0.5
GENEVA,NE,1219,1135,-84,0.4821580288870008
GENEVA,NY,9609,8635,-974,0.47330629247971934
GENEVA,OH,6036,5360,-676,0.47034047034047033
GENOA,CO,25,0,-25,0
GENOA,IL,2361,2236,-125,0.48640417663693714
GENOA,NE,296,158,-138,0.34801762114537443
GENOA,NV,543,932,389,0.631864406779661
GENOA,NY,78,50,-28,0.390625
GENOA,OH,1199,1264,65,0.5131952902963866
GENOA,WI,72,81,9,0.5294117647058824
GENOA,WV,105,109,4,0.5093457943925234
GENOA CITY,WI,2507,2665,158,0.5152745552977571
GENOLA,UT,256,397,141,0.6079632465543645
GENTRY,AR,2964,3350,386,0.5305669939816281
GENTRY,MO,29,0,-29,0
GENTRYVILLE,IN,94,73,-21,0.437125748502994
GEORGE,IA,461,281,-180,0.37870619946091644
GEORGE,WA,14,0,-14,0
GEORGE WEST,TX,1284,1298,14,0.5027110766847405
GEORGES MILLS,NH,119,103,-16,0.46396396396396394
GEORGETOWN,CA,1026,1081,55,0.5130517323208353
GEORGETOWN,CO,976,707,-269,0.42008318478906714
GEORGETOWN,CT,11,0,-11,0
GEORGETOWN,DE,4987,5289,302,0.5146944336317634
GEORGETOWN,FL,777,1003,226,0.5634831460674158
GEORGETOWN,GA,581,756,175,0.5654450261780105
GEORGETOWN,ID,26,11,-15,0.2972972972972973
GEORGETOWN,IL,2392,1878,-514,0.43981264637002343
GEORGETOWN,IN,3121,3390,269,0.5206573491015205
GEORGETOWN,KY,22327,22973,646,0.507130242825607
GEORGETOWN,LA,96,0,-96,0
GEORGETOWN,MA,1927,2128,201,0.5247842170160296
GEORGETOWN,ME,585,811,226,0.580945558739255
GEORGETOWN,MS,20,20,0,0.5
GEORGETOWN,NY,136,56,-80,0.2916666666666667
GEORGETOWN,OH,4190,3448,-742,0.45142707515056296
GEORGETOWN,PA,230,174,-56,0.4306930693069307
GEORGETOWN,SC,8323,7747,-576,0.4820784069695084
GEORGETOWN,TN,1431,1633,202,0.5329634464751958
GEORGETOWN,TX,46682,65473,18791,0.5837724577593509
GEORGETOWN TOWNSHIP,MI,110,142,32,0.5634920634920635
GEORGIANA,AL,853,923,70,0.5197072072072072
GEPP,AR,0,15,15,1
GERALD,MO,1244,1117,-127,0.47310461668784415
GERALDINE,AL,917,586,-331,0.38988689288090483
GERALDINE,MT,12,0,-12,0
GERBER,CA,858,799,-59,0.4821967410983706
GERING,NE,4667,4291,-376,0.4790131725831659
GERLACH,NV,13,0,-13,0
GERMAN VALLEY,IL,0,13,13,1
GERMANSVILLE,PA,299,451,152,0.6013333333333334
GERMANTON,NC,931,988,57,0.5148514851485149
GERMANTOWN,IL,145,129,-16,0.4708029197080292
GERMANTOWN,KY,24,60,36,0.7142857142857143
GERMANTOWN,MD,39679,36063,-3616,0.4761294922236012
GERMANTOWN,NY,1223,1420,197,0.5372682557699584
GERMANTOWN,OH,2930,2949,19,0.5016159210750127
GERMANTOWN,TN,10950,13038,2088,0.5435217608804402
GERMANTOWN,WI,6836,6914,78,0.5028363636363636
GERMANTOWN HILLS,IL,1252,1300,48,0.5094043887147336
GERMFASK,MI,193,229,36,0.542654028436019
GERONIMO,OK,589,501,-88,0.4596330275229358
GERRARDSTOWN,WV,1380,1527,147,0.5252837977296182
GERRY,NY,150,222,72,0.5967741935483871
GERTON,NC,0,16,16,1
GERVAIS,OR,865,890,25,0.5071225071225072
GETTYSBURG,OH,96,35,-61,0.26717557251908397
GETTYSBURG,PA,9382,9649,267,0.507014870474489
GETTYSBURG,SD,547,344,-203,0.38608305274971944
GETZVILLE,NY,3113,2578,-535,0.4529959585310139
GEYSERVILLE,CA,295,262,-33,0.4703770197486535
GFAFB,ND,45,27,-18,0.375
GHEEN,MN,48,50,2,0.5102040816326531
GHEENS,LA,24,11,-13,0.3142857142857143
GHENT,KY,192,285,93,0.5974842767295597
GHENT,MN,12,25,13,0.6756756756756757
GHENT,NY,903,1280,377,0.5863490609253321
GHENT,WV,36,91,55,0.7165354330708661
GIBBON,MN,299,244,-55,0.44935543278084716
GIBBON,NE,1382,1261,-121,0.477109345440787
GIBBSBORO,NJ,473,647,174,0.5776785714285714
GIBBSTOWN,NJ,1248,1321,73,0.514207862981705
GIBRALTAR,MI,1797,1512,-285,0.45693563009972804
GIBSLAND,LA,12,68,56,0.85
GIBSON,GA,289,338,49,0.5390749601275917
GIBSON,LA,476,457,-19,0.48981779206859594
GIBSON,NC,101,125,24,0.5530973451327433
GIBSON CITY,IL,1653,1580,-73,0.4887101763068358
GIBSON ISLAND,MD,30,34,4,0.53125
GIBSONBURG,OH,1292,1341,49,0.5093049753133309
GIBSONIA,PA,6398,7331,933,0.5339791681841358
GIBSONTON,FL,8767,9166,399,0.511124742095578
GIBSONVILLE,NC,3942,4219,277,0.5169709594412449
GIDDINGS,TX,3064,2818,-246,0.47908874532471946
GIDEON,MO,302,169,-133,0.35881104033970274
GIFFORD,IL,86,87,1,0.5028901734104047
GIG HARBOR,WA,23922,25283,1361,0.5138298953358399
GILA BEND,AZ,557,414,-143,0.42636457260556127
GILBERT,AZ,114808,120199,5391,0.5114698711102222
GILBERT,IA,348,316,-32,0.4759036144578313
GILBERT,LA,140,176,36,0.5569620253164557
GILBERT,MN,1079,1032,-47,0.4888678351492184
GILBERT,PA,127,43,-84,0.2529411764705882
GILBERT,SC,2671,3339,668,0.5555740432612313
GILBERT,WV,24,76,52,0.76
GILBERTOWN,AL,327,419,92,0.561662198391421
GILBERTS,IL,2191,2228,37,0.5041864675265897
GILBERTSVILLE,KY,1676,1491,-185,0.470792548152826
GILBERTSVILLE,NY,199,102,-97,0.3388704318936877
GILBERTSVILLE,PA,3597,3946,349,0.5231340315524328
GILBERTVILLE,IA,49,22,-27,0.30985915492957744
GILBERTVILLE,MA,482,408,-74,0.4584269662921348
GILBOA,NY,441,265,-176,0.37535410764872523
GILCHRIST,OR,20,26,6,0.5652173913043478
GILCHRIST,TX,11,0,-11,0
GILCREST,CO,228,71,-157,0.23745819397993312
GILEAD,ME,130,138,8,0.5149253731343284
GILFORD,NH,3380,3230,-150,0.4886535552193646
GILL,CO,143,59,-84,0.29207920792079206
GILL,MA,187,329,142,0.6375968992248062
GILLESPIE,IL,1863,1588,-275,0.4601564763836569
GILLETT,PA,1123,1038,-85,0.4803331790837575
GILLETT,WI,1309,1347,38,0.5071536144578314
GILLETTE,NJ,642,765,123,0.5437100213219617
GILLETTE,WY,21507,20781,-726,0.4914160045402951
GILLHAM,AR,46,53,7,0.5353535353535354
GILLIAM,MO,41,11,-30,0.21153846153846154
GILLSVILLE,GA,1181,1277,96,0.5195280716029292
GILMAN,IA,94,121,27,0.5627906976744186
GILMAN,IL,793,552,-241,0.4104089219330855
GILMAN,VT,0,27,27,1
GILMAN,WI,388,322,-66,0.4535211267605634
GILMAN CITY,MO,13,31,18,0.7045454545454546
GILMANTON,NH,837,841,4,0.50119189511323
GILMANTON IRON WORKS,NH,303,320,17,0.5136436597110754
GILMANTON IW,NH,56,63,7,0.5294117647058824
GILMER,TX,8658,8275,-383,0.48869072225831217
GILMER,WV,24,17,-7,0.4146341463414634
GILMORE CITY,IA,106,36,-70,0.2535211267605634
GILROY,CA,18181,17838,-343,0.4952386240595241
GILSON,IL,0,14,14,1
GILSUM,NH,78,101,23,0.5642458100558659
GIRARD,GA,25,106,81,0.8091603053435115
GIRARD,IL,1250,1199,-51,0.4895875867701103
GIRARD,KS,1713,1628,-85,0.48727925770727326
GIRARD,OH,7125,5483,-1642,0.43488261421319796
GIRARD,PA,2987,2843,-144,0.48765008576329333
GIRARDVILLE,PA,831,505,-326,0.37799401197604793
GIRDLER,KY,29,0,-29,0
GIRDLETREE,MD,11,12,1,0.5217391304347826
GIRDWOOD,AK,1183,716,-467,0.3770405476566614
GIVEN,WV,0,31,31,1
GLADBROOK,IA,434,345,-89,0.4428754813863928
GLADE HILL,VA,900,875,-25,0.49295774647887325
GLADE PARK,CO,198,140,-58,0.41420118343195267
GLADE SPRING,VA,1423,1521,98,0.5166440217391305
GLADE VALLEY,NC,286,398,112,0.5818713450292398
GLADEVILLE,TN,0,11,11,1
GLADEWATER,TX,5626,5798,172,0.5075280112044818
GLADSTONE,IL,85,26,-59,0.23423423423423423
GLADSTONE,MI,3799,3519,-280,0.4808690899152774
GLADSTONE,MO,2318,2242,-76,0.49166666666666664
GLADSTONE,ND,24,0,-24,0
GLADSTONE,NJ,309,339,30,0.5231481481481481
GLADSTONE,OR,6160,5651,-509,0.4784522902379138
GLADSTONE,VA,190,256,66,0.5739910313901345
GLADWIN,MI,8236,7371,-865,0.4722880758633946
GLADWYNE,PA,1380,1645,265,0.543801652892562
GLADYS,VA,791,909,118,0.5347058823529411
GLASCO,KS,23,45,22,0.6617647058823529
GLASCO,NY,148,11,-137,0.06918238993710692
GLASFORD,IL,723,555,-168,0.43427230046948356
GLASGOW,KY,13670,13379,-291,0.494620873230064
GLASGOW,MO,337,277,-60,0.4511400651465798
GLASGOW,MT,1837,1732,-105,0.4852899971980947
GLASGOW,PA,23,0,-23,0
GLASGOW,VA,637,678,41,0.5155893536121673
GLASGOW,WV,11,0,-11,0
GLASSBORO,NJ,6495,6247,-248,0.49026840370428504
GLASSELL,CA,640,556,-84,0.46488294314381273
GLASSELL PARK,CA,717,674,-43,0.4845434938892883
GLASSPORT,PA,2184,1825,-359,0.4552257420803193
GLASTONBURY,CT,10769,11140,371,0.5084668401113698
GLEASON,TN,1125,1009,-116,0.47282099343955014
GLEASON,WI,656,604,-52,0.4793650793650794
GLEN,MS,321,369,48,0.5347826086956522
GLEN,MT,11,0,-11,0
GLEN,NH,779,804,25,0.5078963992419456
GLEN ALLEN,VA,27548,31020,3472,0.5296407594590903
GLEN ALPINE,NC,0,24,24,1
GLEN ARBOR,MI,994,803,-191,0.4468558708959377
GLEN ARM,MD,855,1068,213,0.5553822152886115
GLEN AUBREY,NY,63,59,-4,0.48360655737704916
GLEN BURNIE,MD,41859,36649,-5210,0.4668186681612065
GLEN CAMPBELL,PA,85,103,18,0.5478723404255319
GLEN CARBON,IL,5130,4708,-422,0.4785525513315715
GLEN COVE,NY,8790,8768,-22,0.49937350495500626
GLEN DALE,WV,563,632,69,0.5288702928870292
GLEN DANIEL,WV,11,0,-11,0
GLEN EASTON,WV,36,11,-25,0.23404255319148937
GLEN ECHO,MD,30,12,-18,0.2857142857142857
GLEN ELDER,KS,13,22,9,0.6285714285714286
GLEN ELLEN,CA,1186,1170,-16,0.4966044142614601
GLEN ELLYN,IL,11477,11709,232,0.5050030190632279
GLEN FLORA,WI,25,47,22,0.6527777777777778
GLEN FORK,WV,12,0,-12,0
GLEN GARDNER,NJ,1470,1534,64,0.5106524633821571
GLEN HAVEN,CO,11,39,28,0.78
GLEN HEAD,NY,2873,3367,494,0.5395833333333333
GLEN LYON,PA,1033,742,-291,0.4180281690140845
GLEN MILLS,PA,5971,6438,467,0.5188169876702393
GLEN MORGAN,WV,248,296,48,0.5441176470588235
GLEN OAKS,NY,3056,2677,-379,0.46694575266003835
GLEN RIDGE,FL,245,220,-25,0.4731182795698925
GLEN RIDGE,NJ,1688,1979,291,0.5396782110717208
GLEN ROCK,NJ,2565,3000,435,0.5390835579514824
GLEN ROCK,PA,2266,2270,4,0.5004409171075838
GLEN ROGERS,WV,13,0,-13,0
GLEN ROSE,TX,2154,2680,526,0.5544062887877534
GLEN SAINT MARY,FL,2077,2312,235,0.5267714741398952
GLEN SPEY,NY,691,612,-79,0.4696853415195702
GLEN ST MARY,FL,346,363,17,0.5119887165021156
GLEN ULLIN,ND,270,150,-120,0.35714285714285715
GLEN WILD,NY,47,0,-47,0
GLENALLEN,MO,121,171,50,0.5856164383561644
GLENARDEN,MD,1044,932,-112,0.4716599190283401
GLENARM,IL,0,11,11,1
GLENBEULAH,WI,51,198,147,0.7951807228915663
GLENBROOK,NV,232,115,-117,0.3314121037463977
GLENBURN,ME,559,458,-101,0.4503441494591937
GLENBURN,ND,85,51,-34,0.375
GLENBURNIE,MD,545,405,-140,0.4263157894736842
GLENCOE,AL,740,728,-12,0.49591280653950953
GLENCOE,AR,15,0,-15,0
GLENCOE,IL,2497,2833,336,0.5315196998123828
GLENCOE,KY,714,541,-173,0.43107569721115535
GLENCOE,MD,28,51,23,0.6455696202531646
GLENCOE,MN,2920,2753,-167,0.48528115635466246
GLENCOE,MO,370,417,47,0.5298602287166455
GLENCOE,OK,403,596,193,0.5965965965965966
GLENDALE,AZ,146536,139294,-7242,0.48733163068957075
GLENDALE,CA,68774,58326,-10448,0.4588985051140834
GLENDALE,CO,958,841,-117,0.46748193440800445
GLENDALE,KY,609,456,-153,0.428169014084507
GLENDALE,NY,5043,3782,-1261,0.4285552407932011
GLENDALE,OH,547,572,25,0.5111706881143878
GLENDALE,OR,962,842,-120,0.46674057649667405
GLENDALE,RI,66,38,-28,0.36538461538461536
GLENDALE,SC,17,17,0,0.5
GLENDALE,WI,2729,2855,126,0.5112822349570201
GLENDALE HEIGHTS,IL,10798,9246,-1552,0.4612851726202355
GLENDALE HTS,IL,985,864,-121,0.4672796106003245
GLENDIVE,MT,3626,3511,-115,0.49194339358273786
GLENDO,WY,213,41,-172,0.16141732283464566
GLENDORA,CA,14775,14833,58,0.5009794650094569
GLENDORA,NJ,1300,1379,79,0.5147443075774543
GLENEDEN BCH,OR,43,64,21,0.5981308411214953
GLENEDEN BEACH,OR,677,736,59,0.5208775654635527
GLENELG,MD,121,247,126,0.6711956521739131
GLENFIELD,NY,511,614,103,0.5457777777777778
GLENFORD,NY,0,23,23,1
GLENFORD,OH,389,404,15,0.5094577553593947
GLENHAVEN,CA,11,0,-11,0
GLENMONT,NY,2320,2500,180,0.5186721991701245
GLENMONT,OH,64,72,8,0.5294117647058824
GLENMOORE,PA,2090,2191,101,0.5117963092735343
GLENMORA,LA,847,789,-58,0.48227383863080686
GLENN,CA,11,15,4,0.5769230769230769
GLENN DALE,MD,1763,2225,462,0.5579237713139418
GLENN HEIGHTS,TX,5470,7164,1694,0.5670413170808928
GLENNALLEN,AK,480,477,-3,0.49843260188087773
GLENNIE,MI,699,662,-37,0.48640705363703157
GLENNS FERRY,ID,573,383,-190,0.4006276150627615
GLENNVILLE,GA,3038,3009,-29,0.49760211675210847
GLENOLDEN,PA,4965,4132,-833,0.4542156754974167
GLENOMA,WA,169,176,7,0.5101449275362319
GLENPOOL,OK,5459,5394,-65,0.4970054362848982
GLENROCK,WY,1757,1326,-431,0.43010055141096337
GLENS FALLS,NY,8915,8122,-793,0.4767271233198333
GLENS FORK,KY,11,0,-11,0
GLENSHAW,PA,3044,3139,95,0.5076823548439269
GLENSIDE,PA,6802,6873,71,0.5025959780621572
GLENVIEW,IL,18369,18872,503,0.5067533095244489
GLENVIEW,KY,0,16,16,1
GLENVILLE,MN,144,144,0,0.5
GLENVILLE,NC,780,955,175,0.5504322766570605
GLENVILLE,NY,1767,1729,-38,0.4945652173913043
GLENVILLE,PA,367,465,98,0.5588942307692307
GLENVILLE,WV,1197,1124,-73,0.4842740198190435
GLENWOOD,AL,38,23,-15,0.3770491803278688
GLENWOOD,AR,1806,1577,-229,0.46615430091634646
GLENWOOD,FL,0,11,11,1
GLENWOOD,GA,260,309,49,0.5430579964850615
GLENWOOD,IA,3205,3426,221,0.5166641532197256
GLENWOOD,IL,3064,2875,-189,0.48408823034180837
GLENWOOD,IN,27,25,-2,0.4807692307692308
GLENWOOD,MD,721,819,98,0.5318181818181819
GLENWOOD,MN,2970,2702,-268,0.4763751763046544
GLENWOOD,NJ,327,356,29,0.5212298682284041
GLENWOOD,NM,0,13,13,1
GLENWOOD,NY,64,51,-13,0.4434782608695652
GLENWOOD,WA,0,23,23,1
GLENWOOD,WV,54,11,-43,0.16923076923076924
GLENWOOD CITY,WI,985,934,-51,0.4867118290776446
GLENWOOD LANDING,NY,52,139,87,0.7277486910994765
GLENWOOD SPGS,CO,549,558,9,0.5040650406504065
GLENWOOD SPRINGS,CO,7397,7250,-147,0.4949819075578617
GLIDDEN,IA,484,417,-67,0.462819089900111
GLIDDEN,WI,318,271,-47,0.4601018675721562
GLIDE,OR,886,756,-130,0.46041412911084045
GLOBE,AZ,3767,3364,-403,0.47174309353526855
GLORIETA,NM,139,196,57,0.5850746268656717
GLOSTER,LA,512,153,-359,0.23007518796992482
GLOSTER,MS,352,468,116,0.5707317073170731
GLOU POINT,VA,40,25,-15,0.38461538461538464
GLOUCESTER,MA,11364,11720,356,0.5077109686362848
GLOUCESTER,NC,40,55,15,0.5789473684210527
GLOUCESTER,VA,6178,7164,986,0.5369509818617898
GLOUCESTER CITY,NJ,4103,3989,-114,0.49295600593178446
GLOUCESTER CY,NJ,92,81,-11,0.4682080924855491
GLOUCESTER POINT,VA,1160,1076,-84,0.481216457960644
GLOUCESTER PT,VA,19,24,5,0.5581395348837209
GLOUCSTR CITY,NJ,96,135,39,0.5844155844155844
GLOUSTER,OH,1717,1661,-56,0.4917110716400237
GLOVER,VT,167,203,36,0.5486486486486486
GLOVERSVILLE,NY,12576,11654,-922,0.48097399917457695
GLOVERVILLE,SC,52,30,-22,0.36585365853658536
GLYNDON,MD,0,24,24,1
GLYNDON,MN,892,786,-106,0.4684147794994041
GLYNN,LA,16,0,-16,0
GNADENHUTTEN,OH,593,575,-18,0.4922945205479452
GOBLES,MI,2462,2356,-106,0.48899958488999584
GODDARD,KS,3079,3364,285,0.5221170262300171
GODEFFROY,NY,33,38,5,0.5352112676056338
GODFREY,IL,5568,5237,-331,0.4846830171217029
GODLEY,IL,100,151,51,0.601593625498008
GODLEY,TX,1779,3853,2074,0.6841264204545454
GODWIN,NC,393,494,101,0.5569334836527621
GOEHNER,NE,11,14,3,0.56
GOESSEL,KS,22,0,-22,0
GOETZVILLE,MI,26,111,85,0.8102189781021898
GOFFSTOWN,NH,4610,4528,-82,0.4955132414094988
GOLCONDA,IL,847,805,-42,0.4872881355932203
GOLCONDA,NV,41,39,-2,0.4875
GOLD BAR,WA,2299,1979,-320,0.46259934548854603
GOLD BEACH,OR,2979,2870,-109,0.49068216789194735
GOLD CANYON,AZ,13141,21110,7969,0.6163323698578144
GOLD HILL,NC,657,760,103,0.5363443895553988
GOLD HILL,OR,3049,2852,-197,0.4833079139128961
GOLD RIVER,CA,1663,1461,-202,0.46766965428937257
GOLDEN,CO,31449,29935,-1514,0.48766779616838263
GOLDEN,IL,25,26,1,0.5098039215686274
GOLDEN,MO,353,392,39,0.5261744966442953
GOLDEN,MS,800,784,-16,0.494949494949495
GOLDEN CITY,MO,370,280,-90,0.4307692307692308
GOLDEN EAGLE,IL,0,12,12,1
GOLDEN HILLS,CA,207,233,26,0.5295454545454545
GOLDEN MEADOW,LA,905,554,-351,0.37971213159698425
GOLDEN VALLEY,AZ,4285,5973,1688,0.5822772470267109
GOLDEN VALLEY,MN,2474,2052,-422,0.4533804684047724
GOLDENDALE,WA,4507,3836,-671,0.45978664748891285
GOLDENROD,FL,729,682,-47,0.4833451452870305
GOLDENS BRG,NY,66,93,27,0.5849056603773585
GOLDENS BRIDGE,NY,407,445,38,0.5223004694835681
GOLDFIELD,IA,197,97,-100,0.3299319727891156
GOLDFIELD,NV,11,25,14,0.6944444444444444
GOLDONNA,LA,12,18,6,0.6
GOLDSBORO,MD,129,107,-22,0.4533898305084746
GOLDSBORO,NC,28174,26960,-1214,0.4889904596075017
GOLDSBY,OK,90,168,78,0.6511627906976745
GOLDSMITH,TX,19,26,7,0.5777777777777777
GOLDSTON,NC,217,176,-41,0.44783715012722647
GOLDTHWAITE,TX,977,1180,203,0.5470560964302271
GOLDVEIN,VA,11,58,47,0.8405797101449275
GOLETA,CA,18965,14496,-4469,0.433220764472072
GOLF,IL,0,12,12,1
GOLIAD,TX,1380,1615,235,0.5392320534223706
GONVICK,MN,89,95,6,0.5163043478260869
GONZALES,CA,953,670,-283,0.41281577325939617
GONZALES,LA,13630,15121,1491,0.5259295328858127
GONZALES,TX,3605,3723,118,0.5080513100436681
GONZALEZ,FL,0,13,13,1
GOOCHLAND,VA,1296,1572,276,0.5481171548117155
GOOD HOPE,GA,352,701,349,0.6657169990503324
GOOD HOPE,IL,55,36,-19,0.3956043956043956
GOOD THUNDER,MN,296,213,-83,0.41846758349705304
GOODE,VA,606,955,349,0.6117873158231902
GOODELLS,MI,186,159,-27,0.4608695652173913
GOODFELLOW AFB,TX,413,220,-193,0.34755134281200634
GOODFIELD,IL,393,174,-219,0.30687830687830686
GOODHUE,MN,598,468,-130,0.43902439024390244
GOODING,ID,3062,2650,-412,0.4639355742296919
GOODLAND,FL,461,548,87,0.5431119920713577
GOODLAND,IN,456,314,-142,0.4077922077922078
GOODLAND,KS,2605,2408,-197,0.4803510871733493
GOODLETTSVILLE,TN,14130,13781,-349,0.49374798466554404
GOODMAN,MO,1319,1547,228,0.5397766922540126
GOODMAN,MS,23,93,70,0.8017241379310345
GOODRICH,MI,2056,1903,-153,0.48067693862086386
GOODRICH,ND,11,0,-11,0
GOODRICH,TX,546,664,118,0.5487603305785124
GOODRIDGE,MN,11,12,1,0.5217391304347826
GOODSON,MO,59,94,35,0.6143790849673203
GOODSPRING,TN,244,247,3,0.5030549898167006
GOODSPRINGS,NV,15,15,0,0.5
GOODVIEW,VA,1339,1490,151,0.5266878755744079
GOODWATER,AL,878,934,56,0.5154525386313465
GOODWELL,OK,276,56,-220,0.1686746987951807
GOODYEAR,AZ,47843,60641,12798,0.5589856568710593
GOOSE CREEK,SC,27024,22842,-4182,0.4580676212248827
GORDO,AL,1566,1444,-122,0.479734219269103
GORDON,AL,233,300,67,0.5628517823639775
GORDON,GA,1308,1301,-7,0.49865848984285166
GORDON,NE,904,827,-77,0.4777585210860774
GORDON,PA,29,0,-29,0
GORDON,TX,135,358,223,0.7261663286004056
GORDON,WI,838,750,-88,0.4722921914357683
GORDON,WV,11,0,-11,0
GORDONSVILLE,TN,1013,916,-97,0.47485743908761013
GORDONSVILLE,VA,1669,1992,323,0.5441136301556951
GORDONVILLE,PA,863,782,-81,0.47537993920972643
GORDONVILLE,TX,930,1035,105,0.5267175572519084
GORE,OK,983,1010,27,0.5067737079779228
GORE,VA,463,617,154,0.5712962962962963
GORE SPRINGS,MS,65,62,-3,0.4881889763779528
GOREVILLE,IL,1101,1101,0,0.5
GORHAM,KS,39,0,-39,0
GORHAM,ME,5232,5872,640,0.5288184438040345
GORHAM,NH,1473,1343,-130,0.47691761363636365
GORMAN,CA,13,0,-13,0
GORMAN,TX,895,459,-436,0.33899556868537667
GORMANIA,WV,0,12,12,1
GORUM,LA,0,11,11,1
GOSHEN,AL,223,343,120,0.6060070671378092
GOSHEN,CA,73,82,9,0.5290322580645161
GOSHEN,CT,1091,1345,254,0.5521346469622331
GOSHEN,IN,21802,17864,-3938,0.45036051026067664
GOSHEN,KY,1652,1703,51,0.5076005961251863
GOSHEN,MA,130,36,-94,0.21686746987951808
GOSHEN,NH,167,238,71,0.5876543209876544
GOSHEN,NY,3779,4088,309,0.5196389983475277
GOSHEN,OH,3104,3107,3,0.5002415070037031
GOSHEN,UT,0,12,12,1
GOSHEN,VA,128,142,14,0.5259259259259259
GOSHEN,VT,232,256,24,0.5245901639344263
GOSPORT,IN,1374,1287,-87,0.4836527621195039
GOTHA,FL,1673,1751,78,0.5113901869158879
GOTHENBURG,NE,2148,1954,-194,0.4763529985372989
GOULD,AR,28,48,20,0.631578947368421
GOULD CITY,MI,156,45,-111,0.22388059701492538
GOULDS,FL,590,693,103,0.5401402961808262
GOULDSBORO,ME,449,452,3,0.5016648168701443
GOULDSBORO,PA,1879,1607,-272,0.4609868043602983
GOUVERNEUR,NY,5039,4215,-824,0.455478711908364
GOVANS,MD,165,145,-20,0.46774193548387094
GOVERNMENT CAMP,OR,12,0,-12,0
GOWANDA,NY,2021,1809,-212,0.47232375979112273
GOWEN,MI,1783,1769,-14,0.49802927927927926
GOWER,MO,495,699,204,0.585427135678392
GOWRIE,IA,281,187,-94,0.3995726495726496
GR,MI,437,335,-102,0.4339378238341969
GR,NJ,49,58,9,0.5420560747663551
GRABILL,IN,660,647,-13,0.495026778882938
GRACE,ID,527,540,13,0.5060918462980318
GRACEMONT,OK,11,22,11,0.6666666666666666
GRACETON,PA,163,154,-9,0.48580441640378547
GRACEVILLE,FL,1858,2065,207,0.5263828702523579
GRACEVILLE,MN,105,63,-42,0.375
GRACEY,KY,0,59,59,1
GRADY,AL,146,201,55,0.579250720461095
GRADY,AR,12,13,1,0.52
GRAEAGLE,CA,101,205,104,0.6699346405228758
GRAETTINGER,IA,423,299,-124,0.41412742382271467
GRAFORD,TX,1250,1389,139,0.526335733232285
GRAFTON,IL,526,411,-115,0.4386339381003202
GRAFTON,MA,2295,2306,11,0.5011953923060204
GRAFTON,ND,2548,2177,-371,0.46074074074074073
GRAFTON,NH,406,440,34,0.5200945626477541
GRAFTON,OH,2862,3418,556,0.5442675159235669
GRAFTON,VT,80,96,16,0.5454545454545454
GRAFTON,WI,7231,7263,32,0.5011039050641645
GRAFTON,WV,3591,3166,-425,0.46855113215924227
GRAHAM,AL,29,0,-29,0
GRAHAM,FL,0,13,13,1
GRAHAM,KY,40,35,-5,0.4666666666666667
GRAHAM,NC,9723,10782,1059,0.5258229700073153
GRAHAM,TX,4760,4777,17,0.5008912655971479
GRAHAM,WA,10816,10945,129,0.5029640181976931
GRAHAMSVILLE,NY,531,601,70,0.5309187279151943
GRAIN VALLEY,MO,6806,7601,795,0.527590754494343
GRAMBLING,LA,1073,679,-394,0.3875570776255708
GRAMERCY,LA,299,430,131,0.5898491083676269
GRAMLING,SC,0,13,13,1
GRAMPIAN,PA,198,218,20,0.5240384615384616
GRANADA,MN,78,69,-9,0.46938775510204084
GRANADA HILLS,CA,12945,13057,112,0.5021536804861164
GRANBURY,TX,23942,28577,4635,0.5441268874121746
GRANBY,CO,2190,1983,-207,0.47519769949676494
GRANBY,CT,2405,2793,388,0.5373220469411312
GRANBY,MA,2064,2018,-46,0.4943655071043606
GRANBY,MO,1733,1680,-53,0.4922355698798711
GRAND BAY,AL,4781,4515,-266,0.48569277108433734
GRAND BLANC,MI,22693,20836,-1857,0.47866939281858073
GRAND CANE,LA,292,462,170,0.6127320954907162
GRAND CANYON,AZ,2103,1206,-897,0.3644605621033545
GRAND CHAIN,IL,26,12,-14,0.3157894736842105
GRAND CHENIER,LA,53,0,-53,0
GRAND CHUTE,WI,18,20,2,0.5263157894736842
GRAND COTEAU,LA,0,60,60,1
GRAND COULEE,WA,780,634,-146,0.44837340876944837
GRAND FORKS,ND,40992,30038,-10954,0.42289173588624523
GRAND FORKS AFB,ND,962,723,-239,0.429080118694362
GRAND GORGE,NY,61,46,-15,0.42990654205607476
GRAND HAVEN,MI,13913,13657,-256,0.4953572723975336
GRAND ISLAND,FL,3289,3563,274,0.5199941622883829
GRAND ISLAND,NE,30017,23219,-6798,0.4361522278157638
GRAND ISLAND,NY,6907,7346,439,0.5154002666105382
GRAND ISLE,LA,141,78,-63,0.3561643835616438
GRAND ISLE,ME,0,11,11,1
GRAND ISLE,VT,1081,1214,133,0.5289760348583878
GRAND JCT,CO,672,613,-59,0.47704280155642026
GRAND JCT,MI,79,81,2,0.50625
GRAND JCT,TN,0,11,11,1
GRAND JUNCTION,CO,63611,59272,-4339,0.48234499483248294
GRAND JUNCTION,IA,308,199,-109,0.39250493096646943
GRAND JUNCTION,MI,1600,1417,-183,0.46967185946304274
GRAND JUNCTION,TN,462,227,-235,0.32946298984034833
GRAND LAKE,CO,3124,2095,-1029,0.4014178961486875
GRAND LAKE STREAM,ME,61,91,30,0.5986842105263158
GRAND LEDGE,MI,7079,6795,-284,0.48976502811013406
GRAND MARAIS,MI,285,242,-43,0.45920303605313095
GRAND MARAIS,MN,2362,2457,95,0.5098568167669641
GRAND MARSH,WI,606,569,-37,0.48425531914893616
GRAND MEADOW,MN,547,435,-112,0.4429735234215886
GRAND MOUND,IA,87,35,-52,0.28688524590163933
GRAND PRAIRIE,TX,72943,67136,-5807,0.47927241056832215
GRAND RAPIDS,MI,205115,161611,-43504,0.4406859617261934
GRAND RAPIDS,MN,10177,9560,-617,0.4843694583776663
GRAND RAPIDS,OH,921,953,32,0.508537886872999
GRAND RIDGE,FL,952,992,40,0.5102880658436214
GRAND RIDGE,IL,46,24,-22,0.34285714285714286
GRAND RIVER,IA,23,11,-12,0.3235294117647059
GRAND RIVER,OH,22,11,-11,0.3333333333333333
GRAND RIVERS,KY,945,983,38,0.5098547717842323
GRAND RONDE,OR,1154,1070,-84,0.48111510791366907
GRAND SALINE,TX,2340,2491,151,0.5156282343200166
GRAND TERRACE,CA,4104,4128,24,0.5014577259475219
GRAND TOWER,IL,23,11,-12,0.3235294117647059
GRAND VALLEY,PA,14,0,-14,0
GRAND VIEW,ID,307,239,-68,0.43772893772893773
GRANDFALLS,TX,11,14,3,0.56
GRANDFIELD,OK,114,127,13,0.5269709543568465
GRANDIN,MO,40,52,12,0.5652173913043478
GRANDVIEW,IA,51,25,-26,0.32894736842105265
GRANDVIEW,IN,334,409,75,0.550471063257066
GRANDVIEW,MO,13319,12329,-990,0.48070024953212726
GRANDVIEW,OH,620,521,-99,0.4566170026292726
GRANDVIEW,TN,98,331,233,0.7715617715617715
GRANDVIEW,TX,1991,2473,482,0.5539874551971327
GRANDVIEW,WA,4482,2794,-1688,0.3840021990104453
GRANDVIEW HEIGHTS,OH,623,461,-162,0.4252767527675277
GRANDVILLE,MI,10200,11580,1380,0.5316804407713499
GRANDY,NC,1050,1231,181,0.5396755808855765
GRANGER,IA,928,1289,361,0.5814163283716735
GRANGER,IN,10669,10925,256,0.5059275724738354
GRANGER,TX,726,934,208,0.5626506024096386
GRANGER,WA,851,751,-100,0.46878901373283394
GRANGEVILLE,ID,2925,2827,-98,0.4914812239221141
GRANITE,OK,260,321,61,0.5524956970740104
GRANITE,OR,39,0,-39,0
GRANITE BAY,CA,5954,7318,1364,0.5513863773357445
GRANITE CANYON,WY,0,11,11,1
GRANITE CITY,IL,18407,14581,-3826,0.44200921547229294
GRANITE FALLS,MN,1745,1628,-117,0.48265638897124225
GRANITE FALLS,NC,6539,5694,-845,0.46546227417640806
GRANITE FALLS,WA,3967,4478,511,0.5302545885139136
GRANITE QUARRY,NC,45,47,2,0.5108695652173914
GRANITE SHOALS,TX,585,586,1,0.5004269854824936
GRANITE SPGS,NY,0,24,24,1
GRANITE SPRINGS,NY,0,15,15,1
GRANITEVILLE,SC,3445,4557,1112,0.5694826293426644
GRANITEVILLE,VT,332,301,-31,0.4755134281200632
GRANNIS,AR,27,0,-27,0
GRANT,AL,2089,2070,-19,0.49771579706660257
GRANT,FL,1023,1383,360,0.5748129675810474
GRANT,MI,2891,2704,-187,0.4832886505808758
GRANT,NE,316,246,-70,0.4377224199288256
GRANT CITY,MO,425,400,-25,0.48484848484848486
GRANT PARK,IL,992,862,-130,0.46494066882416396
GRANT TOWN,WV,0,12,12,1
GRANT TOWNSHIP,MI,367,337,-30,0.4786931818181818
GRANT TWP,MI,0,13,13,1
GRANT VALKARIA,FL,182,190,8,0.510752688172043
GRANTHAM,NH,1809,1872,63,0.508557457212714
GRANTON,WI,638,500,-138,0.43936731107205623
GRANTS,NM,3155,2773,-382,0.4677800269905533
GRANTS PASS,OR,29521,30526,1005,0.508368444718304
GRANTSBORO,NC,328,534,206,0.6194895591647331
GRANTSBURG,IL,23,12,-11,0.34285714285714286
GRANTSBURG,WI,1914,1862,-52,0.493114406779661
GRANTSVILLE,MD,1101,1070,-31,0.49286043298019344
GRANTSVILLE,UT,3985,4990,1005,0.5559888579387187
GRANTSVILLE,WV,617,529,-88,0.46160558464223383
GRANTVILLE,GA,1948,1968,20,0.5025536261491318
GRANTVILLE,KS,11,11,0,0.5
GRANTVILLE,PA,986,1102,116,0.5277777777777778
GRANVILLE,IA,11,0,-11,0
GRANVILLE,IL,609,443,-166,0.4211026615969582
GRANVILLE,MA,597,504,-93,0.45776566757493187
GRANVILLE,ND,91,48,-43,0.34532374100719426
GRANVILLE,NY,2647,2680,33,0.5030974281959827
GRANVILLE,OH,3601,4401,800,0.549987503124219
GRANVILLE,PA,0,11,11,1
GRANVILLE,TN,26,24,-2,0.48
GRANVILLE,VT,0,14,14,1
GRANVILLE,WV,106,169,63,0.6145454545454545
GRANVILLE SUMMIT,PA,11,24,13,0.6857142857142857
GRAPELAND,TX,1914,1798,-116,0.484375
GRAPEVIEW,WA,1460,1409,-51,0.491111885674451
GRAPEVILLE,PA,25,49,24,0.6621621621621622
GRAPEVINE,AR,77,52,-25,0.40310077519379844
GRAPEVINE,TX,29195,28745,-450,0.49611667241974455
GRASONVILLE,MD,2051,1992,-59,0.4927034380410586
GRASS LAKE,MI,2745,2892,147,0.5130388504523683
GRASS RANGE,MT,25,0,-25,0
GRASS VALLEY,CA,17357,18680,1323,0.5183561339734162
GRASSFLAT,PA,0,12,12,1
GRASSTON,MN,283,356,73,0.5571205007824727
GRASSY BUTTE,ND,11,11,0,0.5
GRASSY CREEK,NC,0,16,16,1
GRASSY KEY,FL,162,352,190,0.6848249027237354
GRATIOT,WI,48,13,-35,0.21311475409836064
GRATIS,OH,63,11,-52,0.14864864864864866
GRATON,CA,506,326,-180,0.3918269230769231
GRATZ,KY,46,58,12,0.5576923076923077
GRATZ,PA,137,87,-50,0.38839285714285715
GRAVEL SWITCH,KY,50,143,93,0.7409326424870466
GRAVETTE,AR,2640,2760,120,0.5111111111111111
GRAVITY,IA,13,0,-13,0
GRAVOIS MILLS,MO,2940,2964,24,0.5020325203252033
GRAWN,MI,1533,1581,48,0.5077071290944123
GRAY,GA,3335,3701,366,0.5260090960773166
GRAY,KY,1019,1173,154,0.5351277372262774
GRAY,LA,3139,2905,-234,0.48064195896757117
GRAY,ME,3388,3536,148,0.510687463893703
GRAY,TN,3114,3408,294,0.5225390984360626
GRAY COURT,SC,2988,2968,-20,0.4983210208193418
GRAY SUMMIT,MO,73,75,2,0.5067567567567568
GRAYLAND,WA,495,519,24,0.5118343195266272
GRAYLING,MI,5620,5191,-429,0.48015909721579875
GRAYMONT,IL,12,0,-12,0
GRAYS KNOB,KY,11,0,-11,0
GRAYSLAKE,IL,12010,11489,-521,0.4889144218902932
GRAYSON,GA,8804,9599,795,0.521599739172961
GRAYSON,KY,4919,4431,-488,0.473903743315508
GRAYSON,LA,1124,1137,13,0.502874834144184
GRAYSVILLE,AL,940,825,-115,0.46742209631728043
GRAYSVILLE,GA,13,11,-2,0.4583333333333333
GRAYSVILLE,OH,14,11,-3,0.44
GRAYSVILLE,PA,22,0,-22,0
GRAYSVILLE,TN,1122,1353,231,0.5466666666666666
GRAYTOWN,OH,204,155,-49,0.43175487465181056
GRAYVILLE,IL,794,779,-15,0.49523204068658616
GREAT BARRINGTON,MA,3576,4189,613,0.53947198969736
GREAT BEND,KS,8735,7742,-993,0.46986708745524064
GREAT BEND,ND,90,95,5,0.5135135135135135
GREAT BEND,NY,197,0,-197,0
GREAT BEND,PA,192,238,46,0.5534883720930233
GREAT CACAPON,WV,341,597,256,0.6364605543710021
GREAT FALLS,MT,37257,33886,-3371,0.4763082805054608
GREAT FALLS,SC,1206,1197,-9,0.49812734082397003
GREAT FALLS,VA,5131,6240,1109,0.5487644006683668
GREAT LAKES,IL,2758,2129,-629,0.43564559034172295
GREAT MEADOWS,NJ,755,829,74,0.5233585858585859
GREAT MILLS,MD,3293,2901,-392,0.4683564740071037
GREAT NCK PLZ,NY,224,166,-58,0.42564102564102563
GREAT NECK,NY,12853,12896,43,0.5008349838828693
GREAT NECK PLAZA,NY,100,160,60,0.6153846153846154
GREAT RIVER,NY,102,149,47,0.5936254980079682
GREAT VALLEY,NY,451,518,67,0.5345717234262126
GREECE,NY,385,416,31,0.519350811485643
GREELEY,CO,58091,51843,-6248,0.4715829497698619
GREELEY,KS,25,23,-2,0.4791666666666667
GREELEY,PA,257,301,44,0.5394265232974911
GREELEYVILLE,SC,148,227,79,0.6053333333333333
GREEN,OH,0,96,96,1
GREEN BAY,VA,44,71,27,0.6173913043478261
GREEN BAY,WI,97254,76472,-20782,0.4401874215719006
GREEN BROOK,NJ,566,514,-52,0.4759259259259259
GREEN CASTLE,MO,36,36,0,0.5
GREEN CITY,MO,142,187,45,0.5683890577507599
GREEN COVE SPRINGS,FL,10919,26350,15431,0.7070219217043655
GREEN CREEK,NJ,11,0,-11,0
GREEN FOREST,AR,3030,2556,-474,0.45757250268528465
GREEN HARBOR,MA,69,120,51,0.6349206349206349
GREEN ISLAND,NY,738,652,-86,0.46906474820143884
GREEN ISLE,MN,128,113,-15,0.46887966804979253
GREEN LAKE,WI,1748,1686,-62,0.49097262667443214
GREEN LANE,PA,1275,1171,-104,0.47874080130825836
GREEN MOUNTAIN,IA,13,16,3,0.5517241379310345
GREEN MOUNTAIN,NC,456,599,143,0.5677725118483412
GREEN MOUNTAIN FALLS,CO,185,248,63,0.5727482678983834
GREEN MTN,NC,51,75,24,0.5952380952380952
GREEN MTN FLS,CO,0,14,14,1
GREEN POND,SC,38,47,9,0.5529411764705883
GREEN RIDGE,MO,404,407,3,0.5018495684340321
GREEN RIVER,UT,50,108,58,0.6835443037974683
GREEN RIVER,WY,5493,4928,-565,0.47289127722867286
GREEN SEA,SC,279,395,116,0.586053412462908
GREEN SPRINGS,OH,573,523,-50,0.4771897810218978
GREEN TOWNSHIP,NJ,38,49,11,0.5632183908045977
GREEN VALLEY,AZ,34781,40109,5328,0.5355721725196956
GREEN VALLEY,CA,322,317,-5,0.49608763693270735
GREEN VALLEY,IL,268,233,-35,0.46506986027944114
GREEN VALLEY LAKE,CA,25,11,-14,0.3055555555555556
GREEN VILLAGE,NJ,12,24,12,0.6666666666666666
GREENACRES,FL,19847,19021,-826,0.489374292477102
GREENACRES,WA,5017,6091,1074,0.5483435361901332
GREENBACK,TN,1707,2180,473,0.5608438384358116
GREENBACKVILE,VA,116,115,-1,0.49783549783549785
GREENBACKVILLE,VA,634,780,146,0.5516265912305516
GREENBANK,WA,1006,1093,87,0.5207241543592187
GREENBELT,MD,16719,14413,-2306,0.46296415264037005
GREENBRAE,CA,2918,2958,40,0.5034036759700476
GREENBRIER,AR,6143,7032,889,0.5337381404174573
GREENBRIER,TN,4227,4844,617,0.5340094807628707
GREENBUSH,ME,381,409,28,0.5177215189873418
GREENBUSH,MI,1032,957,-75,0.48114630467571645
GREENBUSH,MN,264,179,-85,0.4040632054176072
GREENCASTLE,IN,7778,7107,-671,0.47746053073563993
GREENCASTLE,PA,5620,5698,78,0.5034458384873652
GREENDALE,IN,333,393,60,0.5413223140495868
GREENDALE,WI,5499,4978,-521,0.4751360122172378
GREENE,IA,478,462,-16,0.49148936170212765
GREENE,ME,1669,1699,30,0.5044536817102138
GREENE,NY,2232,2009,-223,0.4737090308889413
GREENE,RI,292,460,168,0.6117021276595744
GREENEHAVEN,AZ,48,55,7,0.5339805825242718
GREENEVILLE,TN,14323,16081,1758,0.5289106696487305
GREENFIELD,CA,2168,1873,-295,0.46349913387775304
GREENFIELD,IA,1234,1028,-206,0.45446507515473034
GREENFIELD,IL,590,489,-101,0.4531974050046339
GREENFIELD,IN,17296,18046,750,0.5106106049459567
GREENFIELD,MA,8295,7642,-653,0.47951308276338084
GREENFIELD,MO,1016,1063,47,0.5113035113035113
GREENFIELD,NH,388,529,141,0.5768811341330425
GREENFIELD,OH,2904,2902,-2,0.49982776438167414
GREENFIELD,TN,1498,1376,-122,0.47877522616562285
GREENFIELD,WI,7132,6510,-622,0.47720275619410646
GREENFIELD CENTER,NY,1513,1499,-14,0.49767596281540505
GREENFIELD PARK,NY,16,0,-16,0
GREENFIELD TWP,ME,27,17,-10,0.38636363636363635
GREENFLD CTR,NY,29,42,13,0.5915492957746479
GREENLAND,NH,1717,1797,80,0.5113830392714855
GREENLAW CHOPPING TWP,ME,17,0,-17,0
GREENLAWN,NY,2109,2357,248,0.5277653381101657
GREENLEAF,ID,232,281,49,0.5477582846003899
GREENLEAF,KS,15,24,9,0.6153846153846154
GREENLEAF,WI,699,747,48,0.516597510373444
GREENOCK,PA,0,16,16,1
GREENOUGH,MT,22,16,-6,0.42105263157894735
GREENPORT,NY,1904,2047,143,0.5180966843837004
GREENS FARMS,CT,0,14,14,1
GREENS FORK,IN,179,227,48,0.5591133004926109
GREENSBORO,AL,1490,1457,-33,0.49440108585001696
GREENSBORO,FL,0,12,12,1
GREENSBORO,GA,4935,6888,1953,0.5825932504440497
GREENSBORO,MD,1491,1462,-29,0.49508973924822214
GREENSBORO,NC,155682,137607,-18075,0.4691856837453842
GREENSBORO,PA,238,190,-48,0.4439252336448598
GREENSBORO,VT,256,359,103,0.583739837398374
GREENSBORO BEND,VT,23,52,29,0.6933333333333334
GREENSBURG,IN,10538,8930,-1608,0.4587014588041915
GREENSBURG,KS,503,314,-189,0.3843329253365973
GREENSBURG,KY,3526,3171,-355,0.4734955950425564
GREENSBURG,LA,692,834,142,0.546526867627785
GREENSBURG,PA,19569,18715,-854,0.4888465155156201
GREENTOP,MO,241,230,-11,0.4883227176220807
GREENTOWN,IN,1978,1812,-166,0.47810026385224275
GREENTOWN,PA,2479,2142,-337,0.46353603116208614
GREENUP,IL,853,891,38,0.510894495412844
GREENUP,KY,2821,2448,-373,0.46460428923894476
GREENVALE,NY,369,477,108,0.5638297872340425
GREENVIEW,IL,225,38,-187,0.1444866920152091
GREENVILLE,AL,4524,3945,-579,0.46581650726177826
GREENVILLE,CA,1368,665,-703,0.32710280373831774
GREENVILLE,DE,437,524,87,0.5452653485952134
GREENVILLE,FL,1030,1096,66,0.51552210724365
GREENVILLE,GA,1094,1272,178,0.5376162299239222
GREENVILLE,IL,3704,3019,-685,0.44905548118399524
GREENVILLE,IN,1572,1357,-215,0.46329805394332535
GREENVILLE,KY,4020,3712,-308,0.4800827728918779
GREENVILLE,ME,1116,990,-126,0.4700854700854701
GREENVILLE,MI,9588,8556,-1032,0.47156084656084657
GREENVILLE,MO,302,323,21,0.5168
GREENVILLE,MS,11322,10518,-804,0.4815934065934066
GREENVILLE,NC,49538,44264,-5274,0.4718875930150743
GREENVILLE,NH,759,731,-28,0.4906040268456376
GREENVILLE,NY,1322,1191,-131,0.47393553521687226
GREENVILLE,OH,9963,9114,-849,0.4777480735964774
GREENVILLE,PA,7721,6030,-1691,0.4385135626499891
GREENVILLE,RI,2191,2331,140,0.5154798761609907
GREENVILLE,SC,119584,114285,-5299,0.4886710081284822
GREENVILLE,TX,15478,16670,1192,0.5185392559412716
GREENVILLE,VA,810,917,107,0.5309785755645628
GREENVILLE,WI,2676,3135,459,0.5394940629839958
GREENVILLE JUNCTION,ME,187,156,-31,0.45481049562682213
GREENWEL SPGS,LA,72,69,-3,0.48936170212765956
GREENWELL SPRINGS,LA,2827,2953,126,0.5108996539792388
GREENWICH,CT,18189,19038,849,0.5114030139414941
GREENWICH,NY,2252,2227,-25,0.49720919848180395
GREENWICH,OH,1423,1237,-186,0.4650375939849624
GREENWOOD,AR,5042,5230,188,0.5091510903426791
GREENWOOD,CA,269,255,-14,0.4866412213740458
GREENWOOD,DE,1949,2248,299,0.5356206814391232
GREENWOOD,FL,730,859,129,0.540591567023285
GREENWOOD,IN,42687,43155,468,0.50272593835185575
GREENWOOD,LA,1101,1146,45,0.5100133511348465
GREENWOOD,ME,213,300,87,0.5847953216374269
GREENWOOD,MI,376,356,-20,0.48633879781420764
GREENWOOD,MO,1987,2485,498,0.5556797853309481
GREENWOOD,MS,7236,6254,-982,0.4636026686434396
GREENWOOD,NE,113,64,-49,0.3615819209039548
GREENWOOD,NY,0,24,24,1
GREENWOOD,SC,17972,16868,-1104,0.4841561423650976
GREENWOOD,VA,25,11,-14,0.3055555555555556
GREENWOOD,WI,964,891,-73,0.4803234501347709
GREENWOOD LAKE,NY,1756,1492,-264,0.45935960591133007
GREENWOOD LK,NY,33,38,5,0.5352112676056338
GREENWOOD SPRINGS,MS,0,14,14,1
GREENWOOD VILLAGE,CO,13153,13343,190,0.5035854468599034
GREER,AZ,217,231,14,0.515625
GREER,SC,30010,35050,5040,0.5387334767906548
GREERS FERRY,AR,225,235,10,0.5108695652173914
GREGORY,MI,1413,1374,-39,0.4930032292787944
GREGORY,SD,380,432,52,0.5320197044334976
GREGORY,TX,139,231,92,0.6243243243243243
GRELTON,OH,0,12,12,1
GRENADA,CA,80,88,8,0.5238095238095238
GRENADA,MS,6689,5717,-972,0.4608254070610995
GRENLOCH,NJ,0,12,12,1
GRENORA,ND,48,0,-48,0
GRENVILLE,SD,35,12,-23,0.2553191489361702
GRESHAM,OR,41471,35585,-5886,0.46180699750830567
GRESHAM,SC,253,315,62,0.5545774647887324
GRESHAM,WI,554,404,-150,0.42171189979123175
GRETHEL,KY,11,24,13,0.6857142857142857
GRETNA,FL,73,98,25,0.5730994152046783
GRETNA,LA,14563,11170,-3393,0.43407298021995105
GRETNA,NE,4167,5128,961,0.5516944593867671
GRETNA,VA,2185,1987,-198,0.4762703739213806
GREY EAGLE,MN,482,425,-57,0.4685777287761852
GREYBULL,WY,1222,1133,-89,0.481104033970276
GRIDLEY,CA,4228,3678,-550,0.46521629142423476
GRIDLEY,IL,405,432,27,0.5161290322580645
GRIDLEY,KS,34,25,-9,0.423728813559322
GRIFFIN,GA,26147,25491,-656,0.49364808861691
GRIFFITH,IN,9121,6185,-2936,0.40408989938586176
GRIFFITHSVILLE,WV,97,11,-86,0.10185185185185185
GRIFFITHVILLE,AR,12,11,-1,0.4782608695652174
GRIFTON,NC,1877,2017,140,0.5179763739085773
GRIGGSVILLE,IL,448,389,-59,0.4647550776583035
GRIMES,IA,7412,8834,1422,0.5437646189831343
GRIMESLAND,NC,1249,1610,361,0.5631339629240993
GRIMSLEY,TN,252,421,169,0.62555720653789
GRINDSTONE,ME,0,13,13,1
GRINDSTONE,PA,283,278,-5,0.49554367201426025
GRINDSTONE TWP,ME,25,25,0,0.5
GRINNELL,IA,5307,5023,-284,0.4862536302032914
GRINNELL,KS,11,0,-11,0
GRISWOLD,CT,815,884,69,0.5203060623896409
GRISWOLD,IA,531,371,-160,0.4113082039911308
GRIZZLY FLATS,CA,759,329,-430,0.3023897058823529
GROESBECK,OH,178,231,53,0.5647921760391198
GROESBECK,TX,2213,2417,204,0.5220302375809935
GROOM,TX,13,12,-1,0.48
GROSSE ILE,MI,3596,3652,56,0.5038631346578366
GROSSE POINTE,MI,3159,3351,192,0.5147465437788018
GROSSE POINTE FARMS,MI,3176,3885,709,0.5502053533493839
GROSSE POINTE PARK,MI,3327,3363,36,0.5026905829596413
GROSSE POINTE SHORES,MI,652,766,114,0.5401974612129761
GROSSE POINTE WOODS,MI,3071,3367,296,0.5229885057471264
GROSVENOR DALE,CT,12,0,-12,0
GROTON,CT,18703,16156,-2547,0.46346711035887433
GROTON,MA,2793,3155,362,0.5304303967720242
GROTON,NY,2362,2132,-230,0.4744103248776146
GROTON,SD,692,559,-133,0.44684252597921664
GROTON,VT,303,349,46,0.5352760736196319
GROTTOES,VA,2007,2067,60,0.5073637702503682
GROVE,OK,8025,7984,-41,0.4987194702979574
GROVE CITY,MN,365,313,-52,0.4616519174041298
GROVE CITY,OH,26042,26994,952,0.5089750358247228
GROVE CITY,PA,4967,4453,-514,0.4727176220806794
GROVE HILL,AL,940,1015,75,0.5191815856777494
GROVELAND,CA,2009,1676,-333,0.45481682496607867
GROVELAND,FL,9249,12752,3503,0.579610017726467
GROVELAND,IL,292,238,-54,0.4490566037735849
GROVELAND,MA,1560,1700,140,0.5214723926380368
GROVELAND,NY,13,0,-13,0
GROVEOAK,AL,51,32,-19,0.3855421686746988
GROVEPORT,OH,6395,6441,46,0.501791835462761
GROVER,CO,11,24,13,0.6857142857142857
GROVER,MO,360,377,17,0.5115332428765265
GROVER,NC,1990,1672,-318,0.4565811032222829
GROVER,WY,28,0,-28,0
GROVER BEACH,CA,6025,5601,-424,0.4817650094615517
GROVER HILL,OH,173,178,5,0.5071225071225072
GROVERTOWN,IN,240,241,1,0.501039501039501
GROVES,TX,5673,5277,-396,0.48191780821917807
GROVESPRING,MO,137,243,106,0.6394736842105263
GROVETON,NH,918,891,-27,0.4925373134328358
GROVETON,TX,868,909,41,0.5115362971299944
GROVETOWN,GA,21442,22949,1507,0.5169741614291186
GRUETLI LAAGER,TN,266,413,147,0.6082474226804123
GRULLA,TX,327,160,-167,0.32854209445585214
GRUNDY,VA,1777,1300,-477,0.4224894377640559
GRUNDY CENTER,IA,1325,1242,-83,0.48383326840670043
GRUVER,TX,189,11,-178,0.055
GRYGLA,MN,23,0,-23,0
GUADALUPE,CA,1420,1583,163,0.5271395271395272
GUALALA,CA,1034,1072,38,0.5090218423551757
GUASTI,CA,501,96,-405,0.16080402010050251
GUATAY,CA,36,0,-36,0
GUERNEVILLE,CA,2925,2357,-568,0.44623248769405527
GUERNSEY,WY,388,270,-118,0.41033434650455924
GUEYDAN,LA,746,773,27,0.5088874259381172
GUFFEY,CO,351,353,2,0.5014204545454546
GUIDE ROCK,NE,12,0,-12,0
GUILD,NH,11,0,-11,0
GUILD,TN,87,75,-12,0.46296296296296297
GUILDERLAND,NY,4125,2709,-1416,0.39640035118525024
GUILDERLAND CENTER,NY,34,34,0,0.5
GUILDHALL,VT,62,90,28,0.5921052631578947
GUILFORD,CT,7190,8001,811,0.5266934369034296
GUILFORD,IN,433,560,127,0.5639476334340383
GUILFORD,ME,1129,1094,-35,0.49212775528565
GUILFORD,NY,214,136,-78,0.38857142857142857
GUILFORD,VT,650,660,10,0.5038167938931297
GUIN,AL,1363,1344,-19,0.49649057997783524
GULF BREEZE,FL,15319,17745,2426,0.5366864263247036
GULF SHORES,AL,15306,19985,4679,0.5662916890992038
GULF STREAM,FL,484,449,-35,0.4812433011789925
GULFPORT,FL,9771,10277,506,0.5126197126895451
GULFPORT,MS,43821,44112,291,0.5016546688956365
GULLIVER,MI,224,196,-28,0.4666666666666667
GULPH MILLS,PA,188,161,-27,0.46131805157593125
GUM SPRING,VA,171,267,96,0.6095890410958904
GUN BARREL CITY,TX,4976,5203,227,0.5111504077021318
GUNNISON,CO,8254,6622,-1632,0.44514654477009946
GUNNISON,UT,181,190,9,0.5121293800539084
GUNPOWDER,MD,30,0,-30,0
GUNTER,TX,886,1412,526,0.6144473455178416
GUNTERSVILLE,AL,6679,6957,278,0.5101936051628043
GUNTOWN,MS,1616,1574,-42,0.4934169278996865
GURDON,AR,1360,1300,-60,0.48872180451127817
GURLEY,AL,2007,2537,530,0.558318661971831
GURNEE,IL,14671,13779,-892,0.484323374340949
GUSTAVUS,AK,163,189,26,0.5369318181818182
GUSTINE,CA,2257,2124,-133,0.48482081716503084
GUSTINE,TX,69,41,-28,0.37272727272727274
GUSTON,KY,565,665,100,0.540650406504065
GUTHRIE,KY,885,680,-205,0.43450479233226835
GUTHRIE,OK,8101,8989,888,0.5259801053247514
GUTHRIE CENTER,IA,945,968,23,0.5060115002613695
GUTTENBERG,IA,1566,1253,-313,0.44448385952465413
GUTTENBERG,NJ,9270,7376,-1894,0.44310945572509913
GUY,TX,36,39,3,0.52
GUYMON,OK,4964,3589,-1375,0.41961884718812115
GUYS MILLS,PA,521,456,-65,0.46673490276356194
GUYSVILLE,OH,190,222,32,0.5388349514563107
GUYTON,GA,8076,9249,1173,0.5338528138528138
GWINN,MI,4631,3822,-809,0.45214716668638355
GWINNER,ND,323,295,-28,0.4773462783171521
GWYNEDD,PA,50,37,-13,0.42528735632183906
GWYNEDD VALLEY,PA,63,44,-19,0.411214953271028
GWYNN OAK,MD,15081,14420,-661,0.48879698993254467
GYPSUM,CO,1744,1762,18,0.5025670279520822
GYPSUM,KS,137,160,23,0.5387205387205387
GYPSY,WV,30,0,-30,0
HACIENDA HEIGHTS,CA,11777,11434,-343,0.4926112619016845
HACIENDA HTS,CA,532,534,2,0.50093808630394
HACKBERRY,LA,307,169,-138,0.3550420168067227
HACKENSACK,MN,2062,2042,-20,0.4975633528265107
HACKENSACK,NJ,20859,17158,-3701,0.45132440750190705
HACKETT,AR,2243,1150,-1093,0.3389330975537872
HACKETTSTOWN,NJ,9838,9592,-246,0.4936695831188883
HACKLEBURG,AL,758,617,-141,0.44872727272727275
HADDAM,CT,873,915,42,0.511744966442953
HADDOCK,GA,299,266,-33,0.47079646017699117
HADDON HEIGHTS,NJ,1819,1857,38,0.5051686615886833
HADDON HGTS,NJ,51,51,0,0.5
HADDON HTS,NJ,35,46,11,0.5679012345679012
HADDON TOWNSHIP,NJ,1624,1488,-136,0.4781491002570694
HADDONFIELD,NJ,5423,5528,105,0.5047940827321705
HADLEY,MA,2411,2250,-161,0.48272902810555673
HADLEY,MI,0,11,11,1
HADLEY,NY,1531,1462,-69,0.4884731039091213
HADLEY,PA,583,402,-181,0.40812182741116754
HAGAMAN,NY,394,383,-11,0.4929214929214929
HAGAN,GA,14,0,-14,0
HAGER CITY,WI,497,590,93,0.5427782888684453
HAGERHILL,KY,570,613,43,0.518174133558749
HAGERMAN,ID,995,1133,138,0.5324248120300752
HAGERMAN,NM,537,431,-106,0.4452479338842975
HAGERSTOWN,IN,1334,1156,-178,0.4642570281124498
HAGERSTOWN,MD,43051,40977,-2074,0.48765887561289095
HAGUE,NY,796,637,-159,0.44452198185624564
HAGUE,VA,395,415,20,0.5123456790123457
HAHIRA,GA,4642,5358,716,0.5358
HAHNVILLE,LA,759,873,114,0.5349264705882353
HAIGLER,NE,23,0,-23,0
HAIKU,HI,4699,4426,-273,0.48504109589041094
HAILEY,ID,3836,4150,314,0.5196594039569247
HAILEYVILLE,OK,34,67,33,0.6633663366336634
HAINES,AK,1363,984,-379,0.4192586280357904
HAINES,FL,13,22,9,0.6285714285714286
HAINES,OR,92,71,-21,0.43558282208588955
HAINES CITY,FL,24775,31520,6745,0.559907629451994
HAINES FALLS,NY,126,97,-29,0.4349775784753363
HAINESPORT,NJ,1489,1538,49,0.5080938222662702
HAINESPORT TOWNSHIP,NJ,31,36,5,0.5373134328358209
HAINESVILLE,IL,825,807,-18,0.4944852941176471
HAKALAU,HI,0,15,15,1
HALCOTT CENTER,NY,25,0,-25,0
HALE,MI,2864,2470,-394,0.4630671166104237
HALE,MO,146,100,-46,0.4065040650406504
HALE CENTER,TX,354,261,-93,0.424390243902439
HALEDON,NJ,3117,3070,-47,0.49620171326975915
HALEIWA,HI,3638,3431,-207,0.4853586080067902
HALES CORNERS,WI,3606,3291,-315,0.4771639843410178
HALES LOCATION,NH,42,35,-7,0.45454545454545453
HALESITE,NY,1218,1254,36,0.5072815533980582
HALETHORPE,MD,11748,10326,-1422,0.4677901603696657
HALEYVILLE,AL,4709,4179,-530,0.47018451845184517
HALF MOON BAY,CA,4383,4262,-121,0.49300173510699824
HALF WAY,MO,398,457,59,0.5345029239766081
HALFMOON,NY,5687,5383,-304,0.48626919602529356
HALFWAY,OR,266,263,-3,0.497164461247637
HALIFAX,MA,2377,2120,-257,0.4714253947075828
HALIFAX,NC,347,394,47,0.5317139001349528
HALIFAX,PA,2065,2147,82,0.5097340930674265
HALIFAX,VA,1623,1787,164,0.5240469208211144
HALL,MT,0,13,13,1
HALLAM,NE,13,11,-2,0.4583333333333333
HALLAM,PA,469,479,10,0.5052742616033755
HALLANDALE,FL,5208,5512,304,0.514179104477612
HALLANDALE BEACH,FL,24562,23284,-1278,0.48664465159051956
HALLETTSVILLE,TX,2156,2366,210,0.5232198142414861
HALLIDAY,ND,96,40,-56,0.29411764705882354
HALLOCK,MN,364,135,-229,0.27054108216432865
HALLOWELL,ME,1452,1480,28,0.504774897680764
HALLS,TN,1677,1693,16,0.502373887240356
HALLSBORO,NC,195,264,69,0.5751633986928104
HALLSTEAD,PA,1254,1195,-59,0.4879542670477746
HALLSVILLE,MO,1543,1567,24,0.5038585209003216
HALLSVILLE,TX,3763,4107,344,0.5218551461245236
HALLTOWN,WV,30,0,-30,0
HALLWOOD,VA,34,11,-23,0.24444444444444444
HALSEY,OR,525,510,-15,0.4927536231884058
HALSTAD,MN,143,81,-62,0.36160714285714285
HALSTEAD,KS,1359,1215,-144,0.47202797202797203
HALTOM CITY,TX,16061,14321,-1740,0.4713646237904022
HAM LAKE,MN,853,820,-33,0.49013747758517634
HAMBLETON,WV,11,0,-11,0
HAMBURG,AR,1758,1709,-49,0.4929333717911739
HAMBURG,IA,637,498,-139,0.43876651982378856
HAMBURG,LA,11,0,-11,0
HAMBURG,MI,27,29,2,0.5178571428571429
HAMBURG,MN,62,24,-38,0.27906976744186046
HAMBURG,NJ,3788,3940,152,0.5098343685300207
HAMBURG,NY,15301,15160,-141,0.4976855651488789
HAMBURG,PA,3662,3616,-46,0.49683979115141524
HAMBURG TWP,MI,117,91,-26,0.4375
HAMDEN,CT,22968,22787,-181,0.49802207409026333
HAMDEN,NY,153,161,8,0.5127388535031847
HAMDEN,OH,392,380,-12,0.49222797927461137
HAMEL,IL,40,28,-12,0.4117647058823529
HAMEL,MN,1503,2100,597,0.5828476269775187
HAMER,SC,215,323,108,0.6003717472118959
HAMERSVILLE,OH,1024,1011,-13,0.4968058968058968
HAMILTON,AL,4358,3838,-520,0.46827720839433873
HAMILTON,GA,1467,1675,208,0.5330999363462763
HAMILTON,IL,1295,1110,-185,0.46153846153846156
HAMILTON,IN,1596,1521,-75,0.4879692011549567
HAMILTON,MA,38,25,-13,0.3968253968253968
HAMILTON,MI,1815,1924,109,0.5145760898635999
HAMILTON,MO,1249,1223,-26,0.4947411003236246
HAMILTON,MS,703,656,-47,0.48270787343635024
HAMILTON,MT,7837,8266,429,0.5133204992858473
HAMILTON,NJ,8667,8817,150,0.5042896362388469
HAMILTON,NY,2026,1887,-139,0.4822386915410171
HAMILTON,OH,35366,34249,-1117,0.4919773037420096
HAMILTON,TX,2041,2024,-17,0.49790897908979087
HAMILTON,VA,892,1193,301,0.5721822541966427
HAMILTON,WA,31,0,-31,0
HAMILTON CITY,CA,417,42,-375,0.0915032679738562
HAMILTON SQ,NJ,300,294,-6,0.494949494949495
HAMILTON SQUARE,NJ,248,246,-2,0.4979757085020243
HAMLER,OH,291,143,-148,0.3294930875576037
HAMLET,IN,577,629,52,0.521558872305141
HAMLET,NC,3888,3392,-496,0.46593406593406594
HAMLIN,ME,32,23,-9,0.41818181818181815
HAMLIN,NY,2341,2283,-58,0.4937283737024221
HAMLIN,PA,161,16,-145,0.0903954802259887
HAMLIN,TX,1152,817,-335,0.414931437277806
HAMLIN,WV,843,799,-44,0.4866017052375152
HAMLTON,NJ,186,119,-67,0.3901639344262295
HAMMETT,ID,78,48,-30,0.38095238095238093
HAMMON,OK,27,11,-16,0.2894736842105263
HAMMOND,IL,12,25,13,0.6756756756756757
HAMMOND,IN,24468,21151,-3317,0.46364453407571404
HAMMOND,LA,17200,16038,-1162,0.4825200072206511
HAMMOND,MN,36,22,-14,0.3793103448275862
HAMMOND,NY,1556,1357,-199,0.46584277377274286
HAMMOND,OR,621,735,114,0.5420353982300885
HAMMOND,WI,1208,1261,53,0.5107330903199676
HAMMONDSPORT,NY,2191,2062,-129,0.48483423465788855
HAMMONDSVILLE,OH,24,11,-13,0.3142857142857143
HAMMONTON,NJ,6345,6515,170,0.5066096423017107
HAMPDEN,MA,1255,1395,140,0.5264150943396226
HAMPDEN,ME,3228,3312,84,0.5064220183486239
HAMPDEN TOWNSHIP,PA,309,371,62,0.5455882352941176
HAMPSHIRE,IL,3583,4265,682,0.5434505606523955
HAMPSHIRE,TN,207,337,130,0.6194852941176471
HAMPSTEAD,MD,3642,3950,308,0.5202845100105374
HAMPSTEAD,NC,10270,13050,2780,0.5596054888507719
HAMPSTEAD,NH,2307,2350,43,0.5046167060339274
HAMPTON,AR,709,888,179,0.5560425798371947
HAMPTON,CT,568,617,49,0.5206751054852321
HAMPTON,FL,362,543,181,0.6
HAMPTON,GA,19723,22226,2503,0.5298338458604496
HAMPTON,IA,2323,2073,-250,0.471565059144677
HAMPTON,IL,618,535,-83,0.4640069384215091
HAMPTON,MN,440,354,-86,0.44584382871536526
HAMPTON,NE,35,24,-11,0.4067796610169492
HAMPTON,NH,8856,8876,20,0.5005639521768555
HAMPTON,NJ,1181,1234,53,0.5109730848861284
HAMPTON,NY,0,29,29,1
HAMPTON,SC,1231,1157,-74,0.48450586264656614
HAMPTON,TN,1248,1431,183,0.5341545352743561
HAMPTON,VA,67780,62916,-4864,0.48139193242333356
HAMPTON BAYS,NY,7355,5886,-1469,0.4445283588852806
HAMPTON FALLS,NH,843,1075,232,0.5604796663190824
HAMPTONVILLE,NC,1158,1319,161,0.5324989907145741
HAMSHIRE,TX,263,223,-40,0.4588477366255144
HAMTRAMCK,MI,8959,6794,-2165,0.4312829302355107
HANA,HI,229,167,-62,0.4217171717171717
HANAHAN,SC,8347,7532,-815,0.4743371748850683
HANALEI,HI,797,632,-165,0.44226731980405876
HANAMAULU,HI,11,0,-11,0
HANAPEPE,HI,109,114,5,0.5112107623318386
HANCEVILLE,AL,4832,4880,48,0.5024711696869851
HANCOCK,IA,11,0,-11,0
HANCOCK,MA,43,43,0,0.5
HANCOCK,MD,1251,1205,-46,0.49063517915309446
HANCOCK,ME,1210,1469,259,0.5483389324374767
HANCOCK,MI,3508,3047,-461,0.464836003051106
HANCOCK,MN,264,197,-67,0.42733188720173537
HANCOCK,NH,487,620,133,0.5600722673893406
HANCOCK,NY,1248,1125,-123,0.4740834386852086
HANCOCK,VT,11,12,1,0.5217391304347826
HANCOCK,WI,798,721,-77,0.47465437788018433
HANCOCKS BRIDGE,NJ,0,11,11,1
HANFORD,CA,23427,21589,-1838,0.47958503643149103
HANGERTOWN,MD,208,159,-49,0.4332425068119891
HANKAMER,TX,12,0,-12,0
HANKINSON,ND,466,382,-84,0.45047169811320753
HANLEY FALLS,MN,11,11,0,0.5
HANNA,IN,248,91,-157,0.26843657817109146
HANNA,OK,0,12,12,1
HANNA,UT,12,0,-12,0
HANNA,WY,108,52,-56,0.325
HANNA CITY,IL,891,798,-93,0.4724689165186501
HANNACROIX,NY,62,93,31,0.6
HANNAWA FALLS,NY,64,70,6,0.5223880597014925
HANNIBAL,MO,13302,10249,-3053,0.43518321939620397
HANNIBAL,NY,1687,1537,-150,0.47673697270471466
HANOVER,IL,553,358,-195,0.3929747530186608
HANOVER,IN,2194,2127,-67,0.49224716500809995
HANOVER,KS,59,12,-47,0.16901408450704225
HANOVER,MA,3424,3741,317,0.5221214235868806
HANOVER,MD,11766,13961,2195,0.5426594628211606
HANOVER,ME,18,0,-18,0
HANOVER,MI,765,599,-166,0.43914956011730205
HANOVER,MN,692,956,264,0.5800970873786407
HANOVER,NH,3784,3388,-396,0.4723926380368098
HANOVER,NM,0,13,13,1
HANOVER,PA,20925,21094,169,0.5020109950260596
HANOVER,VA,637,926,289,0.5924504158669226
HANOVER PARK,IL,10300,8687,-1613,0.45752356875757094
HANOVER TOWNSHIP,PA,3872,3828,-44,0.49714285714285716
HANOVERTON,OH,623,499,-124,0.4447415329768271
HANSCOM AFB,MA,1316,1245,-71,0.4861382272549785
HANSEN,ID,636,570,-66,0.472636815920398
HANSKA,MN,123,52,-71,0.29714285714285715
HANSON,KY,767,860,93,0.5285802089735709
HANSON,MA,2400,2866,466,0.5442461071021648
HANSTON,KS,23,0,-23,0
HANSVILLE,WA,1104,1368,264,0.5533980582524272
HAPEVILLE,GA,2217,2195,-22,0.49750679963735267
HAPPY,TX,0,102,102,1
HAPPY CAMP,CA,432,154,-278,0.2627986348122867
HAPPY JACK,AZ,425,548,123,0.5632065775950668
HAPPY VALLEY,OR,14360,15273,913,0.5154051226672965
HARAHAN,LA,413,391,-22,0.486318407960199
HARBERT,MI,184,139,-45,0.43034055727554177
HARBESON,DE,629,1149,520,0.6462317210348706
HARBINGER,NC,33,60,27,0.6451612903225806
HARBOR BEACH,MI,1593,1379,-214,0.4639973082099596
HARBOR CITY,CA,6467,6154,-313,0.48760003169320976
HARBOR SPGS,MI,938,650,-288,0.4093198992443325
HARBOR SPRINGS,MI,5385,5497,112,0.5051461128469031
HARBORCREEK,PA,690,628,-62,0.4764795144157815
HARBORSIDE,ME,81,106,25,0.5668449197860963
HARCOURT,IA,45,20,-25,0.3076923076923077
HARDEEVILLE,SC,3556,5002,1446,0.5844823556905819
HARDENVILLE,MO,11,0,-11,0
HARDIN,IL,221,74,-147,0.25084745762711863
HARDIN,KY,1093,1150,57,0.5127061970575123
HARDIN,MO,120,163,43,0.5759717314487632
HARDIN,MT,1719,1339,-380,0.4378678875081753
HARDIN,TX,52,86,34,0.6231884057971014
HARDING,PA,802,689,-113,0.46210596914822266
HARDINSBURG,IN,629,474,-155,0.42973708068902994
HARDINSBURG,KY,2064,1972,-92,0.4886025768087215
HARDWICK,GA,68,224,156,0.7671232876712328
HARDWICK,MA,24,17,-7,0.4146341463414634
HARDWICK,MN,0,11,11,1
HARDWICK,NJ,318,378,60,0.5431034482758621
HARDWICK,VT,1149,917,-232,0.44385285575992256
HARDY,AR,1806,1977,171,0.5226011102299762
HARDY,KY,47,0,-47,0
HARDY,VA,2087,2413,326,0.5362222222222223
HARDYVILLE,KY,573,518,-55,0.4747937671860678
HARGILL,TX,11,0,-11,0
HARKER HEIGHTS,TX,14748,14807,59,0.5009981390627644
HARKER HTS,TX,2583,2308,-275,0.47188713964424456
HARKERS ISLAND,NC,157,273,116,0.6348837209302326
HARLAN,IA,3063,2776,-287,0.475423873951019
HARLAN,IN,529,518,-11,0.49474689589302767
HARLAN,KY,1616,1481,-135,0.4782047142395867
HARLEM,GA,2663,3303,640,0.5536372779081462
HARLEM,MT,1218,406,-812,0.25
HARLETON,TX,1365,780,-585,0.36363636363636365
HARLEYSVILLE,PA,6658,6574,-84,0.49682587666263606
HARLEYVILLE,SC,370,531,161,0.5893451720310766
HARLINGEN,TX,22975,26514,3539,0.5357554203964517
HARLOWTON,MT,293,266,-27,0.47584973166368516
HARMAN,WV,12,11,-1,0.4782608695652174
HARMONY,FL,1359,2158,799,0.6135911288029571
HARMONY,IN,0,11,11,1
HARMONY,ME,122,151,29,0.5531135531135531
HARMONY,MN,601,601,0,0.5
HARMONY,NC,1235,1465,230,0.5425925925925926
HARMONY,PA,1228,1589,361,0.5640752573659922
HARNED,KY,394,348,-46,0.46900269541778977
HAROLD,KY,923,714,-209,0.436163714111179
HARPER,KS,764,754,-10,0.49670619235836627
HARPER,TX,820,1024,204,0.5553145336225597
HARPER WOODS,MI,6058,5344,-714,0.4686897035607788
HARPERS FERRY,IA,360,353,-7,0.4950911640953717
HARPERS FERRY,WV,3611,3885,274,0.5182764140875133
HARPERSFIELD,NY,12,0,-12,0
HARPERSVILLE,AL,533,630,97,0.5417024935511608
HARPSTER,ID,101,134,33,0.5702127659574469
HARPSTER,OH,15,0,-15,0
HARPSWELL,ME,2695,2876,181,0.5162448393466164
HARPURSVILLE,NY,1368,1254,-114,0.4782608695652174
HARRAH,OK,3901,4103,202,0.5126186906546727
HARRAH,WA,128,22,-106,0.14666666666666667
HARRELLS,NC,373,348,-25,0.4826629680998613
HARRIET,AR,0,26,26,1
HARRIETTA,MI,89,90,1,0.5027932960893855
HARRIMAN,NY,1825,1404,-421,0.43480953855682875
HARRIMAN,TN,6687,6439,-248,0.4905531007161359
HARRINGTON,DE,3792,3685,-107,0.4928447238197138
HARRINGTON,ME,169,237,68,0.583743842364532
HARRINGTON,WA,52,74,22,0.5873015873015873
HARRINGTON PARK,NJ,968,1246,278,0.5627822944896116
HARRINGTON PK,NJ,37,39,2,0.5131578947368421
HARRIS,MN,1142,1127,-15,0.49669457910973996
HARRISBURG,AR,2291,2167,-124,0.4860924181247196
HARRISBURG,IL,5923,5096,-827,0.4624739087031491
HARRISBURG,MO,546,455,-91,0.45454545454545453
HARRISBURG,NC,5300,6673,1373,0.557337342353629
HARRISBURG,NE,11,0,-11,0
HARRISBURG,OR,2274,2016,-258,0.4699300699300699
HARRISBURG,PA,82275,78833,-3442,0.4893177247560643
HARRISBURG,SD,3326,3716,390,0.5276909968758875
HARRISON,AR,13338,12760,-578,0.4889263545099241
HARRISON,GA,68,104,36,0.6046511627906976
HARRISON,ID,916,1006,90,0.5234131113423517
HARRISON,ME,1314,1451,137,0.5247739602169982
HARRISON,MI,7419,7033,-386,0.48664544699695544
HARRISON,MT,0,11,11,1
HARRISON,NE,0,11,11,1
HARRISON,NJ,9907,8542,-1365,0.4630061249932246
HARRISON,NY,4008,4099,91,0.5056124336992722
HARRISON,OH,6583,7379,796,0.528505944707062
HARRISON,TN,4760,4507,-253,0.4863494118916586
HARRISON CITY,PA,766,824,58,0.5182389937106918
HARRISON TOWNSHIP,MI,10885,9663,-1222,0.4702647459606774
HARRISON TWP,MI,307,203,-104,0.3980392156862745
HARRISON VALLEY,PA,0,18,18,1
HARRISONBURG,LA,35,14,-21,0.2857142857142857
HARRISONBURG,VA,25556,22475,-3081,0.467926963835856
HARRISONVILLE,MO,5578,5586,8,0.5003582945180939
HARRISONVILLE,NJ,17,0,-17,0
HARRISONVILLE,PA,49,71,22,0.5916666666666667
HARRISVILLE,MI,1277,1235,-42,0.491640127388535
HARRISVILLE,MS,44,34,-10,0.4358974358974359
HARRISVILLE,NH,279,301,22,0.5189655172413793
HARRISVILLE,NY,1311,978,-333,0.4272608125819135
HARRISVILLE,PA,913,794,-119,0.4651435266549502
HARRISVILLE,RI,1838,1882,44,0.5059139784946236
HARRISVILLE,UT,1025,1217,192,0.5428189116859946
HARRISVILLE,WV,1181,908,-273,0.4346577309717568
HARROD,OH,817,698,-119,0.46072607260726073
HARRODS CREEK,KY,0,11,11,1
HARRODSBURG,KY,8877,8478,-399,0.488504753673293
HARROGATE,TN,1962,1848,-114,0.48503937007874015
HARSENS IS,MI,11,0,-11,0
HARSENS ISLAND,MI,837,537,-300,0.39082969432314413
HARSHAW,WI,402,463,61,0.5352601156069364
HART,MI,2909,2473,-436,0.45949461166852473
HARTFIELD,VA,397,566,169,0.5877466251298027
HARTFORD,AL,2095,2072,-23,0.4972402207823374
HARTFORD,AR,231,266,35,0.5352112676056338
HARTFORD,CT,68530,56124,-12406,0.4502382595023024
HARTFORD,IA,129,55,-74,0.29891304347826086
HARTFORD,IL,285,128,-157,0.3099273607748184
HARTFORD,KS,97,113,16,0.5380952380952381
HARTFORD,KY,2332,2422,90,0.509465713083719
HARTFORD,ME,332,404,72,0.5489130434782609
HARTFORD,MI,1891,1823,-68,0.49084544964997306
HARTFORD,NY,111,38,-73,0.2550335570469799
HARTFORD,SD,1925,1858,-67,0.4911445942373777
HARTFORD,TN,74,131,57,0.6390243902439025
HARTFORD,VT,36,77,41,0.6814159292035398
HARTFORD,WI,8579,8179,-400,0.48806540159923617
HARTFORD CITY,IN,4091,3715,-376,0.47591596208045095
HARTINGTON,NE,648,615,-33,0.48693586698337293
HARTLAND,ME,960,920,-40,0.48936170212765956
HARTLAND,MI,2265,2181,-84,0.49055330634278005
HARTLAND,MN,24,0,-24,0
HARTLAND,VT,649,773,124,0.5436005625879043
HARTLAND,WI,7236,7825,589,0.5195538144877498
HARTLEY,IA,1014,906,-108,0.471875
HARTLY,DE,1170,1260,90,0.5185185185185185
HARTMAN,AR,645,713,68,0.5250368188512519
HARTS,WV,218,204,-14,0.4834123222748815
HARTSBURG,IL,36,16,-20,0.3076923076923077
HARTSBURG,MO,529,610,81,0.5355575065847235
HARTSDALE,NY,4208,4184,-24,0.49857006673021925
HARTSEL,CO,1131,790,-341,0.4112441436751692
HARTSELLE,AL,9091,8353,-738,0.47884659481770236
HARTSFIELD,GA,11,0,-11,0
HARTSHORN,MO,15,27,12,0.6428571428571429
HARTSHORNE,OK,1148,1062,-86,0.4805429864253394
HARTSTOWN,PA,33,11,-22,0.25
HARTSVILLE,IN,29,54,25,0.6506024096385542
HARTSVILLE,SC,8350,8516,166,0.5049211431281869
HARTSVILLE,TN,2974,3246,272,0.5218649517684888
HARTVILLE,MO,1336,1314,-22,0.4958490566037736
HARTVILLE,OH,3048,2903,-145,0.48781717358427157
HARTWELL,GA,5316,6237,921,0.5398597766813814
HARTWICK,NY,264,198,-66,0.42857142857142855
HARTWOOD,VA,13,0,-13,0
HARVARD,IL,5090,3995,-1095,0.4397358282883875
HARVARD,MA,1395,1659,264,0.5432220039292731
HARVARD,NE,301,281,-20,0.48281786941580757
HARVEL,IL,11,0,-11,0
HARVEST,AL,7831,9592,1761,0.5505366469609138
HARVEY,IA,11,15,4,0.5769230769230769
HARVEY,IL,6497,5628,-869,0.46416494845360823
HARVEY,LA,11822,11189,-633,0.48624570857416016
HARVEY,ND,881,846,-35,0.4898668210770122
HARVEY CEDARS,NJ,2040,1448,-592,0.4151376146788991
HARVEYS LAKE,PA,1504,1320,-184,0.46742209631728043
HARVEYVILLE,KS,28,40,12,0.5882352941176471
HARVIELL,MO,322,338,16,0.5121212121212121
HARWICH,MA,4353,4906,553,0.5298628361594124
HARWICH PORT,MA,2005,2164,159,0.5190693211801392
HARWICK,PA,40,57,17,0.5876288659793815
HARWINTON,CT,1490,1662,172,0.5272842639593909
HARWOOD,MD,879,816,-63,0.4814159292035398
HARWOOD,MO,26,0,-26,0
HARWOOD,ND,119,96,-23,0.44651162790697674
HARWOOD,TX,22,40,18,0.6451612903225806
HARWOOD HEIGHTS,IL,3321,3276,-45,0.4965893587994543
HASBROUCK HEIGHTS,NJ,2836,2717,-119,0.48928507113272107
HASBROUCK HTS,NJ,359,327,-32,0.47667638483965014
HASKELL,NJ,1369,1322,-47,0.49126718691936083
HASKELL,OK,1578,1580,2,0.5003166561114629
HASKELL,TX,1196,1176,-20,0.4957841483979764
HASKINS,OH,139,67,-72,0.32524271844660196
HASLET,TX,9740,15649,5909,0.6163692937886486
HASLETT,MI,6309,5435,-874,0.4627895095367847
HASTINGS,FL,2208,2641,433,0.5446483811095071
HASTINGS,IA,0,12,12,1
HASTINGS,MI,8416,7522,-894,0.4719538210565943
HASTINGS,MN,11338,10867,-471,0.4893942805674398
HASTINGS,NE,13808,10532,-3276,0.43270336894001643
HASTINGS,NY,773,703,-70,0.47628726287262874
HASTINGS,OK,13,34,21,0.723404255319149
HASTINGS,PA,395,243,-152,0.38087774294670845
HASTINGS HDSN,NY,322,303,-19,0.4848
HASTINGS ON HUDSON,NY,2363,2334,-29,0.49691292314243135
HASTY,CO,0,15,15,1
HATBORO,PA,5796,5658,-138,0.4939759036144578
HATCH,NM,55,48,-7,0.46601941747572817
HATCH,UT,54,15,-39,0.21739130434782608
HATFIELD,AR,478,433,-45,0.47530186608122943
HATFIELD,MA,856,828,-28,0.4916864608076009
HATFIELD,PA,6300,5776,-524,0.4783040741967539
HATLEY,WI,680,733,53,0.5187544232130219
HATTERAS,NC,11,92,81,0.8932038834951457
HATTIESBURG,MS,36396,31822,-4574,0.4664751238676009
HATTIEVILLE,AR,255,286,31,0.5286506469500925
HATTON,ND,255,154,-101,0.3765281173594132
HAUBSTADT,IN,937,1026,89,0.5226693835965359
HAUGAN,MT,14,0,-14,0
HAUGEN,WI,0,16,16,1
HAUGHTON,LA,7036,7083,47,0.50166442382605
HAUPPAUGE,NY,6552,6280,-272,0.48940149625935164
HAUSER,ID,472,659,187,0.5826702033598585
HAUULA,HI,1887,1357,-530,0.4183107274969174
HAVANA,AR,188,272,84,0.591304347826087
HAVANA,FL,3011,3399,388,0.5302652106084244
HAVANA,IL,2214,1882,-332,0.45947265625
HAVELOCK,IA,12,12,0,0.5
HAVELOCK,NC,14014,10525,-3489,0.4289090834997351
HAVEN,KS,750,699,-51,0.4824016563146998
HAVERFORD,PA,2421,2631,210,0.5207838479809976
HAVERHILL,FL,566,592,26,0.5112262521588946
HAVERHILL,IA,17,0,-17,0
HAVERHILL,MA,24423,23815,-608,0.49369791450723494
HAVERHILL,NH,14,11,-3,0.44
HAVERSTRAW,NY,4818,3823,-995,0.44242564517995603
HAVERTOWN,PA,7240,7698,458,0.5153300307939483
HAVILAH,CA,0,15,15,1
HAVILAND,KS,69,29,-40,0.29591836734693877
HAVRE,MT,6391,5094,-1297,0.44353504571179797
HAVRE DE GRACE,MD,7992,7728,-264,0.4916030534351145
HAW RIVER,NC,1777,2151,374,0.5476069246435845
HAWAII NATIONAL PARK,HI,13,25,12,0.6578947368421053
HAWAIIAN GARDENS,CA,2522,1830,-692,0.42049632352941174
HAWAIIAN GDNS,CA,76,77,1,0.5032679738562091
HAWARDEN,IA,1218,1099,-119,0.4743202416918429
HAWESVILLE,KY,1361,1456,95,0.5168619098331558
HAWI,HI,155,440,285,0.7394957983193278
HAWICK,MN,61,70,9,0.5343511450381679
HAWK POINT,MO,948,752,-196,0.4423529411764706
HAWK RUN,PA,11,0,-11,0
HAWKEYE,IA,93,36,-57,0.27906976744186046
HAWKINS,TX,1253,1554,301,0.5536159600997507
HAWKINS,WI,67,23,-44,0.25555555555555554
HAWKINSVILLE,GA,3673,3602,-71,0.49512027491408933
HAWKS,MI,97,74,-23,0.4327485380116959
HAWLEY,MA,92,53,-39,0.36551724137931035
HAWLEY,MN,1263,1192,-71,0.4855397148676171
HAWLEY,PA,5823,5604,-219,0.49041743239695457
HAWLEY,TX,964,1185,221,0.5514192647743137
HAWLEYVILLE,CT,0,15,15,1
HAWORTH,NJ,747,922,175,0.5524266027561414
HAWORTH,OK,267,384,117,0.5898617511520737
HAWTHORN,PA,34,0,-34,0
HAWTHORN WOODS,IL,1313,1449,136,0.5246198406951484
HAWTHORNE,CA,28713,23862,-4851,0.45386590584878744
HAWTHORNE,FL,4429,4049,-380,0.47758905402217505
HAWTHORNE,NJ,5442,5278,-164,0.4923507462686567
HAWTHORNE,NV,1962,1068,-894,0.35247524752475246
HAWTHORNE,NY,1070,1173,103,0.5229603209986625
HAWTHORNE,WI,0,12,12,1
HAXTUN,CO,508,477,-31,0.4842639593908629
HAY SPRINGS,NE,110,126,16,0.5338983050847458
HAYDEN,AL,2245,2521,276,0.528955098615191
HAYDEN,CO,984,1023,39,0.5097159940209267
HAYDEN,ID,12031,13570,1539,0.5300574196320457
HAYDENVILLE,MA,267,299,32,0.5282685512367491
HAYDENVILLE,OH,18,0,-18,0
HAYES,LA,14,0,-14,0
HAYES,VA,4554,4198,-356,0.4796617915904936
HAYES CENTER,NE,12,0,-12,0
HAYESVILLE,NC,4140,5077,937,0.5508299880655311
HAYFIELD,MN,868,777,-91,0.4723404255319149
HAYFORK,CA,757,599,-158,0.441740412979351
HAYMARKET,VA,7738,9672,1934,0.5555427914991384
HAYNESVILLE,LA,960,896,-64,0.4827586206896552
HAYNESVILLE,ME,0,11,11,1
HAYNEVILLE,AL,550,513,-37,0.4825964252116651
HAYS,KS,13071,10810,-2261,0.4526611113437461
HAYS,MT,81,41,-40,0.3360655737704918
HAYS,NC,688,608,-80,0.4691358024691358
HAYSI,VA,864,749,-115,0.4643521388716677
HAYSVILLE,KS,6246,5748,-498,0.4792396198099049
HAYTI,MO,3520,2259,-1261,0.39089807925246584
HAYTI,SD,50,22,-28,0.3055555555555556
HAYWARD,CA,63599,53713,-9886,0.4578644980905619
HAYWARD,MN,0,11,11,1
HAYWARD,WI,6931,7151,220,0.5078113904274961
HAZARD,KY,4094,3806,-288,0.4817721518987342
HAZEL,KY,471,420,-51,0.4713804713804714
HAZEL CREST,IL,5228,4957,-271,0.48669612174766813
HAZEL DELL,IL,18,21,3,0.5384615384615384
HAZEL GREEN,AL,4248,5397,1149,0.5595645412130638
HAZEL GREEN,KY,68,123,55,0.643979057591623
HAZEL GREEN,WI,905,856,-49,0.48608745031232253
HAZEL HURST,PA,14,0,-14,0
HAZEL PARK,MI,7384,6314,-1070,0.46094320338735584
HAZELHURST,WI,688,662,-26,0.49037037037037035
HAZELTON,ID,345,283,-62,0.45063694267515925
HAZELTON,ND,11,0,-11,0
HAZELWOOD,MO,9208,8141,-1067,0.46924894806617096
HAZELWOOD,NC,0,17,17,1
HAZELWOOD,PA,70,83,13,0.5424836601307189
HAZEN,AR,554,606,52,0.5224137931034483
HAZEN,ND,1461,1192,-269,0.449302676215605
HAZLE TOWNSHIP,PA,2175,2095,-80,0.49063231850117095
HAZLEHURST,GA,5507,4957,-550,0.47371941896024466
HAZLEHURST,MS,2174,2056,-118,0.48605200945626476
HAZLET,NJ,3774,4119,345,0.5218548080577727
HAZLET TOWNSHIP,NJ,461,505,44,0.5227743271221532
HAZLET TWP,NJ,128,138,10,0.518796992481203
HAZLETON,IA,713,446,-267,0.38481449525452976
HAZLETON,IN,44,36,-8,0.45
HAZLETON,PA,19129,15815,-3314,0.45258127289377287
HB,CA,505,430,-75,0.45989304812834225
HD,NV,56,64,8,0.5333333333333333
HEAD WATERS,VA,11,0,-11,0
HEADLAND,AL,2509,3043,534,0.5480907780979827
HEALDSBURG,CA,6210,6166,-44,0.4982223658694247
HEALDTON,OK,1342,1128,-214,0.45668016194331984
HEALY,AK,488,294,-194,0.37595907928388744
HEALY,KS,15,0,-15,0
HEARNE,TX,2380,2210,-170,0.48148148148148145
HEARTLAND,TX,2243,3985,1742,0.6398522800256904
HEARTWELL,NE,0,13,13,1
HEATH,MA,11,22,11,0.6666666666666666
HEATH,OH,6420,6038,-382,0.48466848611334085
HEATH,TX,1533,1862,329,0.5484536082474227
HEATH SPRINGS,SC,957,1127,170,0.5407869481765835
HEATHCOTE,NY,430,526,96,0.5502092050209205
HEATHSVILLE,VA,1486,1916,430,0.5631981187536743
HEAVENER,OK,1849,1593,-256,0.4628123184195235
HEBBRONVILLE,TX,1257,1179,-78,0.4839901477832512
HEBER,AZ,458,558,100,0.5492125984251969
HEBER,CA,1130,976,-154,0.4634377967711301
HEBER CITY,UT,8443,8852,409,0.5118242266551026
HEBER SPRINGS,AR,6543,6346,-197,0.49235782450151294
HEBO,OR,68,35,-33,0.33980582524271846
HEBRON,CT,1495,1696,201,0.5314948292071451
HEBRON,IL,894,581,-313,0.39389830508474577
HEBRON,IN,2910,2863,-47,0.4959293261735666
HEBRON,KY,4640,5089,449,0.5230753417617432
HEBRON,MD,1185,1177,-8,0.4983065198983912
HEBRON,ME,106,139,33,0.5673469387755102
HEBRON,ND,40,66,26,0.6226415094339622
HEBRON,NE,881,817,-64,0.48115429917550057
HEBRON,NH,377,432,55,0.5339925834363412
HEBRON,OH,2004,2331,327,0.5377162629757786
HECKER,IL,20,0,-20,0
HECLA,SD,18,12,-6,0.4
HECTOR,AR,685,637,-48,0.48184568835098335
HECTOR,MN,667,546,-121,0.45012366034624895
HECTOR,NY,170,212,42,0.5549738219895288
HEDGESVILLE,WV,4766,5974,1208,0.5562383612662942
HEDRICK,IA,181,167,-14,0.47988505747126436
HEENEY,CO,45,93,48,0.6739130434782609
HEFLIN,AL,2393,2728,335,0.5327084553798086
HEFLIN,LA,238,259,21,0.5211267605633803
HEGINS,PA,423,499,76,0.5412147505422994
HEIDELBERG,MS,832,856,24,0.5071090047393365
HEIDELBERG,PA,147,129,-18,0.4673913043478261
HEIDRICK,KY,22,0,-22,0
HEILWOOD,PA,13,11,-2,0.4583333333333333
HEISKELL,TN,1740,1864,124,0.5172031076581576
HEISLERVILLE,NJ,0,12,12,1
HELEN,GA,729,827,98,0.531491002570694
HELENA,AL,5209,6043,834,0.5370600782083185
HELENA,AR,1729,1459,-270,0.45765370138017564
HELENA,GA,36,32,-4,0.47058823529411764
HELENA,MO,13,11,-2,0.4583333333333333
HELENA,MT,30718,30324,-394,0.4967727138691393
HELENA,OH,180,101,-79,0.3594306049822064
HELENA,OK,23,0,-23,0
HELENDALE,CA,2051,2527,476,0.5519877675840978
HELENVILLE,WI,309,388,79,0.5566714490674318
HELENWOOD,TN,1095,1080,-15,0.496551724137931
HELLAM,PA,742,767,25,0.508283631544069
HELLERTOWN,PA,3624,3631,7,0.5004824259131634
HELMETTA,NJ,940,812,-128,0.4634703196347032
HELMVILLE,MT,0,11,11,1
HELOTES,TX,8620,9497,877,0.5242037864988685
HELPER,UT,1347,1364,17,0.5031353744005902
HELTONVILLE,IN,301,187,-114,0.3831967213114754
HEMET,CA,48378,50413,2035,0.5102995212114464
HEMINGFORD,NE,159,133,-26,0.4554794520547945
HEMINGWAY,SC,1591,1814,223,0.5327459618208517
HEMLOCK,MI,1687,1562,-125,0.48076331178824255
HEMLOCK,NY,386,346,-40,0.4726775956284153
HEMLOCK,OH,27,29,2,0.5178571428571429
HEMPHILL,TX,2575,2312,-263,0.4730918764067935
HEMPSTEAD,NY,14307,11587,-2720,0.4474781802734224
HEMPSTEAD,TX,3927,4242,315,0.519280205655527
HENAGAR,AL,1906,1663,-243,0.4659568506584477
HENDERSON,AR,52,48,-4,0.48
HENDERSON,CO,2321,2640,319,0.532150776053215
HENDERSON,IL,26,0,-26,0
HENDERSON,KY,20365,16234,-4131,0.44356403180414766
HENDERSON,MD,274,191,-83,0.410752688172043
HENDERSON,MI,11,22,11,0.6666666666666666
HENDERSON,MN,488,389,-99,0.443557582668187
HENDERSON,NC,13461,11449,-2012,0.4596146126053794
HENDERSON,NE,128,112,-16,0.4666666666666667
HENDERSON,NV,180562,192253,11691,0.5156793583949144
HENDERSON,NY,806,742,-64,0.479328165374677
HENDERSON,TN,4324,4174,-150,0.49117439397505297
HENDERSON,TX,7976,7367,-609,0.48015381607247604
HENDERSON,WV,11,12,1,0.5217391304347826
HENDERSON HARBOR,NY,107,145,38,0.5753968253968254
HENDERSON HBR,NY,30,56,26,0.6511627906976745
HENDERSONVILLE,NC,26389,29354,2965,0.5265952675672282
HENDERSONVILLE,TN,28448,30336,1888,0.5160587915078934
HENDERSONVLLE,NC,47,31,-16,0.3974358974358974
HENDRICKS,MN,264,233,-31,0.4688128772635815
HENDRIX,OK,75,25,-50,0.25
HENDRUM,MN,12,13,1,0.52
HENEFER,UT,12,0,-12,0
HENLEY,MO,0,41,41,1
HENNEPIN,IL,327,146,-181,0.3086680761099366
HENNESSEY,OK,1356,961,-395,0.41476046611998274
HENNIKER,NH,1659,1675,16,0.5023995200959808
HENNING,MN,1014,979,-35,0.49121926743602606
HENNING,TN,790,658,-132,0.4544198895027624
HENRICO,NC,562,545,-17,0.49232158988256547
HENRICO,VA,68617,65923,-2694,0.4899881076259848
HENRIETTA,MO,22,22,0,0.5
HENRIETTA,NY,4195,3738,-457,0.47119626875078785
HENRIETTA,TX,1820,1840,20,0.5027322404371585
HENRY,IL,1129,1047,-82,0.4811580882352941
HENRY,NE,117,113,-4,0.49130434782608695
HENRY,TN,358,385,27,0.5181695827725438
HENRY,VA,277,177,-100,0.3898678414096916
HENRYETTA,OK,3292,3415,123,0.5091695243775161
HENRYVILLE,IN,1706,1840,134,0.5188945290468133
HENRYVILLE,PA,1053,1177,124,0.5278026905829596
HENSLER,ND,0,14,14,1
HENSLEY,AR,1483,1584,101,0.5164656015650473
HENSONVILLE,NY,35,23,-12,0.39655172413793105
HEPHZIBAH,GA,14019,13471,-548,0.49003273917788287
HEPPNER,OR,579,535,-44,0.48025134649910234
HEPZIBAH,WV,25,0,-25,0
HERALD,CA,532,580,48,0.5215827338129496
HERBSTER,WI,29,34,5,0.5396825396825397
HERCULANEUM,MO,1374,1476,102,0.5178947368421053
HERCULES,CA,6891,6913,22,0.5007968704723269
HEREFORD,AZ,4425,4529,104,0.5058074603529149
HEREFORD,PA,442,407,-35,0.4793875147232038
HEREFORD,TX,4998,4145,-853,0.45335229137044736
HERINGTON,KS,1690,1467,-223,0.46468165980361104
HERITAGE RANCH,CA,280,310,30,0.5254237288135594
HERKIMER,NY,4819,4488,-331,0.48221768561297945
HERLONG,CA,245,217,-28,0.4696969696969697
HERMAN,MN,126,22,-104,0.14864864864864866
HERMAN,NE,65,13,-52,0.16666666666666666
HERMANN,MO,1886,1905,19,0.5025059351094698
HERMANSVILLE,MI,141,90,-51,0.38961038961038963
HERMANTOWN,MN,3196,3127,-69,0.4945437292424482
HERMANVILLE,MS,15,39,24,0.7222222222222222
HERMINIE,PA,314,326,12,0.509375
HERMISTON,OR,9108,9039,-69,0.49809885931558934
HERMITAGE,AR,134,204,70,0.6035502958579881
HERMITAGE,MO,668,738,70,0.5248933143669986
HERMITAGE,PA,6536,6314,-222,0.49136186770428014
HERMITAGE,TN,24064,22056,-2008,0.4782307025151778
HERMLEIGH,TX,25,26,1,0.5098039215686274
HERMON,ME,2525,2301,-224,0.47679237463738083
HERMON,NY,801,614,-187,0.43392226148409896
HERMOSA,SD,926,1078,152,0.5379241516966068
HERMOSA BEACH,CA,11905,10026,-1879,0.45716109616524553
HERNANDO,FL,10404,12400,1996,0.5437642518856342
HERNANDO,MS,7639,9754,2115,0.5608003219686081
HERNANDO BEACH,FL,759,1027,268,0.5750279955207167
HERNDON,KY,50,47,-3,0.4845360824742268
HERNDON,PA,319,281,-38,0.4683333333333333
HERNDON,VA,47126,44124,-3002,0.4835506849315068
HERNSHAW,WV,13,0,-13,0
HERON,MT,53,56,3,0.5137614678899083
HERON LAKE,MN,144,136,-8,0.4857142857142857
HERREID,SD,12,22,10,0.6470588235294118
HERRICK,IL,97,76,-21,0.4393063583815029
HERRIMAN,UT,15712,18862,3150,0.5455544628911899
HERRIN,IL,6233,5410,-823,0.4646568753757623
HERRON,MI,101,98,-3,0.49246231155778897
HERSCHER,IL,325,283,-42,0.4654605263157895
HERSEY,MI,1226,1125,-101,0.47851977881752444
HERSHEY,NE,258,192,-66,0.4266666666666667
HERSHEY,PA,8494,7031,-1463,0.45288244766505636
HERTFORD,NC,3466,4196,730,0.5476376925084834
HESPERIA,CA,29898,31222,1324,0.5108311518324608
HESPERIA,MI,2894,2317,-577,0.4446363461907503
HESPERUS,CO,894,1076,182,0.5461928934010152
HESSEL,MI,401,560,159,0.5827263267429761
HESSMER,LA,910,940,30,0.5081081081081081
HESSTON,KS,1773,1680,-93,0.48653344917463076
HESSTON,PA,0,24,24,1
HETH,AR,30,12,-18,0.2857142857142857
HETTICK,IL,11,11,0,0.5
HETTINGER,ND,938,576,-362,0.380449141347424
HEUVELTON,NY,628,518,-110,0.45200698080279234
HEWETT,WV,0,12,12,1
HEWITT,MN,37,44,7,0.5432098765432098
HEWITT,NJ,2054,2069,15,0.5018190637885035
HEWITT,TX,7296,6810,-486,0.48277328796256913
HEWITT,WI,0,11,11,1
HEWLETT,NY,2656,2732,76,0.5070527097253155
HEYBURN,ID,2468,2131,-337,0.4633616003479017
HEYWORTH,IL,1214,1233,19,0.5038823048630977
HGHLNDS RANCH,CO,104,119,15,0.5336322869955157
HGLND COUNTY,OH,43,61,18,0.5865384615384616
HHI,SC,343,194,-149,0.3612662942271881
HI HAT,KY,46,39,-7,0.4588235294117647
HI NELLA,NJ,234,208,-26,0.47058823529411764
HI RLS MTN PK,NM,0,14,14,1
HIALEAH,FL,116973,102327,-14646,0.4666073871409029
HIALEAH GARDENS,FL,2374,2230,-144,0.4843614248479583
HIALEAH GDNS,FL,1206,1101,-105,0.47724317295188556
HIAWASSEE,GA,4423,5368,945,0.5482586048411807
HIAWATHA,IA,6275,3715,-2560,0.3718718718718719
HIAWATHA,KS,2301,2093,-208,0.47633136094674555
HIBBING,MN,9331,7310,-2021,0.4392764857881137
HIBBS,PA,11,0,-11,0
HICKMAN,CA,44,126,82,0.7411764705882353
HICKMAN,KY,1181,1160,-21,0.49551473729175566
HICKMAN,NE,938,1321,383,0.584772023019035
HICKMAN,TN,38,107,69,0.7379310344827587
HICKORY,KY,1120,1066,-54,0.4876486733760293
HICKORY,MS,63,27,-36,0.3
HICKORY,NC,29952,30031,79,0.5006585199139756
HICKORY,PA,84,98,14,0.5384615384615384
HICKORY CORNERS,MI,525,604,79,0.5349867139061116
HICKORY CREEK,TX,921,1062,141,0.5355521936459909
HICKORY CRNRS,MI,47,15,-32,0.24193548387096775
HICKORY FLAT,MS,1016,669,-347,0.39703264094955487
HICKORY GROVE,SC,129,192,63,0.5981308411214953
HICKORY HILL,TN,391,314,-77,0.4453900709219858
HICKORY HILLS,IL,3917,3331,-586,0.45957505518763797
HICKORY RIDGE,AR,12,36,24,0.75
HICKORY VALLEY,TN,11,0,-11,0
HICKSON,ND,97,149,52,0.6056910569105691
HICKSVILLE,NY,13099,11622,-1477,0.4701266130010922
HICKSVILLE,OH,2351,1999,-352,0.4595402298850575
HICO,TX,1426,1494,68,0.5116438356164383
HICO,WV,11,24,13,0.6857142857142857
HIDALGO,TX,1145,1635,490,0.5881294964028777
HIDDEN HILLS,CA,333,349,16,0.5117302052785924
HIDDEN VALLEY,PA,11,12,1,0.5217391304347826
HIDDEN VALLEY LAKE,CA,1866,1847,-19,0.49744142203070296
HIDDEN VL LK,CA,139,130,-9,0.483271375464684
HIDDENITE,NC,1036,962,-74,0.48148148148148145
HIDEAWAY,TX,1607,1971,364,0.5508664058133035
HIDEOUT,UT,569,751,182,0.568939393939394
HIGBEE,MO,279,273,-6,0.4945652173913043
HIGDEN,AR,1031,1145,114,0.5261948529411765
HIGDON,AL,74,143,69,0.6589861751152074
HIGGANUM,CT,1367,1544,177,0.5304019237375472
HIGGINS,TX,11,0,-11,0
HIGGINS LAKE,MI,574,360,-214,0.3854389721627409
HIGGINSON,AR,35,24,-11,0.4067796610169492
HIGGINSPORT,OH,35,11,-24,0.2391304347826087
HIGGINSVILLE,MO,2508,2527,19,0.5018867924528302
HIGH BRIDGE,NJ,1049,1004,-45,0.48904042864101316
HIGH FALLS,NY,712,791,79,0.5262807717897539
HIGH HILL,MO,0,18,18,1
HIGH ISLAND,TX,34,0,-34,0
HIGH POINT,NC,47870,42515,-5355,0.47037672180118384
HIGH RIDGE,MO,5679,5233,-446,0.47956378299120234
HIGH ROLLS MOUNTAIN PARK,NM,70,43,-27,0.3805309734513274
HIGH SHOALS,NC,51,26,-25,0.33766233766233766
HIGH SPRINGS,FL,4315,5126,811,0.5429509585848956
HIGH VIEW,WV,11,28,17,0.717948717948718
HIGHGATE CENTER,VT,538,531,-7,0.49672591206735267
HIGHGATE CTR,VT,14,11,-3,0.44
HIGHGATE SPRINGS,VT,34,11,-23,0.24444444444444444
HIGHLAND,AR,150,184,34,0.5508982035928144
HIGHLAND,CA,15528,15385,-143,0.49768705722511564
HIGHLAND,IL,5635,5279,-356,0.48369067253069453
HIGHLAND,IN,7444,6852,-592,0.47929490766648014
HIGHLAND,KS,239,103,-136,0.30116959064327486
HIGHLAND,MD,752,1046,294,0.5817575083426029
HIGHLAND,MI,5407,5407,0,0.5
HIGHLAND,NY,5030,4927,-103,0.4948277593652707
HIGHLAND,UT,4987,5626,639,0.530104588711957
HIGHLAND,WI,187,178,-9,0.4876712328767123
HIGHLAND BEACH,FL,5563,7117,1554,0.5612776025236593
HIGHLAND CITY,FL,518,690,172,0.5711920529801324
HIGHLAND COUNTY,OH,47,34,-13,0.41975308641975306
HIGHLAND FALLS,NY,1761,1612,-149,0.4779128372368811
HIGHLAND FLS,NY,165,134,-31,0.44816053511705684
HIGHLAND HEIGHTS,KY,3360,2998,-362,0.4715319282793331
HIGHLAND HEIGHTS,OH,387,396,9,0.5057471264367817
HIGHLAND HGTS,KY,295,261,-34,0.4694244604316547
HIGHLAND HOME,AL,171,221,50,0.5637755102040817
HIGHLAND HTS,OH,218,199,-19,0.47721822541966424
HIGHLAND LAKE,AL,108,115,7,0.515695067264574
HIGHLAND LAKE,NY,80,63,-17,0.4405594405594406
HIGHLAND LAKES,NJ,1671,1820,149,0.5213405900887997
HIGHLAND LKS,NJ,86,76,-10,0.4691358024691358
HIGHLAND MILLS,NY,2493,2277,-216,0.47735849056603774
HIGHLAND PARK,CA,3015,2389,-626,0.442079940784604
HIGHLAND PARK,IL,12060,12824,764,0.515351229705835
HIGHLAND PARK,MI,6415,5820,-595,0.4756845116469146
HIGHLAND PARK,NJ,6924,6027,-897,0.46536946953903174
HIGHLAND SPGS,VA,108,106,-2,0.4953271028037383
HIGHLAND SPRINGS,VA,595,634,39,0.51586655817738
HIGHLAND VILLAGE,TX,4312,4850,538,0.5293604016590264
HIGHLANDS,NC,4998,4914,-84,0.4957627118644068
HIGHLANDS,NJ,2401,2395,-6,0.4993744787322769
HIGHLANDS,TX,3818,3655,-163,0.4890940719925064
HIGHLANDS RANCH,CO,38609,39111,502,0.5032295419454452
HIGHLANDVILLE,MO,645,832,187,0.5633039945836155
HIGHMORE,SD,192,116,-76,0.37662337662337664
HIGHMOUNT,NY,0,16,16,1
HIGHSPIRE,PA,1450,1394,-56,0.490154711673699
HIGHTOWN,VA,12,31,19,0.7209302325581395
HIGHTSTOWN,NJ,3276,3181,-95,0.49264364255846366
HIGHWOOD,IL,2369,1918,-451,0.44739911359925355
HIGLEY,AZ,1935,1312,-623,0.40406529103788114
HILBERT,WI,1037,890,-147,0.4618578100674624
HILDALE,UT,28,22,-6,0.44
HILDEBRAN,NC,594,643,49,0.5198059822150364
HILDRETH,NE,37,0,-37,0
HILES,WI,31,27,-4,0.46551724137931033
HILHAM,TN,823,776,-47,0.48530331457160725
HILL,NH,301,189,-112,0.38571428571428573
HILL AFB,UT,2328,1590,-738,0.4058192955589586
HILL AIR FORCE BASE,UT,1551,1007,-544,0.3936669272869429
HILL CITY,KS,950,790,-160,0.4540229885057471
HILL CITY,MN,417,446,29,0.5168018539976825
HILL CITY,SD,1265,1216,-49,0.49012494961708986
HILLBURN,NY,42,36,-6,0.46153846153846156
HILLCREST HGTS,MD,341,363,22,0.515625
HILLER,PA,13,0,-13,0
HILLIARD,FL,3154,3641,487,0.5358351729212656
HILLIARD,OH,26824,25911,-913,0.49134351000284443
HILLIARDS,PA,73,39,-34,0.3482142857142857
HILLISTER,TX,34,62,28,0.6458333333333334
HILLMAN,MI,1726,1695,-31,0.4954691610640164
HILLMAN,MN,433,335,-98,0.4361979166666667
HILLPOINT,WI,15,14,-1,0.4827586206896552
HILLROSE,CO,34,22,-12,0.39285714285714285
HILLS,IA,374,278,-96,0.4263803680981595
HILLS,MN,47,84,37,0.6412213740458015
HILLSBORO,AL,669,716,47,0.5169675090252708
HILLSBORO,IL,2639,2478,-161,0.4842681258549932
HILLSBORO,IN,356,383,27,0.5182679296346414
HILLSBORO,KS,1565,1252,-313,0.4444444444444444
HILLSBORO,KY,507,633,126,0.5552631578947368
HILLSBORO,MO,5043,5240,197,0.5095789166585627
HILLSBORO,ND,955,694,-261,0.4208611279563372
HILLSBORO,NH,83,57,-26,0.40714285714285714
HILLSBORO,NM,12,15,3,0.5555555555555556
HILLSBORO,OH,8569,8281,-288,0.4914540059347181
HILLSBORO,OR,50011,48110,-1901,0.49031298091132375
HILLSBORO,TN,1134,1285,151,0.531211244315833
HILLSBORO,TX,4520,4250,-270,0.4846066134549601
HILLSBORO,VA,1120,1340,220,0.5447154471544715
HILLSBORO,WI,1146,1065,-81,0.4816824966078697
HILLSBORO,WV,211,165,-46,0.43882978723404253
HILLSBORO BEACH,FL,2711,4498,1787,0.6239422943542794
HILLSBOROUGH,CA,1390,1342,-48,0.4912152269399707
HILLSBOROUGH,NC,8700,10348,1648,0.5432591348173037
HILLSBOROUGH,NH,3613,3355,-258,0.48148679678530426
HILLSBOROUGH,NJ,10349,12006,1657,0.537061060165511
HILLSDALE,IL,547,236,-311,0.30140485312899107
HILLSDALE,MI,6353,5860,-493,0.4798165888807009
HILLSDALE,NJ,2099,2293,194,0.5220856102003643
HILLSDALE,NY,1264,1583,319,0.5560238847910081
HILLSDALE,WI,39,50,11,0.5617977528089888
HILLSDALE,WY,11,0,-11,0
HILLSIDE,IL,2626,2566,-60,0.49422187981510013
HILLSIDE,NJ,5796,5354,-442,0.48017937219730944
HILLSVILLE,PA,16,22,6,0.5789473684210527
HILLSVILLE,VA,2883,2947,64,0.5054888507718697
HILLTOP LAKES,TX,27,33,6,0.55
HILLVIEW,KY,141,84,-57,0.37333333333333335
HILMAR,CA,2034,1787,-247,0.4676786181627846
HILO,HI,18630,16786,-1844,0.4739665687824712
HILTON,NY,5553,5777,224,0.5098852603706973
HILTON HEAD,SC,2028,2421,393,0.5441672285906946
HILTON HEAD ISLAND,SC,22326,29694,7368,0.5708189158016148
HILTONIA,GA,67,69,2,0.5073529411764706
HILTONS,VA,28,60,32,0.6818181818181818
HIMROD,NY,180,187,7,0.5095367847411444
HINCKLEY,IL,1092,892,-200,0.4495967741935484
HINCKLEY,MN,2566,2391,-175,0.4823481944724632
HINCKLEY,OH,1642,2190,548,0.5715031315240083
HINCKLEY,UT,0,15,15,1
HINDMAN,KY,513,444,-69,0.46394984326018807
HINDSVILLE,AR,394,782,388,0.6649659863945578
HINES,IL,257,1049,792,0.8032159264931087
HINES,MN,40,11,-29,0.21568627450980393
HINES,OR,696,787,91,0.5306810519217802
HINES,WV,11,0,-11,0
HINESBURG,VT,1708,1857,149,0.5208976157082749
HINESTON,LA,118,112,-6,0.48695652173913045
HINESVILLE,GA,28175,24880,-3295,0.46894731882009233
HINGHAM,MA,8138,8909,771,0.5226139496685633
HINKLEY,CA,23,61,38,0.7261904761904762
HINSDALE,IL,5840,6564,724,0.5291841341502741
HINSDALE,MA,858,927,69,0.519327731092437
HINSDALE,NH,1732,1607,-125,0.4812818209044624
HINSDALE,NY,474,494,20,0.5103305785123967
HINTON,IA,318,302,-16,0.4870967741935484
HINTON,OK,1973,1482,-491,0.42894356005788714
HINTON,WV,1597,1664,67,0.5102729224164366
HIRAM,GA,9992,10222,230,0.5056891263480756
HIRAM,ME,389,522,133,0.5729967069154775
HIRAM,OH,1031,926,-105,0.4731732243229433
HISTORIC NEW CASTLE,DE,904,835,-69,0.48016101207590567
HITCHCOCK,SD,11,0,-11,0
HITCHCOCK,TX,4344,4198,-146,0.49145399203933504
HITTERDAL,MN,11,0,-11,0
HIWASSE,AR,78,23,-55,0.22772277227722773
HIWASSEE,VA,158,119,-39,0.4296028880866426
HIXSON,TN,16668,17305,637,0.5093750919848115
HIXTON,WI,518,378,-140,0.421875
HMILTON,TX,32,39,7,0.5492957746478874
HO HO KUS,NJ,990,1171,181,0.5418787598334105
HOAGLAND,IN,280,192,-88,0.4067796610169492
HOBART,IN,12105,10792,-1313,0.47132812158798093
HOBART,NY,320,318,-2,0.49843260188087773
HOBART,OK,2218,1761,-457,0.44257351093239505
HOBART,WA,65,11,-54,0.14473684210526316
HOBBS,NM,16107,14237,-1870,0.4691866596361719
HOBBSVILLE,NC,25,15,-10,0.375
HOBE SOUND,FL,15650,17042,1392,0.521289612137526
HOBGOOD,NC,15,0,-15,0
HOBOKEN,GA,386,526,140,0.5767543859649122
HOBOKEN,NJ,40258,29122,-11136,0.4197463245892188
HOBSON,MT,23,38,15,0.6229508196721312
HOBSON CITY,AL,115,89,-26,0.4362745098039216
HOCKESSIN,DE,4037,4773,736,0.5417707150964812
HOCKLEY,TX,5146,9036,3890,0.6371456776195177
HODGE,LA,208,140,-68,0.40229885057471265
HODGEN,OK,39,11,-28,0.22
HODGENVILLE,KY,3612,3532,-80,0.4944008958566629
HODGES,AL,103,90,-13,0.46632124352331605
HODGES,SC,1187,1257,70,0.5143207855973814
HODGKINS,IL,699,709,10,0.5035511363636364
HOFFMAN,IL,60,0,-60,0
HOFFMAN,MN,253,224,-29,0.469601677148847
HOFFMAN,NC,60,25,-35,0.29411764705882354
HOFFMAN EST,IL,70,87,17,0.554140127388535
HOFFMAN ESTATES,IL,19752,18081,-1671,0.47791610498770914
HOGANSBURG,NY,762,732,-30,0.4899598393574297
HOGANSVILLE,GA,3201,3322,121,0.5092748735244519
HOHENWALD,TN,4515,4279,-236,0.48658176029110756
HOISINGTON,KS,1775,1323,-452,0.42704970948999355
HOKAH,MN,157,71,-86,0.31140350877192985
HOKES BLUFF,AL,251,236,-15,0.48459958932238195
HOLBROOK,AZ,1710,1729,19,0.5027624309392266
HOLBROOK,MA,3359,3198,-161,0.4877230440750343
HOLBROOK,NY,8580,7961,-619,0.4812889184450759
HOLBROOK,PA,23,13,-10,0.3611111111111111
HOLCOMB,KS,676,673,-3,0.4988880652335063
HOLCOMB,MO,288,306,18,0.5151515151515151
HOLCOMB,MS,292,265,-27,0.4757630161579892
HOLCOMBE,WI,1077,1010,-67,0.4839482510781025
HOLDEN,LA,1528,1518,-10,0.4983585029546947
HOLDEN,MA,4186,4475,289,0.5166839856829465
HOLDEN,ME,1944,1988,44,0.5055951169888098
HOLDEN,MO,2344,2472,128,0.5132890365448505
HOLDEN,WV,42,60,18,0.5882352941176471
HOLDEN BEACH,NC,187,232,45,0.5536992840095465
HOLDENVILLE,OK,2296,2359,63,0.5067669172932331
HOLDER,FL,11,27,16,0.7105263157894737
HOLDER,IL,22,13,-9,0.37142857142857144
HOLDERNESS,NH,1201,1092,-109,0.4762320104666376
HOLDINGFORD,MN,449,357,-92,0.44292803970223327
HOLDREGE,NE,2759,2697,-62,0.4943181818181818
HOLGATE,OH,586,483,-103,0.45182413470533206
HOLIDAY,FL,25391,27033,1642,0.5156607660613459
HOLIDAY ISLAND,AR,649,694,45,0.5167535368577811
HOLLADAY,TN,988,961,-27,0.4930733709594664
HOLLADAY,UT,5213,4761,-452,0.47734108682574694
HOLLAND,IA,11,0,-11,0
HOLLAND,IN,197,129,-68,0.39570552147239263
HOLLAND,MA,858,913,55,0.515527950310559
HOLLAND,MI,38616,34273,-4343,0.47020812468273676
HOLLAND,NE,58,56,-2,0.49122807017543857
HOLLAND,NY,1393,1209,-184,0.46464258262874714
HOLLAND,OH,6626,6281,-345,0.4866351592159293
HOLLAND,PA,2103,2104,1,0.5001188495364868
HOLLAND,TX,969,841,-128,0.46464088397790054
HOLLAND PATENT,NY,826,834,8,0.5024096385542168
HOLLAND POINT,MD,39,37,-2,0.4868421052631579
HOLLANDALE,MN,13,15,2,0.5357142857142857
HOLLANDALE,MS,531,552,21,0.5096952908587258
HOLLANDALE,WI,11,0,-11,0
HOLLANSBURG,OH,11,22,11,0.6666666666666666
HOLLEY,NY,2711,2646,-65,0.4939331715512414
HOLLIDAY,TX,588,644,56,0.5227272727272727
HOLLIDAYSBURG,PA,5391,5044,-347,0.48337326305701966
HOLLIS,NH,2296,2831,535,0.5521747610688512
HOLLIS,NY,7140,5755,-1385,0.446297014346646
HOLLIS,OK,931,719,-212,0.43575757575757573
HOLLIS CENTER,ME,1391,1637,246,0.5406208718626155
HOLLISTER,CA,15431,15716,285,0.5045750794619065
HOLLISTER,FL,195,422,227,0.6839546191247974
HOLLISTER,MO,7445,5025,-2420,0.4029671210906175
HOLLISTER,NC,415,316,-99,0.4322845417236662
HOLLISTON,MA,3767,4184,417,0.5262231165891083
HOLLOMAN AFB,NM,598,635,37,0.5150040551500406
HOLLOMAN AIR FORCE BASE,NM,2637,3110,473,0.5411519053419175
HOLLOW ROCK,TN,280,337,57,0.546191247974068
HOLLSOPPLE,PA,395,320,-75,0.44755244755244755
HOLLY,CO,160,177,17,0.5252225519287834
HOLLY,MI,8088,8322,234,0.5071297989031078
HOLLY GROVE,AR,86,24,-62,0.21818181818181817
HOLLY HILL,FL,5775,6165,390,0.5163316582914573
HOLLY HILL,SC,1251,1367,116,0.5221543162719633
HOLLY LAKE RANCH,TX,1193,1389,196,0.5379550735863672
HOLLY LK RNCH,TX,188,240,52,0.5607476635514018
HOLLY POND,AL,1083,1020,-63,0.48502139800285304
HOLLY RIDGE,NC,3986,4956,970,0.5542384254081861
HOLLY SPRINGS,GA,876,488,-388,0.35777126099706746
HOLLY SPRINGS,MS,2980,3096,116,0.5095457537853851
HOLLY SPRINGS,NC,13324,19056,5732,0.5885114268066708
HOLLYWOOD,AL,520,569,49,0.5224977043158862
HOLLYWOOD,CA,5965,5119,-846,0.46183688199206063
HOLLYWOOD,FL,100443,95329,-5114,0.4869388880943138
HOLLYWOOD,MD,2809,3032,223,0.5190891970552988
HOLLYWOOD,SC,2060,2527,467,0.5509047307608459
HOLMDEL,NJ,3970,4991,1021,0.5569690882713982
HOLMEN,WI,5869,5971,102,0.5043074324324325
HOLMES,NY,799,892,93,0.527498521584861
HOLMES,PA,671,546,-125,0.4486442070665571
HOLMES BEACH,FL,5681,7428,1747,0.5666336104966054
HOLMESVILLE,OH,220,213,-7,0.49191685912240185
HOLSTEIN,IA,792,649,-143,0.45038167938931295
HOLT,FL,1089,1384,295,0.5596441568944601
HOLT,MI,9473,9288,-185,0.49506955919194073
HOLT,MO,1176,1104,-72,0.4842105263157895
HOLTON,IN,391,362,-29,0.4807436918990704
HOLTON,KS,2243,2256,13,0.5014447655034452
HOLTON,MI,1336,1099,-237,0.4513347022587269
HOLTS SUMMIT,MO,4349,4174,-175,0.4897336618561539
HOLTSVILLE,NY,3672,3414,-258,0.48179508890770534
HOLTVILLE,CA,1836,1562,-274,0.45968216597998823
HOLTWOOD,PA,962,998,36,0.5091836734693878
HOLUALOA,HI,1363,1410,47,0.5084745762711864
HOLY CROSS,IA,56,20,-36,0.2631578947368421
HOLYOKE,CO,1338,1157,-181,0.46372745490981965
HOLYOKE,MA,19144,16242,-2902,0.4589950828011078
HOLYROOD,KS,82,25,-57,0.2336448598130841
HOME,KS,12,0,-12,0
HOME,PA,159,142,-17,0.4717607973421927
HOMEDALE,ID,1898,2006,108,0.5138319672131147
HOMELAND,CA,2114,2202,88,0.510194624652456
HOMER,AK,5664,5232,-432,0.4801762114537445
HOMER,GA,1107,1427,320,0.5631412786108919
HOMER,IL,417,361,-56,0.4640102827763496
HOMER,LA,1958,1929,-29,0.4962696166709545
HOMER,MI,1780,1668,-112,0.4837587006960557
HOMER,NE,34,0,-34,0
HOMER,NY,2564,2506,-58,0.4942800788954635
HOMER,OH,60,0,-60,0
HOMER CITY,PA,1911,1762,-149,0.47971685270895725
HOMER GLEN,IL,3992,4907,915,0.5514102708169457
HOMERVILLE,GA,1853,1581,-272,0.4603960396039604
HOMERVILLE,OH,189,114,-75,0.37623762376237624
HOMESTEAD,FL,66709,69977,3268,0.5119544064498193
HOMESTEAD,PA,5112,4581,-531,0.4726090993500464
HOMETOWN,IL,1360,1076,-284,0.44170771756978655
HOMETOWN,WV,0,12,12,1
HOMEWOOD,AL,1890,1672,-218,0.46939921392476136
HOMEWOOD,CA,882,419,-463,0.3220599538816295
HOMEWOOD,IL,6209,6387,178,0.5070657351540171
HOMEWOOD,PA,76,69,-7,0.47586206896551725
HOMEWORTH,OH,301,410,109,0.5766526019690577
HOMINY,OK,1680,1118,-562,0.3995711222301644
HOMOSASSA,FL,17628,21298,3670,0.5471407285618867
HOMOSASSA SPG,FL,46,43,-3,0.48314606741573035
HOMOSASSA SPRINGS,FL,908,1054,146,0.5372069317023446
HONAKER,VA,1158,1124,-34,0.4925503943908852
HONAUNAU,HI,72,298,226,0.8054054054054054
HONDO,TX,3525,3811,286,0.5194929116684842
HONEA JR,TX,0,11,11,1
HONEA PATH,SC,3536,3431,-105,0.49246447538395294
HONEOYE,NY,1655,1365,-290,0.4519867549668874
HONEOYE FALLS,NY,2859,2940,81,0.5069839627521987
HONESDALE,PA,4636,4552,-84,0.4954288202002612
HONEY BROOK,PA,3542,3417,-125,0.4910188245437563
HONEY CREEK,IA,24,29,5,0.5471698113207547
HONEY GROVE,PA,34,12,-22,0.2608695652173913
HONEY GROVE,TX,967,1163,196,0.5460093896713615
HONEYVILLE,UT,66,81,15,0.5510204081632653
HONOKAA,HI,1169,1233,64,0.5133222314737719
HONOLULU,HI,199495,166960,-32535,0.45560846488654816
HONOLULU,WA,11,0,-11,0
HONOMU,HI,63,199,136,0.7595419847328244
HONOR,MI,955,956,1,0.500261643118786
HONORAVILLE,AL,205,153,-52,0.4273743016759777
HOOD RIVER,OR,8498,8175,-323,0.4903136808012955
HOODSPORT,WA,1767,1482,-285,0.45614035087719296
HOOKER,OK,676,514,-162,0.4319327731092437
HOOKERTON,NC,250,295,45,0.5412844036697247
HOOKS,TX,1920,1793,-127,0.48289792620522487
HOOKSETT,NH,5437,5778,341,0.5152028533214444
HOOKSTOWN,PA,315,289,-26,0.478476821192053
HOOLEHUA,HI,11,42,31,0.7924528301886793
HOONAH,AK,65,22,-43,0.25287356321839083
HOOPA,CA,50,42,-8,0.45652173913043476
HOOPER,NE,548,514,-34,0.4839924670433145
HOOPER,UT,1960,2340,380,0.5441860465116279
HOOPER BAY,AK,13,0,-13,0
HOOPESTON,IL,3642,2967,-675,0.44893327280980483
HOOPLE,ND,49,0,-49,0
HOOSICK FALLS,NY,2041,1986,-55,0.4931710951080209
HOOVER,AL,29209,29185,-24,0.4997944994348734
HOOVERSVILLE,PA,173,156,-17,0.47416413373860183
HOP BOTTOM,PA,162,81,-81,0.3333333333333333
HOPATCONG,NJ,3554,3613,59,0.5041160876238314
HOPE,AR,5528,4712,-816,0.46015625
HOPE,ID,849,892,43,0.5123492245835727
HOPE,IN,1553,1404,-149,0.4748055461616503
HOPE,KS,68,60,-8,0.46875
HOPE,ME,481,528,47,0.5232903865213082
HOPE,MI,749,661,-88,0.46879432624113476
HOPE,ND,15,0,-15,0
HOPE,NM,11,0,-11,0
HOPE,RI,978,1255,277,0.5620241827138379
HOPE HULL,AL,1185,911,-274,0.43463740458015265
HOPE MILLS,NC,15426,15044,-382,0.49373153921890384
HOPE VALLEY,RI,1578,1667,89,0.5137134052388289
HOPEDALE,IL,294,183,-111,0.3836477987421384
HOPEDALE,MA,1795,1688,-107,0.48463967843812805
HOPEDALE,OH,369,320,-49,0.4644412191582003
HOPELAWN,NJ,302,240,-62,0.44280442804428044
HOPEWELL,IL,26,28,2,0.5185185185185185
HOPEWELL,NJ,1343,1496,153,0.5269461077844312
HOPEWELL,OH,106,129,23,0.548936170212766
HOPEWELL,PA,363,365,2,0.5013736263736264
HOPEWELL,VA,14742,10082,-4660,0.4061392201095714
HOPEWELL JCT,NY,977,948,-29,0.49246753246753244
HOPEWELL JUNCTION,NY,5343,5886,543,0.5241784664707454
HOPKINS,MI,1605,1846,241,0.5349174152419589
HOPKINS,MN,28407,25073,-3334,0.468829468960359
HOPKINS,MO,57,70,13,0.5511811023622047
HOPKINS,SC,3775,4100,325,0.5206349206349207
HOPKINSVILLE,KY,18271,17971,-300,0.49586115556536614
HOPKINTON,IA,311,163,-148,0.3438818565400844
HOPKINTON,MA,5598,6493,895,0.5370109999172938
HOPKINTON,NH,801,1019,218,0.5598901098901099
HOPKINTON,RI,17,0,-17,0
HOPLAND,CA,279,200,-79,0.4175365344467641
HOPWOOD,PA,906,774,-132,0.4607142857142857
HOQUIAM,WA,5336,4740,-596,0.4704247717348154
HORACE,ND,1092,1675,583,0.6053487531622697
HORATIO,AR,522,524,2,0.5009560229445507
HORDVILLE,NE,11,0,-11,0
HORICON,WI,2230,1975,-255,0.469678953626635
HORIZON CITY,TX,5913,8651,2738,0.5939989014007141
HORN LAKE,MS,11560,10378,-1182,0.4730604430668247
HORNBEAK,TN,655,563,-92,0.46223316912972084
HORNBECK,LA,331,323,-8,0.4938837920489297
HORNBROOK,CA,458,303,-155,0.39816031537450725
HORNELL,NY,7285,5823,-1462,0.4442325297528227
HORNER,WV,24,11,-13,0.3142857142857143
HORNERSVILLE,MO,88,65,-23,0.42483660130718953
HORNICK,IA,74,14,-60,0.1590909090909091
HORNSBY,TN,38,45,7,0.54216867469879515
HORNTOWN,SC,13,19,6,0.59375
HORNTOWN,VA,141,258,117,0.6466165413533834
HORSE BRANCH,KY,87,139,52,0.6150442477876106
HORSE CAVE,KY,1940,1999,59,0.5074892104595075
HORSE SHOE,NC,949,1046,97,0.5243107769423558
HORSEHEADS,NY,8325,7808,-517,0.4839769416723486
HORSESHOE BAY,TX,1316,1608,292,0.5499316005471956
HORSESHOE BEACH,FL,11,0,-11,0
HORSESHOE BEND,AR,1260,1365,105,0.52
HORSESHOE BEND,ID,1037,1033,-4,0.4990338164251208
HORSESHOE BND,AR,62,63,1,0.504
HORSESHOE BND,ID,42,44,2,0.5116279069767442
HORSESHOE LAKE,AR,32,43,11,0.5733333333333334
HORSHAM,PA,5598,5801,203,0.5089042898499868
HORTENSE,GA,1345,1666,321,0.5533045499833942
HORTON,AL,1149,1102,-47,0.48956019546868057
HORTON,KS,1067,1162,95,0.5213100044863167
HORTON,MI,871,845,-26,0.49242424242424243
HORTON,OK,47,51,4,0.5204081632653061
HORTONVILLE,WI,2386,2590,204,0.5204983922829582
HOSCHTON,GA,6529,10532,4003,0.6173143426528339
HOSFORD,FL,323,372,49,0.5352517985611511
HOSKINS,NE,12,12,0,0.5
HOSMER,SD,11,22,11,0.6666666666666666
HOSPERS,IA,85,22,-63,0.205607476635514
HOSTETTER,PA,12,0,-12,0
HOT SPRINGS,AR,3691,3357,-334,0.476305334846765
HOT SPRINGS,MT,617,659,42,0.5164576802507836
HOT SPRINGS,NC,576,746,170,0.5642965204236006
HOT SPRINGS,SD,3527,3577,50,0.5035191441441441
HOT SPRINGS,VA,707,732,25,0.5086865879082696
HOT SPRINGS NATIONAL PARK,AR,40063,36400,-3663,0.47604723853366987
HOT SPRINGS VILLAGE,AR,7741,8504,763,0.5234841489689135
HOT SULPHUR SPRINGS,CO,107,33,-74,0.2357142857142857
HOTCHKISS,CO,1591,1749,158,0.5236526946107785
HOUGHTON,MI,5026,3750,-1276,0.4273017319963537
HOUGHTON,NY,145,161,16,0.5261437908496732
HOUGHTON LAKE,MI,4922,4453,-469,0.47498666666666667
HOUGHTON LAKE HEIGHTS,MI,39,11,-28,0.22
HOULKA,MS,968,867,-101,0.47247956403269753
HOULTON,ME,4307,3842,-465,0.47146889188857527
HOULTON,WI,303,371,68,0.5504451038575667
HOUMA,LA,27831,23923,-3908,0.4622444641960042
HOUSATONIC,MA,600,522,-78,0.46524064171123
HOUSE SPRINGS,MO,3225,3189,-36,0.4971936389148737
HOUSTON,AK,23,65,42,0.7386363636363636
HOUSTON,AL,46,86,40,0.6515151515151515
HOUSTON,AR,1355,773,-582,0.3632518796992481
HOUSTON,DE,273,331,58,0.5480132450331126
HOUSTON,MN,853,869,16,0.5046457607433217
HOUSTON,MO,2519,2482,-37,0.4963007398520296
HOUSTON,MS,2253,2206,-47,0.4947297600358825
HOUSTON,OH,60,39,-21,0.3939393939393939
HOUSTON,PA,1491,1628,137,0.5219621673613337
HOUSTON,TX,1218120,1123097,-95023,0.47970649452827313
HOUTZDALE,PA,824,809,-15,0.49540722596448256
HOVEN,SD,11,0,-11,0
HOVLAND,MN,38,57,19,0.6
HOWARD,CO,287,364,77,0.5591397849462365
HOWARD,KS,171,131,-40,0.4337748344370861
HOWARD,OH,2771,2757,-14,0.49873371924746746
HOWARD,PA,1215,1123,-92,0.4803250641573995
HOWARD,SD,403,342,-61,0.4590604026845638
HOWARD BEACH,NY,6403,6276,-127,0.4949917185897941
HOWARD CITY,MI,3602,3242,-360,0.47369959088252483
HOWARD LAKE,MN,1556,1432,-124,0.47925033467202144
HOWARDS GROVE,WI,363,303,-60,0.45495495495495497
HOWARDSVILLE,VA,12,0,-12,0
HOWARDWICK,TX,189,177,-12,0.48360655737704916
HOWE,IN,1541,1250,-291,0.44786814761734145
HOWE,OK,560,725,165,0.5642023346303502
HOWE,TX,1831,1985,154,0.5201781970649895
HOWELL,MI,23077,23503,426,0.5045727780163161
HOWELL,NJ,9153,9100,-53,0.49854818386018734
HOWELLS,NE,35,27,-8,0.43548387096774194
HOWES CAVE,NY,176,213,37,0.5475578406169666
HOWEY IN HLS,FL,129,178,49,0.5798045602605864
HOWEY IN THE HILLS,FL,1630,1993,363,0.5500966050234612
HOWLAND,ME,348,297,-51,0.4604651162790698
HOXIE,AR,1129,1069,-60,0.48635122838944495
HOXIE,KS,473,346,-127,0.42246642246642246
HOYLETON,IL,14,23,9,0.6216216216216216
HOYT,KS,368,419,51,0.5324015247776366
HOYT LAKES,MN,727,693,-34,0.4880281690140845
HSV,AL,293,268,-25,0.47771836007130125
HTGN,WV,192,176,-16,0.4782608695652174
HUACHUCA CITY,AZ,3439,3209,-230,0.48270156438026474
HUBBARD,IA,194,93,-101,0.3240418118466899
HUBBARD,OH,4598,4373,-225,0.487459592018727
HUBBARD,OR,1610,1401,-209,0.46529392228495514
HUBBARD,TX,1154,1055,-99,0.4775916704391127
HUBBARD LAKE,MI,1088,878,-210,0.44659206510681587
HUBBARDSTON,MA,1194,1218,24,0.5049751243781094
HUBBARDSTON,MI,47,133,86,0.7388888888888889
HUBBARDSVILLE,NY,93,15,-78,0.1388888888888889
HUBBELL,MI,55,69,14,0.5564516129032258
HUBBELL,NE,11,0,-11,0
HUBER HEIGHTS,OH,2238,2067,-171,0.4801393728222996
HUBERT,NC,9637,9485,-152,0.49602552034306036
HUBERTUS,WI,1258,1441,183,0.5339014449796221
HUDDLESTON,VA,1450,1581,131,0.5216100296931706
HUDGINS,VA,41,68,27,0.6238532110091743
HUDSON,CO,1448,1542,94,0.5157190635451505
HUDSON,FL,34236,38989,4753,0.532454762717651
HUDSON,IA,964,850,-114,0.4685777287761852
HUDSON,IL,669,637,-32,0.4877488514548239
HUDSON,IN,1097,981,-116,0.4720885466794995
HUDSON,KY,45,46,1,0.5054945054945055
HUDSON,MA,7874,7168,-706,0.476532376013828
HUDSON,ME,363,362,-1,0.4993103448275862
HUDSON,MI,2321,2025,-296,0.465945697192821
HUDSON,NC,3570,3754,184,0.5125614418350628
HUDSON,NH,8547,7892,-655,0.4800778636170083
HUDSON,NY,7231,7168,-63,0.49781234807972774
HUDSON,OH,6715,7731,1016,0.5351654437214454
HUDSON,PA,89,93,4,0.510989010989011
HUDSON,SD,24,16,-8,0.4
HUDSON,WI,13916,13370,-546,0.4899948691636737
HUDSON,WY,26,12,-14,0.3157894736842105
HUDSON FALLS,NY,6017,5711,-306,0.4869542974079127
HUDSON OAKS,TX,164,196,32,0.5444444444444444
HUDSONVILLE,MI,11151,10839,-312,0.4929058663028649
HUEYSVILLE,KY,39,62,23,0.6138613861386139
HUEYTOWN,AL,2114,2179,65,0.5075704635453063
HUFFMAN,TX,4848,5180,332,0.5165536497806142
HUGER,SC,727,1270,543,0.6359539308963446
HUGGINS,MO,14,0,-14,0
HUGHES,AR,439,379,-60,0.4633251833740831
HUGHES SPGS,TX,166,136,-30,0.4503311258278146
HUGHES SPRINGS,TX,1340,1434,94,0.5169430425378515
HUGHESTOWN,PA,464,512,48,0.5245901639344263
HUGHESVILLE,MD,1516,1949,433,0.5624819624819625
HUGHESVILLE,MO,12,39,27,0.7647058823529411
HUGHESVILLE,PA,2139,2256,117,0.5133105802047782
HUGHSON,CA,2537,2586,49,0.5047823540894008
HUGO,CO,231,217,-14,0.484375
HUGO,MN,6492,7798,1306,0.5456962911126662
HUGO,OK,3084,3241,157,0.5124110671936759
HUGOTON,KS,1567,1246,-321,0.44294347671525064
HUGUENOT,NY,103,185,82,0.6423611111111112
HULBERT,MI,17,0,-17,0
HULBERT,OK,1521,1538,17,0.5027786858450474
HULETT,WY,173,186,13,0.5181058495821727
HULETTS LANDING,NY,163,152,-11,0.48253968253968255
HULL,GA,2415,2463,48,0.504920049200492
HULL,IA,888,747,-141,0.45688073394495415
HULL,IL,25,0,-25,0
HULL,MA,5474,5474,0,0.5
HULL,TX,277,498,221,0.6425806451612903
HULLS COVE,ME,36,70,34,0.660377358490566
HUMANSVILLE,MO,1273,1135,-138,0.47134551495016613
HUMAROCK,MA,758,393,-365,0.34144222415291053
HUMBIRD,WI,23,23,0,0.5
HUMBLE,TX,56748,61884,5136,0.521646773214647
HUMBOLDT,AZ,619,727,108,0.5401188707280832
HUMBOLDT,IA,3043,2485,-558,0.44952966714905934
HUMBOLDT,IL,163,39,-124,0.19306930693069307
HUMBOLDT,KS,968,916,-52,0.4861995753715499
HUMBOLDT,NE,448,233,-215,0.342143906020558
HUMBOLDT,SD,78,116,38,0.5979381443298969
HUMBOLDT,TN,5724,6027,303,0.5128925197855502
HUME,IL,14,0,-14,0
HUME,MO,18,11,-7,0.3793103448275862
HUME,VA,11,12,1,0.5217391304347826
HUMESTON,IA,100,107,7,0.5169082125603864
HUMMELSTOWN,PA,8783,8525,-258,0.4925467991680148
HUMPHREY,AR,110,74,-36,0.40217391304347827
HUMPHREY,NE,13,71,58,0.8452380952380952
HUNDRED,WV,36,46,10,0.5609756097560976
HUNGERFORD,TX,62,0,-62,0
HUNGRY HORSE,MT,335,211,-124,0.38644688644688646
HUNKER,PA,400,399,-1,0.49937421777221525
HUNLOCK CREEK,PA,1173,1052,-121,0.4728089887640449
HUNNEWELL,MO,24,11,-13,0.3142857142857143
HUNT,NY,24,16,-8,0.4
HUNT,TX,165,212,47,0.5623342175066313
HUNT VALLEY,MD,105,372,267,0.779874213836478
HUNTER,ND,24,24,0,0.5
HUNTER,NY,673,356,-317,0.3459669582118562
HUNTER,OK,11,0,-11,0
HUNTERS,WA,102,38,-64,0.2714285714285714
HUNTERSVILLE,NC,29401,34720,5319,0.5414762714243384
HUNTERTOWN,IN,2539,2815,276,0.5257751214045573
HUNTINGBURG,IN,3918,3514,-404,0.47282023681377827
HUNTINGDON,PA,5173,4919,-254,0.4874157748711851
HUNTINGDON,TN,3234,3516,282,0.5208888888888888
HUNTINGDON VALLEY,PA,5532,5907,375,0.5163912929451875
HUNTINGDON VY,PA,224,233,9,0.5098468271334792
HUNTINGTN BCH,CA,3458,3395,-63,0.49540347293156284
HUNTINGTN STA,NY,408,445,37,0.5216881594372802
HUNTINGTN WDS,MI,65,124,59,0.656084656084656
HUNTINGTON,AR,553,739,186,0.5719814241486069
HUNTINGTON,IN,13313,10524,-2789,0.4414985107186307
HUNTINGTON,MA,855,779,-76,0.47674418604651164
HUNTINGTON,NY,10993,11678,685,0.5151074059371002
HUNTINGTON,OR,78,90,12,0.5357142857142857
HUNTINGTON,TX,2629,2867,238,0.5216521106259098
HUNTINGTON,UT,749,648,-101,0.4638511095204009
HUNTINGTON,VT,601,459,-142,0.4330188679245283
HUNTINGTON,WV,30331,23935,-6396,0.4410680720893377
HUNTINGTON BEACH,CA,76099,72210,-3889,0.48688886041979923
HUNTINGTON PARK,CA,12455,9999,-2456,0.44531041239868174
HUNTINGTON STATION,NY,12948,12626,-322,0.49370454367717215
HUNTINGTON WOODS,MI,1322,1548,226,0.5393728222996516
HUNTINGTOWN,MD,3429,3873,444,0.5304026294165982
HUNTLAND,TN,361,324,-37,0.472992700729927
HUNTLEY,IL,9964,9930,-34,0.49914547099628026
HUNTLEY,MT,664,636,-28,0.48923076923076925
HUNTLY,VA,0,14,14,1
HUNTSBURG,OH,147,96,-51,0.3950617283950617
HUNTSVILLE,AL,96676,92369,-4307,0.4886085323600201
HUNTSVILLE,AR,3358,3769,411,0.5288340115055423
HUNTSVILLE,MO,917,1057,140,0.5354609929078015
HUNTSVILLE,OH,1079,1052,-27,0.4936649460347255
HUNTSVILLE,TN,899,763,-136,0.4590854392298436
HUNTSVILLE,TX,20393,19604,-789,0.4901367602570193
HUNTSVILLE,UT,934,1188,254,0.5598491988689915
HURDLE MILLS,NC,565,873,308,0.6070931849791377
HURLBURT FIELD,FL,2963,1952,-1011,0.39715157680569685
HURLBURT FLD,FL,229,143,-86,0.3844086021505376
HURLEY,MS,96,14,-82,0.12727272727272726
HURLEY,NM,347,82,-265,0.19114219114219114
HURLEY,NY,1063,1288,225,0.5478519778817524
HURLEY,SD,38,27,-11,0.4153846153846154
HURLEY,VA,181,65,-116,0.26422764227642276
HURLEY,WI,1244,1142,-102,0.4786253143336127
HURLEYVILLE,NY,475,354,-121,0.4270205066344994
HURLOCK,MD,1760,1935,175,0.523680649526387
HURON,CA,85,29,-56,0.2543859649122807
HURON,OH,5707,4917,-790,0.46282003012048195
HURON,SD,8265,7140,-1125,0.4634858812074002
HURON,TN,523,456,-67,0.46578140960163433
HURRICANE,UT,9070,11058,1988,0.5493839427662957
HURRICANE,WV,6539,6534,-5,0.49980876615925957
HURRICANE MILLS,TN,120,49,-71,0.28994082840236685
HURST,IL,88,60,-28,0.40540540540540543
HURST,TX,18428,18308,-120,0.49836672473867594
HURT,VA,1645,1555,-90,0.4859375
HURTSBORO,AL,41,15,-26,0.26785714285714285
HUSON,MT,431,423,-8,0.4953161592505855
HUSSER,LA,0,14,14,1
HUSTISFORD,WI,825,609,-216,0.4246861924686193
HUSTON,ID,0,24,24,1
HUSTON,TX,123,119,-4,0.49173553719008267
HUSTONTOWN,PA,110,134,24,0.5491803278688525
HUSTONVILLE,KY,1500,1417,-83,0.48577305450805625
HUSUM,WA,13,11,-2,0.4583333333333333
HUTCHINS,TX,1838,1582,-256,0.4625730994152047
HUTCHINSON,KS,28180,23327,-4853,0.45288989846040345
HUTCHINSON,MN,8934,7962,-972,0.47123579545454547
HUTCHINSON IS,FL,225,604,379,0.7285886610373945
HUTCHINSON ISLAND,FL,4921,4205,-716,0.4607714223098838
HUTSONVILLE,IL,52,59,7,0.5315315315315315
HUTTIG,AR,16,23,7,0.5897435897435898
HUTTO,TX,15756,21020,5264,0.571568414183163
HUTTONSVILLE,WV,12,0,-12,0
HUXLEY,IA,1868,2090,222,0.528044466902476
HYANNIS,MA,8743,7976,-767,0.47706202524074404
HYANNIS PORT,MA,410,336,-74,0.450402144772118
HYATTSVILLE,MD,45515,37257,-8258,0.450115981249698
HYDE,PA,97,63,-34,0.39375
HYDE PARK,MA,11280,9355,-1925,0.4533559486309668
HYDE PARK,NY,4533,4759,226,0.5121609987085665
HYDE PARK,PA,0,11,11,1
HYDE PARK,UT,1089,1433,344,0.5681998413957177
HYDE PARK,VT,916,1012,96,0.524896265560166
HYDEN,KY,378,375,-3,0.49800796812749004
HYDES,MD,14,23,9,0.6216216216216216
HYDESVILLE,CA,101,178,77,0.6379928315412187
HYDRO,OK,560,429,-131,0.43377148634984836
HYGIENE,CO,93,96,3,0.5079365079365079
HYMERA,IN,87,49,-38,0.3602941176470588
HYNDMAN,PA,663,576,-87,0.4648910411622276
HYPOLUXO,FL,1075,1154,79,0.5177209510991476
HYRUM,UT,2630,3348,718,0.5600535296085647
HYSHAM,MT,63,22,-41,0.25882352941176473
I V,NV,564,381,-183,0.4031746031746032
IAEGER,WV,24,11,-13,0.3142857142857143
IBERIA,MO,1038,995,-43,0.4894244958189867
ICARD,NC,101,123,22,0.5491071428571429
ICKESBURG,PA,34,42,8,0.5526315789473685
IDA,MI,767,612,-155,0.4437998549673677
IDA GROVE,IA,1466,1263,-203,0.4628068889703188
IDABEL,OK,4825,3547,-1278,0.4236741519350215
IDAHO CITY,ID,556,775,219,0.5822689706987227
IDAHO FALLS,ID,43635,42499,-1136,0.4934056237954815
IDAHO SPRINGS,CO,2359,1659,-700,0.41289198606271776
IDALOU,TX,634,878,244,0.5806878306878307
IDANHA,OR,23,0,-23,0
IDAVILLE,IN,71,66,-5,0.48175182481751827
IDER,AL,537,391,-146,0.4213362068965517
IDLEDALE,CO,34,0,-34,0
IDLEWILD,MI,664,433,-231,0.39471285323609845
IDLEWYLDE,MD,814,732,-82,0.47347994825355755
IDLEYLD PARK,OR,207,42,-165,0.1686746987951807
IDYLLWILD,CA,2198,1898,-300,0.46337890625
IGIUGIG,AK,32,16,-16,0.3333333333333333
IGNACIO,CO,1427,1560,133,0.5222631402745229
IGO,CA,92,96,4,0.5106382978723404
IJAMSVILLE,MD,1528,2058,530,0.5738984941438929
ILA,GA,17,0,-17,0
ILIAMNA,AK,0,22,22,1
ILIFF,CO,36,26,-10,0.41935483870967744
ILION,NY,4346,4063,-283,0.4831727910572006
ILLINOIS CITY,IL,49,43,-6,0.4673913043478261
ILLIOPOLIS,IL,164,122,-42,0.42657342657342656
ILWACO,WA,745,778,33,0.5108338804990151
IMBLER,OR,0,14,14,1
IMBODEN,AR,781,748,-33,0.4892086330935252
IMLAY,NV,13,31,18,0.7045454545454546
IMLAY CITY,MI,3461,3069,-392,0.46998468606431854
IMLER,PA,75,110,35,0.5945945945945946
IMMOKALEE,FL,5314,5761,447,0.5201805869074492
IMPERIAL,CA,5592,6086,494,0.5211508820003425
IMPERIAL,MO,7850,8733,883,0.5266236507266477
IMPERIAL,NE,799,534,-265,0.4006001500375094
IMPERIAL,PA,2458,2531,73,0.5073160954099017
IMPERIAL,TX,11,0,-11,0
IMPERIAL BCH,CA,1382,1101,-281,0.44341522351993556
IMPERIAL BEACH,CA,13297,10967,-2330,0.4519864820309924
INA,IL,71,16,-55,0.1839080459770115
INCHELIUM,WA,212,293,81,0.5801980198019802
INCLINE VILLAGE,NV,6149,5681,-468,0.48021978021978023
INCLINE VLG,NV,126,74,-52,0.37
INDEPENDENCE,CA,27,34,7,0.5573770491803278
INDEPENDENCE,IA,3577,3432,-145,0.48965615637038096
INDEPENDENCE,KS,6865,6041,-824,0.468076863474353
INDEPENDENCE,KY,9652,9959,307,0.5078272398143899
INDEPENDENCE,LA,2125,2188,63,0.5073035010433573
INDEPENDENCE,MN,127,81,-46,0.3894230769230769
INDEPENDENCE,MO,53579,50649,-2930,0.48594427601028517
INDEPENDENCE,OH,2335,2623,288,0.5290439693424768
INDEPENDENCE,OR,5627,5040,-587,0.47248523483641136
INDEPENDENCE,VA,1190,1221,31,0.5064288676897553
INDEPENDENCE,WI,1184,864,-320,0.421875
INDEPENDENCE,WV,22,37,15,0.6271186440677966
INDIAHOMA,OK,62,134,72,0.6836734693877551
INDIALANTIC,FL,7699,8512,813,0.5250755659737215
INDIAN BEACH,NC,43,50,7,0.5376344086021505
INDIAN CREEK VILLAGE,FL,181,216,35,0.5440806045340051
INDIAN HARBOUR BEACH,FL,6249,6670,421,0.516293830791857
INDIAN HEAD,MD,3122,3186,64,0.5050729232720355
INDIAN HEAD,PA,26,0,-26,0
INDIAN HEAD PARK,IL,216,196,-20,0.47572815533980584
INDIAN HILLS,CO,395,426,31,0.5188794153471377
INDIAN ISLAND,ME,220,161,-59,0.4225721784776903
INDIAN LAKE,NY,641,614,-27,0.4892430278884462
INDIAN LAKE ESTATES,FL,452,624,172,0.5799256505576208
INDIAN LAND,SC,2537,3773,1236,0.5979397781299525
INDIAN LK EST,FL,58,24,-34,0.2926829268292683
INDIAN MOUND,TN,838,933,95,0.5268210050818747
INDIAN ORCH,MA,493,397,-96,0.4460674157303371
INDIAN ORCHARD,MA,4268,3516,-752,0.4516957862281603
INDIAN RIVER,MI,3381,3148,-233,0.48215653239393474
INDIAN RIVER SHORES,FL,459,1081,622,0.701948051948052
INDIAN RK BCH,FL,152,83,-69,0.35319148936170214
INDIAN RKS BEACH,FL,469,341,-128,0.42098765432098767
INDIAN ROCKS BEACH,FL,4664,5102,438,0.5224247388900266
INDIAN SHORES,FL,941,1079,138,0.5341584158415842
INDIAN SPGS,NV,0,11,11,1
INDIAN SPRINGS,AL,104,113,9,0.5207373271889401
INDIAN SPRINGS,NV,232,733,501,0.7595854922279792
INDIAN TRAIL,NC,14146,15598,1452,0.5244082840236687
INDIAN TWP,ME,0,35,35,1
INDIAN VALLEY,ID,13,11,-2,0.4583333333333333
INDIAN WELLS,CA,4840,5802,962,0.5451982710016914
INDIANA,PA,11752,11316,-436,0.49054967920929426
INDIANAPOLIS,IN,556011,492595,-63416,0.46976175989837937
INDIANOLA,IA,8625,8701,76,0.5021932355996768
INDIANOLA,MS,3124,2835,-289,0.4757509649270012
INDIANOLA,NE,187,61,-126,0.24596774193548387
INDIANOLA,OK,0,12,12,1
INDIANOLA,PA,69,14,-55,0.1686746987951807
INDIANOLA,WA,452,497,45,0.523709167544784
INDIANTOWN,FL,2294,2020,-274,0.46824292999536393
INDIO,CA,28817,31771,2954,0.524377764573843
INDN RIV SHRS,FL,167,261,94,0.6098130841121495
INDPLS,IN,297,197,-100,0.39878542510121456
INDUSTRY,IL,78,11,-67,0.12359550561797752
INDUSTRY,PA,736,696,-40,0.4860335195530726
INEZ,KY,1119,1075,-44,0.48997265268915224
INEZ,TX,476,767,291,0.6170555108608206
INGALLS,IN,730,755,25,0.5084175084175084
INGALLS,KS,11,0,-11,0
INGLESIDE,IL,3265,3142,-123,0.4904011237708756
INGLESIDE,MD,14,0,-14,0
INGLESIDE,TX,4774,4627,-147,0.49218168279970215
INGLEWOOD,CA,32077,27132,-4945,0.4582411457717577
INGLIS,FL,2655,3087,432,0.5376175548589341
INGOLD,NC,0,16,16,1
INGRAM,TX,2155,2119,-36,0.4957884885353299
INKOM,ID,563,608,45,0.5192143467122118
INKSTER,MI,13145,10371,-2774,0.4410188807620344
INLET,NY,463,493,30,0.5156903765690377
INLET BEACH,FL,1699,2204,505,0.5646938252626185
INMAN,KS,977,942,-35,0.49088066701406985
INMAN,SC,10265,12632,2367,0.5516879940603573
INOLA,OK,2487,2108,-379,0.458759521218716
INSTITUTE,WV,0,15,15,1
INTERCESSION CITY,FL,710,939,229,0.569436021831413
INTERIOR,SD,11,0,-11,0
INTERLACHEN,FL,5217,5584,367,0.5169891676696602
INTERLAKEN,NJ,595,452,-143,0.43170964660936006
INTERLAKEN,NY,1043,846,-197,0.44785600847009
INTERLOCHEN,MI,2938,2916,-22,0.49812094294499487
INTERNATIONAL FALLS,MN,4895,3918,-977,0.44457052082151366
INTERVALE,NH,704,581,-123,0.4521400778210117
INTL FALLS,MN,104,69,-35,0.3988439306358382
INVER GROVE HEIGHTS,MN,15191,14009,-1182,0.47976027397260274
INVERNESS,CA,139,235,96,0.6283422459893048
INVERNESS,FL,20300,22789,2489,0.5288820812736429
INVERNESS,IL,1800,2104,304,0.5389344262295082
INVERNESS,MS,25,52,27,0.6753246753246753
INWOOD,IA,459,334,-125,0.42118537200504413
INWOOD,NY,2207,1755,-452,0.44295810196870267
INWOOD,WV,4299,4612,313,0.5175625631242284
INYOKERN,CA,671,807,136,0.5460081190798376
IOLA,KS,4536,3615,-921,0.44350386455649615
IOLA,TX,716,968,252,0.5748218527315915
IOLA,WI,1441,1325,-116,0.4790310918293565
IONA,ID,668,756,88,0.5308988764044944
IONA,SD,48,35,-13,0.42168674698795183
IONE,CA,2949,3574,625,0.5479074045684501
IONE,OR,11,11,0,0.5
IONE,WA,473,532,59,0.5293532338308458
IONIA,IA,36,41,5,0.5324675324675324
IONIA,MI,8141,7136,-1005,0.46710741637756104
IOTA,LA,876,924,48,0.5133333333333333
IOWA,LA,3227,3606,379,0.5277330601492756
IOWA CITY,IA,48131,35894,-12237,0.42718238619458493
IOWA COLONY,TX,119,255,136,0.6818181818181818
IOWA FALLS,IA,3511,2899,-612,0.45226209048361937
IOWA HILL,CA,86,71,-15,0.45222929936305734
IOWA PARK,TX,3174,3310,136,0.5104873534855028
IPAVA,IL,27,57,30,0.6785714285714286
IPSWICH,MA,4941,5223,282,0.5138724911452184
IPSWICH,SD,195,180,-15,0.48
IRA,MI,2034,1925,-109,0.4862338974488507
IRAAN,TX,38,11,-27,0.22448979591836735
IRASBURG,VT,363,284,-79,0.43894899536321486
IREDELL,TX,38,169,131,0.8164251207729468
IRENE,SD,39,48,9,0.5517241379310345
IRETON,IA,138,40,-98,0.2247191011235955
IRMA,WI,150,129,-21,0.46236559139784944
IRMO,SC,12537,13738,1201,0.5228544243577545
IRON,MN,121,123,2,0.5040983606557377
IRON BELT,WI,13,0,-13,0
IRON CITY,GA,35,48,13,0.5783132530120482
IRON CITY,TN,538,594,56,0.5247349823321554
IRON MOUNTAIN,MI,5217,4792,-425,0.4787691078029773
IRON RIDGE,WI,622,496,-126,0.44364937388193204
IRON RIVER,MI,3408,3132,-276,0.47889908256880737
IRON RIVER,WI,1465,1374,-91,0.4839732300105671
IRON STATION,NC,1915,2614,699,0.5771693530580703
IRONDALE,AL,4469,4566,97,0.5053680132816823
IRONDALE,MO,187,155,-32,0.45321637426900585
IRONDALE,OH,23,47,24,0.6714285714285714
IRONDEQUOIT,NY,683,788,105,0.5356900067980965
IRONS,MI,1509,1303,-206,0.46337126600284495
IRONTON,MN,814,579,-235,0.41564967695620963
IRONTON,MO,1720,1848,128,0.5179372197309418
IRONTON,OH,6436,5807,-629,0.47431185167034223
IRONWOOD,MI,4288,3426,-862,0.4441275602800104
IROQUOIS,SD,54,34,-20,0.38636363636363635
IRRIGON,OR,1702,1285,-417,0.4301975225979243
IRVINE,CA,164386,164968,582,0.5008835477935595
IRVINE,KY,3996,4077,81,0.5050167224080268
IRVINE,PA,17,15,-2,0.46875
IRVING,IL,41,37,-4,0.47435897435897434
IRVING,NY,1078,923,-155,0.4612693653173413
IRVING,TX,142652,126376,-16276,0.46975036055726543
IRVINGTON,AL,3814,3498,-316,0.4783916849015317
IRVINGTON,IL,81,11,-70,0.11956521739130435
IRVINGTON,KY,1673,1714,41,0.5060525538824919
IRVINGTON,NJ,22163,17910,-4253,0.4469343448207022
IRVINGTON,NY,2289,2585,296,0.5303652031185885
IRVINGTON,VA,359,564,205,0.6110509209100758
IRVONA,PA,34,27,-7,0.4426229508196721
IRWIN,IA,27,12,-15,0.3076923076923077
IRWIN,ID,148,95,-53,0.39094650205761317
IRWIN,OH,12,0,-12,0
IRWIN,PA,10407,10987,580,0.5135552023931943
IRWINTON,GA,170,87,-83,0.33852140077821014
ISANTI,MN,5013,5471,458,0.5218428080885158
ISCHUA,NY,53,52,-1,0.49523809523809526
ISELIN,NJ,7102,6570,-532,0.4805441778818022
ISHPEMING,MI,5386,4920,-466,0.47739181059576946
ISLAMORADA,FL,3590,4168,578,0.5372518690384119
ISLAND,KY,75,138,63,0.647887323943662
ISLAND CITY,OR,211,175,-36,0.4533678756476684
ISLAND FALLS,ME,411,374,-37,0.4764331210191083
ISLAND HEIGHTS,NJ,587,553,-34,0.4850877192982456
ISLAND LAKE,IL,2521,2504,-17,0.4983084577114428
ISLAND PARK,ID,1975,1592,-383,0.4463134286515279
ISLAND PARK,NY,2600,2664,64,0.506079027355623
ISLAND POND,VT,543,500,-43,0.4793863854266539
ISLANDIA,NY,1293,1136,-157,0.4676821737340469
ISLANDTON,SC,35,23,-12,0.39655172413793105
ISLE,MN,1889,1622,-267,0.46197664483053263
ISLE LA MOTTE,VT,314,258,-56,0.45104895104895104
ISLE OF PALMS,SC,2571,3464,893,0.5739850869925435
ISLESBORO,ME,698,684,-14,0.49493487698986977
ISLESFORD,ME,68,74,6,0.5211267605633803
ISLETON,CA,943,901,-42,0.4886117136659436
ISLIP,NY,4260,4012,-248,0.48500967117988397
ISLIP TERRACE,NY,2772,2412,-360,0.4652777777777778
ISOLA,MS,112,124,12,0.5254237288135594
ISOM,KY,23,51,28,0.6891891891891891
ISSAQUAH,WA,27131,27402,271,0.5024847340142666
ISSUE,MD,12,0,-12,0
ITALY,TX,1201,1208,7,0.5014528850145289
ITASCA,IL,4707,4319,-388,0.4785065366718369
ITASCA,TX,933,1030,97,0.5247070809984717
ITHACA,MI,2459,2272,-187,0.48023673641936165
ITHACA,NE,11,0,-11,0
ITHACA,NY,34118,26969,-7149,0.4414850950284021
ITTA BENA,MS,1016,770,-246,0.4311310190369541
IUKA,IL,492,480,-12,0.49382716049382713
IUKA,MS,3350,3305,-45,0.4966190833959429
IVA,SC,1842,2302,460,0.5555019305019305
IVANHOE,CA,1251,813,-438,0.3938953488372093
IVANHOE,MN,106,86,-20,0.4479166666666667
IVANHOE,NC,37,85,48,0.6967213114754098
IVANHOE,TX,99,98,-1,0.49746192893401014
IVANHOE,VA,58,48,-10,0.4528301886792453
IVEL,KY,98,40,-58,0.2898550724637681
IVESDALE,IL,13,0,-13,0
IVEY,GA,188,196,8,0.5104166666666666
IVINS,UT,4015,4946,931,0.5519473273072202
IVOR,VA,479,554,75,0.5363020329138432
IVORYTON,CT,770,813,43,0.5135818066961465
IVYDALE,WV,154,104,-50,0.40310077519379844
IVYLAND,PA,256,266,10,0.5095785440613027
IXONIA,WI,935,955,20,0.5052910052910053
JACINTO CITY,TX,208,173,-35,0.4540682414698163
JACK,AL,115,257,142,0.6908602150537635
JACKMAN,ME,384,342,-42,0.47107438016528924
JACKPOT,NV,175,11,-164,0.05913978494623656
JACKSBORO,TN,3051,3367,316,0.5246182611405422
JACKSBORO,TX,2505,2033,-472,0.4479947113265756
JACKSON,AL,2267,1916,-351,0.45804446569447765
JACKSON,CA,3265,3241,-24,0.49815554872425455
JACKSON,GA,8179,8386,207,0.506248113492303
JACKSON,ID,287,294,7,0.5060240963855421
JACKSON,KY,2531,2356,-175,0.48209535502353185
JACKSON,LA,1185,939,-246,0.442090395480226
JACKSON,ME,142,107,-35,0.42971887550200805
JACKSON,MI,45625,40684,-4941,0.4713761021446199
JACKSON,MN,2113,1708,-405,0.4470034022507197
JACKSON,MO,9543,9931,388,0.5099620006162062
JACKSON,MS,64534,53733,-10801,0.45433637447470554
JACKSON,NC,88,135,47,0.6053811659192825
JACKSON,NH,296,384,88,0.5647058823529412
JACKSON,NJ,17774,16941,-833,0.4880023044793317
JACKSON,OH,5427,5450,23,0.5010572768226533
JACKSON,SC,1195,1239,44,0.5090386195562859
JACKSON,TN,37060,35070,-1990,0.48620546235962847
JACKSON,WI,3593,3829,236,0.5158986796011856
JACKSON,WY,7852,6772,-1080,0.46307439824945296
JACKSON BELDEN,OH,121,145,24,0.5451127819548872
JACKSON CENTER,OH,673,325,-348,0.3256513026052104
JACKSON CENTER,PA,167,162,-5,0.49240121580547114
JACKSON CTR,OH,185,72,-113,0.2801556420233463
JACKSON HEIGHTS,NY,16502,11903,-4599,0.4190459426157367
JACKSON HOLE,WY,319,290,-29,0.47619047619047616
JACKSON SPGS,NC,46,73,27,0.6134453781512605
JACKSON SPRINGS,NC,527,867,340,0.6219512195121951
JACKSONBURG,WV,0,15,15,1
JACKSONS GAP,AL,865,973,108,0.529379760609358
JACKSONVILLE,AL,7425,6384,-1041,0.4623071909624158
JACKSONVILLE,AR,21355,19900,-1455,0.4823657738455945
JACKSONVILLE,FL,498718,498073,-645,0.4996764617658065
JACKSONVILLE,GA,0,11,11,1
JACKSONVILLE,IL,6914,6737,-177,0.4935169584645813
JACKSONVILLE,NC,62230,52486,-9744,0.4575298999267757
JACKSONVILLE,OH,47,14,-33,0.22950819672131148
JACKSONVILLE,OR,3809,3906,97,0.5062864549578743
JACKSONVILLE,TX,7967,7178,-789,0.4739517992736877
JACKSONVILLE,VT,117,42,-75,0.2641509433962264
JACKSONVILLE BEACH,FL,15000,14447,-553,0.49061024892179167
JACKSONVILLE NAS,FL,54,52,-2,0.49056603773584906
JACOBSBURG,OH,191,88,-103,0.3154121863799283
JACOBSON,MN,13,18,5,0.5806451612903226
JACOBUS,PA,263,255,-8,0.4922779922779923
JACUMBA,CA,0,60,60,1
JAFFREY,NH,2565,2444,-121,0.4879217408664404
JAKIN,GA,67,39,-28,0.36792452830188677
JAL,NM,237,133,-104,0.35945945945945945
JAMAICA,IA,11,11,0,0.5
JAMAICA,NY,58066,48707,-9359,0.456173377164639
JAMAICA,VT,102,285,183,0.7364341085271318
JAMAICA PLAIN,MA,24723,19997,-4726,0.44716010733452594
JAMES CREEK,PA,145,105,-40,0.42
JAMESBURG,NJ,4740,5624,884,0.5426476263990737
JAMESON,MO,45,11,-34,0.19642857142857142
JAMESPORT,MO,402,256,-146,0.3890577507598784
JAMESPORT,NY,211,257,46,0.5491452991452992
JAMESTOWN,CA,2447,2327,-120,0.4874319229157939
JAMESTOWN,CO,88,69,-19,0.4394904458598726
JAMESTOWN,IN,717,749,32,0.5109140518417462
JAMESTOWN,KS,13,0,-13,0
JAMESTOWN,KY,1968,1847,-121,0.48414154652686764
JAMESTOWN,LA,0,13,13,1
JAMESTOWN,MO,106,119,13,0.5288888888888889
JAMESTOWN,NC,6569,6699,130,0.5048990051251131
JAMESTOWN,ND,8367,7280,-1087,0.4652649070109286
JAMESTOWN,NY,20000,19197,-803,0.4897568691481491
JAMESTOWN,OH,1990,1898,-92,0.4881687242798354
JAMESTOWN,PA,1378,1248,-130,0.4752475247524752
JAMESTOWN,RI,3181,3285,104,0.508042066192391
JAMESTOWN,SC,62,68,6,0.5230769230769231
JAMESTOWN,TN,4547,5312,765,0.5387970382391724
JAMESVILLE,NC,632,523,-109,0.45281385281385284
JAMESVILLE,NY,2994,3208,214,0.5172524991938084
JAMISON,PA,1692,2005,313,0.542331620232621
JAMUL,CA,2827,3042,215,0.518316578633498
JANE,MO,171,165,-6,0.49107142857142855
JANE LEW,WV,1160,1165,5,0.5010752688172043
JANESVILLE,CA,1043,1076,33,0.5077866918357716
JANESVILLE,IA,277,327,50,0.5413907284768212
JANESVILLE,IL,12,0,-12,0
JANESVILLE,MN,1419,1267,-152,0.47170513775130307
JANESVILLE,WI,34660,30977,-3683,0.47194417782653075
JARALES,NM,0,11,11,1
JARRATT,VA,707,706,-1,0.4996461429582449
JARREAU,LA,189,130,-59,0.40752351097178685
JARRELL,TX,5498,9576,4078,0.635266020963248
JARRETTSVILLE,MD,1356,1655,299,0.5496512786449684
JARVISBURG,NC,130,209,79,0.616519174041298
JASONVILLE,IN,1841,1860,19,0.502566873817887
JASPER,AL,10152,10063,-89,0.4977986643581499
JASPER,AR,767,792,25,0.5080179602309173
JASPER,FL,1914,2219,305,0.536898136946528
JASPER,GA,6695,8378,1683,0.5558283022623234
JASPER,IN,8411,7985,-426,0.4870090265918517
JASPER,MI,52,19,-33,0.2676056338028169
JASPER,MN,214,114,-100,0.3475609756097561
JASPER,MO,995,841,-154,0.45806100217864926
JASPER,NY,127,85,-42,0.4009433962264151
JASPER,OR,120,29,-91,0.19463087248322147
JASPER,TN,2884,2945,61,0.5052324583976668
JASPER,TX,4980,5020,40,0.502
JAVA,VA,11,22,11,0.6666666666666666
JAVA CENTER,NY,23,11,-12,0.3235294117647059
JAX,FL,745,728,-17,0.4942294636795655
JAX BCH,FL,654,723,69,0.5250544662309368
JAY,FL,1616,2049,433,0.5590723055934516
JAY,ME,1698,1775,77,0.5110855168442269
JAY,NY,463,440,-23,0.48726467331118495
JAY,OK,3260,2710,-550,0.4539363484087102
JAY,VT,108,104,-4,0.49056603773584906
JAYESS,MS,928,885,-43,0.4881412024269167
JAYTON,TX,11,0,-11,0
JB ANDREWS,MD,1759,1800,41,0.5057600449564484
JB MDL,NJ,760,678,-82,0.4714881780250348
JB PEARL HARBOR HICKAM,HI,144,95,-49,0.39748953974895396
JBER,AK,5945,5067,-878,0.4601343988376317
JBPHH,HI,148,177,29,0.5446153846153846
JBSA FSH,TX,223,272,49,0.5494949494949495
JBSA FT SAM HOUSTON,TX,1444,1583,139,0.5229600264288073
JBSA LACKLAND,TX,1393,1156,-237,0.45351118085523734
JBSA RANDOLPH,TX,0,24,24,1
JEAN,NV,539,494,-45,0.4782187802516941
JEAN LAFITTE,LA,37,39,2,0.5131578947368421
JEANERETTE,LA,2339,2270,-69,0.49251464525927535
JEANNETTE,PA,5927,6064,137,0.5057126177966809
JEDDO,MI,55,70,15,0.56
JEFFERS,MN,75,36,-39,0.32432432432432434
JEFFERSON,AR,27,56,29,0.6746987951807228
JEFFERSON,CO,557,341,-216,0.37973273942093544
JEFFERSON,GA,8064,10696,2632,0.5701492537313433
JEFFERSON,IA,2228,2169,-59,0.4932908801455538
JEFFERSON,LA,1258,1098,-160,0.46604414261460103
JEFFERSON,MA,812,916,104,0.5300925925925926
JEFFERSON,MD,1370,1675,305,0.5500821018062397
JEFFERSON,ME,1067,1240,173,0.5374945817078457
JEFFERSON,NC,1718,1982,264,0.5356756756756756
JEFFERSON,NH,327,300,-27,0.4784688995215311
JEFFERSON,NY,711,637,-74,0.4725519287833828
JEFFERSON,OH,3119,3087,-32,0.49742184982275217
JEFFERSON,OR,2402,2394,-8,0.4991659716430359
JEFFERSON,PA,139,182,43,0.5669781931464174
JEFFERSON,SC,684,812,128,0.5427807486631016
JEFFERSON,SD,362,404,42,0.5274151436031331
JEFFERSON,TX,2739,2900,161,0.5142755807767334
JEFFERSON,WI,4602,4168,-434,0.4752565564424173
JEFFERSON CITY,MO,28950,25926,-3024,0.4724469713535972
JEFFERSON CITY,MT,29,37,8,0.5606060606060606
JEFFERSON CITY,TN,5692,5720,28,0.5012267788293024
JEFFERSON CTY,MO,14,23,9,0.6216216216216216
JEFFERSON HILLS,PA,343,324,-19,0.48575712143928035
JEFFERSON PARK,IL,630,552,-78,0.467005076142132
JEFFERSON TOWNSHIP,PA,204,210,6,0.5072463768115942
JEFFERSON TWP,PA,116,155,39,0.5719557195571956
JEFFERSON VALLEY,NY,130,69,-61,0.34673366834170855
JEFFERSON VLY,NY,22,11,-11,0.3333333333333333
JEFFERSONTON,VA,418,631,213,0.6015252621544328
JEFFERSONTOWN,KY,11,27,16,0.7105263157894737
JEFFERSONVILLE,GA,630,745,115,0.5418181818181819
JEFFERSONVILLE,IN,23776,24035,259,0.5027085817071385
JEFFERSONVILLE,KY,2275,2152,-123,0.4861079737971538
JEFFERSONVILLE,NY,553,673,120,0.5489396411092985
JEFFERSONVILLE,OH,943,826,-117,0.46693046919163367
JEFFERSONVILLE,VT,1159,1133,-26,0.4943280977312391
JEFFERSONVLLE,NY,25,14,-11,0.358974358974359
JEFFERSONVLLE,VT,25,16,-9,0.3902439024390244
JEKYLL ISLAND,GA,733,1462,729,0.6660592255125285
JELLICO,TN,1106,969,-137,0.4669879518072289
JEMEZ PUEBLO,NM,13,69,56,0.8414634146341463
JEMEZ SPRINGS,NM,339,356,17,0.5122302158273381
JEMISON,AL,2254,2443,189,0.5201192250372578
JENA,LA,2032,2049,17,0.5020828228375398
JENERA,OH,39,11,-28,0.22
JENISON,MI,7022,7113,91,0.5032189600282986
JENKINS,KY,1293,1198,-95,0.4809313528703332
JENKINS,MN,136,252,116,0.6494845360824743
JENKINS TOWNSHIP,PA,385,395,10,0.5064102564102564
JENKINSBURG,GA,549,754,205,0.5786646201074443
JENKINSVILLE,SC,0,22,22,1
JENKINTOWN,PA,2615,2870,255,0.5232452142206017
JENKS,OK,8164,9448,1284,0.53645241880536
JENNER,CA,35,11,-24,0.2391304347826087
JENNERS,PA,12,0,-12,0
JENNINGS,FL,929,1107,178,0.543713163064833
JENNINGS,LA,5246,5020,-226,0.4889927917397234
JENNINGS,MO,1281,1128,-153,0.46824408468244083
JENNINGS,OK,314,439,125,0.5830013280212484
JENSEN,UT,15,33,18,0.6875
JENSEN BEACH,FL,23223,27263,4040,0.5400110921839718
JEREMIAH,KY,18,11,-7,0.3793103448275862
JERICHO,NY,4621,5849,1228,0.5586437440305635
JERICHO,VT,1573,1755,182,0.52734375
JERICO SPRINGS,MO,113,68,-45,0.3756906077348066
JERMYN,PA,1099,1104,5,0.5011348161597822
JEROME,AZ,12,11,-1,0.4782608695652174
JEROME,ID,8898,6615,-2283,0.42641655385805455
JEROME,MI,1281,1256,-25,0.49507292077256604
JEROME,PA,35,11,-24,0.2391304347826087
JEROMESVILLE,OH,659,688,29,0.5107646622123236
JERRY CITY,OH,14,0,-14,0
JERSEY CITY,NJ,153196,130954,-22242,0.4608622206581031
JERSEY SHORE,PA,4599,4245,-354,0.4799864314789688
JERSEY VILLAGE,TX,5698,5138,-560,0.47416020671834624
JERSEYVILLE,IL,4489,4379,-110,0.49379792512404147
JERUSALEM,AR,24,61,37,0.7176470588235294
JERUSALEM,OH,26,11,-15,0.2972972972972973
JESSIEVILLE,AR,382,488,106,0.5609195402298851
JESSUP,MD,4872,4810,-62,0.4967981821937616
JESSUP,PA,1123,1124,1,0.5002225189141077
JESUP,GA,9970,8837,-1133,0.4698782368267135
JESUP,IA,1390,1231,-159,0.4696680656238077
JETERSVILLE,VA,374,393,19,0.5123859191655802
JETMORE,KS,270,199,-71,0.42430703624733473
JEWELL,IA,411,381,-30,0.4810606060606061
JEWELL,KS,26,13,-13,0.3333333333333333
JEWELL RIDGE,VA,13,11,-2,0.4583333333333333
JEWETT,IL,11,0,-11,0
JEWETT,NY,58,79,21,0.5766423357664233
JEWETT,OH,544,493,-51,0.47540983606557374
JEWETT,TX,713,800,87,0.5287508261731659
JEWETT CITY,CT,3868,4188,320,0.5198609731876862
JIM FALLS,WI,174,171,-3,0.4956521739130435
JIM THORPE,PA,2678,2745,67,0.5061773925871289
JOANNA,SC,437,340,-97,0.4375804375804376
JOAQUIN,TX,920,849,-71,0.47993216506500846
JOBSTOWN,NJ,48,12,-36,0.2
JODIE,WV,12,0,-12,0
JOELTON,TN,2427,2468,41,0.5041879468845761
JOHANNESBURG,CA,0,50,50,1
JOHANNESBURG,MI,1099,1007,-92,0.4781576448243115
JOHN DAY,OR,1556,1434,-122,0.47959866220735786
JOHNS CREEK,GA,6395,6806,411,0.5155670024998106
JOHNS ISLAND,SC,11609,16440,4831,0.5861171521266355
JOHNSBURG,IL,766,762,-4,0.4986910994764398
JOHNSBURG,NY,37,12,-25,0.24489795918367346
JOHNSON,KS,292,34,-258,0.10429447852760736
JOHNSON,MN,11,0,-11,0
JOHNSON,NE,38,12,-26,0.24
JOHNSON,VT,1557,1433,-124,0.47926421404682273
JOHNSON CITY,NY,9301,7979,-1322,0.46174768518518516
JOHNSON CITY,TN,42672,39775,-2897,0.48243113757929335
JOHNSON CITY,TX,1320,1637,317,0.5536016232668245
JOHNSON CREEK,WI,1511,1569,58,0.5094155844155844
JOHNSON LAKE,NE,293,216,-77,0.4243614931237721
JOHNSON VALLEY,CA,85,99,14,0.5380434782608695
JOHNSONBURG,PA,1578,1169,-409,0.4255551510738988
JOHNSONVILLE,NY,447,309,-138,0.4087301587301587
JOHNSONVILLE,SC,1411,1406,-5,0.49911253106141285
JOHNSTON,IA,12367,11830,-537,0.48890358308881265
JOHNSTON,RI,10101,10665,564,0.513579890205143
JOHNSTON,SC,1213,1199,-14,0.49709784411276947
JOHNSTON CITY,IL,2034,1961,-73,0.49086357947434295
JOHNSTOWN,CO,7627,8835,1208,0.5366905600777548
JOHNSTOWN,NY,5337,4779,-558,0.4724199288256228
JOHNSTOWN,OH,4289,4395,106,0.5061031782588669
JOHNSTOWN,PA,22755,21614,-1141,0.48714192341499696
JOICE,IA,39,0,-39,0
JOINER,AR,54,53,-1,0.4953271028037383
JOINT BASE CHARLESTON,SC,62,81,19,0.5664335664335665
JOINT BASE LEWIS MCCHORD,WA,9635,8974,-661,0.4822397764522543
JOINT BASE MDL,NJ,4012,3161,-851,0.44068032901157117
JOINT BASE PEARL HBR HICKAM,HI,0,20,20,1
JOLIET,IL,42366,38329,-4037,0.4749860586157755
JOLIET,MT,699,732,33,0.5115303983228512
JOLO,WV,12,14,2,0.5384615384615384
JOLON,CA,49,48,-1,0.4948453608247423
JONES,AL,0,11,11,1
JONES,MI,869,614,-255,0.4140256237356709
JONES,OK,2031,2285,254,0.5294253938832252
JONES CREEK,TX,328,314,-14,0.48909657320872274
JONESBORO,AR,47523,39693,-7830,0.45511144744083654
JONESBORO,GA,38476,36247,-2229,0.4850849136142821
JONESBORO,IL,1160,836,-324,0.4188376753507014
JONESBORO,IN,1076,940,-136,0.4662698412698413
JONESBORO,LA,2844,2474,-370,0.46521248589695374
JONESBORO,ME,11,51,40,0.8225806451612904
JONESBORO,TX,94,123,29,0.5668202764976958
JONESBOROUGH,TN,8331,9799,1468,0.5404853833425262
JONESBURG,MO,600,627,27,0.511002444987775
JONESPORT,ME,453,510,57,0.5295950155763239
JONESTOWN,PA,2613,2624,11,0.5010502195913691
JONESTOWN,TX,1213,1650,437,0.5763185469786937
JONESVILLE,LA,2137,1895,-242,0.46999007936507936
JONESVILLE,MI,2582,2288,-294,0.4698151950718686
JONESVILLE,NC,2315,1698,-617,0.4231248442561675
JONESVILLE,SC,844,996,152,0.5413043478260869
JONESVILLE,VA,1559,1617,58,0.5091309823677582
JOPLIN,MO,41393,35923,-5470,0.4646256919654405
JOPPA,AL,630,607,-23,0.49070331447049315
JOPPA,IL,11,0,-11,0
JOPPA,MD,5685,5617,-68,0.49699168288798445
JORDAN,AR,13,14,1,0.5185185185185185
JORDAN,MN,3395,3117,-278,0.47865479115479115
JORDAN,MT,0,43,43,1
JORDAN,NY,1238,1180,-58,0.4880066170388751
JORDAN VALLEY,OR,12,22,10,0.6470588235294118
JORDANVILLE,NY,52,13,-39,0.2
JOSEPH,OR,1311,1102,-209,0.4566929133858268
JOSEPH CITY,AZ,22,179,157,0.8905472636815921
JOSEPHINE,TX,153,225,72,0.5952380952380952
JOSHUA,TX,6572,7472,900,0.5320421532326972
JOSHUA TREE,CA,4998,4143,-855,0.4532326878897276
JOURDANTON,TX,2078,2195,117,0.5136906154926282
JOY,IL,124,48,-76,0.27906976744186046
JOYCE,WA,15,0,-15,0
JUDA,WI,44,105,61,0.7046979865771812
JUDITH GAP,MT,13,0,-13,0
JUDSON,TX,0,25,25,1
JUDSONIA,AR,2896,2897,1,0.5000863110650785
JULESBURG,CO,727,744,17,0.5057783820530252
JULIAETTA,ID,280,247,-33,0.4686907020872865
JULIAN,CA,1455,1493,38,0.5064450474898237
JULIAN,NC,408,593,185,0.5924075924075924
JULIAN,PA,442,544,102,0.5517241379310345
JULIAN,WV,53,11,-42,0.171875
JULIETTE,GA,760,926,166,0.5492289442467378
JULINGTON CREEK,FL,304,471,167,0.607741935483871
JUMPING BRANCH,WV,26,39,13,0.6
JUNCTION,IL,0,15,15,1
JUNCTION,TX,1370,1428,58,0.5103645461043602
JUNCTION CITY,AR,195,244,49,0.5558086560364465
JUNCTION CITY,CA,14,0,-14,0
JUNCTION CITY,KS,21901,17208,-4693,0.4400010227824797
JUNCTION CITY,KY,951,947,-4,0.49894625922023184
JUNCTION CITY,OH,971,873,-98,0.4734273318872017
JUNCTION CITY,OR,6165,5599,-566,0.4759435566133968
JUNCTION CITY,WI,423,599,176,0.586105675146771
JUNE LAKE,CA,168,232,64,0.58
JUNEAU,AK,12805,11736,-1069,0.4782201214294446
JUNEAU,WI,1800,1357,-443,0.42983845422869815
JUNIATA,NE,386,328,-58,0.45938375350140054
JUNIOR,WV,11,0,-11,0
JUNO BEACH,FL,3395,2981,-414,0.467534504391468
JUPITER,FL,55528,56648,1120,0.5049921551847097
JURUPA VALLEY,CA,26353,24642,-1711,0.4832238454750466
JUSTICE,IL,5363,4944,-419,0.4796740079557582
JUSTICEBURG,TX,11,0,-11,0
JUSTIN,TX,6978,12185,5207,0.6358607733653394
K C,MO,204,197,-7,0.4912718204488778
KAAAWA,HI,561,507,-54,0.4747191011235955
KABETOGAMA,MN,80,138,58,0.6330275229357798
KADOKA,SD,12,0,-12,0
KAGEL CANYON,CA,379,335,-44,0.469187675070028
KAHOKA,MO,1521,1467,-54,0.49096385542168675
KAHUKU,HI,881,641,-240,0.4211563731931669
KAHULUI,HI,8999,7518,-1481,0.4551674032814676
KAIBETO,AZ,12,12,0,0.5
KAILUA,HI,25162,21940,-3222,0.4657976306738567
KAILUA KONA,HI,19562,19936,374,0.5047344169325029
KAISER,MO,927,755,-172,0.44887039239001186
KALAHEO,HI,1802,1894,92,0.5124458874458875
KALAMA,WA,2640,2983,343,0.5304997332384848
KALAMAZOO,MI,94700,70485,-24215,0.426703393165239
KALANI WAY,HI,26,21,-5,0.44680851063829785
KALEVA,MI,1118,746,-372,0.4002145922746781
KALIDA,OH,37,14,-23,0.27450980392156865
KALISPELL,MT,26724,29823,3099,0.5274019841901427
KALKASKA,MI,4480,4228,-252,0.4855305466237942
KALONA,IA,2068,1758,-310,0.4594877156299007
KAMAS,UT,3166,3377,211,0.5161241020938407
KAMAY,TX,11,0,-11,0
KAMIAH,ID,1870,2012,142,0.5182895414734673
KAMRAR,IA,11,0,-11,0
KAMUELA,HI,4943,5175,232,0.5114647163471042
KANAB,UT,2548,3061,513,0.5457300766625067
KANARRAVILLE,UT,22,12,-10,0.35294117647058826
KANAWHA,IA,264,202,-62,0.4334763948497854
KANDIYOHI,MN,106,69,-37,0.3942857142857143
KANE,IL,121,0,-121,0
KANE,PA,2638,2498,-140,0.4863707165109034
KANEOHE,HI,17422,15613,-1809,0.4726199485394279
KANKAKEE,IL,19758,13070,-6688,0.3981357377848178
KANNAPOLIS,NC,18365,19594,1229,0.5161885191917596
KANOPOLIS,KS,42,58,16,0.58
KANOSH,UT,11,11,0,0.5
KANSAS,AL,0,14,14,1
KANSAS,IL,130,171,41,0.5681063122923588
KANSAS,MO,147,125,-22,0.45955882352941174
KANSAS,OH,0,12,12,1
KANSAS,OK,959,1019,60,0.5151668351870576
KANSAS CITY,KS,59342,51177,-8165,0.46306065020494214
KANSAS CITY,MO,288474,267160,-21314,0.4808201082007221
KANSASVILLE,WI,874,982,108,0.5290948275862069
KAPAA,HI,8487,6829,-1658,0.44587359623922695
KAPAAU,HI,667,656,-11,0.4958427815570673
KAPLAN,LA,3933,3431,-502,0.46591526344378054
KAPOLEI,HI,20374,17581,-2793,0.46320642866552497
KAPOWSIN,WA,51,41,-10,0.44565217391304346
KAPPA,IL,96,79,-17,0.4514285714285714
KARLSTAD,MN,352,162,-190,0.3151750972762646
KARNACK,TX,767,781,14,0.5045219638242894
KARNAK,IL,50,23,-27,0.3150684931506849
KARNES CITY,TX,1217,1181,-36,0.4924937447873228
KARNS CITY,PA,356,238,-118,0.4006734006734007
KARTHAUS,PA,12,0,-12,0
KASILOF,AK,1453,1163,-290,0.4445718654434251
KASKA,PA,15,19,4,0.5588235294117647
KASOTA,MN,567,405,-162,0.4166666666666667
KASSON,MN,2397,2481,84,0.508610086100861
KATHLEEN,FL,621,834,213,0.5731958762886598
KATHLEEN,GA,5022,7046,2024,0.5838581372224063
KATHRYN,ND,11,0,-11,0
KATONAH,NY,2589,3125,536,0.5469023451172559
KATTSKILL BAY,NY,106,133,27,0.5564853556485355
KATY,TX,126971,153491,26520,0.5472791322888663
KAUFMAN,TX,5936,6354,418,0.5170056956875508
KAUKAUNA,WI,8421,8414,-7,0.4997920997920998
KAUNAKAKAI,HI,1119,1169,50,0.5109265734265734
KAUNEONGA LAKE,NY,328,152,-176,0.31666666666666665
KAUNEONGA LK,NY,13,0,-13,0
KAW CITY,OK,18,23,5,0.5609756097560976
KAWKAWLIN,MI,1495,1345,-150,0.4735915492957746
KAYCEE,WY,17,63,46,0.7875
KAYENTA,AZ,622,788,166,0.5588652482269504
KAYSVILLE,UT,7751,8350,599,0.5186013291099931
KC,KS,316,391,75,0.553041018387553
KEAAU,HI,3619,4511,892,0.5548585485854859
KEALAKEKUA,HI,1566,1748,182,0.5274592637296318
KEAMS CANYON,AZ,85,41,-44,0.3253968253968254
KEANSBURG,NJ,3989,3917,-72,0.4954464963318998
KEARNEY,MO,5100,5440,340,0.5161290322580645
KEARNEY,NE,20438,16396,-4042,0.4451322148015421
KEARNEYSVILLE,WV,2355,2856,501,0.5480713874496258
KEARNS,UT,2569,1877,-692,0.42217723796671164
KEARNY,AZ,617,612,-5,0.4979658258746949
KEARNY,NJ,12392,10603,-1789,0.461100239182431
KEASBEY,NJ,1356,1102,-254,0.4483319772172498
KEATCHIE,LA,274,90,-184,0.24725274725274726
KEAUHOU,HI,288,0,-288,0
KEAVY,KY,199,215,16,0.5193236714975845
KECHI,KS,792,959,167,0.5476870359794404
KEEDYSVILLE,MD,894,826,-68,0.48023255813953486
KEEGO HARBOR,MI,1928,1778,-150,0.47976254722072315
KEELING,VA,24,77,53,0.7623762376237624
KEENE,CA,46,46,0,0.5
KEENE,ND,11,0,-11,0
KEENE,NH,13852,12176,-1676,0.4678039034885508
KEENE,NY,408,368,-40,0.4742268041237113
KEENE,TX,2382,2423,41,0.5042663891779396
KEENE VALLEY,NY,173,248,75,0.5890736342042755
KEENESBURG,CO,1647,2036,389,0.552810209068694
KEESEVILLE,NY,1993,1925,-68,0.49132210311383356
KEESLER AFB,MS,590,213,-377,0.26525529265255293
KEEWATIN,MN,251,71,-180,0.2204968944099379
KEISER,AR,72,12,-60,0.14285714285714285
KEITHSBURG,IL,96,40,-56,0.29411764705882354
KEITHVILLE,LA,3130,3021,-109,0.4911396520890912
KEIZER,OR,22233,17121,-5112,0.43505107485897243
KEKAHA,HI,629,473,-156,0.42921960072595283
KELAYRES,PA,34,24,-10,0.41379310344827586
KELFORD,NC,17,0,-17,0
KELL,IL,11,33,22,0.75
KELLER,TX,14694,15954,1260,0.5205559906029757
KELLER,WA,0,13,13,1
KELLERTON,IA,45,61,16,0.5754716981132075
KELLEY,IA,47,121,74,0.7202380952380952
KELLEYS ISLAND,OH,515,241,-274,0.3187830687830688
KELLIHER,MN,38,63,25,0.6237623762376238
KELLOGG,IA,478,373,-105,0.4383078730904818
KELLOGG,ID,1780,1575,-205,0.46944858420268254
KELLOGG,MN,209,250,41,0.5446623093681917
KELLY,LA,0,14,14,1
KELLY,NC,51,82,31,0.6165413533834586
KELLYTON,AL,422,282,-140,0.4005681818181818
KELLYVILLE,OK,1074,1059,-15,0.4964838255977497
KELSEYVILLE,CA,4302,4032,-270,0.4838012958963283
KELSO,TN,130,121,-9,0.4820717131474104
KELSO,WA,12082,10277,-1805,0.45963594078447156
KEMAH,TX,4149,3972,-177,0.48910232729959363
KEMMERER,WY,1399,1140,-259,0.44899566758566367
KEMP,TX,4181,4618,437,0.5248323673144676
KEMPNER,TX,3191,3825,634,0.5451824401368301
KEMPTON,IN,35,25,-10,0.4166666666666667
KEMPTON,PA,560,624,64,0.527027027027027
KENAI,AK,7807,5910,-1897,0.4308522271633739
KENANSVILLE,FL,478,749,271,0.6104319478402608
KENANSVILLE,NC,829,778,-51,0.48413192283758555
KENBRIDGE,VA,1087,1076,-11,0.497457235321313
KENDALL,FL,2262,2035,-227,0.4735862229462416
KENDALL,NY,551,386,-165,0.4119530416221985
KENDALL,WI,205,177,-28,0.46335078534031415
KENDALL PARK,NJ,2621,2935,314,0.5282577393808495
KENDALLVILLE,IN,7625,6549,-1076,0.4620431776492169
KENDLETON,TX,0,38,38,1
KENDRICK,ID,219,295,76,0.5739299610894941
KENDUSKEAG,ME,343,255,-88,0.42642140468227424
KENEDY,TX,1575,1537,-38,0.49389460154241643
KENEFIC,OK,0,27,27,1
KENEL,SD,0,15,15,1
KENESAW,NE,129,104,-25,0.44635193133047213
KENILWORTH,IL,474,691,217,0.5931330472103005
KENILWORTH,NJ,2329,2124,-205,0.47698181001571976
KENLY,NC,2499,2597,98,0.5096153846153846
KENMARE,ND,375,238,-137,0.38825448613376834
KENMORE,NY,3510,3160,-350,0.4737631184407796
KENMORE,WA,10435,10110,-325,0.49209053297639327
KENNA,WV,469,613,144,0.566543438077634
KENNARD,IN,0,17,17,1
KENNARD,NE,25,11,-14,0.3055555555555556
KENNARD,TX,126,179,53,0.5868852459016394
KENNEBUNK,ME,5296,6417,1121,0.5478528131136344
KENNEBUNKPORT,ME,2891,3527,636,0.5495481458398255
KENNEDALE,TX,2812,3133,321,0.5269974768713205
KENNEDY,AL,47,36,-11,0.43373493975903615
KENNEDY,NY,684,378,-306,0.3559322033898305
KENNEDYVILLE,MD,164,153,-11,0.48264984227129337
KENNER,LA,19120,17591,-1529,0.47917517910163165
KENNERDELL,PA,320,367,47,0.5342066957787481
KENNESAW,GA,40944,41151,207,0.5012607345148913
KENNETH CITY,FL,2803,3108,305,0.5257993571307731
KENNETT,MO,8084,6615,-1469,0.4500306143275053
KENNETT SQ,PA,287,247,-40,0.46254681647940077
KENNETT SQUARE,PA,6023,6907,884,0.534184068058778
KENNEWICK,WA,41414,39862,-1552,0.4904522860376987
KENNEY,IL,0,24,24,1
KENO,OR,318,504,186,0.6131386861313869
KENOCKEE,MI,395,340,-55,0.46258503401360546
KENOSHA,WI,53377,45589,-7788,0.46065315360830994
KENOVA,WV,1644,1432,-212,0.46553966189856955
KENSETT,AR,762,825,63,0.5198487712665406
KENSETT,IA,34,50,16,0.5952380952380952
KENSINGTON,CA,1564,1666,102,0.5157894736842106
KENSINGTON,CT,899,973,74,0.5197649572649573
KENSINGTON,KS,31,14,-17,0.3111111111111111
KENSINGTON,MD,5696,6255,559,0.5233871642540373
KENSINGTON,MN,78,33,-45,0.2972972972972973
KENSINGTON,NH,1371,1490,119,0.5207969241523943
KENSINGTON,OH,103,91,-12,0.4690721649484536
KENT,CT,946,1062,116,0.5288844621513944
KENT,IA,151,134,-17,0.47017543859649125
KENT,NY,350,337,-13,0.49053857350800584
KENT,OH,15791,13811,-1980,0.4665563137625836
KENT,WA,67930,63648,-4282,0.48372828284363645
KENT CITY,MI,1783,1642,-141,0.47941605839416057
KENTANF,IN,19,20,1,0.5128205128205128
KENTFIELD,CA,1347,1367,20,0.5036845983787767
KENTLAND,IN,1185,1091,-94,0.47934973637961337
KENTON,DE,0,27,27,1
KENTON,MI,0,18,18,1
KENTON,OH,5037,4873,-164,0.4917255297679112
KENTON,TN,1019,881,-138,0.4636842105263158
KENTS HILL,ME,112,217,105,0.6595744680851063
KENTS STORE,VA,185,429,244,0.6986970684039088
KENTWOOD,LA,2063,2138,75,0.5089264460842656
KENTWOOD,MI,2190,2035,-155,0.4816568047337278
KENVIL,NJ,227,274,47,0.5469061876247505
KENWOOD,CA,371,491,120,0.5696055684454756
KENYON,MN,1106,1156,50,0.51105216622458
KEOKEE,VA,0,11,11,1
KEOKUK,IA,7087,5651,-1436,0.44363322342596956
KEOSAUQUA,IA,906,764,-142,0.45748502994011975
KEOTA,IA,349,414,65,0.5425950196592398
KEOTA,OK,480,610,130,0.5596330275229358
KERENS,TX,1207,1346,139,0.527222875048962
KERHONKSON,NY,1926,2091,165,0.520537714712472
KERKHOVEN,MN,277,130,-147,0.3194103194103194
KERMAN,CA,4261,4017,-244,0.4852621406136748
KERMIT,TX,2123,1687,-436,0.4427821522309711
KERMIT,WV,221,189,-32,0.4609756097560976
KERNERSVILLE,NC,19951,21372,1421,0.5171938145826779
KERNVILLE,CA,562,625,63,0.5265374894692502
KERRVILLE,TX,18294,17995,-299,0.49588029430405905
KERSEY,CO,1291,1043,-248,0.44687232219365897
KERSEY,PA,832,709,-123,0.4600908500973394
KERSHAW,SC,2519,2698,179,0.517155453325666
KESHENA,WI,648,834,186,0.562753036437247
KESWICK,VA,1671,2258,587,0.5747009417154493
KETCHIKAN,AK,5914,5501,-413,0.48190976784932105
KETCHUM,ID,3790,4043,253,0.5161496233882293
KETCHUM,OK,429,106,-323,0.19813084112149532
KETTERING,MD,356,397,41,0.5272244355909694
KETTERING,OH,10605,10377,-228,0.49456677151844436
KETTLE FALLS,WA,2743,2789,46,0.5041576283441793
KETTLE RIVER,MN,22,117,95,0.841726618705036
KEUKA PARK,NY,648,205,-443,0.2403282532239156
KEUTERVILLE,ID,18,17,-1,0.4857142857142857
KEVIL,KY,1549,1512,-37,0.4939562234563868
KEW GARDENS,NY,7360,5418,-1942,0.42401001721709186
KEW GARDENS HILLS,NY,611,484,-127,0.4420091324200913
KEWADIN,MI,2053,1741,-312,0.4588824459673168
KEWANEE,IL,6518,5257,-1261,0.4464543524416136
KEWANNA,IN,646,637,-9,0.49649259547934527
KEWASKUM,WI,2726,2579,-147,0.48614514608859566
KEWAUNEE,WI,1823,1741,-82,0.4884960718294052
KEWEENAW BAY,MI,19,22,3,0.5365853658536586
KEY BISCAYNE,FL,6370,6438,68,0.5026545908806995
KEY COL BCH,FL,11,31,20,0.7380952380952381
KEY COLONY BEACH,FL,1574,1780,206,0.5307096004770423
KEY LARGO,FL,11476,13173,1697,0.5344233031765995
KEY WEST,FL,27313,26109,-1204,0.48873123432293814
KEYES,CA,1002,952,-50,0.4872057318321392
KEYES,OK,0,11,11,1
KEYESPORT,IL,34,30,-4,0.46875
KEYMAR,MD,569,578,9,0.5039232781168265
KEYPORT,NJ,4847,4574,-273,0.4855110922407388
KEYPORT,WA,249,175,-74,0.41273584905660377
KEYSER,WV,4031,3893,-138,0.49129227662796565
KEYSTONE,CO,362,226,-136,0.3843537414965986
KEYSTONE,IA,104,34,-70,0.2463768115942029
KEYSTONE,IN,12,0,-12,0
KEYSTONE,SD,267,315,48,0.5412371134020618
KEYSTONE HEIGHTS,FL,6243,6497,254,0.5099686028257456
KEYSVILLE,GA,296,276,-20,0.4825174825174825
KEYSVILLE,VA,1263,1302,39,0.5076023391812865
KEYTESVILLE,MO,265,214,-51,0.44676409185803756
KIAMESHA LAKE,NY,193,155,-38,0.4454022988505747
KIAWAH ISLAND,SC,332,448,116,0.5743589743589743
KIDDER,MO,59,107,48,0.6445783132530121
KIEFER,OK,845,855,10,0.5029411764705882
KIEL,WI,2526,2295,-231,0.4760423148724331
KIELER,WI,15,11,-4,0.4230769230769231
KIESTER,MN,87,11,-76,0.11224489795918367
KIEZER,OR,92,76,-16,0.4523809523809524
KIHEI,HI,19661,19661,0,0.5
KILA,MT,964,826,-138,0.46145251396648046
KILAUEA,HI,1862,1721,-141,0.48032375104660896
KILBUCK,PA,28,43,15,0.6056338028169014
KILDEER,IL,1551,1717,166,0.5253977968176254
KILGORE,TX,9465,8703,-762,0.47902906208718626
KILKENNY,MN,69,22,-47,0.24175824175824176
KILL BUCK,NY,0,11,11,1
KILL DEVIL HILLS,NC,5960,6132,172,0.5071121402580219
KILLBUCK,OH,656,571,-85,0.46536267318663405
KILLDEER,ND,1098,835,-263,0.4319710294878427
KILLEEN,TX,115830,94103,-21727,0.44825253771441365
KILLEN,AL,3652,4265,613,0.5387141594038146
KILLINGLY,CT,38,68,30,0.6415094339622641
KILLINGTON,VT,1517,1503,-14,0.49768211920529803
KILLINGWORTH,CT,1647,1894,247,0.5348771533465123
KILLONA,LA,56,36,-20,0.391304347826087
KILMARNOCK,VA,1605,1467,-138,0.4775390625
KILMICHAEL,MS,89,147,58,0.6228813559322034
KILN,MS,2279,2427,148,0.5157246068848279
KIMBALL,MI,3132,3161,29,0.5023041474654378
KIMBALL,MN,952,932,-20,0.49469214437367304
KIMBALL,NE,1679,1328,-351,0.44163618224143664
KIMBALL,SD,46,51,5,0.5257731958762887
KIMBALL,TN,128,131,3,0.5057915057915058
KIMBALLTON,IA,29,0,-29,0
KIMBERLING CITY,MO,2582,2555,-27,0.4973720070079813
KIMBERLING CY,MO,48,45,-3,0.4838709677419355
KIMBERLY,AL,734,914,180,0.5546116504854369
KIMBERLY,ID,2585,3171,586,0.5509034051424601
KIMBERLY,WI,3197,2961,-236,0.48083793439428385
KIMBERTON,PA,14,0,-14,0
KIMBOLTON,OH,587,633,46,0.5188524590163934
KIMMELL,IN,270,148,-122,0.35406698564593303
KIMPER,KY,271,147,-124,0.35167464114832536
KINARD,FL,13,0,-13,0
KINARDS,SC,0,13,13,1
KINBRAE,MN,26,0,-26,0
KINCAID,IL,3387,1618,-1769,0.3232767232767233
KINCAID,WV,11,0,-11,0
KINCHELOE,MI,1157,1106,-51,0.4887317719840919
KINDE,MI,431,168,-263,0.28046744574290483
KINDER,LA,1739,1862,123,0.5170785892807553
KINDERHOOK,IL,0,11,11,1
KINDERHOOK,NY,722,693,-29,0.48975265017667846
KINDRED,ND,182,324,142,0.6403162055335968
KING,NC,4492,5139,647,0.5335894507320113
KING,WI,0,42,42,1
KING CITY,CA,2291,2165,-126,0.4858617594254937
KING CITY,MO,556,530,-26,0.4880294659300184
KING CITY,OR,866,803,-63,0.4811264230077891
KING FERRY,NY,254,179,-75,0.4133949191685912
KING GEORGE,VA,7433,8779,1346,0.5415124599062423
KING OF PRUSSIA,PA,16623,16101,-522,0.49202420242024203
KING SALMON,AK,143,193,50,0.5744047619047619
KING WILLIAM,VA,565,742,177,0.5677123182861515
KINGDOM CITY,MO,158,223,65,0.5853018372703412
KINGFIELD,ME,1117,893,-224,0.44427860696517413
KINGFISHER,OK,2609,2240,-369,0.4619509177149928
KINGMAN,AZ,28224,31934,3710,0.5308354666046079
KINGMAN,IN,884,819,-65,0.48091603053435117
KINGMAN,KS,1883,1895,12,0.5015881418740075
KINGS BAY,GA,480,12,-468,0.024390243902439025
KINGS BEACH,CA,2185,913,-1272,0.2947062621045836
KINGS ISLAND,OH,0,16,16,1
KINGS MILLS,OH,135,243,108,0.6428571428571429
KINGS MOUNTAIN,KY,130,138,8,0.5149253731343284
KINGS MOUNTAIN,NC,8831,8919,88,0.5024788732394366
KINGS MTN,NC,419,305,-114,0.4212707182320442
KINGS PARK,NY,4559,4412,-147,0.491806933452235
KINGS POINT,NY,252,323,71,0.5617391304347826
KINGSBURG,CA,4528,4879,351,0.5186563197618794
KINGSBURY,TX,703,668,-35,0.48723559445660103
KINGSFORD,MI,2726,2436,-290,0.47191011235955055
KINGSFORD HEIGHTS,IN,448,357,-91,0.4434782608695652
KINGSFORD HTS,IN,25,15,-10,0.375
KINGSLAND,AR,130,81,-49,0.38388625592417064
KINGSLAND,GA,13447,12269,-1178,0.4770959713796858
KINGSLAND,TX,4252,4671,419,0.5234786506780231
KINGSLEY,IA,664,516,-148,0.43728813559322033
KINGSLEY,MI,2556,2396,-160,0.48384491114701134
KINGSLEY,PA,463,336,-127,0.42052565707133915
KINGSPORT,TN,33696,35310,1614,0.5116946352491087
KINGSTON,AR,11,0,-11,0
KINGSTON,GA,1633,1968,335,0.546514856984171
KINGSTON,ID,307,454,147,0.5965834428383706
KINGSTON,IL,741,562,-179,0.4313123561013047
KINGSTON,MA,3911,4357,446,0.5269714562167392
KINGSTON,MI,757,567,-190,0.4282477341389728
KINGSTON,MO,0,56,56,1
KINGSTON,NH,2100,2093,-7,0.4991652754590985
KINGSTON,NJ,82,0,-82,0
KINGSTON,NY,15988,14850,-1138,0.48154873856929764
KINGSTON,OH,1069,1180,111,0.5246776345042241
KINGSTON,OK,3085,3457,372,0.5284316722714766
KINGSTON,PA,10655,9783,-872,0.4786671885703102
KINGSTON,RI,1145,916,-229,0.4444444444444444
KINGSTON,TN,5572,5520,-52,0.4976559682654165
KINGSTON,WA,3885,4241,356,0.5219049963081467
KINGSTON,WI,11,0,-11,0
KINGSTON SPGS,TN,114,148,34,0.5648854961832062
KINGSTON SPRINGS,TN,1672,1815,143,0.5205047318611987
KINGSTOWNE,VA,1122,1218,96,0.5205128205128206
KINGSTREE,SC,2821,2799,-22,0.49804270462633454
KINGSVILLE,MD,982,1247,265,0.5594436967249888
KINGSVILLE,MO,1035,1008,-27,0.4933920704845815
KINGSVILLE,OH,631,643,12,0.5047095761381476
KINGSVILLE,TX,12157,9880,-2277,0.4483368879611562
KINGWOOD,TX,26790,26924,134,0.5012473470603567
KINGWOOD,WV,2180,1870,-310,0.4617283950617284
KINMUNDY,IL,550,418,-132,0.4318181818181818
KINNEAR,WY,0,33,33,1
KINNELON,NJ,2837,3237,400,0.532927230819888
KINROSS,IA,33,12,-21,0.26666666666666666
KINROSS,MI,11,25,14,0.6944444444444444
KINSALE,VA,105,112,7,0.5161290322580645
KINSEY,AL,961,783,-178,0.44896788990825687
KINSLEY,KS,750,517,-233,0.4080505130228887
KINSMAN,OH,817,757,-60,0.4809402795425667
KINSTON,AL,763,826,63,0.5198237885462555
KINSTON,NC,14324,12348,-1976,0.46295740851829636
KINTA,OK,58,65,7,0.5284552845528455
KINTNERSVILLE,PA,460,497,37,0.5193312434691745
KINZERS,PA,531,433,-98,0.4491701244813278
KIOWA,CO,1273,1243,-30,0.4940381558028617
KIOWA,KS,328,191,-137,0.36801541425818884
KIOWA,OK,205,167,-38,0.4489247311827957
KIPTON,OH,11,0,-11,0
KIRBY,AR,36,37,1,0.5068493150684932
KIRBY,TX,432,345,-87,0.444015444015444
KIRBYVILLE,MO,1042,1112,70,0.5162488393686165
KIRBYVILLE,TX,2570,2319,-251,0.4743301288607077
KIRKERSVILLE,OH,57,0,-57,0
KIRKLAND,AZ,502,630,128,0.5565371024734982
KIRKLAND,IL,660,627,-33,0.48717948717948717
KIRKLAND,WA,52683,51466,-1217,0.4941574090965828
KIRKLIN,IN,280,331,51,0.5417348608837971
KIRKLYN,PA,338,284,-54,0.4565916398713826
KIRKSEY,KY,53,25,-28,0.32051282051282054
KIRKSVILLE,MO,13838,10117,-3721,0.4223335420580255
KIRKVILLE,NY,1340,1364,24,0.5044378698224852
KIRKWOOD,CA,46,73,27,0.6134453781512605
KIRKWOOD,IL,145,47,-98,0.24479166666666666
KIRKWOOD,MO,3239,3446,207,0.5154824233358265
KIRKWOOD,NY,1494,1327,-167,0.4704005671747607
KIRKWOOD,PA,603,524,-79,0.4649511978704525
KIRON,IA,23,0,-23,0
KIRTLAND,NM,1192,1371,179,0.5349200156067109
KIRTLAND,OH,322,295,-27,0.47811993517017826
KIRTLAND AFB,NM,0,37,37,1
KISMET,KS,23,0,-23,0
KISSEE MILLS,MO,297,457,160,0.6061007957559682
KISSIMMEE,FL,198802,201246,2444,0.5030546334439867
KITE,GA,260,288,28,0.5255474452554745
KITTANNING,PA,5282,5157,-125,0.4940128364785899
KITTERY,ME,4553,4501,-52,0.49712834106472276
KITTERY POINT,ME,816,978,162,0.5451505016722408
KITTITAS,WA,421,346,-75,0.4511082138200782
KITTREDGE,CO,200,267,67,0.5717344753747323
KITTRELL,NC,1150,929,-221,0.44684944684944683
KITTS HILL,OH,298,380,82,0.56047197640118
KITTY HAWK,NC,4148,4605,457,0.5261053353136068
KLAMATH,CA,141,254,113,0.6430379746835443
KLAMATH FALLS,OR,23625,23544,-81,0.499141385231826
KLAMATH RIVER,CA,51,0,-51,0
KLAWOCK,AK,348,157,-191,0.3108910891089109
KLEIN,TX,27,43,16,0.6142857142857143
KLEMME,IA,267,94,-173,0.26038781163434904
KLINE TOWNSHIP,PA,35,34,-1,0.4927536231884058
KLONDIKE,TX,0,14,14,1
KNAPP,WI,188,196,8,0.5104166666666666
KNEELAND,CA,26,11,-15,0.2972972972972973
KNIFE RIVER,MN,12,26,14,0.6842105263157895
KNIFLEY,KY,50,22,-28,0.3055555555555556
KNIGHTDALE,NC,14772,13429,-1343,0.4761887876316443
KNIGHTS LANDING,CA,110,111,1,0.502262443438914
KNIGHTS LNDG,CA,16,0,-16,0
KNIGHTSEN,CA,47,38,-9,0.4470588235294118
KNIGHTSTOWN,IN,1817,1661,-156,0.4775733179988499
KNIGTDALE,NC,33,52,19,0.611764705882353
KNIPPA,TX,13,12,-1,0.48
KNOB LICK,KY,13,0,-13,0
KNOB NOSTER,MO,3288,2965,-323,0.4741723972493203
KNOBEL,AR,12,0,-12,0
KNOLLWOOD,TX,1084,1244,160,0.5343642611683849
KNOTTS ISLAND,NC,617,610,-7,0.4971475142624287
KNOX,IN,5265,4377,-888,0.45395146235220907
KNOX,ME,89,111,22,0.555
KNOX,PA,1447,1194,-253,0.45210147671336615
KNOX CITY,MO,14,14,0,0.5
KNOX CITY,TX,246,302,56,0.551094890510949
KNOX DALE,PA,11,0,-11,0
KNOXVILLE,AR,242,280,38,0.5363984674329502
KNOXVILLE,IA,5242,4991,-251,0.48773575686504445
KNOXVILLE,IL,1256,1226,-30,0.4939564867042707
KNOXVILLE,MD,1110,1165,55,0.512087912087912
KNOXVILLE,PA,535,334,-201,0.38434982738780205
KNOXVILLE,TN,187108,179916,-7192,0.49020227560050567
KODAK,TN,4496,5356,860,0.5436459602111247
KODIAK,AK,7440,4697,-2743,0.38699843453901295
KOHLER,WI,812,714,-98,0.46788990825688076
KOKOMO,IN,47838,33735,-14103,0.41355595601485784
KOKOMO,MS,59,47,-12,0.44339622641509435
KOLOA,HI,2974,3174,200,0.5162654521795705
KONAWA,OK,1036,1110,74,0.5172413793103449
KOOSKIA,ID,877,984,107,0.5287479849543256
KOOTENAI,ID,0,133,133,1
KOPPEL,PA,288,223,-65,0.436399217221135
KOPPERL,TX,100,162,62,0.6183206106870229
KOSCIUSKO,MS,3288,3185,-103,0.49204387455584736
KOSHKONONG,MO,179,145,-34,0.44753086419753085
KOSSE,TX,265,400,135,0.6015037593984962
KOTLIK,AK,0,11,11,1
KOTZEBUE,AK,729,376,-353,0.3402714932126697
KOUNTZE,TX,2558,2775,217,0.5203450215638478
KOUTS,IN,1322,1248,-74,0.4856031128404669
KRAKOW,WI,0,11,11,1
KREBS,OK,526,521,-5,0.4976122254059217
KREMLIN,OK,0,26,26,1
KREMMLING,CO,753,722,-31,0.4894915254237288
KRESGEVILLE,PA,216,28,-188,0.11475409836065574
KRESS,TX,63,43,-20,0.4056603773584906
KRONENWETTER,WI,3016,2987,-29,0.4975845410628019
KROTZ SPRINGS,LA,73,129,56,0.6386138613861386
KRUM,TX,3638,3868,230,0.5153210764721556
KULA,HI,3511,3544,33,0.502338766832034
KULM,ND,51,0,-51,0
KULPMONT,PA,964,981,17,0.5043701799485861
KULPSVILLE,PA,12,0,-12,0
KUNA,ID,11070,13722,2652,0.5534849951597289
KUNIA,HI,58,26,-32,0.30952380952380953
KUNKLE,OH,12,0,-12,0
KUNKLETOWN,PA,2589,2854,265,0.5243431930920448
KURE BEACH,NC,1301,1418,117,0.5215152629643252
KURTISTOWN,HI,841,1119,278,0.5709183673469388
KUTTAWA,KY,1146,968,-178,0.45789971617786185
KUTZTOWN,PA,3807,3943,136,0.508774193548387
KYKOTSMOVI,AZ,0,12,12,1
KYLE,SD,71,29,-42,0.29
KYLE,TX,24279,29594,5315,0.5493289774098342
L COMPTON,RI,242,232,-10,0.48945147679324896
LA,CA,0,32,32,1
LA BARGE,WY,34,23,-11,0.40350877192982454
LA BELLE,FL,89,343,254,0.7939814814814815
LA BELLE,MO,171,177,6,0.5086206896551724
LA BELLE,PA,0,11,11,1
LA BLANCA,TX,29,27,-2,0.48214285714285715
LA CANADA,CA,684,871,187,0.5601286173633441
LA CANADA FLINTRIDGE,CA,3856,4920,1064,0.5606198723792161
LA CANADA FLT,CA,75,85,10,0.53125
LA CENTER,KY,849,677,-172,0.4436435124508519
LA CENTER,WA,2844,3755,911,0.5690256099409001
LA CONNER,WA,2198,2332,134,0.5147902869757175
LA COSTE,TX,103,184,81,0.6411149825783972
LA CRESCENT,MN,2758,2577,-181,0.4830365510777882
LA CRESCENTA,CA,7360,7825,465,0.515311162331248
LA CROSSE,FL,12,0,-12,0
LA CROSSE,IN,155,62,-93,0.2857142857142857
LA CROSSE,KS,598,602,4,0.5016666666666667
LA CROSSE,VA,1116,905,-211,0.4477981197427016
LA CROSSE,WI,37400,28361,-9039,0.43127385532458445
LA CYGNE,KS,1377,1275,-102,0.4807692307692308
LA FARGE,WI,788,696,-92,0.46900269541778977
LA FARGEVILLE,NY,827,848,21,0.506268656716418
LA FAYETTE,GA,6741,6981,240,0.5087450808919982
LA FAYETTE,IN,620,558,-62,0.47368421052631576
LA FAYETTE,NY,1420,1547,127,0.521402089652848
LA FERIA,TX,2915,3561,646,0.5498764669549104
LA FOLLETTE,TN,7536,7093,-443,0.4848588420261125
LA FONTAINE,IN,593,563,-30,0.4870242214532872
LA FRANCE,SC,17,0,-17,0
LA GRANDE,OR,10671,7836,-2835,0.4234073593775328
LA GRANGE,CA,877,949,72,0.5197152245345017
LA GRANGE,IL,9344,9130,-214,0.4942080762152214
LA GRANGE,KY,5471,5174,-297,0.4860497886331611
LA GRANGE,MO,231,354,123,0.6051282051282051
LA GRANGE,NC,3821,3697,-124,0.4917531258313381
LA GRANGE,NY,48,28,-20,0.3684210526315789
LA GRANGE,TX,3524,3540,16,0.5011325028312571
LA GRANGE PARK,IL,3691,3504,-187,0.48700486448922864
LA GRULLA,TX,14,0,-14,0
LA HABRA,CA,17123,16167,-956,0.485641333733854
LA HABRA HEIGHTS,CA,1703,1595,-108,0.4836264402668284
LA HARPE,IL,385,263,-122,0.4058641975308642
LA HARPE,KS,118,66,-52,0.358695652173913
LA HONDA,CA,368,227,-141,0.3815126050420168
LA JARA,CO,500,410,-90,0.45054945054945056
LA JOLLA,CA,22645,22918,273,0.5029958518973728
LA JOYA,TX,344,367,23,0.5161744022503516
LA JUNTA,CO,4962,3864,-1098,0.43779741672331746
LA LUZ,NM,865,864,-1,0.4997108155002892
LA MARQUE,TX,8074,10224,2150,0.5587495901191387
LA MESA,CA,35871,34543,-1328,0.49057005709091944
LA MESA,NM,392,524,132,0.5720524017467249
LA MIRADA,CA,10351,10322,-29,0.49929860204130994
LA MOILLE,IL,185,127,-58,0.40705128205128205
LA MONTE,MO,494,421,-73,0.4601092896174863
LA MOTTE,IA,11,11,0,0.5
LA PALMA,CA,3449,3477,28,0.5020213687554144
LA PINE,OR,7105,7961,856,0.5284083366520642
LA PLACE,LA,9621,7991,-1630,0.45372473313649786
LA PLATA,MD,6193,7406,1213,0.5445988675637915
LA PLATA,MO,965,887,-78,0.4789416846652268
LA PLATA,NM,57,47,-10,0.4519230769230769
LA POINTE,WI,780,635,-145,0.44876325088339225
LA PORTE,CA,0,11,11,1
LA PORTE,IN,15344,15085,-259,0.49574419139636533
LA PORTE,TX,11596,12112,516,0.5108824025645352
LA PORTE CITY,IA,1292,1112,-180,0.46256239600665555
LA PRYOR,TX,61,11,-50,0.1527777777777778
LA PUENTE,CA,20079,17965,-2114,0.4722163810324887
LA PUSH,WA,13,0,-13,0
LA QUINTA,CA,23632,27033,3401,0.5335636040659232
LA RUE,OH,421,403,-18,0.4890776699029126
LA RUSSELL,MO,0,24,24,1
LA SAL,UT,27,12,-15,0.3076923076923077
LA SALLE,CO,2343,1717,-626,0.4229064039408867
LA SALLE,IL,4428,3967,-461,0.47254318046456223
LA SALLE,MI,876,1003,127,0.533794571580628
LA SELVA BEACH,CA,411,322,-89,0.4392905866302865
LA VALLE,WI,1194,1174,-20,0.49577702702702703
LA VERGNE,TN,17995,14194,-3801,0.4409580912734164
LA VERKIN,UT,1704,1681,-23,0.496602658788774
LA VERNE,CA,9605,10187,582,0.5147029102667745
LA VERNIA,TX,4231,5304,1073,0.5562663869952805
LA VETA,CO,1223,1211,-12,0.49753492193919474
LA VILLA,TX,168,11,-157,0.061452513966480445
LA VISTA,NE,9181,8457,-724,0.47947613108062137
LA WARD,TX,0,22,22,1
LABADIE,MO,713,762,49,0.5166101694915254
LABADIEVILLE,LA,313,338,25,0.5192012288786483
LABELLE,FL,7742,10587,2845,0.5776092530961864
LAC DU FLAMBEAU,WI,1364,1314,-50,0.49066467513069456
LAC DU FLAMBU,WI,49,44,-5,0.4731182795698925
LACASSINE,LA,0,25,25,1
LACEY,WA,35881,37041,1160,0.5079537039576534
LACEYS SPRING,AL,1406,1359,-47,0.491500904159132
LACEYVILLE,PA,758,749,-9,0.49701393497013935
LACHINE,MI,712,737,25,0.5086266390614217
LACKAWANNA,NY,3933,3510,-423,0.47158403869407495
LACKAWAXEN,PA,381,597,216,0.6104294478527608
LACKLAND AFB,TX,64,37,-27,0.36633663366336633
LACLEDE,ID,62,130,68,0.6770833333333334
LACLEDE,MO,29,26,-3,0.4727272727272727
LACOMBE,LA,2756,3022,266,0.523018345448252
LACON,IL,1017,998,-19,0.49528535980148886
LACONA,IA,221,213,-8,0.49078341013824883
LACONA,NY,955,721,-234,0.4301909307875895
LACONIA,IN,392,241,-151,0.3807266982622433
LACONIA,NH,11011,10635,-376,0.4913147925713758
LACOOCHEE,FL,12,12,0,0.5
LACROSSE,WA,56,36,-20,0.391304347826087
LACY LAKEVIEW,TX,232,230,-2,0.49783549783549785
LADD,IL,187,90,-97,0.3249097472924188
LADDONIA,MO,105,38,-67,0.26573426573426573
LADERA RANCH,CA,6645,8051,1406,0.5478361458900382
LADOGA,IN,878,714,-164,0.4484924623115578
LADONIA,TX,182,207,25,0.532133676092545
LADORA,IA,11,0,-11,0
LADSON,SC,19816,19072,-744,0.49043406706439
LADY LAKE,FL,25890,31696,5806,0.5504115583648803
LADYS ISLAND,SC,585,688,103,0.5404556166535742
LADYSMITH,VA,15,13,-2,0.4642857142857143
LADYSMITH,WI,2970,2683,-287,0.4746152485405979
LAFAYETTE,AL,1369,1439,70,0.5124643874643875
LAFAYETTE,CA,9490,10253,763,0.5193233044623411
LAFAYETTE,CO,16341,17081,740,0.5110705523308001
LAFAYETTE,GA,138,134,-4,0.49264705882352944
LAFAYETTE,IN,75050,51345,-23705,0.40622651212468847
LAFAYETTE,LA,60424,57815,-2609,0.48896726122514567
LAFAYETTE,MN,24,70,46,0.7446808510638298
LAFAYETTE,NJ,1035,1207,172,0.5383586083853702
LAFAYETTE,OH,12,0,-12,0
LAFAYETTE,OR,1598,1512,-86,0.48617363344051445
LAFAYETTE,TN,6098,6301,203,0.5081861440438745
LAFAYETTE,VA,23,20,-3,0.46511627906976744
LAFAYETTE HILL,PA,2888,3048,160,0.5134770889487871
LAFAYETTE HL,PA,108,122,14,0.5304347826086957
LAFE,AR,56,49,-7,0.4666666666666667
LAFITTE,LA,767,486,-281,0.38786911412609737
LAGO VISTA,TX,4304,6207,1903,0.5905242127295215
LAGRANGE,GA,19381,19584,203,0.5026049018349801
LAGRANGE,IN,3945,3198,-747,0.44771104577908444
LAGRANGE,KY,2189,2183,-6,0.4993138151875572
LAGRANGE,ME,91,92,1,0.5027322404371585
LAGRANGE,OH,1885,2029,144,0.5183955033214103
LAGRANGEVILLE,NY,1896,2082,186,0.5233785822021116
LAGRO,IN,103,114,11,0.5253456221198156
LAGUNA,NM,147,193,46,0.5676470588235294
LAGUNA BEACH,CA,12822,14598,1776,0.5323851203501094
LAGUNA HILLS,CA,15375,14474,-901,0.48490736708097426
LAGUNA NIGUEL,CA,26574,28100,1526,0.5139554450012803
LAGUNA VISTA,TX,1900,3881,1981,0.6713371389033039
LAGUNA WOODS,CA,9374,10328,954,0.5242107400263932
LAGUNITAS,CA,35,25,-10,0.4166666666666667
LAHAINA,HI,13290,13015,-275,0.4947728568713172
LAHASKA,PA,15,31,16,0.6739130434782609
LAHOMA,OK,124,97,-27,0.43891402714932126
LAIE,HI,1236,1021,-215,0.4523704031900753
LAINGSBURG,MI,2578,2480,-98,0.4903123764333729
LAIRD HILL,TX,38,0,-38,0
LAIRDSVILLE,PA,11,0,-11,0
LAJITAS,TX,26,16,-10,0.38095238095238093
LAKE,MI,2827,2660,-167,0.4847822125022781
LAKE,MS,650,650,0,0.5
LAKE ALFRED,FL,5325,5753,428,0.5193175663477162
LAKE ALMANOR,CA,139,77,-62,0.35648148148148145
LAKE ALUMA,OK,18,16,-2,0.47058823529411764
LAKE ANDES,SD,358,211,-147,0.37082601054481545
LAKE ANN,MI,1647,1465,-182,0.47075835475578404
LAKE ANNETTE,MO,15,0,-15,0
LAKE ARIEL,PA,5584,5145,-439,0.4795414297697828
LAKE ARROWHEAD,CA,1761,1682,-79,0.48852744699390066
LAKE ARTHUR,LA,1381,1378,-3,0.4994563247553461
LAKE ARTHUR,NM,0,11,11,1
LAKE BALBOA,CA,4587,3566,-1021,0.4373850116521526
LAKE BARRINGTON,IL,2321,2559,238,0.5243852459016394
LAKE BENTON,MN,357,242,-115,0.4040066777963272
LAKE BLUFF,IL,4532,4404,-128,0.4928379588182632
LAKE BUTLER,FL,3427,3360,-67,0.49506409311919847
LAKE CHARLES,LA,60834,49710,-11124,0.4496851932262267
LAKE CITY,AR,1649,1174,-475,0.4158696422245838
LAKE CITY,CO,1051,731,-320,0.4102132435465769
LAKE CITY,FL,22946,23731,785,0.5084088523255564
LAKE CITY,GA,812,707,-105,0.46543778801843316
LAKE CITY,IA,894,657,-237,0.42359767891682787
LAKE CITY,IL,0,14,14,1
LAKE CITY,MI,4367,3970,-397,0.47619047619047616
LAKE CITY,MN,3411,3196,-215,0.4837293779324958
LAKE CITY,PA,1343,1300,-43,0.49186530457813094
LAKE CITY,SC,3529,3264,-265,0.4804946268217283
LAKE CITY,SD,23,12,-11,0.34285714285714286
LAKE CITY,TN,19,35,16,0.6481481481481481
LAKE CITY,TX,54,72,18,0.5714285714285714
LAKE CLARKE,FL,190,191,1,0.5013123359580053
LAKE CLARKE SHORES,FL,576,563,-13,0.4942932396839333
LAKE CLEAR,NY,172,247,75,0.5894988066825776
LAKE COMO,FL,38,14,-24,0.2692307692307692
LAKE COMO,NJ,169,127,-42,0.42905405405405406
LAKE COMO,PA,0,11,11,1
LAKE CORMORANT,MS,552,553,1,0.5004524886877828
LAKE CRYSTAL,MN,1848,1193,-655,0.39230516277540284
LAKE DALLAS,TX,4415,4438,23,0.5012989946910652
LAKE DELTON,WI,737,491,-246,0.3998371335504886
LAKE ELMO,MN,3809,5842,2033,0.605325872966532
LAKE ELMORE,VT,15,0,-15,0
LAKE ELSINORE,CA,27682,29269,1587,0.5139330301487244
LAKE FOREST,CA,22979,23236,257,0.502780482527318
LAKE FOREST,IL,7936,9096,1160,0.5340535462658526
LAKE FOREST PARK,WA,4133,4265,132,0.5078590140509646
LAKE FREDERICK,VA,282,306,24,0.5204081632653061
LAKE GENEVA,WI,10077,9672,-405,0.4897463162691782
LAKE GEORGE,CO,529,423,-106,0.44432773109243695
LAKE GEORGE,MI,138,79,-59,0.3640552995391705
LAKE GEORGE,MN,111,32,-79,0.22377622377622378
LAKE GEORGE,NY,3298,3134,-164,0.4872512437810945
LAKE GROVE,NY,4180,3805,-375,0.4765184721352536
LAKE GROVE,OR,643,695,52,0.5194319880418535
LAKE HAMILTON,FL,181,356,175,0.6629422718808193
LAKE HARMONY,PA,380,172,-208,0.3115942028985507
LAKE HAVASU CITY,AZ,41495,51634,10139,0.5544352457344114
LAKE HELEN,FL,1679,2026,347,0.5468286099865047
LAKE HIAWATHA,NJ,2794,2618,-176,0.483739837398374
LAKE HILL,NY,0,13,13,1
LAKE HOPATCONG,NJ,2836,2681,-155,0.48595251042233095
LAKE HUGHES,CA,1233,906,-327,0.423562412342216
LAKE HUNTINGTON,NY,12,0,-12,0
LAKE IN THE HILLS,IL,8132,7852,-280,0.49124124124124124
LAKE ISABELLA,CA,2792,2851,59,0.5052277157540316
LAKE ISABELLA,MI,142,112,-30,0.4409448818897638
LAKE JACKSON,TX,16292,12908,-3384,0.44205479452054797
LAKE JUNALUSKA,NC,860,875,15,0.5043227665706052
LAKE KATRINE,NY,1030,1004,-26,0.4936086529006883
LAKE LA,CA,31,30,-1,0.4918032786885246
LAKE LEELANAU,MI,1247,1129,-118,0.4751683501683502
LAKE LILLIAN,MN,106,35,-71,0.24822695035460993
LAKE LINDEN,MI,1304,1252,-52,0.48982785602503914
LAKE LOS ANGELES,CA,265,204,-61,0.4349680170575693
LAKE LOTAWANA,MO,1229,1224,-5,0.49898083978801466
LAKE LURE,NC,1737,2010,273,0.5364291433146517
LAKE LUZERNE,NY,1691,1640,-51,0.4923446412488742
LAKE LYNN,PA,13,0,-13,0
LAKE MARY,FL,29738,28431,-1307,0.4887654936478193
LAKE MILLS,IA,1423,1157,-266,0.4484496124031008
LAKE MILLS,WI,3641,3634,-7,0.4995189003436426
LAKE MILTON,OH,1150,979,-171,0.4598403006106153
LAKE MONROE,FL,476,882,406,0.6494845360824743
LAKE MONTEZUMA,AZ,133,0,-133,0
LAKE NEBAGAMON,WI,908,959,51,0.5136582753079807
LAKE NORDEN,SD,604,462,-142,0.4333958724202627
LAKE ODESSA,MI,2072,1897,-175,0.47795414462081126
LAKE ORION,MI,11896,11999,103,0.50215526260724
LAKE OSWEGO,OR,23816,24425,609,0.5063120582077486
LAKE OZARK,MO,5982,5377,-605,0.47336913460691965
LAKE PANASOFFKEE,FL,2984,3832,848,0.562206572769953
LAKE PARK,FL,2817,2467,-350,0.4668811506434519
LAKE PARK,GA,3694,3751,57,0.5038280725319007
LAKE PARK,IA,296,396,100,0.5722543352601156
LAKE PARK,MN,1252,1146,-106,0.4778982485404504
LAKE PEEKSKILL,NY,593,534,-59,0.4738243123336291
LAKE PLACID,FL,17089,18657,1568,0.5219325239187601
LAKE PLACID,NY,3372,3172,-200,0.484718826405868
LAKE PLEASANT,MA,0,11,11,1
LAKE PLEASANT,NY,305,231,-74,0.43097014925373134
LAKE POINT,UT,348,358,10,0.5070821529745042
LAKE POWELL,UT,0,11,11,1
LAKE PRESTON,SD,74,87,13,0.5403726708074534
LAKE PROVIDENCE,LA,1667,1525,-142,0.47775689223057644
LAKE QUIVIRA,KS,535,421,-114,0.44037656903765693
LAKE RIDGE,VA,1322,1073,-249,0.4480167014613779
LAKE SAINT CROIX BEACH,MN,30,31,1,0.5081967213114754
LAKE SAINT LOUIS,MO,8166,9714,1548,0.5432885906040269
LAKE SHERWOOD,MO,164,191,27,0.5380281690140845
LAKE SHORE,MN,361,355,-6,0.4958100558659218
LAKE ST LOUIS,MO,1234,1433,199,0.5373078365204349
LAKE STATION,IN,3953,3900,-53,0.4966254934419967
LAKE STEVENS,WA,18408,20340,1932,0.5249303189842056
LAKE SUCCESS,NY,19,28,9,0.5957446808510638
LAKE SUZY,FL,1316,3391,2075,0.7204164011047376
LAKE TAPPS,WA,1786,2134,348,0.5443877551020408
LAKE TOMAHAWK,WI,928,789,-139,0.45952242283051836
LAKE TOXAWAY,NC,1234,1564,330,0.5589706933523946
LAKE VIEW,AL,89,124,35,0.5821596244131455
LAKE VIEW,IA,662,506,-156,0.4332191780821918
LAKE VIEW,NY,1663,1847,184,0.5262108262108263
LAKE VIEW,SC,418,486,68,0.5376106194690266
LAKE VIEW PLT,ME,36,33,-3,0.4782608695652174
LAKE VIEW TER,CA,433,448,15,0.5085130533484676
LAKE VILLA,IL,8123,7751,-372,0.48828272647095883
LAKE VILLAGE,AR,1784,1606,-178,0.4737463126843658
LAKE VILLAGE,IN,1049,1078,29,0.5068171133051246
LAKE WACCAMAW,NC,483,730,247,0.6018136850783182
LAKE WALES,FL,26112,26642,530,0.5050233157675247
LAKE WAYNOKA,OH,145,154,9,0.5150501672240803
LAKE WILSON,MN,38,0,-38,0
LAKE WINNEBAGO,MO,350,425,75,0.5483870967741935
LAKE WINOLA,PA,124,83,-41,0.40096618357487923
LAKE WORTH,FL,55424,58756,3332,0.5145909966719215
LAKE WORTH,TX,837,861,24,0.5070671378091873
LAKE WORTH BEACH,FL,16883,15673,-1210,0.48141663595036244
LAKE WYLIE,SC,303,330,27,0.5213270142180095
LAKE ZURICH,IL,6303,7663,1360,0.5486896749248175
LAKEBAY,WA,2113,2377,264,0.5293986636971046
LAKEFIELD,MN,978,740,-238,0.4307334109429569
LAKEHEAD,CA,568,429,-139,0.43029087261785354
LAKEHILLS,TX,1383,1649,266,0.5438654353562006
LAKEHURST,NJ,1048,1128,80,0.5183823529411765
LAKELAND,FL,140935,147392,6457,0.5111973557800692
LAKELAND,GA,2684,2810,126,0.5114670549690572
LAKELAND,MI,97,0,-97,0
LAKELAND,MN,1279,1158,-121,0.47517439474764056
LAKELAND,TN,6656,7305,649,0.5232433206790345
LAKEMONT,GA,805,871,66,0.5196897374701671
LAKEMOOR,IL,854,715,-139,0.455704270235819
LAKEMORE,OH,479,233,-246,0.32724719101123595
LAKEOSWEGO,OR,336,323,-13,0.49013657056145676
LAKEPORT,CA,4503,4370,-133,0.4925053533190578
LAKEPORT,MI,98,186,88,0.6549295774647887
LAKESHORE,CA,11,0,-11,0
LAKESHORE,FL,551,394,-157,0.41693121693121693
LAKESIDE,AZ,6922,7346,424,0.5148584244463135
LAKESIDE,CA,16651,16388,-263,0.49601985532249765
LAKESIDE,MI,12,78,66,0.8666666666666667
LAKESIDE,MT,1753,1953,200,0.5269832703723691
LAKESIDE,OH,476,744,268,0.6098360655737705
LAKESIDE,OR,1514,1421,-93,0.48415672913117547
LAKESIDE,TX,515,504,-11,0.4946025515210991
LAKESIDE MARBLEHEAD,OH,2746,2374,-372,0.463671875
LAKETOWN,UT,0,14,14,1
LAKEVIEW,AL,34,26,-8,0.43333333333333335
LAKEVIEW,AR,889,930,41,0.5112699285321606
LAKEVIEW,FL,11,19,8,0.6333333333333333
LAKEVIEW,MI,1829,1773,-56,0.49222654081066075
LAKEVIEW,OH,2549,2099,-450,0.451592082616179
LAKEVIEW,OR,2806,2816,10,0.5008893632159374
LAKEVILLE,CT,1308,1489,181,0.5323560958169468
LAKEVILLE,IN,1315,1321,6,0.5011380880121397
LAKEVILLE,MA,3297,3767,470,0.5332672706681767
LAKEVILLE,ME,51,55,4,0.5188679245283019
LAKEVILLE,MI,119,151,32,0.5592592592592592
LAKEVILLE,MN,18503,23188,4685,0.5561871866829772
LAKEVILLE,NY,513,474,-39,0.48024316109422494
LAKEVILLE,OH,141,231,90,0.6209677419354839
LAKEVILLE,PA,526,475,-51,0.4745254745254745
LAKEWAY,TX,4905,5663,758,0.5358629825889477
LAKEWOOD,CA,20605,20341,-264,0.49677624187954866
LAKEWOOD,CO,85908,80277,-5631,0.48305803772903694
LAKEWOOD,IL,11,0,-11,0
LAKEWOOD,NJ,21053,17873,-3180,0.45915326516980937
LAKEWOOD,NY,2484,2159,-325,0.46500107688994186
LAKEWOOD,OH,29251,22901,-6350,0.4391202638441479
LAKEWOOD,PA,58,116,58,0.6666666666666666
LAKEWOOD,WA,43547,31657,-11890,0.4209483538109675
LAKEWOOD,WI,538,471,-67,0.466798810703667
LAKEWOOD RANCH,FL,16968,23157,6189,0.5771214953271028
LAKEWORTH,FL,0,31,31,1
LAKIN,KS,1001,665,-336,0.39915966386554624
LAKOTA,IA,11,11,0,0.5
LAKOTA,ND,78,35,-43,0.30973451327433627
LAMAR,AR,1715,1503,-212,0.4670602858918583
LAMAR,CO,4682,3893,-789,0.45399416909620993
LAMAR,IN,34,11,-23,0.24444444444444444
LAMAR,MO,3406,3172,-234,0.48221343873517786
LAMAR,MS,226,369,143,0.6201680672268908
LAMAR,PA,17,0,-17,0
LAMAR,SC,1035,1129,94,0.5217190388170055
LAMBERT,MS,139,98,-41,0.41350210970464135
LAMBERTON,MN,459,301,-158,0.3960526315789474
LAMBERTVILLE,MI,2903,3159,256,0.5211151435169911
LAMBERTVILLE,NJ,2540,2495,-45,0.4955312810327706
LAME DEER,MT,542,135,-407,0.19940915805022155
LAMESA,TX,3328,2717,-611,0.44946236559139785
LAMIRADA,CA,214,195,-19,0.4767726161369193
LAMOILLE,NV,12,0,-12,0
LAMONI,IA,1239,1081,-158,0.46594827586206894
LAMONT,CA,2914,2238,-676,0.4343944099378882
LAMONT,FL,47,128,81,0.7314285714285714
LAMONT,IA,119,25,-94,0.1736111111111111
LAMONT,OK,0,22,22,1
LAMOURE,ND,264,230,-34,0.46558704453441296
LAMPASAS,TX,5018,5719,701,0.5326441277824345
LAMPE,MO,868,1120,252,0.5633802816901409
LAMY,NM,235,412,177,0.6367851622874807
LANAGAN,MO,22,11,-11,0.3333333333333333
LANAI CITY,HI,979,692,-287,0.41412327947336924
LANARK,IL,1315,1260,-55,0.4893203883495146
LANCASTER,CA,63473,62487,-986,0.49608605906637027
LANCASTER,KY,6467,5931,-536,0.4783836102597193
LANCASTER,MA,2075,2090,15,0.5018007202881153
LANCASTER,MN,0,11,11,1
LANCASTER,MO,370,298,-72,0.44610778443113774
LANCASTER,NH,1700,1699,-1,0.49985289791115034
LANCASTER,NY,8955,9406,451,0.512281466151081
LANCASTER,OH,25121,24605,-516,0.4948115673892933
LANCASTER,PA,78482,70498,-7984,0.47320445697409047
LANCASTER,SC,15306,18363,3057,0.5453978437138021
LANCASTER,TN,24,0,-24,0
LANCASTER,TX,15821,14549,-1272,0.4790582811985512
LANCASTER,VA,1200,1323,123,0.5243757431629013
LANCASTER,WI,2207,2156,-51,0.49415539766215905
LANCING,TN,557,616,59,0.525149190110827
LAND O LAKES,FL,31741,35101,3360,0.525133897848658
LAND O LAKES,WI,1320,1125,-195,0.4601226993865031
LANDAFF,NH,51,59,8,0.5363636363636364
LANDENBERG,PA,2190,2471,281,0.5301437459772581
LANDER,WY,4965,4522,-443,0.47665226098872143
LANDERS,CA,1102,1012,-90,0.47871333964049195
LANDGROVE,VT,32,31,-1,0.49206349206349204
LANDING,NJ,1810,1802,-8,0.4988925802879291
LANDIS,NC,1263,1384,121,0.5228560634680771
LANDISBURG,PA,709,624,-85,0.46811702925731435
LANDISVILLE,NJ,260,315,55,0.5478260869565217
LANDISVILLE,PA,1584,1631,47,0.5073094867807154
LANDOVER,MD,3790,3539,-251,0.4828762450538955
LANDOVER HILLS,MD,246,222,-24,0.47435897435897434
LANDRUM,SC,3029,3383,354,0.5276044915782907
LANE,KS,22,39,17,0.639344262295082
LANE,OK,0,11,11,1
LANE,SC,37,73,36,0.6636363636363637
LANESBORO,MN,471,415,-56,0.4683972911963883
LANESBOROUGH,MA,1087,1125,38,0.5085895117540687
LANESVILLE,IN,1329,1414,85,0.5154939846882974
LANETT,AL,3247,3262,15,0.5011522507297588
LANEVILLE,TX,23,212,189,0.902127659574468
LANEXA,VA,1503,1635,132,0.5210325047801148
LANGDON,KS,0,32,32,1
LANGDON,ND,1168,1011,-157,0.4639743001376778
LANGDON,NH,178,153,-25,0.4622356495468278
LANGELOTH,PA,63,24,-39,0.27586206896551724
LANGHORNE,PA,9006,8973,-33,0.49908226263974637
LANGLEY,KY,45,93,48,0.6739130434782609
LANGLEY,OK,285,170,-115,0.37362637362637363
LANGLEY,SC,86,32,-54,0.2711864406779661
LANGLEY,WA,3172,3184,12,0.500943989930774
LANGLEY AFB,VA,693,657,-36,0.4866666666666667
LANGLEY PARK,MD,0,35,35,1
LANGLOIS,OR,158,153,-5,0.4919614147909968
LANGSTON,AL,85,191,106,0.6920289855072463
LANGSTON,OK,38,0,-38,0
LANGSVILLE,OH,14,11,-3,0.44
LANHAM,MD,10171,9684,-487,0.4877360866280534
LANHAM SEABROOK,MD,4855,4535,-320,0.48296059637912675
LANNON,WI,443,729,286,0.6220136518771331
LANOKA HARBOR,NJ,1977,2278,301,0.5353701527614572
LANSDALE,PA,19158,18982,-176,0.4976927110644992
LANSDOWNE,PA,7667,7264,-403,0.48650458777041056
LANSE,MI,1644,1609,-35,0.4946203504457424
LANSFORD,ND,29,0,-29,0
LANSFORD,PA,3609,2697,-912,0.42768791627021885
LANSING,IA,569,527,-42,0.48083941605839414
LANSING,IL,10372,10218,-154,0.49626032054395336
LANSING,KS,3624,3782,158,0.5106670267350797
LANSING,MI,99396,78453,-20943,0.441121400738829
LANSING,NC,556,723,167,0.565285379202502
LANSING,NY,1592,1629,37,0.5057435579012729
LANTANA,FL,14176,13552,-624,0.4887478361223312
LANTANA,TX,1991,3321,1330,0.6251882530120482
LAONA,WI,396,468,72,0.5416666666666666
LAOTTO,IN,168,236,68,0.5841584158415841
LAPAZ,IN,50,58,8,0.5370370370370371
LAPEER,MI,13261,11315,-1946,0.4604085286458333
LAPEL,IN,1309,969,-340,0.4253731343283582
LAPINE,AL,51,77,26,0.6015625
LAPOINT,UT,13,42,29,0.7636363636363637
LAPORTE,CO,1244,1153,-91,0.4810179390905298
LAPORTE,IN,265,256,-9,0.491362763915547
LAPORTE,MN,1392,1446,54,0.5095137420718816
LAPORTE,PA,59,45,-14,0.4326923076923077
LAPWAI,ID,401,426,25,0.5151148730350665
LAQUEY,MO,160,253,93,0.612590799031477
LARAMIE,WY,22900,17840,-5060,0.4378988708885616
LARCHMONT,NY,5198,5693,495,0.5227251859333395
LARCHWOOD,IA,466,434,-32,0.4822222222222222
LAREDO,MO,12,0,-12,0
LAREDO,TX,45239,45546,307,0.5016908079528557
LARGO,FL,68370,70631,2261,0.5081330350141365
LARGO,MD,2447,2851,404,0.5381275953189883
LARIMER,PA,13,0,-13,0
LARIMORE,ND,436,321,-115,0.4240422721268164
LARKSPUR,CA,4271,3766,-505,0.46858280452905315
LARKSPUR,CO,2258,2558,300,0.5311461794019934
LARKSVILLE,PA,522,494,-28,0.4862204724409449
LARNED,KS,3150,2438,-712,0.43629205440229063
LAROSE,LA,1614,1472,-142,0.4769928710304601
LARSEN,WI,576,711,135,0.5524475524475524
LARUE,TX,602,880,278,0.5937921727395412
LARWILL,IN,96,37,-59,0.2781954887218045
LAS ANIMAS,CO,2361,1901,-460,0.4460347254809948
LAS CRUCES,NM,58282,58396,114,0.500488523971957
LAS VEGAS,NM,7326,5519,-1807,0.42966134682755935
LAS VEGAS,NV,837913,835441,-2472,0.499261363704273
LASARA,TX,14,0,-14,0
LASCASSAS,TN,1053,1476,423,0.5836298932384342
LASHMEET,WV,13,0,-13,0
LATHAM,NY,7855,8182,327,0.5101951736609092
LATHAM,OH,0,25,25,1
LATHROP,CA,7085,10751,3666,0.6027696793002916
LATHROP,MO,1970,1634,-336,0.45338512763596006
LATHRUP VILLAGE,MI,579,558,-21,0.49076517150395776
LATIMER,IA,45,11,-34,0.19642857142857142
LATON,CA,344,305,-39,0.4699537750385208
LATONIA,KY,705,711,6,0.5021186440677966
LATROBE,PA,8031,7576,-455,0.4854232075350804
LATTA,SC,1537,1642,105,0.5165146272412708
LATTY,OH,29,11,-18,0.275
LAUDERDALE,FL,15,0,-15,0
LAUDERDALE,MS,608,601,-7,0.49710504549214224
LAUDERDALE BY THE SEA,FL,1347,1182,-165,0.46737841043890865
LAUDERDALE LAKES,FL,17784,15539,-2245,0.46631455751282896
LAUDERHILL,FL,33862,31190,-2672,0.47946258377913054
LAUGHLIN,NV,7898,7701,-197,0.4936854926597859
LAUGHLINTOWN,PA,14,39,25,0.7358490566037735
LAUPAHOEHOE,HI,49,99,50,0.668918918918919
LAURA,OH,341,208,-133,0.3788706739526412
LAUREL,DE,5117,4966,-151,0.4925121491619558
LAUREL,FL,51,68,17,0.5714285714285714
LAUREL,IA,16,0,-16,0
LAUREL,IN,927,830,-97,0.4723961297666477
LAUREL,MD,55334,49700,-5634,0.47318011310623226
LAUREL,MS,12781,11685,-1096,0.47760156952505517
LAUREL,MT,4962,4999,37,0.5018572432486698
LAUREL,NE,434,327,-107,0.4296977660972405
LAUREL,NY,530,438,-92,0.4524793388429752
LAUREL BLOOMERY,TN,38,0,-38,0
LAUREL FORK,VA,49,100,51,0.6711409395973155
LAUREL HILL,FL,1306,1717,411,0.5679788289778366
LAUREL HILL,NC,1153,1089,-64,0.4857270294380018
LAUREL PARK,NC,363,426,63,0.5399239543726235
LAUREL RUN,PA,133,119,-14,0.4722222222222222
LAUREL SPRINGS,NC,121,360,239,0.7484407484407485
LAUREL SPRINGS,NJ,5066,4580,-486,0.47480821065726725
LAURELDALE,PA,165,129,-36,0.4387755102040816
LAURELTON,NY,3926,3462,-464,0.46859772604223066
LAURELVILLE,OH,1609,1311,-298,0.448972602739726
LAURENCE HARBOR,NJ,110,147,37,0.5719844357976653
LAURENCE HBR,NJ,451,426,-25,0.48574686431014824
LAURENS,IA,1058,788,-270,0.4268689057421452
LAURENS,NY,218,271,53,0.5541922290388548
LAURENS,SC,6825,6630,-195,0.4927536231884058
LAURIE,MO,50,38,-12,0.4318181818181818
LAURINBURG,NC,6586,6368,-218,0.49158561062220163
LAURIUM,MI,1064,872,-192,0.45041322314049587
LAURYS STATION,PA,106,298,192,0.7376237623762376
LAVA HOT SPGS,ID,39,0,-39,0
LAVA HOT SPRINGS,ID,338,361,23,0.5164520743919886
LAVACA,AR,1707,1722,15,0.5021872265966754
LAVALE,MD,1111,852,-259,0.43402954661232807
LAVALETTE,WV,503,597,94,0.5427272727272727
LAVALLETTE,NJ,2823,3193,370,0.530751329787234
LAVEEN,AZ,20601,18942,-1659,0.4790228359001593
LAVERNE,OK,285,209,-76,0.4230769230769231
LAVERNIA,TX,176,211,35,0.5452196382428941
LAVINA,MT,20,48,28,0.7058823529411765
LAVINIA,TN,36,35,-1,0.49295774647887325
LAVISTA,NE,203,203,0,0.5
LAVON,TX,1894,3105,1211,0.621124224844969
LAVONIA,GA,3111,3568,457,0.5342117083395718
LAWAI,HI,258,168,-90,0.39436619718309857
LAWLER,IA,84,24,-60,0.2222222222222222
LAWLEY,AL,0,11,11,1
LAWN,TX,13,14,1,0.5185185185185185
LAWNDALE,CA,9144,7607,-1537,0.45412214196167394
LAWNDALE,NC,1859,1924,65,0.5085910652920962
LAWNSIDE,NJ,923,1109,186,0.5457677165354331
LAWRENCE,KS,56014,48916,-7098,0.4661774516344229
LAWRENCE,MA,32399,28077,-4322,0.4642668165883987
LAWRENCE,MI,1257,1187,-70,0.48567921440261863
LAWRENCE,MS,63,81,18,0.5625
LAWRENCE,NJ,736,636,-100,0.46355685131195334
LAWRENCE,NY,2376,2308,-68,0.4927412467976089
LAWRENCE,PA,425,275,-150,0.39285714285714285
LAWRENCE TOWNSHIP,NJ,8038,7608,-430,0.4862584686181772
LAWRENCE TWP,NJ,398,416,18,0.5110565110565111
LAWRENCEBURG,IN,7109,7551,442,0.515075034106412
LAWRENCEBURG,KY,8792,8521,-271,0.49217351123433256
LAWRENCEBURG,TN,9805,9818,13,0.5003312439484279
LAWRENCEVILLE,GA,99294,96375,-2919,0.4925409748094997
LAWRENCEVILLE,IL,3957,3290,-667,0.4539809576376432
LAWRENCEVILLE,NJ,2069,1853,-216,0.47246302906680265
LAWRENCEVILLE,PA,914,849,-65,0.4815655133295519
LAWRENCEVILLE,VA,1441,1420,-21,0.4963299545613422
LAWSON,MO,1973,2011,38,0.5047690763052208
LAWSONVILLE,NC,71,21,-50,0.22826086956521738
LAWTELL,LA,23,44,21,0.6567164179104478
LAWTEY,FL,1061,1275,214,0.545804794520548
LAWTON,IA,239,206,-33,0.46292134831460674
LAWTON,MI,2710,2248,-462,0.45340863251311014
LAWTON,OK,47332,42970,-4362,0.4758477110141525
LAWTONS,NY,44,35,-9,0.4430379746835443
LAYTON,UT,31328,28637,-2691,0.477561911114817
LAYTONSVILLE,MD,130,170,40,0.5666666666666667
LAYTONVILLE,CA,503,359,-144,0.41647331786542924
LE CENTER,MN,1167,988,-179,0.45846867749419956
LE CLAIRE,IA,1985,1964,-21,0.4973410990124082
LE GRAND,CA,349,280,-69,0.4451510333863275
LE GRAND,IA,150,93,-57,0.38271604938271603
LE MARS,IA,5455,5252,-203,0.4905202204165499
LE RAYSVILLE,PA,60,48,-12,0.4444444444444444
LE ROY,IL,1395,1228,-167,0.4681662218833397
LE ROY,KS,105,87,-18,0.453125
LE ROY,MN,516,312,-204,0.37681159420289856
LE ROY,NY,3123,2960,-163,0.48660200558934735
LE ROY,WV,0,24,24,1
LE SUEUR,MN,2612,2277,-335,0.46573941501329513
LEABURG,OR,61,54,-7,0.46956521739130436
LEACHVILLE,AR,779,771,-8,0.4974193548387097
LEAD,SD,2588,2031,-557,0.43970556397488636
LEAD HILL,AR,1114,1211,97,0.5208602150537635
LEADORE,ID,12,22,10,0.6470588235294118
LEADVILLE,CO,4305,3504,-801,0.44871302343449865
LEADWOOD,MO,242,225,-17,0.4817987152034261
LEAF RIVER,IL,360,298,-62,0.45288753799392095
LEAGUE CITY,TX,30886,33312,2426,0.5188946696158759
LEAKESVILLE,MS,1166,1158,-8,0.49827882960413084
LEAKEY,TX,463,536,73,0.5365365365365365
LEANDER,TX,33137,49066,15929,0.5968881914285367
LEARNED,MS,34,40,6,0.5405405405405406
LEARY,GA,29,40,11,0.5797101449275363
LEASBURG,MO,525,435,-90,0.453125
LEASBURG,NC,153,254,101,0.6240786240786241
LEAVENWORTH,IN,229,297,68,0.564638783269962
LEAVENWORTH,KS,17027,16599,-428,0.49363587699994055
LEAVENWORTH,WA,4384,4296,-88,0.4949308755760369
LEAVITTSBURG,OH,987,1011,24,0.506006006006006
LEAWOOD,KS,12397,13961,1564,0.5296684118673648
LEBANON,CT,1907,2213,306,0.5371359223300971
LEBANON,GA,31,12,-19,0.27906976744186046
LEBANON,IL,2163,2041,-122,0.48549000951474786
LEBANON,IN,10383,9789,-594,0.4852766210588935
LEBANON,KY,5645,4913,-732,0.4653343436256867
LEBANON,ME,1858,2040,182,0.5233453052847614
LEBANON,MO,14836,14044,-792,0.48628808864265927
LEBANON,NH,6862,5936,-926,0.4638224722612908
LEBANON,NJ,2733,2996,263,0.5229533950078548
LEBANON,OH,11673,13066,1393,0.5281539269978577
LEBANON,OK,12,11,-1,0.4782608695652174
LEBANON,OR,16411,15011,-1400,0.47772261472853417
LEBANON,PA,29105,28036,-1069,0.4906459459932448
LEBANON,TN,29756,33774,4018,0.531622855343932
LEBANON,VA,2251,2422,171,0.5182965974748556
LEBANON JCT,KY,155,140,-15,0.4745762711864407
LEBANON JUNCTION,KY,1262,1256,-6,0.4988085782366958
LEBANON SPG,NY,14,0,-14,0
LEBANON SPRINGS,NY,11,12,1,0.5217391304347826
LEBEC,CA,381,319,-62,0.45571428571428574
LEBO,KS,499,552,53,0.5252140818268316
LEBURN,KY,0,40,40,1
LECANTO,FL,6394,7142,748,0.5276300236406619
LECLAIRE,IA,234,259,25,0.5253549695740365
LECOMPTE,LA,292,428,136,0.5944444444444444
LECOMPTON,KS,222,306,84,0.5795454545454546
LEDBETTER,KY,1077,862,-215,0.444559051057246
LEDBETTER,TX,25,91,66,0.7844827586206896
LEDERACH,PA,11,33,22,0.75
LEDGEWOOD,NJ,1359,1511,152,0.5264808362369338
LEDYARD,CT,2767,2838,71,0.5063336306868867
LEDYARD,IA,13,0,-13,0
LEE,FL,856,1239,383,0.5914081145584725
LEE,IL,12,13,1,0.52
LEE,MA,2502,2728,226,0.5216061185468451
LEE,ME,158,204,46,0.56353591160221
LEE,NH,1249,1462,213,0.5392843969015123
LEE CENTER,NY,683,586,-97,0.46178092986603625
LEE VINING,CA,91,17,-74,0.1574074074074074
LEECHBURG,PA,2707,2664,-43,0.4959970210389127
LEEDEY,OK,81,61,-20,0.4295774647887324
LEEDS,AL,4825,4994,169,0.5086057643344536
LEEDS,MA,987,868,-119,0.4679245283018868
LEEDS,ME,578,633,55,0.5227085053674649
LEEDS,ND,14,12,-2,0.46153846153846156
LEEDS,NY,509,532,23,0.5110470701248799
LEEDS,UT,271,462,191,0.6302864938608458
LEEPER,PA,120,75,-45,0.38461538461538464
LEES SUMMIT,MO,36715,40619,3904,0.5252411617141232
LEESBURG,AL,1331,1309,-22,0.49583333333333335
LEESBURG,FL,42480,48707,6227,0.5341441214208166
LEESBURG,GA,9117,9728,611,0.5162111966038737
LEESBURG,IN,1853,1731,-122,0.4829799107142857
LEESBURG,NJ,51,24,-27,0.32
LEESBURG,OH,1257,1276,19,0.503750493485985
LEESBURG,TX,275,372,97,0.5749613601236476
LEESBURG,VA,29379,30667,1288,0.5107251107484262
LEESPORT,PA,1664,1879,215,0.5303415184871578
LEESVILLE,LA,10650,9089,-1561,0.4604589898171133
LEESVILLE,SC,3614,4205,591,0.5377925565929147
LEET,WV,12,12,0,0.5
LEETON,MO,326,233,-93,0.41681574239713776
LEETONIA,OH,1388,1324,-64,0.4882005899705015
LEETSDALE,PA,299,142,-157,0.3219954648526077
LEFORS,TX,11,13,2,0.5416666666666666
LEGGETT,TX,12,0,-12,0
LEHI,UT,23136,27047,3911,0.5389673793914274
LEHIGH,IA,128,30,-98,0.189873417721519
LEHIGH ACRES,FL,59593,60105,512,0.5021387157680162
LEHIGH VALLEY,PA,360,90,-270,0.2
LEHIGHTON,PA,6352,6260,-92,0.4963526799873137
LEHT,NJ,33,47,14,0.5875
LEICESTER,MA,2158,2080,-78,0.49079754601226994
LEICESTER,NC,3923,4219,296,0.5181773520019651
LEICESTER,NY,593,431,-162,0.4208984375
LEICESTER,VT,196,243,47,0.5535307517084282
LEIGH,NE,81,58,-23,0.4172661870503597
LEIGHTON,AL,1104,1286,182,0.5380753138075314
LEIMERT PARK,CA,467,455,-12,0.49349240780911063
LEIPSIC,OH,1237,1071,-166,0.46403812824956675
LEISENRING,PA,12,0,-12,0
LEITCHFIELD,KY,5938,6024,86,0.5035947166025748
LELAND,IL,430,386,-44,0.4730392156862745
LELAND,MI,922,768,-154,0.4544378698224852
LELAND,MS,1844,1711,-133,0.48129395218002813
LELAND,NC,16116,22670,6554,0.5844892486979838
LEMAY,MO,249,204,-45,0.4503311258278146
LEMING,TX,64,11,-53,0.14666666666666667
LEMINGTON,VT,19,0,-19,0
LEMITAR,NM,0,11,11,1
LEMMON,SD,776,637,-139,0.4508138711960368
LEMON COVE,CA,0,29,29,1
LEMON GROVE,CA,11510,10363,-1147,0.4737804599277648
LEMON SPRINGS,NC,136,0,-136,0
LEMONT,IL,5724,6879,1155,0.5458224232325637
LEMONT,PA,286,276,-10,0.49110320284697506
LEMONT FRNC,PA,0,11,11,1
LEMONT FURNACE,PA,767,687,-80,0.47248968363136173
LEMOORE,CA,15814,12810,-3004,0.44752655114589157
LEMOYNE,NE,24,11,-13,0.3142857142857143
LEMOYNE,PA,3677,3303,-374,0.47320916905444127
LEMPSTER,NH,377,261,-116,0.4090909090909091
LENA,IL,1217,1183,-34,0.49291666666666667
LENA,LA,0,13,13,1
LENA,MS,645,735,90,0.532608695652174
LENA,WI,702,720,18,0.5063291139240507
LENEXA,KS,25360,26138,778,0.5075536914054914
LENGBY,MN,71,24,-47,0.25263157894736843
LENHARTSVILLE,PA,384,364,-20,0.48663101604278075
LENNI,PA,0,11,11,1
LENNON,MI,1186,1156,-30,0.4935952177625961
LENNOX,SD,1188,1176,-12,0.49746192893401014
LENOIR,NC,12525,13056,531,0.5103787967632227
LENOIR CITY,TN,9453,11177,1724,0.541783809985458
LENORA,KS,13,0,-13,0
LENORE,ID,363,445,82,0.5507425742574258
LENORE,WV,33,0,-33,0
LENOX,GA,581,745,164,0.5618401206636501
LENOX,IA,714,626,-88,0.4671641791044776
LENOX,MA,3306,3638,332,0.523905529953917
LENOX,MI,494,581,87,0.5404651162790698
LENOX DALE,MA,42,44,2,0.5116279069767442
LENZBURG,IL,124,120,-4,0.4918032786885246
LEO,IN,1285,1400,115,0.521415270018622
LEO CEDARVILLE,IN,118,158,40,0.572463768115942
LEOLA,AR,226,181,-45,0.44471744471744473
LEOLA,PA,3415,3157,-258,0.4803712720632988
LEOLA,SD,39,15,-24,0.2777777777777778
LEOMA,TN,1521,1709,188,0.5291021671826626
LEOMINSTER,MA,18739,17809,-930,0.4872770055817008
LEON,IA,1594,1403,-191,0.4681348014681348
LEON,KS,389,354,-35,0.47644683714670255
LEON,WV,551,666,115,0.5472473294987674
LEON VALLEY,TX,106,248,142,0.7005649717514124
LEONA,TX,0,12,12,1
LEONA VALLEY,CA,384,378,-6,0.49606299212598426
LEONARD,MI,888,949,61,0.5166031573217202
LEONARD,MN,24,28,4,0.5384615384615384
LEONARD,ND,51,15,-36,0.22727272727272727
LEONARD,TX,1575,1915,340,0.5487106017191977
LEONARDO,NJ,914,924,10,0.5027203482045702
LEONARDTOWN,MD,4094,4937,843,0.546672572251135
LEONARDVILLE,KS,51,25,-26,0.32894736842105265
LEONIA,NJ,2662,2617,-45,0.49573782913430575
LEONIDAS,MI,74,50,-24,0.4032258064516129
LEONVILLE,LA,23,0,-23,0
LEOPOLD,IN,0,12,12,1
LEOPOLD,MO,0,11,11,1
LEOTI,KS,813,545,-268,0.4013254786450663
LEPANTO,AR,1001,764,-237,0.43286118980169974
LERNA,IL,225,135,-90,0.375
LERONA,WV,0,28,28,1
LEROY,AL,12,0,-12,0
LEROY,MI,1364,1216,-148,0.47131782945736433
LESAGE,WV,376,362,-14,0.4905149051490515
LESHARA,NE,42,32,-10,0.43243243243243246
LESLIE,AR,452,620,168,0.5783582089552238
LESLIE,GA,11,36,25,0.7659574468085106
LESLIE,MI,2422,2004,-418,0.4527790329868956
LESLIE,MO,447,291,-156,0.3943089430894309
LESTER,AL,34,65,31,0.6565656565656566
LESTER,PA,75,66,-9,0.46808510638297873
LESTER,WV,50,17,-33,0.2537313432835821
LESTER PR,MN,17,0,-17,0
LESTER PRAIRIE,MN,686,592,-94,0.46322378716744916
LESTERVILLE,MO,12,17,5,0.5862068965517241
LETART,WV,80,74,-6,0.4805194805194805
LETCHER,SD,0,22,22,1
LETHA,ID,69,61,-8,0.46923076923076923
LETOHATCHEE,AL,11,13,2,0.5416666666666666
LETTS,IA,189,132,-57,0.411214953271028
LEUPP,AZ,0,14,14,1
LEVAN,UT,40,27,-13,0.40298507462686567
LEVANT,ME,1073,1196,123,0.5271044513001322
LEVELLAND,TX,6422,4754,-1668,0.42537580529706515
LEVERETT,MA,537,603,66,0.5289473684210526
LEVERING,MI,870,814,-56,0.4833729216152019
LEVITTOWN,NY,9773,8999,-774,0.47938418921798426
LEVITTOWN,PA,17942,17477,-465,0.49343572658742485
LEWELLEN,NE,131,167,36,0.5604026845637584
LEWES,DE,13404,17337,3933,0.5639699424221724
LEWIS,CO,65,40,-25,0.38095238095238093
LEWIS,IA,60,25,-35,0.29411764705882354
LEWIS,IN,0,25,25,1
LEWIS,NY,112,75,-37,0.40106951871657753
LEWIS CENTER,OH,11926,12670,744,0.5151244104732476
LEWIS RUN,PA,436,304,-132,0.41081081081081083
LEWISBERRY,PA,2018,2145,127,0.5152534230122507
LEWISBURG,KY,1539,1624,85,0.5134366108125198
LEWISBURG,OH,1693,1536,-157,0.47568906782285536
LEWISBURG,PA,6444,5703,-741,0.46949864163991106
LEWISBURG,TN,8823,8731,-92,0.49737951464053776
LEWISBURG,WV,4064,3695,-369,0.47622116252094343
LEWISPORT,KY,1680,1518,-162,0.474671669793621
LEWISTON,CA,241,240,-1,0.498960498960499
LEWISTON,ID,18250,15737,-2513,0.46302998205196105
LEWISTON,ME,19829,17542,-2287,0.4694014075084959
LEWISTON,MI,2698,2401,-297,0.4708766424789174
LEWISTON,MN,641,620,-21,0.4916732751784298
LEWISTON,NC,62,40,-22,0.39215686274509803
LEWISTON,NY,4002,4024,22,0.5013705457263893
LEWISTON,UT,361,317,-44,0.46755162241887904
LEWISTON WOODVILLE,NC,96,53,-43,0.35570469798657717
LEWISTOWN,IL,1314,1236,-78,0.48470588235294115
LEWISTOWN,MO,315,252,-63,0.4444444444444444
LEWISTOWN,MT,4034,4146,112,0.5068459657701712
LEWISTOWN,OH,28,43,15,0.6056338028169014
LEWISTOWN,PA,10012,9716,-296,0.4924979724249797
LEWISVILLE,AR,450,454,4,0.5022123893805309
LEWISVILLE,ID,71,120,49,0.6282722513089005
LEWISVILLE,IN,35,67,32,0.6568627450980392
LEWISVILLE,MN,35,0,-35,0
LEWISVILLE,NC,3466,4294,828,0.5533505154639176
LEWISVILLE,OH,107,93,-14,0.465
LEWISVILLE,TX,72138,63216,-8922,0.46704197881111753
LEXA,AR,197,276,79,0.5835095137420718
LEXINGTON,AL,801,856,55,0.5165962582981292
LEXINGTON,GA,663,746,83,0.5294535131298793
LEXINGTON,IL,1055,936,-119,0.47011551983927674
LEXINGTON,IN,1601,1491,-110,0.4822121604139715
LEXINGTON,KY,164873,148315,-16558,0.4735653984188411
LEXINGTON,MA,10447,11254,807,0.5185936131975485
LEXINGTON,MI,3198,2743,-455,0.4617067833698031
LEXINGTON,MO,3039,2569,-470,0.458095577746077
LEXINGTON,MS,1495,1435,-60,0.48976109215017066
LEXINGTON,NC,22080,24422,2342,0.5251817126145112
LEXINGTON,NE,5717,4379,-1338,0.4337361331220285
LEXINGTON,OH,1566,1456,-110,0.4818001323626737
LEXINGTON,OK,2277,2457,180,0.5190114068441065
LEXINGTON,SC,36777,41842,5065,0.5322123150892278
LEXINGTON,TN,6926,6728,-198,0.49274937747180314
LEXINGTON,TX,1474,1406,-68,0.48819444444444443
LEXINGTON,VA,6279,6053,-226,0.4908368472267272
LEXINGTON PARK,MD,12314,11037,-1277,0.4726564172840564
LEXINGTON TWP,ME,19,51,32,0.7285714285714285
LEYDEN,MA,54,71,17,0.568
LIBBY,MT,5527,5217,-310,0.48557334326135515
LIBERAL,KS,7017,5532,-1485,0.4408319387999044
LIBERAL,MO,417,386,-31,0.4806973848069738
LIBERTY,IL,331,172,-159,0.341948310139165
LIBERTY,IN,1998,1799,-199,0.4737951013958388
LIBERTY,KY,2893,3057,164,0.513781512605042
LIBERTY,ME,391,378,-13,0.49154746423927176
LIBERTY,MO,10731,10726,-5,0.49988348790604464
LIBERTY,MS,1121,1099,-22,0.49504504504504504
LIBERTY,NC,2333,2723,390,0.5385680379746836
LIBERTY,NE,11,0,-11,0
LIBERTY,NY,3066,2566,-500,0.45561079545454547
LIBERTY,PA,176,126,-50,0.41721854304635764
LIBERTY,SC,4620,4618,-2,0.4998917514613553
LIBERTY,TN,722,757,35,0.5118323191345504
LIBERTY,TX,4796,4221,-575,0.4681157813019851
LIBERTY,UT,83,105,22,0.5585106382978723
LIBERTY CENTER,OH,1101,978,-123,0.4704184704184704
LIBERTY COR,NJ,0,11,11,1
LIBERTY CORNER,NJ,11,121,110,0.9166666666666666
LIBERTY HILL,SC,0,11,11,1
LIBERTY HILL,TX,7667,13781,6114,0.6425307720999627
LIBERTY LAKE,WA,6619,7441,822,0.5292318634423897
LIBERTY TOWNSHIP,OH,4940,4563,-377,0.4801641586867305
LIBERTY TOWNSHP,OH,444,534,90,0.5460122699386503
LIBERTY TWP,OH,2783,2856,73,0.5064727788615002
LIBERTYTOWN,MD,12,0,-12,0
LIBERTYVILLE,IA,37,11,-26,0.22916666666666666
LIBERTYVILLE,IL,9444,10064,620,0.5158909165470577
LIBUSE,LA,11,0,-11,0
LICKING,MO,2019,2110,91,0.5110196173407605
LIDGERWOOD,ND,293,130,-163,0.3073286052009456
LIDO BEACH,NY,1081,796,-285,0.42408098028769314
LIGHTFOOT,VA,327,172,-155,0.34468937875751504
LIGHTHOUSE POINT,FL,6630,6341,-289,0.4888597640891219
LIGHTHOUSE PT,FL,1323,1432,109,0.5197822141560798
LIGNUM,VA,46,28,-18,0.3783783783783784
LIGONIER,IN,2767,2370,-397,0.46135876970994744
LIGONIER,PA,2694,2804,110,0.5100036376864314
LIHUE,HI,5757,5246,-511,0.47677906025629374
LILBOURN,MO,470,295,-175,0.38562091503267976
LILBURN,GA,18553,19368,815,0.5107460246301522
LILESVILLE,NC,158,276,118,0.6359447004608295
LILLIAN,AL,2562,3373,811,0.5683235046335299
LILLIAN,TX,13,24,11,0.6486486486486487
LILLIE,LA,0,22,22,1
LILLINGTON,NC,6508,7275,767,0.5278241311760865
LILLIWAUP,WA,267,227,-40,0.45951417004048584
LILLY,GA,11,0,-11,0
LILLY,PA,356,272,-84,0.43312101910828027
LILY,KY,980,995,15,0.5037974683544304
LILY,WI,68,44,-24,0.39285714285714285
LILY DALE,NY,118,45,-73,0.27607361963190186
LIMA,MT,26,23,-3,0.46938775510204084
LIMA,NY,1316,1397,81,0.5149281238481386
LIMA,OH,30778,28786,-1992,0.4832784903633067
LIME SPRINGS,IA,206,37,-169,0.1522633744855967
LIMERICK,ME,1216,1417,201,0.5381693885301937
LIMERICK,PA,2546,2496,-50,0.4950416501388338
LIMESTONE,ME,872,748,-124,0.4617283950617284
LIMESTONE,MI,11,0,-11,0
LIMESTONE,NY,113,86,-27,0.4321608040201005
LIMESTONE,TN,1648,1916,268,0.5375982042648709
LIMINGTON,ME,1143,1284,141,0.5290482076637825
LIMON,CO,1181,1098,-83,0.4817902588854761
LINCOLN,AL,3067,3550,483,0.5364969019192988
LINCOLN,AR,2173,2216,43,0.5048986101617681
LINCOLN,CA,17119,21078,3959,0.5518234416315417
LINCOLN,DE,1780,1955,175,0.5234270414993306
LINCOLN,IL,7963,6704,-1259,0.4570805208972523
LINCOLN,KS,932,691,-241,0.425754775107825
LINCOLN,MA,2182,2389,207,0.5226427477576022
LINCOLN,ME,2585,2341,-244,0.475233455136013
LINCOLN,MI,705,769,64,0.5217096336499322
LINCOLN,MO,1341,1375,34,0.5062592047128129
LINCOLN,MT,586,586,0,0.5
LINCOLN,NE,168486,135307,-33179,0.4453920926420293
LINCOLN,NH,1453,992,-461,0.40572597137014316
LINCOLN,RI,5325,5841,516,0.5231058570660935
LINCOLN,TX,37,65,28,0.6372549019607843
LINCOLN,VT,533,497,-36,0.4825242718446602
LINCOLN CITY,OR,8105,7952,-153,0.4952357227377468
LINCOLN PARK,MI,15357,11910,-3447,0.4367917262625151
LINCOLN PARK,NJ,2874,2893,19,0.501647303624068
LINCOLN UNIV,PA,22,25,3,0.5319148936170213
LINCOLN UNIVERSITY,PA,1399,1688,289,0.5468091998704243
LINCOLNDALE,NY,12,12,0,0.5
LINCOLNSHIRE,IL,3748,4446,698,0.5425921405906761
LINCOLNTON,GA,1782,2069,287,0.5372630485588159
LINCOLNTON,NC,12762,12907,145,0.5028244185593518
LINCOLNVILLE,KS,31,0,-31,0
LINCOLNVILLE,ME,1488,1768,280,0.542997542997543
LINCOLNVILLE CENTER,ME,0,33,33,1
LINCOLNWOOD,IL,3274,3705,431,0.5308783493337155
LINCROFT,NJ,1420,2053,633,0.5911315865246185
LIND,WA,34,12,-22,0.2608695652173913
LINDALE,GA,1699,1631,-68,0.48978978978978976
LINDALE,TX,6693,7617,924,0.5322851153039833
LINDEN,AL,969,882,-87,0.47649918962722854
LINDEN,CA,1555,1178,-377,0.43102817416758143
LINDEN,IA,13,11,-2,0.4583333333333333
LINDEN,IN,206,273,67,0.569937369519833
LINDEN,MI,5582,5299,-283,0.48699568054406767
LINDEN,NC,1612,1978,366,0.550974930362117
LINDEN,NJ,14445,12509,-1936,0.46408696297395563
LINDEN,PA,994,947,-47,0.487892838742916
LINDEN,TN,3506,2266,-1240,0.3925848925848926
LINDEN,TX,1986,1485,-501,0.4278305963699222
LINDEN,VA,1501,1715,214,0.533271144278607
LINDEN,WI,44,12,-32,0.21428571428571427
LINDENHURST,IL,2425,2385,-40,0.49584199584199584
LINDENHURST,NY,12366,11480,-886,0.4814224607900696
LINDENWOLD,NJ,1006,1051,45,0.5109382596013612
LINDENWOOD,IL,14,0,-14,0
LINDLEY,NY,364,356,-8,0.49444444444444446
LINDON,CO,15,12,-3,0.4444444444444444
LINDON,UT,2862,3384,522,0.5417867435158501
LINDSAY,CA,3404,3226,-178,0.4865761689291101
LINDSAY,OK,2158,2207,49,0.5056128293241695
LINDSAY,TX,12,33,21,0.7333333333333333
LINDSBORG,KS,1671,1577,-94,0.48552955665024633
LINDSEY,OH,48,15,-33,0.23809523809523808
LINDSIDE,WV,102,113,11,0.5255813953488372
LINDSTROM,MN,3129,3056,-73,0.4940986257073565
LINE LEXINGTON,PA,0,23,23,1
LINESVILLE,PA,1834,1508,-326,0.4512268102932376
LINEVILLE,AL,1923,1674,-249,0.4653878231859883
LINEVILLE,IA,38,12,-26,0.24
LINFIELD,PA,173,171,-2,0.49709302325581395
LINGLE,WY,160,117,-43,0.4223826714801444
LINKWOOD,MD,36,0,-36,0
LINN,KS,58,0,-58,0
LINN,MO,1444,1348,-96,0.4828080229226361
LINN,TX,0,11,11,1
LINN,WV,12,0,-12,0
LINN CREEK,MO,1361,1347,-14,0.49741506646971934
LINN GROVE,IA,11,0,-11,0
LINN VALLEY,KS,356,305,-51,0.46142208774583965
LINNEUS,ME,87,80,-7,0.47904191616766467
LINNEUS,MO,0,11,11,1
LINO LAKES,MN,1434,1589,155,0.5256367846510089
LINTHICUM,MD,375,339,-36,0.47478991596638653
LINTHICUM HEIGHTS,MD,3663,3987,324,0.5211764705882352
LINTHICUM HTS,MD,180,169,-11,0.48424068767908307
LINTON,IN,4735,4090,-645,0.4634560906515581
LINTON,ND,479,331,-148,0.408641975308642
LINVILLE,NC,758,1281,523,0.6282491417361452
LINVILLE,VA,11,61,50,0.8472222222222222
LINVILLE FALLS,NC,0,12,12,1
LINWOOD,KS,401,642,241,0.6155321188878236
LINWOOD,MA,23,40,17,0.6349206349206349
LINWOOD,MI,1126,1082,-44,0.490036231884058
LINWOOD,NC,1589,1642,53,0.5082017951098731
LINWOOD,NJ,2231,2536,305,0.5319907698762324
LINWOOD,PA,3827,3577,-250,0.4831172339276067
LIPAN,TX,1205,1340,135,0.5265225933202358
LISBON,CT,652,712,60,0.5219941348973607
LISBON,IA,1047,1124,77,0.5177337632427452
LISBON,MD,13,0,-13,0
LISBON,ME,1964,2033,69,0.5086314736052039
LISBON,ND,1285,1195,-90,0.48185483870967744
LISBON,NH,1058,1048,-10,0.4976258309591643
LISBON,NY,615,526,-89,0.4609991235758107
LISBON,OH,3397,3348,-49,0.49636767976278723
LISBON FALLS,ME,1984,1739,-245,0.46709642761214076
LISCOMB,IA,67,0,-67,0
LISLE,IL,13749,12558,-1191,0.47736343938875586
LISLE,NY,424,636,212,0.6
LISMAN,AL,116,81,-35,0.41116751269035534
LITCHFIELD,CT,2288,2589,301,0.5308591347139635
LITCHFIELD,IL,3971,3319,-652,0.455281207133059
LITCHFIELD,ME,1418,1634,216,0.5353866317169069
LITCHFIELD,MI,1149,1104,-45,0.49001331557922767
LITCHFIELD,MN,4156,3625,-531,0.4658784217966842
LITCHFIELD,NH,2184,2114,-70,0.49185667752442996
LITCHFIELD,OH,616,760,144,0.5523255813953488
LITCHFIELD,SC,109,248,139,0.6946778711484594
LITCHFIELD PARK,AZ,14162,18671,4509,0.568665671732708
LITHIA,FL,11850,12193,343,0.5071330532795408
LITHIA SPGS,GA,638,601,-37,0.4850686037126715
LITHIA SPRINGS,GA,11961,11837,-124,0.497394739053702
LITHONIA,GA,42407,42210,-197,0.4988359313140385
LITHOPOLIS,OH,630,703,73,0.5273818454613654
LITITZ,PA,13085,13483,398,0.5074902137910268
LITTLE BIRCH,WV,12,14,2,0.5384615384615384
LITTLE CHUTE,WI,3546,3032,-514,0.4609303739738522
LITTLE COMPTON,RI,1533,1930,397,0.5573202425642506
LITTLE DEER ISLE,ME,160,156,-4,0.4936708860759494
LITTLE EGG HARBOR,NJ,2042,2088,46,0.5055690072639225
LITTLE EGG HARBOR TWP,NJ,5771,6186,415,0.5173538513004934
LITTLE ELM,TX,23031,28352,5321,0.551777825350797
LITTLE FALLS,MN,6065,5762,-303,0.487190327217384
LITTLE FALLS,NJ,4145,4056,-89,0.4945738324594562
LITTLE FALLS,NY,3316,3149,-167,0.4870843000773395
LITTLE FERRY,NJ,3583,3365,-218,0.4843120322394934
LITTLE GENESEE,NY,27,12,-15,0.3076923076923077
LITTLE HOCKING,OH,730,665,-65,0.4767025089605735
LITTLE LAKE,MI,24,49,25,0.6712328767123288
LITTLE MEADOWS,PA,22,22,0,0.5
LITTLE MOUNTAIN,SC,320,649,329,0.6697626418988648
LITTLE MTN,SC,13,25,12,0.6578947368421053
LITTLE NECK,NY,4163,4057,-106,0.49355231143552314
LITTLE RIVER,CA,534,100,-434,0.15772870662460567
LITTLE RIVER,KS,77,36,-41,0.3185840707964602
LITTLE RIVER,SC,10428,14755,4327,0.5859111305245602
LITTLE RIVER ACADEMY,TX,908,793,-115,0.466196355085244
LITTLE ROCK,AR,108217,99026,-9191,0.4778255477868975
LITTLE ROCK,IA,0,14,14,1
LITTLE ROCK,MS,108,126,18,0.5384615384615384
LITTLE ROCK AIR FORCE BASE,AR,27,0,-27,0
LITTLE SILVER,NJ,1681,2023,342,0.5461663066954644
LITTLE SIOUX,IA,16,11,-5,0.4074074074074074
LITTLE SUAMICO,WI,785,752,-33,0.4892648015614834
LITTLE SWITZERLAND,NC,222,277,55,0.5551102204408818
LITTLE TORCH KEY,FL,254,349,95,0.5787728026533997
LITTLE VALLEY,NY,1079,1036,-43,0.48983451536643025
LITTLE YORK,IL,75,11,-64,0.12790697674418605
LITTLE YORK,NY,11,0,-11,0
LITTLEFIELD,AZ,2747,2771,24,0.5021747009786155
LITTLEFIELD,TX,1910,1983,73,0.5093758027228359
LITTLEFORK,MN,242,132,-110,0.35294117647058826
LITTLEROCK,CA,3315,3359,44,0.5032963739886125
LITTLEROCK,WA,0,11,11,1
LITTLESTOWN,PA,3839,3584,-255,0.4828236562036912
LITTLETON,CO,85550,84770,-780,0.49771019257867544
LITTLETON,MA,3024,3255,231,0.5183946488294314
LITTLETON,ME,192,184,-8,0.48936170212765956
LITTLETON,NC,2132,2337,205,0.5229357798165137
LITTLETON,NH,4024,3303,-721,0.45079841681452165
LIVE OAK,CA,2776,2780,4,0.5003599712023038
LIVE OAK,FL,9889,11132,1243,0.5295656724228153
LIVE OAK,TX,7637,6820,-817,0.4717437919347029
LIVERMORE,CA,28665,28782,117,0.5010183299389002
LIVERMORE,CO,1005,992,-13,0.49674511767651475
LIVERMORE,IA,14,39,25,0.7358490566037735
LIVERMORE,KY,661,564,-97,0.46040816326530615
LIVERMORE,ME,585,666,81,0.5323741007194245
LIVERMORE FALLS,ME,1540,1457,-83,0.4861528194861528
LIVERMORE FLS,ME,28,20,-8,0.4166666666666667
LIVERPOOL,NY,24878,22681,-2197,0.47690237389347967
LIVERPOOL,PA,1014,951,-63,0.48396946564885496
LIVERPOOL,TX,300,419,119,0.5827538247566064
LIVINGSTN MNR,NY,280,267,-13,0.48811700182815354
LIVINGSTON,AL,835,697,-138,0.4549608355091384
LIVINGSTON,CA,3667,3511,-156,0.4891334633602675
LIVINGSTON,IL,249,93,-156,0.2719298245614035
LIVINGSTON,KY,0,26,26,1
LIVINGSTON,LA,2750,2916,166,0.5146487822096717
LIVINGSTON,MT,8001,7883,-118,0.49628557038529336
LIVINGSTON,NJ,7589,9342,1753,0.5517689445396019
LIVINGSTON,SC,59,54,-5,0.4778761061946903
LIVINGSTON,TN,3574,3703,129,0.5088635426686822
LIVINGSTON,TX,13078,28873,15795,0.6882553455221568
LIVINGSTON,WI,67,112,45,0.6256983240223464
LIVINGSTON MANOR,NY,1371,1370,-1,0.49981758482305727
LIVONIA,LA,110,251,141,0.6952908587257618
LIVONIA,MI,26276,26294,18,0.5001712003043561
LIVONIA,NY,2301,2183,-118,0.4868421052631579
LIZELLA,GA,1996,2312,316,0.5366759517177344
LIZEMORES,WV,11,24,13,0.6857142857142857
LIZTON,IN,460,427,-33,0.4813979706877114
LK ARROWHEAD,CA,20,24,4,0.5454545454545454
LK HAVASU CTY,AZ,47,98,51,0.6758620689655173
LK HOPATCONG,NJ,42,36,-6,0.46153846153846156
LK JUNALUSKA,NC,33,39,6,0.5416666666666666
LK NEBAGAMON,WI,135,143,8,0.5143884892086331
LK PEEKSKILL,NY,20,14,-6,0.4117647058823529
LK WINNEBAGO,MO,37,31,-6,0.45588235294117646
LKSID MARBLHD,OH,56,50,-6,0.4716981132075472
LLANO,CA,131,238,107,0.6449864498644986
LLANO,TX,2527,2794,267,0.5250892689344109
LLOYD HARBOR,NY,287,323,36,0.5295081967213114
LNWD,WA,269,225,-44,0.45546558704453444
LOA,UT,103,86,-17,0.455026455026455
LOAMI,IL,399,273,-126,0.40625
LOBELVILLE,TN,943,898,-45,0.48777838131450296
LOCH ARBOUR,NJ,68,34,-34,0.3333333333333333
LOCH RAVEN,MD,170,175,5,0.5072463768115942
LOCH SHELDRAKE,NY,664,521,-143,0.43966244725738396
LOCH SHELDRKE,NY,26,19,-7,0.4222222222222222
LOCHBUIE,CO,1578,1809,231,0.5341009743135519
LOCHMERE,NH,12,46,34,0.7931034482758621
LOCK HAVEN,PA,8139,7263,-876,0.47156213478768993
LOCKBOURNE,OH,1048,1195,147,0.5327686134641105
LOCKE,NY,727,663,-64,0.47697841726618706
LOCKEFORD,CA,985,1283,298,0.5656966490299824
LOCKESBURG,AR,855,765,-90,0.4722222222222222
LOCKHART,FL,424,398,-26,0.48418491484184917
LOCKHART,SC,17,12,-5,0.41379310344827586
LOCKHART,TX,7649,7334,-315,0.4894880864980311
LOCKLAND,OH,288,289,1,0.5008665511265165
LOCKNEY,TX,93,70,-23,0.4294478527607362
LOCKPORT,IL,10528,9760,-768,0.4810725552050473
LOCKPORT,LA,2140,1800,-340,0.45685279187817257
LOCKPORT,NY,19272,18900,-372,0.4951273184533166
LOCKRIDGE,IA,63,12,-51,0.16
LOCKWOOD,CA,12,19,7,0.6129032258064516
LOCKWOOD,MO,557,595,38,0.5164930555555556
LOCKWOOD,NY,223,134,-89,0.3753501400560224
LOCUST,NC,2046,2820,774,0.5795314426633785
LOCUST FORK,AL,394,332,-62,0.4573002754820937
LOCUST GROVE,AR,88,69,-19,0.4394904458598726
LOCUST GROVE,GA,11232,14128,2896,0.5570977917981073
LOCUST GROVE,OK,1718,1904,186,0.5256764218663722
LOCUST GROVE,VA,5505,6308,803,0.5339879793447896
LOCUST HILL,VA,12,24,12,0.6666666666666666
LOCUST VALLEY,NY,2061,2233,172,0.5200279459711225
LOCUSTDALE,PA,13,0,-13,0
LODA,IL,427,473,46,0.5255555555555556
LODGE,IL,138,143,5,0.5088967971530249
LODGE GRASS,MT,96,0,-96,0
LODGEPOLE,NE,22,50,28,0.6944444444444444
LODI,CA,24771,24600,-171,0.49826821413380323
LODI,NJ,9695,7647,-2048,0.44095260062276553
LODI,NY,410,323,-87,0.4406548431105048
LODI,OH,1850,1664,-186,0.4735344336937962
LODI,WI,3035,3037,2,0.5001646903820817
LOG LANE VILLAGE,CO,78,142,64,0.6454545454545455
LOGAN,AL,63,183,120,0.7439024390243902
LOGAN,IA,738,809,71,0.5229476405946994
LOGAN,KS,37,0,-37,0
LOGAN,NM,126,229,103,0.6450704225352113
LOGAN,OH,6523,6253,-270,0.48943331246086413
LOGAN,UT,49145,31321,-17824,0.38924514701861657
LOGAN,WV,1412,1554,142,0.523937963587323
LOGANDALE,NV,694,883,189,0.5599239061509195
LOGANSPORT,IN,15031,11278,-3753,0.42867459804629593
LOGANSPORT,LA,1032,932,-100,0.4745417515274949
LOGANTON,PA,541,500,-41,0.4803073967339097
LOGANVILLE,GA,24398,28989,4591,0.5429973589075993
LOGANVILLE,PA,24,0,-24,0
LOGANVILLE,WI,53,24,-29,0.3116883116883117
LOHMAN,MO,56,99,43,0.6387096774193548
LOHRVILLE,IA,97,14,-83,0.12612612612612611
LOLETA,CA,353,301,-52,0.4602446483180428
LOLITA,TX,39,0,-39,0
LOLO,MT,2407,2639,232,0.5229885057471264
LOMA,CO,826,981,155,0.5428887659103486
LOMA LINDA,CA,10568,9564,-1004,0.4750645738128353
LOMA LINDA,MO,426,365,-61,0.461441213653603
LOMAX,IL,15,0,-15,0
LOMBARD,IL,21178,19448,-1730,0.47870821641313444
LOMETA,TX,173,510,337,0.746705710102489
LOMIRA,WI,1617,1553,-64,0.48990536277602525
LOMITA,CA,7673,6848,-825,0.4715928655051305
LOMPOC,CA,18888,17719,-1169,0.4840331084218865
LONACONING,MD,703,516,-187,0.42329778506972926
LONDON,AR,842,990,148,0.5403930131004366
LONDON,KY,14222,13760,-462,0.49174469301693946
LONDON,OH,6994,7015,21,0.5007495181668927
LONDON,TX,12,0,-12,0
LONDON MILLS,IL,23,25,2,0.5208333333333334
LONDONDERRY,NH,8336,8984,648,0.5187066974595843
LONDONDERRY,OH,630,621,-9,0.49640287769784175
LONDONDERRY,VT,627,735,108,0.539647577092511
LONE GROVE,OK,1150,1259,109,0.522623495226235
LONE JACK,MO,996,1171,175,0.5403784033225658
LONE OAK,GA,32,33,1,0.5076923076923077
LONE OAK,TX,1474,1534,60,0.5099734042553191
LONE PINE,CA,233,234,1,0.5010706638115632
LONE ROCK,WI,931,932,1,0.5002683843263553
LONE STAR,TX,528,593,65,0.5289919714540589
LONE TREE,CO,14572,14004,-568,0.4900615901455767
LONE TREE,IA,807,719,-88,0.4711664482306684
LONE WOLF,OK,93,46,-47,0.33093525179856115
LONEDELL,MO,521,603,82,0.5364768683274022
LONG BCH TWP,NJ,519,126,-393,0.19534883720930232
LONG BEACH,CA,173868,152685,-21183,0.46756575502292125
LONG BEACH,MN,46,38,-8,0.4523809523809524
LONG BEACH,MS,10835,8547,-2288,0.4409761634506243
LONG BEACH,NJ,773,350,-423,0.3116651825467498
LONG BEACH,NY,13945,12594,-1351,0.4745468932514413
LONG BEACH,WA,2386,2469,83,0.5085478887744593
LONG BEACH TOWNSHIP,NJ,1283,1635,352,0.5603152844413982
LONG BOTTOM,OH,124,82,-42,0.39805825242718446
LONG BRANCH,NJ,12037,9972,-2065,0.453087373347267
LONG BRANCH,TX,11,51,40,0.8225806451612904
LONG EDDY,NY,14,51,37,0.7846153846153846
LONG GROVE,IA,292,382,90,0.5667655786350149
LONG GROVE,IL,1676,1799,123,0.5176978417266187
LONG IS CITY,NY,6398,5569,-829,0.46536308180830616
LONG ISLAND,ME,120,118,-2,0.4957983193277311
LONG ISLAND,VA,0,24,24,1
LONG ISLAND CITY,NY,37108,32298,-4810,0.4653488171051494
LONG KEY,FL,900,1198,298,0.5710200190657769
LONG LAKE,MN,2074,2014,-60,0.4926614481409002
LONG LAKE,NY,666,589,-77,0.4693227091633466
LONG LAKE,SD,0,12,12,1
LONG LAKE,WI,59,58,-1,0.49572649572649574
LONG LANE,MO,56,237,181,0.8088737201365188
LONG PINE,NE,0,24,24,1
LONG POINT,IL,0,11,11,1
LONG POND,PA,2356,1044,-1312,0.3070588235294118
LONG POND TWP,ME,33,19,-14,0.36538461538461536
LONG PRAIRIE,MN,2533,2227,-306,0.46785714285714286
LONG VALLEY,NJ,2335,2977,642,0.5604292168674698
LONGBOAT,FL,28,14,-14,0.3333333333333333
LONGBOAT KEY,FL,14473,15378,905,0.5151586211517202
LONGBRANCH,WA,133,321,188,0.7070484581497798
LONGDALE,OK,0,11,11,1
LONGMEADOW,MA,4363,4971,608,0.5325691022069852
LONGMONT,CO,60495,61809,1314,0.5053718602825745
LONGPORT,NJ,1109,1158,49,0.5108072342302603
LONGS,SC,5394,8102,2708,0.6003260225251926
LONGTON,KS,69,59,-10,0.4609375
LONGVIEW,TX,42359,41753,-606,0.49639766026250715
LONGVIEW,WA,22148,21251,-897,0.4896656604990898
LONGVILLE,LA,557,700,143,0.5568814638027049
LONGVILLE,MN,1321,1385,64,0.5118255728011826
LONGWOOD,FL,22539,24380,1841,0.5196189177092436
LONGWOOD,NC,0,13,13,1
LONOKE,AR,3559,3487,-72,0.4948907181379506
LONSDALE,AR,199,309,110,0.6082677165354331
LONSDALE,MN,1530,1897,367,0.553545374963525
LOOGOOTEE,IN,2366,2243,-123,0.486656541549143
LOOKEBA,OK,98,39,-59,0.2846715328467153
LOOKOUT MOUNTAIN,GA,852,931,79,0.5221536735838475
LOOKOUT MOUNTAIN,TN,475,591,116,0.5544090056285178
LOOKOUT MTN,GA,45,48,3,0.5161290322580645
LOOKOUT MTN,TN,45,35,-10,0.4375
LOOMIS,CA,4246,4686,440,0.5246305418719212
LOOMIS,NE,24,39,15,0.6190476190476191
LOOMIS,WA,12,12,0,0.5
LOON LAKE,NY,41,58,17,0.5858585858585859
LOON LAKE,WA,1789,1667,-122,0.48234953703703703
LOONEYVILLE,WV,25,12,-13,0.32432432432432434
LOOP,TX,0,11,11,1
LOPEZ ISLAND,WA,1439,1579,140,0.5231941683233929
LORAIN,OH,31124,27787,-3337,0.4716776153859211
LORAINE,IL,12,35,23,0.7446808510638298
LORAINE,TX,73,51,-22,0.4112903225806452
LORANGER,LA,1416,1782,366,0.5572232645403377
LORDS VALLEY,PA,344,323,-21,0.48425787106446777
LORDSBURG,NM,1022,940,-82,0.47910295616717635
LORE CITY,OH,447,453,6,0.5033333333333333
LOREAUVILLE,LA,80,148,68,0.6491228070175439
LORENA,TX,2715,4197,1482,0.6072048611111112
LORENZO,TX,143,127,-16,0.4703703703703704
LORETTA,WI,82,66,-16,0.44594594594594594
LORETTO,KY,703,699,-4,0.4985734664764622
LORETTO,MN,934,1014,80,0.5205338809034907
LORETTO,PA,163,47,-116,0.22380952380952382
LORETTO,TN,1305,1279,-26,0.494969040247678
LORIDA,FL,1665,1759,94,0.5137266355140186
LORIMOR,IA,218,192,-26,0.4682926829268293
LORIS,SC,4876,6017,1141,0.5523730836316901
LORMAN,MS,64,61,-3,0.488
LORRAINE,NY,23,34,11,0.5964912280701754
LORTON,VA,15141,13439,-1702,0.47022393282015396
LOS ALAMITOS,CA,5945,6895,950,0.536993769470405
LOS ALAMOS,CA,221,341,120,0.6067615658362989
LOS ALAMOS,NM,6428,6058,-370,0.48518340541406374
LOS ALTOS,CA,10006,11112,1106,0.5261861918742305
LOS ALTOS HILLS,CA,2531,2664,133,0.5128007699711261
LOS ANGELES,CA,882884,723412,-159472,0.4503603320932132
LOS BANOS,CA,13002,12562,-440,0.49139414802065406
LOS FRESNOS,TX,3452,4086,634,0.5420535951180685
LOS GATOS,CA,17665,17970,305,0.5042795004910903
LOS LUNAS,NM,13199,12422,-777,0.4848366574294524
LOS MOLINOS,CA,1621,1521,-100,0.48408656906429026
LOS OJOS,NM,11,0,-11,0
LOS OLIVOS,CA,63,185,122,0.7459677419354839
LOS OSOS,CA,4889,5083,194,0.5097272362615323
LOSANTVILLE,IN,69,77,8,0.5273972602739726
LOST CITY,WV,22,30,8,0.5769230769230769
LOST CREEK,KY,98,77,-21,0.44
LOST CREEK,WV,749,865,116,0.5359355638166047
LOST HILLS,CA,74,49,-25,0.3983739837398374
LOST NATION,IA,52,25,-27,0.3246753246753247
LOST RIVER,WV,13,11,-2,0.4583333333333333
LOST SPRINGS,KS,0,11,11,1
LOSTANT,IL,27,0,-27,0
LOSTINE,OR,24,13,-11,0.35135135135135137
LOTHIAN,MD,1907,2145,238,0.5293682132280355
LOTT,TX,898,573,-325,0.389530931339225
LOTTSBURG,VA,156,226,70,0.5916230366492147
LOTUS,CA,66,47,-19,0.415929203539823
LOU,KY,361,294,-67,0.4488549618320611
LOUANN,AR,14,11,-3,0.44
LOUDON,NH,1612,1711,99,0.5148961781522721
LOUDON,TN,7731,9727,1996,0.557165769274831
LOUDONVILLE,NY,1332,1476,144,0.5256410256410257
LOUDONVILLE,OH,2109,1823,-286,0.4636317395727365
LOUGHMAN,FL,792,1114,322,0.5844700944386149
LOUIN,MS,261,374,113,0.5889763779527559
LOUISA,KY,4116,3978,-138,0.49147516679021497
LOUISA,VA,4144,4848,704,0.5391459074733096
LOUISBURG,KS,2572,2659,87,0.5083158095966355
LOUISBURG,MO,45,55,10,0.55
LOUISBURG,NC,6499,7035,536,0.5198019801980198
LOUISE,TX,80,158,78,0.6638655462184874
LOUISIANA,MO,2085,1989,-96,0.4882179675994109
LOUISVILLE,AL,100,114,14,0.5327102803738317
LOUISVILLE,CO,15135,13108,-2027,0.4641150019473852
LOUISVILLE,GA,1339,1234,-105,0.4795958025650991
LOUISVILLE,IL,888,763,-125,0.46214415505754086
LOUISVILLE,KY,366335,331839,-34496,0.4752955566950359
LOUISVILLE,MS,3427,3302,-125,0.4907118442562045
LOUISVILLE,NE,865,891,26,0.5074031890660592
LOUISVILLE,OH,6640,6263,-377,0.485390994342401
LOUISVILLE,TN,5535,5451,-84,0.4961769524849809
LOUP CITY,NE,551,587,36,0.515817223198594
LOVEJOY,GA,1168,571,-597,0.3283496262219667
LOVEJOY,IL,39,0,-39,0
LOVELADY,TX,672,706,34,0.5123367198838897
LOVELAND,CO,49731,50678,947,0.5047157127349142
LOVELAND,OH,17114,17232,118,0.5017178128457462
LOVELL,ME,551,648,97,0.5404503753127606
LOVELL,WY,1437,1458,21,0.5036269430051813
LOVELOCK,NV,1339,1150,-189,0.4620329449578144
LOVELY,KY,45,38,-7,0.4578313253012048
LOVES PARK,IL,10772,10220,-552,0.4868521341463415
LOVETTSVILLE,VA,2114,2628,514,0.5541965415436525
LOVILIA,IA,58,13,-45,0.18309859154929578
LOVING,NM,140,115,-25,0.45098039215686275
LOVINGSTON,VA,272,425,153,0.6097560975609756
LOVINGTON,IL,617,393,-224,0.3891089108910891
LOVINGTON,NM,3710,3182,-528,0.4616947185142194
LOW MOOR,IA,11,0,-11,0
LOWDEN,IA,255,246,-9,0.49101796407185627
LOWELL,AR,5280,5730,450,0.5204359673024523
LOWELL,FL,0,47,47,1
LOWELL,IN,5565,5767,202,0.5089128132721497
LOWELL,MA,51191,43835,-7356,0.46129480352745567
LOWELL,ME,150,197,47,0.5677233429394812
LOWELL,MI,5688,5873,185,0.5080010379724937
LOWELL,NC,1447,1453,6,0.5010344827586207
LOWELL,OH,795,577,-218,0.4205539358600583
LOWELL,OR,562,650,88,0.5363036303630363
LOWELL,VT,84,154,70,0.6470588235294118
LOWELL,WI,11,0,-11,0
LOWELLVILLE,OH,809,961,152,0.5429378531073447
LOWER BRULE,SD,200,104,-96,0.34210526315789475
LOWER BURRELL,PA,1054,1086,32,0.5074766355140187
LOWER GWYNEDD,PA,192,234,42,0.5492957746478874
LOWER LAKE,CA,1234,1239,5,0.5010109179134654
LOWER PEACH TREE,AL,12,0,-12,0
LOWER SALEM,OH,69,35,-34,0.33653846153846156
LOWESVILLE,VA,16,19,3,0.5428571428571428
LOWGAP,NC,388,602,214,0.6080808080808081
LOWMAN,ID,84,48,-36,0.36363636363636365
LOWMAN,NY,382,403,21,0.513375796178344
LOWMANSVILLE,KY,0,14,14,1
LOWNDESBORO,AL,44,129,85,0.7456647398843931
LOWPOINT,IL,0,17,17,1
LOWRY,CO,151,142,-9,0.48464163822525597
LOWRY,MN,85,37,-48,0.30327868852459017
LOWRY CITY,MO,508,538,30,0.51434034416826
LOWVILLE,NY,3124,3201,77,0.5060869565217392
LOXAHATCHEE,FL,9561,15300,5739,0.6154217449016532
LOXLEY,AL,3123,3527,404,0.5303759398496241
LOYAL,WI,833,713,-120,0.4611901681759379
LOYALHANNA,PA,11,0,-11,0
LOYALL,KY,61,50,-11,0.45045045045045046
LOYALTON,CA,98,155,57,0.6126482213438735
LOYSVILLE,PA,665,490,-175,0.42424242424242425
LSS CRUCES,NM,263,297,34,0.5303571428571429
LTL SWITZRLND,NC,0,25,25,1
LTL TORCH KEY,FL,210,122,-88,0.3674698795180723
LU VERNE,IA,29,0,-29,0
LUANA,IA,60,15,-45,0.2
LUBBOCK,TX,125194,113694,-11500,0.47593014299588093
LUBEC,ME,1011,1215,204,0.545822102425876
LUBLIN,WI,39,11,-28,0.22
LUCAMA,NC,1470,1195,-275,0.44840525328330205
LUCAN,MN,12,0,-12,0
LUCAS,IA,24,49,25,0.6712328767123288
LUCAS,KS,11,24,13,0.6857142857142857
LUCAS,KY,15,11,-4,0.4230769230769231
LUCAS,OH,704,676,-28,0.48985507246376814
LUCASVILLE,OH,3324,3155,-169,0.48695786386788087
LUCEDALE,MS,7981,7599,-382,0.4877406931964057
LUCERNE,CA,1153,1127,-26,0.49429824561403507
LUCERNE,IN,13,12,-1,0.48
LUCERNE VALLEY,CA,2401,2574,173,0.5173869346733668
LUCERNE VLY,CA,39,46,7,0.5411764705882353
LUCERNEMINES,PA,0,11,11,1
LUCINDA,PA,51,23,-28,0.3108108108108108
LUCK,WI,1794,1692,-102,0.4853700516351119
LUCKEY,OH,207,190,-17,0.47858942065491183
LUDINGTON,MI,9338,9024,-314,0.49144973314453766
LUDLAM,FL,14,29,15,0.6744186046511628
LUDLOW,IL,76,61,-15,0.44525547445255476
LUDLOW,KY,1446,1403,-43,0.49245349245349246
LUDLOW,MA,6389,6064,-325,0.486950935517546
LUDLOW,ME,111,111,0,0.5
LUDLOW,VT,1741,1797,56,0.5079140757490107
LUDLOW FALLS,OH,71,48,-23,0.40336134453781514
LUDOWICI,GA,5575,7063,1488,0.5588700743788574
LUEDERS,TX,0,13,13,1
LUFKIN,TX,22311,21235,-1076,0.48764524870252146
LUGOFF,SC,4473,4915,442,0.5235406902428632
LUKE AFB,AZ,14,149,135,0.9141104294478528
LUKE AIR FORCE BASE,AZ,62,321,259,0.8381201044386423
LUKEVILLE,AZ,326,757,431,0.6989843028624192
LULA,GA,2239,2714,475,0.5479507369271149
LULING,LA,2892,2860,-32,0.4972183588317107
LULING,TX,2635,2564,-71,0.4931717638007309
LUMBER BRIDGE,NC,756,741,-15,0.49498997995991983
LUMBER CITY,GA,345,187,-158,0.35150375939849626
LUMBERPORT,WV,460,317,-143,0.40797940797940796
LUMBERTON,MS,2869,2873,4,0.5003483106931382
LUMBERTON,NC,14429,13787,-642,0.488623476041962
LUMBERTON,NJ,4066,4071,5,0.5003072385400025
LUMBERTON,TX,7381,7624,243,0.5080973008997001
LUMMI ISLAND,WA,330,450,120,0.5769230769230769
LUMPKIN,GA,101,208,107,0.6731391585760518
LUNA PIER,MI,594,405,-189,0.40540540540540543
LUNENBURG,MA,4162,4129,-33,0.49800989024243153
LUNENBURG,VT,309,343,34,0.5260736196319018
LUPTON,MI,909,703,-206,0.43610421836228286
LURAY,KS,13,0,-13,0
LURAY,TN,11,0,-11,0
LURAY,VA,4229,4252,23,0.5013559721730928
LUSBY,MD,7050,6687,-363,0.486787508189561
LUSK,WY,886,555,-331,0.3851492019430951
LUTCHER,LA,384,339,-45,0.46887966804979253
LUTHER,MI,725,634,-91,0.4665194996320824
LUTHER,OK,1184,1377,193,0.537680593518157
LUTHERSBURG,PA,22,0,-22,0
LUTHERSVILLE,GA,839,847,8,0.5023724792408066
LUTHERVILLE,MD,749,821,72,0.5229299363057325
LUTHERVILLE TIMONIUM,MD,10026,10614,588,0.5142441860465117
LUTSEN,MN,308,370,62,0.5457227138643068
LUTTRELL,TN,1253,1169,-84,0.48265895953757226
LUTTS,TN,0,25,25,1
LUTZ,FL,31355,34616,3261,0.5247154052538237
LUVERNE,AL,2071,1912,-159,0.48004017072558375
LUVERNE,MN,2343,2184,-159,0.4824387011265739
LUXEMBURG,WI,1916,1917,1,0.5001304461257501
LUXOR,PA,11,0,-11,0
LUXORA,AR,82,73,-9,0.47096774193548385
LUZERNE,MI,364,274,-90,0.42946708463949845
LUZERNE,PA,1142,1044,-98,0.4775846294602013
LYDIA,LA,11,0,-11,0
LYERLY,GA,381,368,-13,0.49132176234979974
LYFORD,TX,149,262,113,0.6374695863746959
LYKENS,PA,1417,1490,73,0.5125558995528036
LYLE,MN,72,11,-61,0.13253012048192772
LYLE,WA,1058,882,-176,0.45463917525773195
LYLES,TN,2229,2077,-152,0.48235020901068276
LYMAN,ME,1994,2147,153,0.5184737985993721
LYMAN,NE,43,23,-20,0.3484848484848485
LYMAN,NH,89,123,34,0.5801886792452831
LYMAN,SC,4561,5296,735,0.5372831490311454
LYMAN,WY,790,695,-95,0.468013468013468
LYME,CT,186,284,98,0.6042553191489362
LYME,NH,526,555,29,0.513413506012951
LYNBROOK,NY,5802,5545,-257,0.48867542081607473
LYNCH,KY,0,22,22,1
LYNCH,NE,0,12,12,1
LYNCH STATION,VA,172,272,100,0.6126126126126126
LYNCHBURG,OH,1298,1118,-180,0.46274834437086093
LYNCHBURG,SC,339,450,111,0.5703422053231939
LYNCHBURG,TN,1007,1037,30,0.5073385518590998
LYNCHBURG,VA,46401,40819,-5582,0.46800045861041045
LYND,MN,39,11,-28,0.22
LYNDEBOROUGH,NH,160,351,191,0.6868884540117417
LYNDEN,WA,8151,8334,183,0.5055505004549591
LYNDHURST,NJ,8441,7443,-998,0.46858473936036266
LYNDHURST,OH,1532,1685,153,0.5237799191793596
LYNDHURST,VA,790,562,-228,0.4156804733727811
LYNDON,IL,247,148,-99,0.37468354430379747
LYNDON,KS,635,537,-98,0.45819112627986347
LYNDON CENTER,VT,30,30,0,0.5
LYNDON STA,WI,30,14,-16,0.3181818181818182
LYNDON STATION,WI,894,846,-48,0.4862068965517241
LYNDONVILLE,NY,1052,930,-122,0.4692230070635722
LYNDONVILLE,VT,2422,2112,-310,0.4658138509042788
LYNDORA,PA,480,445,-35,0.4810810810810811
LYNN,AL,106,73,-33,0.40782122905027934
LYNN,IN,1069,803,-266,0.42895299145299143
LYNN,MA,37189,32491,-4698,0.46628874856486796
LYNN,MI,125,113,-12,0.47478991596638653
LYNN CENTER,IL,11,23,12,0.6764705882352942
LYNN HAVEN,FL,9829,10215,386,0.5096288166034724
LYNNFIELD,MA,3621,3809,188,0.5126514131897711
LYNNVILLE,IA,25,23,-2,0.4791666666666667
LYNNVILLE,IN,423,312,-111,0.42448979591836733
LYNNVILLE,TN,910,888,-22,0.4938820912124583
LYNNWOOD,WA,55913,52114,-3799,0.4824164329288048
LYNWOOD,CA,10309,8357,-1952,0.4477124183006536
LYNWOOD,IL,6237,5770,-467,0.4805530107437328
LYNX,OH,11,0,-11,0
LYNXVILLE,WI,20,40,20,0.6666666666666666
LYON,MS,15,34,19,0.6938775510204082
LYON MOUNTAIN,NY,152,201,49,0.5694050991501416
LYON STATION,PA,27,0,-27,0
LYONS,CO,2380,2131,-249,0.47240079804921303
LYONS,GA,4520,3442,-1078,0.43230344134639537
LYONS,IL,3581,3046,-535,0.45963482722197074
LYONS,IN,377,276,-101,0.4226646248085758
LYONS,KS,1880,1790,-90,0.4877384196185286
LYONS,MI,744,552,-192,0.42592592592592593
LYONS,NE,401,225,-176,0.35942492012779553
LYONS,NY,3285,3057,-228,0.48202459791863767
LYONS,OH,155,169,14,0.5216049382716049
LYONS,OR,1366,1153,-213,0.4577213179833267
LYONS,TX,0,11,11,1
LYONS FALLS,NY,204,129,-75,0.38738738738738737
LYSITE,WY,11,0,-11,0
LYTLE,TX,2117,2532,415,0.5446332544633254
LYTLE CREEK,CA,86,55,-31,0.3900709219858156
LYTTON,IA,24,0,-24,0
MABANK,TX,6183,6422,239,0.5094803649345497
MABEL,MN,289,283,-6,0.49475524475524474
MABELVALE,AR,4577,4538,-39,0.49786066922654965
MABEN,MS,394,560,166,0.5870020964360587
MABIE,WV,12,0,-12,0
MABLETON,GA,17016,17115,99,0.5014502944537225
MABSCOTT,WV,164,69,-95,0.296137339055794
MABTON,WA,766,286,-480,0.2718631178707224
MAC ARTHUR,WV,121,0,-121,0
MACATAWA,MI,129,89,-40,0.40825688073394495
MACCLENNY,FL,4736,5125,389,0.5197241659060947
MACCLESFIELD,NC,376,554,178,0.5956989247311828
MACDANLE,KY,11,0,-11,0
MACDILL AFB,FL,65,68,3,0.5112781954887218
MACEDON,NY,3499,3375,-124,0.49098050625545536
MACEDONIA,IA,40,12,-28,0.23076923076923078
MACEDONIA,OH,3021,3440,419,0.5324253211577156
MACEO,KY,570,428,-142,0.4288577154308617
MACHESNEY PARK,IL,8038,7783,-255,0.4919410909550597
MACHESNEY PK,IL,138,153,15,0.5257731958762887
MACHIAS,ME,1045,1153,108,0.5245677888989991
MACHIAS,NY,801,687,-114,0.46169354838709675
MACHIASPORT,ME,166,253,87,0.60381861575179
MACHIPONGO,VA,48,48,0,0.5
MACK,CO,318,423,105,0.5708502024291497
MACKAY,ID,488,532,44,0.5215686274509804
MACKINAC ISLAND,MI,1640,1088,-552,0.39882697947214074
MACKINAW,IL,1430,1346,-84,0.48487031700288186
MACKINAW CITY,MI,1081,893,-188,0.4523809523809524
MACKS CREEK,MO,730,799,69,0.5225637671680837
MACKS INN,ID,48,117,69,0.7090909090909091
MACKSBURG,IA,11,0,-11,0
MACKSVILLE,KS,22,27,5,0.5510204081632653
MACKVILLE,KY,13,22,9,0.6285714285714286
MACOMB,IL,9692,8409,-1283,0.46455996906248276
MACOMB,MI,20239,22963,2724,0.531526318226008
MACOMB,OK,161,268,107,0.6247086247086248
MACON,GA,67557,65424,-2133,0.491980057301419
MACON,IL,493,419,-74,0.4594298245614035
MACON,MO,3665,3535,-130,0.4909722222222222
MACON,MS,1269,1212,-57,0.48851269649334944
MACON,NC,237,682,445,0.7421109902067464
MACUNGIE,PA,8126,8011,-115,0.4964367602404412
MACY,IN,563,416,-147,0.424923391215526
MACY,NE,169,138,-31,0.4495114006514658
MAD RIVER,CA,46,80,34,0.6349206349206349
MADAWASKA,ME,1703,1606,-97,0.48534300392867935
MADBURY,NH,363,353,-10,0.4930167597765363
MADDOCK,ND,48,11,-37,0.1864406779661017
MADEIRA,OH,81,81,0,0.5
MADEIRA BEACH,FL,6476,7833,1357,0.5474177091341114
MADELIA,MN,1142,1056,-86,0.48043676069153773
MADERA,CA,21315,24311,2996,0.5328321571034059
MADERA,PA,25,22,-3,0.46808510638297873
MADILL,OK,2918,2160,-758,0.4253643166601024
MADISON,AL,34254,38595,4341,0.5297945064448379
MADISON,CA,63,12,-51,0.16
MADISON,CT,6451,7316,865,0.5314157042202368
MADISON,FL,3381,3073,-308,0.4761388286334056
MADISON,GA,4169,4850,681,0.5377536312229737
MADISON,IL,1625,1441,-184,0.4699934768427919
MADISON,IN,10518,9386,-1132,0.4715635048231511
MADISON,KS,242,178,-64,0.4238095238095238
MADISON,ME,2217,2167,-50,0.4942974452554745
MADISON,MN,1145,878,-267,0.43400889767671774
MADISON,MO,511,389,-122,0.43222222222222223
MADISON,MS,11378,14544,3166,0.5610678188411388
MADISON,NC,2629,2810,181,0.5166390880676595
MADISON,NE,733,605,-128,0.4521674140508221
MADISON,NH,332,386,54,0.5376044568245125
MADISON,NJ,4685,4970,285,0.5147591921284309
MADISON,NY,324,197,-127,0.3781190019193858
MADISON,OH,6863,6286,-577,0.47805916799756637
MADISON,SD,5257,3391,-1866,0.392113783533765
MADISON,TN,20475,17295,-3180,0.4579030976965846
MADISON,VA,1552,1669,117,0.5181620614715927
MADISON,WI,186612,148880,-37732,0.4437661702812586
MADISON,WV,1274,819,-455,0.391304347826087
MADISON HEIGHTS,MI,11526,9636,-1890,0.45534448539835554
MADISON HEIGHTS,VA,4601,4657,56,0.5030244113199395
MADISON HTS,MI,2014,1702,-312,0.4580193756727664
MADISON HTS,VA,241,290,49,0.5461393596986818
MADISON LAKE,MN,1476,1254,-222,0.4593406593406593
MADISON TOWNSHIP,PA,51,43,-8,0.4574468085106383
MADISON TWP,PA,68,65,-3,0.48872180451127817
MADISONVILLE,KY,12738,11703,-1035,0.47882656192463485
MADISONVILLE,LA,4241,5449,1208,0.5623323013415893
MADISONVILLE,TN,7110,7022,-88,0.4968864987262949
MADISONVILLE,TX,2252,2102,-150,0.4827744602664217
MADRAS,OR,6678,5413,-1265,0.44768836324538913
MADRID,IA,1586,1504,-82,0.4867313915857605
MADRID,NM,34,98,64,0.7424242424242424
MADRID,NY,559,489,-70,0.4666030534351145
MADRID TWP,ME,159,128,-31,0.445993031358885
MAGALIA,CA,7830,5574,-2256,0.41584601611459265
MAGAZINE,AR,876,1021,145,0.5382182393252504
MAGDALENA,NM,383,322,-61,0.45673758865248226
MAGEE,MS,2893,2830,-63,0.4944958937620129
MAGGIE VALLEY,NC,3661,4442,781,0.5481920276440825
MAGNA,UT,10047,10204,157,0.503876351785097
MAGNET,IN,32,32,0,0.5
MAGNETIC SPRINGS,OH,17,0,-17,0
MAGNOLIA,AR,5821,4857,-964,0.454860460760442
MAGNOLIA,DE,4182,4825,643,0.5356944598645498
MAGNOLIA,IL,22,13,-9,0.37142857142857144
MAGNOLIA,KY,699,862,163,0.5522101217168481
MAGNOLIA,MN,0,11,11,1
MAGNOLIA,MS,1982,2017,35,0.5043760940235059
MAGNOLIA,NC,765,554,-211,0.4200151630022744
MAGNOLIA,NJ,1545,1545,0,0.5
MAGNOLIA,OH,1115,982,-133,0.4682880305197902
MAGNOLIA,TX,22024,27046,5022,0.5511717953943346
MAGNOLIA SPGS,AL,173,186,13,0.5181058495821727
MAGNOLIA SPRINGS,AL,443,580,137,0.5669599217986315
MAHAFFEY,PA,269,161,-108,0.3744186046511628
MAHANOY CITY,PA,2091,2000,-91,0.48887802493277926
MAHNOMEN,MN,1264,930,-334,0.4238833181403829
MAHOMET,IL,5091,5139,48,0.5023460410557185
MAHOPAC,NY,5414,5896,482,0.5213085764809903
MAHTOMEDI,MN,1431,1456,25,0.5043297540699688
MAHTOWA,MN,147,177,30,0.5462962962962963
MAHWAH,NJ,7530,7733,203,0.5066500687938151
MAIDEN,NC,3335,3799,464,0.532520325203252
MAIDEN ROCK,WI,115,88,-27,0.43349753694581283
MAIDENS,VA,440,812,372,0.6485623003194888
MAIDSTONE,VT,0,29,29,1
MAIDSVILLE,WV,587,589,2,0.5008503401360545
MAINE,NY,120,77,-43,0.39086294416243655
MAINESBURG,PA,47,33,-14,0.4125
MAINEVILLE,OH,9152,10506,1354,0.534438905280293
MAITLAND,FL,13810,14823,1013,0.5176893793874201
MAITLAND,MO,42,15,-27,0.2631578947368421
MAIZE,KS,3671,3451,-220,0.48455490030890197
MAJESTIC,KY,11,0,-11,0
MAKANDA,IL,823,710,-113,0.46314416177429873
MAKAWAO,HI,6225,6243,18,0.5007218479307026
MAKINEN,MN,98,42,-56,0.3
MALABAR,FL,2086,2494,408,0.5445414847161572
MALAD CITY,ID,1585,1564,-21,0.49666560812956495
MALAGA,NJ,252,191,-61,0.43115124153498874
MALAGA,WA,885,806,-79,0.47664104080425784
MALAKOFF,TX,3708,2531,-1177,0.4056739862157397
MALCOLM,NE,122,122,0,0.5
MALCOM,IA,33,14,-19,0.2978723404255319
MALDEN,MA,33986,27760,-6226,0.44958377870631294
MALDEN,MO,2504,2305,-199,0.4793096277812435
MALDEN,WA,37,0,-37,0
MALDEN ON HUDSON,NY,15,0,-15,0
MALIBU,CA,8321,7427,-894,0.47161544323088644
MALIN,OR,115,125,10,0.5208333333333334
MALINTA,OH,38,0,-38,0
MALLARD,IA,11,11,0,0.5
MALLORY,NY,23,0,-23,0
MALO,WA,17,26,9,0.6046511627906976
MALONE,FL,179,197,18,0.523936170212766
MALONE,NY,5547,5327,-220,0.4898841272760714
MALONE,TX,12,0,-12,0
MALONE,WI,487,420,-67,0.46306504961411243
MALOTT,WA,25,0,-25,0
MALTA,ID,206,137,-69,0.39941690962099125
MALTA,IL,512,487,-25,0.4874874874874875
MALTA,MT,760,593,-167,0.43828529194382854
MALTA,NY,1291,1352,61,0.5115399167612561
MALTA,OH,985,1015,30,0.5075
MALTA BEND,MO,13,11,-2,0.4583333333333333
MALVERN,AR,8969,8607,-362,0.48970186618115613
MALVERN,IA,622,515,-107,0.4529463500439754
MALVERN,OH,2346,1834,-512,0.438755980861244
MALVERN,PA,11049,12305,1256,0.5268904684422369
MALVERNE,NY,1869,1925,56,0.507380073800738
MAMARONECK,NY,6477,6300,-177,0.49307349142991314
MAMMOTH,AZ,116,58,-58,0.3333333333333333
MAMMOTH CAVE,KY,117,89,-28,0.4320388349514563
MAMMOTH LAKES,CA,5133,2793,-2340,0.35238455715367145
MAMMOTH SPG,AR,226,274,48,0.548
MAMMOTH SPRING,AR,1208,1148,-60,0.4872665534804754
MAMOU,LA,2180,2019,-161,0.48082876875446534
MAN,WV,115,162,47,0.5848375451263538
MANAHAWKIN,NJ,9245,9956,711,0.5185146606947555
MANAKIN SABOT,VA,1343,2258,915,0.627048042210497
MANALAPAN,NJ,8013,9172,1159,0.5337212685481525
MANASQUAN,NJ,4797,5465,668,0.5325472617423505
MANASSA,CO,78,49,-29,0.3858267716535433
MANASSAS,VA,55913,51821,-4092,0.48100878088625687
MANASSAS PARK,VA,10439,8956,-1483,0.46176849703531836
MANAWA,WI,1180,1051,-129,0.47108919766920665
MANAYUNK,PA,1078,841,-237,0.43824908806670143
MANCELONA,MI,3742,3332,-410,0.47102063895957025
MANCHACA,TX,2047,2958,911,0.591008991008991
MANCHESTER,CA,37,31,-6,0.45588235294117646
MANCHESTER,CT,29588,26783,-2805,0.4751201859111955
MANCHESTER,GA,2309,1957,-352,0.45874355368026254
MANCHESTER,IA,3606,3111,-495,0.4631531933899062
MANCHESTER,IL,16,0,-16,0
MANCHESTER,KY,3460,3387,-73,0.49466919818898786
MANCHESTER,MA,1477,1570,93,0.5152609123728258
MANCHESTER,MD,2837,2948,111,0.5095937770095074
MANCHESTER,ME,1817,1242,-575,0.40601503759398494
MANCHESTER,MI,1974,2025,51,0.5063765941485371
MANCHESTER,MO,4967,4574,-393,0.47940467456241487
MANCHESTER,NH,65303,58202,-7101,0.47125217602526215
MANCHESTER,NJ,4072,4867,795,0.5444680613043965
MANCHESTER,NY,661,688,27,0.5100074128984433
MANCHESTER,OH,1665,1662,-3,0.4995491433724076
MANCHESTER,PA,3481,3016,-465,0.46421425273203015
MANCHESTER,TN,11290,11974,684,0.514700825309491
MANCHESTER,VT,771,620,-151,0.44572250179726813
MANCHESTER,WA,478,330,-148,0.4084158415841584
MANCHESTER BY THE SEA,MA,714,900,186,0.5576208178438662
MANCHESTER CENTER,VT,2230,2249,19,0.502121009153829
MANCOS,CO,2249,2489,240,0.5253271422541157
MANDAN,ND,15742,12329,-3413,0.43920772327312885
MANDAREE,ND,0,11,11,1
MANDEVILLE,LA,16292,16085,-207,0.4968032862834728
MANGHAM,LA,385,386,1,0.5006485084306096
MANGO,FL,911,440,-471,0.32568467801628426
MANGONIA PARK,FL,684,661,-23,0.49144981412639405
MANGUM,OK,1835,1491,-344,0.44828622970535176
MANHASSET,NY,4140,5114,974,0.5526258915063756
MANHATTAN,IL,2856,3854,998,0.5743666169895678
MANHATTAN,KS,50788,33161,-17627,0.39501363923334404
MANHATTAN,MT,2221,2161,-60,0.49315381104518485
MANHATTAN BCH,CA,1034,1078,44,0.5104166666666666
MANHATTAN BEACH,CA,13197,12422,-775,0.48487450720168623
MANHEIM,PA,6320,6220,-100,0.4960127591706539
MANILA,AR,1400,1516,116,0.5198902606310014
MANILA,UT,304,84,-220,0.21649484536082475
MANILLA,IA,266,135,-131,0.33665835411471323
MANILLA,IN,52,33,-19,0.38823529411764707
MANISTEE,MI,7286,6272,-1014,0.46260510399763977
MANISTIQUE,MI,3650,3261,-389,0.4718564607148025
MANITO,IL,1338,1214,-124,0.47570532915360503
MANITOU,KY,34,92,58,0.7301587301587301
MANITOU BEACH,MI,1594,1618,24,0.5037359900373599
MANITOU SPRINGS,CO,3884,3560,-324,0.4782375067168189
MANITOWISH WATERS,WI,969,1092,123,0.529839883551674
MANITOWOC,WI,17864,15201,-2663,0.4597308332073189
MANKATO,KS,297,315,18,0.5147058823529411
MANKATO,MN,46066,26435,-19631,0.36461566047364863
MANLIUS,IL,25,0,-25,0
MANLIUS,NY,5540,5738,198,0.5087781521546374
MANLY,IA,684,480,-204,0.41237113402061853
MANNFORD,OK,2890,2446,-444,0.45839580209895053
MANNING,IA,786,750,-36,0.48828125
MANNING,SC,5124,5213,89,0.5043049240592048
MANNINGTON,WV,1224,1138,-86,0.48179508890770534
MANNS CHOICE,PA,465,310,-155,0.4
MANNS HARBOR,NC,0,22,22,1
MANNSVILLE,KY,11,0,-11,0
MANNSVILLE,NY,488,302,-186,0.3822784810126582
MANNSVILLE,OK,352,151,-201,0.30019880715705766
MANOMET,MA,441,329,-112,0.42727272727272725
MANOR,GA,25,22,-3,0.46808510638297873
MANOR,PA,331,234,-97,0.41415929203539825
MANOR,TX,10132,15395,5263,0.60308692756689
MANORVILLE,NY,4427,4157,-270,0.4842730661696179
MANORVILLE,PA,11,0,-11,0
MANQUIN,VA,47,83,36,0.6384615384615384
MANSFIEL,TX,47,87,40,0.6492537313432836
MANSFIELD,AR,1011,1091,80,0.5190294957183634
MANSFIELD,GA,860,1207,347,0.5839380745041123
MANSFIELD,IL,306,273,-33,0.47150259067357514
MANSFIELD,LA,2648,2447,-201,0.4802747791952895
MANSFIELD,MA,7350,7359,9,0.5003059351417499
MANSFIELD,MO,1509,1524,15,0.5024727992087042
MANSFIELD,OH,34293,31777,-2516,0.480959588315423
MANSFIELD,PA,4102,2931,-1171,0.4167496089862079
MANSFIELD,TN,11,11,0,0.5
MANSFIELD,TX,30934,32692,1758,0.5138151070317166
MANSFIELD,WA,0,15,15,1
MANSFIELD CENTER,CT,1643,1635,-8,0.4987797437461867
MANSFIELD CTR,CT,108,107,-1,0.49767441860465117
MANSON,IA,1175,1026,-149,0.4661517492049069
MANSON,NC,162,278,116,0.6318181818181818
MANSON,WA,1410,1508,98,0.5167923235092529
MANSURA,LA,1325,1486,161,0.528637495553184
MANTACHIE,MS,1311,1379,68,0.5126394052044609
MANTECA,CA,29156,31814,2658,0.5217976053796949
MANTEE,MS,34,37,3,0.5211267605633803
MANTENO,IL,4363,4250,-113,0.4934401486125624
MANTEO,NC,2620,2538,-82,0.49205118262892594
MANTI,UT,1041,1181,140,0.5315031503150315
MANTOLOKING,NJ,985,1300,315,0.5689277899343544
MANTON,CA,38,13,-25,0.2549019607843137
MANTON,MI,2376,2249,-127,0.48627027027027026
MANTORVILLE,MN,415,546,131,0.5681581685744017
MANTUA,NJ,3504,3448,-56,0.49597238204833144
MANTUA,OH,2268,2034,-234,0.47280334728033474
MANTUA,UT,12,152,140,0.926829268292683
MANVEL,ND,0,12,12,1
MANVEL,TX,7072,10583,3511,0.5994335882186349
MANVILLE,NJ,3783,3164,-619,0.45544839499064343
MANVILLE,RI,1927,1677,-250,0.4653163152053274
MANY,LA,3130,3108,-22,0.4982366142994549
MANZANITA,OR,902,899,-3,0.4991671293725708
MANZANOLA,CO,72,55,-17,0.4330708661417323
MAPLE,NC,11,0,-11,0
MAPLE,WI,82,54,-28,0.39705882352941174
MAPLE CITY,MI,1203,1053,-150,0.46675531914893614
MAPLE FALLS,WA,2304,1885,-419,0.44998806397708285
MAPLE GLEN,PA,214,169,-45,0.4412532637075718
MAPLE GROVE,MN,27998,28022,24,0.500214209210996
MAPLE HEIGHTS,OH,8750,8368,-382,0.4888421544572964
MAPLE HILL,KS,93,139,46,0.5991379310344828
MAPLE HILL,NC,1130,1041,-89,0.47950253339474896
MAPLE LAKE,MN,1966,1681,-285,0.46092678914176033
MAPLE MOUNT,KY,11,12,1,0.5217391304347826
MAPLE PARK,IL,1001,1146,145,0.5337680484396833
MAPLE PLAIN,MN,1824,1918,94,0.5125601282736505
MAPLE RAPIDS,MI,61,23,-38,0.27380952380952384
MAPLE SHADE,NJ,8921,7706,-1215,0.46346304204005534
MAPLE VALLEY,WA,13081,13214,133,0.5025289979083476
MAPLECREST,NY,11,13,2,0.5416666666666666
MAPLESVILLE,AL,719,732,13,0.5044796691936595
MAPLETON,IA,768,566,-202,0.424287856071964
MAPLETON,IL,942,991,49,0.512674599068805
MAPLETON,KS,0,11,11,1
MAPLETON,ME,528,611,83,0.5364354697102721
MAPLETON,MN,1071,880,-191,0.451050743208611
MAPLETON,ND,292,412,120,0.5852272727272727
MAPLETON,OR,340,326,-14,0.4894894894894895
MAPLETON,UT,2267,3519,1252,0.6081921880400968
MAPLETON DEPOT,PA,263,224,-39,0.459958932238193
MAPLEVILLE,RI,348,337,-11,0.491970802919708
MAPLEWOOD,MN,15231,13543,-1688,0.4706679641342879
MAPLEWOOD,MO,2246,1929,-317,0.4620359281437126
MAPLEWOOD,NJ,7460,7702,242,0.5079804775095634
MAPLEWOOD,OH,24,23,-1,0.48936170212765956
MAQUOKETA,IA,3693,3479,-214,0.4850808700501952
MAQUON,IL,48,37,-11,0.43529411764705883
MARAMEC,OK,0,12,12,1
MARANA,AZ,16866,21279,4413,0.5578450648839953
MARATHON,FL,8221,8487,266,0.5079602585587742
MARATHON,IA,23,25,2,0.5208333333333334
MARATHON,NY,1833,1635,-198,0.47145328719723184
MARATHON,OH,15,12,-3,0.4444444444444444
MARATHON,TX,0,12,12,1
MARATHON,WI,960,901,-59,0.48414830736163356
MARATHON CITY,WI,17,17,0,0.5
MARATHON SHORES,FL,46,43,-3,0.48314606741573035
MARATHON SHRS,FL,16,0,-16,0
MARBLE,MN,31,12,-19,0.27906976744186046
MARBLE,NC,1356,1298,-58,0.48907309721175585
MARBLE FALLS,AR,45,36,-9,0.4444444444444444
MARBLE FALLS,TX,7274,7710,436,0.5145488521089162
MARBLE HILL,GA,48,170,122,0.7798165137614679
MARBLE HILL,MO,2156,2200,44,0.5050505050505051
MARBLE ROCK,IA,0,13,13,1
MARBLEHEAD,MA,7538,7985,447,0.5143979900792373
MARBLEHEAD,OH,661,643,-18,0.49309815950920244
MARBLEMOUNT,WA,156,34,-122,0.17894736842105263
MARBURY,AL,674,569,-105,0.4577634754625905
MARBURY,MD,63,144,81,0.6956521739130435
MARCELINE,MO,1304,1257,-47,0.49082389691526745
MARCELL,MN,191,207,16,0.5201005025125628
MARCELLUS,MI,1792,1634,-158,0.47694103911266783
MARCELLUS,NY,2071,2092,21,0.5025222195532069
MARCH AIR RESERVE BASE,CA,227,306,79,0.574108818011257
MARCH ARB,CA,171,181,10,0.5142045454545454
MARCO ISLAND,FL,29026,31407,2381,0.5196995019277547
MARCOLA,OR,691,656,-35,0.48700816629547145
MARCUS,IA,765,594,-171,0.4370860927152318
MARCUS HOOK,PA,939,969,30,0.5078616352201258
MARCY,NY,1529,1383,-146,0.47493131868131866
MARDELA SPGS,MD,25,11,-14,0.3055555555555556
MARDELA SPRINGS,MD,594,678,84,0.53301886792452835
MARENGO,IA,1343,1316,-27,0.49492290334712297
MARENGO,IL,4439,4157,-282,0.4835970218706375
MARENGO,IN,1207,1106,-101,0.47816688283614356
MARENGO,OH,2275,2204,-71,0.49207412368832326
MARENGO,WI,36,24,-12,0.4
MARENISCO,MI,169,122,-47,0.41924398625429554
MARFA,TX,724,521,-203,0.41847389558232934
MARGARETVILLE,NY,1106,835,-271,0.43019062339000513
MARGATE,FL,29092,27753,-1339,0.48822235904653005
MARGATE CITY,NJ,4846,5376,530,0.525924476619057
MARIA STEIN,OH,35,38,3,0.5205479452054794
MARIANNA,AR,2535,1607,-928,0.38797682279092227
MARIANNA,FL,6892,6994,102,0.5036727639348985
MARIANNA,PA,124,133,9,0.5175097276264592
MARIBEL,WI,103,81,-22,0.44021739130434784
MARICOPA,AZ,30682,38644,7962,0.5574243429593515
MARICOPA,CA,402,449,47,0.5276145710928319
MARIENVILLE,PA,702,488,-214,0.41008403361344536
MARIETTA,GA,126280,123068,-3212,0.49355920239985884
MARIETTA,MN,152,64,-88,0.2962962962962963
MARIETTA,MS,142,88,-54,0.3826086956521739
MARIETTA,NY,910,825,-85,0.4755043227665706
MARIETTA,OH,10549,9493,-1056,0.47365532381997805
MARIETTA,OK,2078,2139,61,0.5072326298316339
MARIETTA,PA,3495,3409,-86,0.49377172653534185
MARIETTA,SC,1917,2034,117,0.5148063781321185
MARIETTA,TX,12,0,-12,0
MARILLA,NY,11,11,0,0.5
MARINA,CA,9922,9742,-180,0.49542310821806346
MARINA DEL REY,CA,24759,24283,-476,0.49514701684270623
MARINA DL REY,CA,15,11,-4,0.4230769230769231
MARINE,IL,235,198,-37,0.45727482678983833
MARINE CITY,MI,2727,2440,-287,0.4722275982194697
MARINE ON SAINT CROIX,MN,947,962,15,0.5039287585123101
MARINETTE,WI,7361,6560,-801,0.4712305150492062
MARINGOUIN,LA,248,245,-3,0.4969574036511156
MARION,AL,1060,1087,27,0.5062878435025617
MARION,AR,8269,5860,-2409,0.41474980536485245
MARION,CT,38,64,26,0.6274509803921569
MARION,IA,18832,18169,-663,0.49104078268154916
MARION,IL,12649,12146,-503,0.4898568259729784
MARION,IN,22297,18616,-3681,0.4550142986336861
MARION,KS,1205,1227,22,0.5045230263157895
MARION,KY,3824,3175,-649,0.45363623374767825
MARION,LA,283,533,250,0.6531862745098039
MARION,MA,2323,2613,290,0.5293760129659644
MARION,MD,13,25,12,0.6578947368421053
MARION,MI,1779,1667,-112,0.483749274521184
MARION,MS,735,762,27,0.5090180360721442
MARION,MT,901,1123,222,0.5548418972332015
MARION,NC,8444,8421,-23,0.4993181144381856
MARION,ND,24,0,-24,0
MARION,NY,1680,1564,-116,0.48212083847102344
MARION,OH,21860,20922,-938,0.4890374456547146
MARION,PA,0,11,11,1
MARION,SC,3745,4020,275,0.5177076625885383
MARION,SD,225,179,-46,0.4430693069306931
MARION,TX,1882,2288,406,0.5486810551558753
MARION,VA,6313,5193,-1120,0.4513297410046932
MARION,WI,1061,933,-128,0.4679037111334002
MARION CENTER,PA,488,534,46,0.5225048923679061
MARION HEIGHTS,PA,74,22,-52,0.22916666666666666
MARION JUNCTION,AL,15,24,9,0.6153846153846154
MARION STATION,MD,243,234,-9,0.49056603773584906
MARION TWP,ME,13,0,-13,0
MARIONVILLE,MO,1581,1699,118,0.5179878048780487
MARIPOSA,CA,3755,3896,141,0.5092144817670893
MARISSA,IL,805,882,77,0.5228215767634855
MARKED TREE,AR,1320,1090,-230,0.45228215767634855
MARKESAN,WI,1484,1465,-19,0.49677856900644285
MARKHAM,IL,3814,3279,-535,0.4622867615959397
MARKHAM,TX,68,34,-34,0.3333333333333333
MARKLE,IN,832,771,-61,0.4809731752963194
MARKLEEVILLE,CA,206,254,48,0.5521739130434783
MARKLEVILLE,IN,507,554,47,0.5221489161168709
MARKLEYSBURG,PA,199,200,1,0.5012531328320802
MARKS,MS,691,620,-71,0.47292143401983217
MARKSVILLE,LA,3792,3436,-356,0.47537354731599335
MARLBORO,NJ,3516,4469,953,0.5596743894802755
MARLBORO,NY,1959,2074,115,0.5142573766426978
MARLBORO,VT,36,80,44,0.6896551724137931
MARLBOROUGH,CT,1619,1825,206,0.5299070847851336
MARLBOROUGH,MA,22209,18602,-3607,0.4558084830070324
MARLBOROUGH,NH,1011,879,-132,0.4650793650793651
MARLETTE,MI,2262,1965,-297,0.46486870120652946
MARLIN,TX,4273,2405,-1868,0.36013776579814316
MARLINTON,WV,1536,1245,-291,0.447680690399137
MARLOW,NH,90,75,-15,0.45454545454545453
MARLOW,OK,3670,3316,-354,0.47466361294016607
MARLTON,NJ,19619,16313,-3306,0.4539964377156852
MARMADUKE,AR,1257,1200,-57,0.4884004884004884
MARMET,WV,241,223,-18,0.48060344827586204
MARMORA,NJ,1330,1564,234,0.5404284727021423
MARNE,MI,969,904,-65,0.4826481580352376
MAROA,IL,754,683,-71,0.47529575504523314
MARQUAND,MO,200,252,52,0.5575221238938053
MARQUETTE,KS,215,71,-144,0.24825174825174826
MARQUETTE,MI,19289,14891,-4398,0.43566413107080165
MARQUETTE,NE,112,72,-40,0.391304347826087
MARQUETTE,WI,11,0,-11,0
MARQUETTE HEIGHTS,IL,681,663,-18,0.49330357142857145
MARQUEZ,TX,225,525,300,0.7
MARRERO,LA,13409,13473,64,0.5011903876199687
MARRIOTT SLATERVILLE CITY,UT,418,471,53,0.5298087739032621
MARRIOTTSVILLE,MD,1065,1472,407,0.5802128498226251
MARS,PA,5568,6532,964,0.5398347107438016
MARS HILL,ME,639,356,-283,0.3577889447236181
MARS HILL,NC,2743,3315,572,0.5472103004291845
MARSEILLES,IL,3400,3078,-322,0.4751466502006792
MARSHALL,AR,1459,1445,-14,0.4975895316804408
MARSHALL,IL,2992,2679,-313,0.4724034561805678
MARSHALL,IN,62,26,-36,0.29545454545454547
MARSHALL,MI,6592,5995,-597,0.47628505601016924
MARSHALL,MN,8919,6970,-1949,0.43866826106111145
MARSHALL,MO,6839,6225,-614,0.4765003061849357
MARSHALL,NC,3155,3501,346,0.5259915865384616
MARSHALL,TX,9962,9232,-730,0.48098364072105865
MARSHALL,VA,1926,2076,150,0.5187406296851574
MARSHALL,WI,2067,2150,83,0.5098411192791084
MARSHALLS CREEK,PA,534,85,-449,0.13731825525040386
MARSHALLS CRK,PA,144,24,-120,0.14285714285714285
MARSHALLTOWN,IA,15165,13013,-2152,0.4618141812761729
MARSHALLVILLE,GA,81,138,57,0.6301369863013698
MARSHALLVILLE,OH,683,478,-205,0.4117140396210164
MARSHFIELD,MA,7648,7647,-1,0.49996730957829355
MARSHFIELD,ME,207,192,-15,0.48120300751879697
MARSHFIELD,MO,6357,6496,139,0.5054072979071034
MARSHFIELD,VT,211,418,207,0.6645468998410174
MARSHFIELD,WI,13687,11526,-2161,0.45714512354737635
MARSHFIELD HILLS,MA,11,30,19,0.7317073170731707
MARSHVILLE,NC,2216,2694,478,0.5486761710794298
MARSING,ID,2007,1234,-773,0.38074668312249305
MARSTON,MO,12,0,-12,0
MARSTON,NC,24,23,-1,0.48936170212765956
MARSTONS MILLS,MA,2542,2597,55,0.5053512356489589
MARSTONS MLS,MA,157,71,-86,0.31140350877192985
MART,TX,1047,1123,76,0.5175115207373272
MARTELL,NE,25,23,-2,0.4791666666666667
MARTELLE,IA,12,0,-12,0
MARTENSDALE,IA,91,0,-91,0
MARTHASVILLE,MO,1234,1347,113,0.5218907400232468
MARTHAVILLE,LA,0,12,12,1
MARTIN,GA,1917,1869,-48,0.4936608557844691
MARTIN,KY,818,590,-228,0.4190340909090909
MARTIN,MI,920,757,-163,0.4514013118664281
MARTIN,OH,12,12,0,0.5
MARTIN,PA,11,0,-11,0
MARTIN,SD,248,99,-149,0.28530259365994237
MARTIN,TN,7463,5724,-1739,0.4340638507621142
MARTIN CITY,MT,11,11,0,0.5
MARTINDALE,TX,841,805,-36,0.4890643985419198
MARTINEZ,CA,11817,11597,-220,0.4953019560946442
MARTINEZ,GA,4990,4837,-153,0.49221532512465654
MARTINS FERRY,OH,3752,3028,-724,0.44660766961651915
MARTINSBURG,MO,12,23,11,0.6571428571428571
MARTINSBURG,OH,25,37,12,0.5967741935483871
MARTINSBURG,PA,1419,1336,-83,0.4849364791288566
MARTINSBURG,WV,28050,29469,1419,0.5123350545037292
MARTINSVILLE,IL,757,686,-71,0.4753984753984754
MARTINSVILLE,IN,14961,12870,-2091,0.462433976501024
MARTINSVILLE,NJ,1032,1023,-9,0.4978102189781022
MARTINSVILLE,OH,286,294,8,0.506896551724138
MARTINSVILLE,VA,10428,10168,-260,0.4936880947756846
MARTINTON,IL,61,34,-27,0.35789473684210527
MARTVILLE,NY,386,296,-90,0.4340175953079179
MARVELL,AR,296,53,-243,0.1518624641833811
MARVIN,NC,244,332,88,0.5763888888888888
MARY ESTHER,FL,8501,7978,-523,0.4841313186479762
MARYDEL,DE,164,83,-81,0.3360323886639676
MARYDEL,MD,288,315,27,0.5223880597014925
MARYLAND,NY,583,595,12,0.5050933786078099
MARYLAND CITY,MD,178,177,-1,0.49859154929577465
MARYLAND HEIGHTS,MO,9287,8483,-804,0.4773776027011818
MARYLAND HTS,MO,617,567,-50,0.47888513513513514
MARYSILLE,CA,276,243,-33,0.4682080924855491
MARYSVALE,UT,0,40,40,1
MARYSVILLE,CA,14002,13436,-566,0.48968583716014286
MARYSVILLE,IN,136,196,60,0.5903614457831325
MARYSVILLE,KS,3085,2068,-1017,0.4013196196390452
MARYSVILLE,MI,4377,4008,-369,0.4779964221824687
MARYSVILLE,OH,13321,15000,1679,0.5296423148900109
MARYSVILLE,PA,1536,1745,209,0.531850045717769
MARYSVILLE,WA,31986,31682,-304,0.49761261544260854
MARYVILLE,IL,2566,2803,237,0.5220711491897932
MARYVILLE,MO,7129,5822,-1307,0.44954057601729597
MARYVILLE,TN,31883,34006,2123,0.5161104281443033
MASARDIS,ME,182,187,5,0.5067750677506775
MASCOT,TN,831,1020,189,0.5510534846029174
MASCOTTE,FL,2711,3201,490,0.5414411366711772
MASCOUTAH,IL,3658,3267,-391,0.47176895306859207
MASHPEE,MA,9725,10326,601,0.514986783701561
MASON,IL,115,144,29,0.555984555984556
MASON,MI,7736,6750,-986,0.4659671406875604
MASON,NH,325,316,-9,0.49297971918876754
MASON,OH,19189,20595,1406,0.5176704202694551
MASON,TN,861,982,121,0.5328269126424309
MASON,TX,762,913,151,0.5450746268656717
MASON,WI,53,105,52,0.6645569620253164
MASON,WV,453,163,-290,0.26461038961038963
MASON CITY,IA,17093,14097,-2996,0.4519717858287913
MASON CITY,IL,1227,1131,-96,0.4796437659033079
MASON CITY,NE,11,0,-11,0
MASONIC HOME,KY,84,118,34,0.5841584158415841
MASONTOWN,PA,1348,1367,19,0.503499079189687
MASONTOWN,WV,577,549,-28,0.48756660746003555
MASONVILLE,CO,82,13,-69,0.1368421052631579
MASONVILLE,NY,17,0,-17,0
MASPETH,NY,8442,7172,-1270,0.45933136928397594
MASS CITY,MI,11,0,-11,0
MASSACHUTESS,NY,19,17,-2,0.4722222222222222
MASSANUTTEN,VA,89,110,21,0.5527638190954773
MASSAPEQUA,NY,12463,12158,-305,0.49380610048332724
MASSAPEQUA PARK,NY,4000,4205,205,0.5124923826934796
MASSAPEQUA PK,NY,69,69,0,0.5
MASSENA,IA,11,0,-11,0
MASSENA,NY,8800,7745,-1055,0.46811725596857057
MASSIES MILL,VA,0,17,17,1
MASSILLON,OH,22587,21543,-1044,0.48817131203263087
MASTIC,NY,5223,4672,-551,0.47215765538150584
MASTIC BEACH,NY,6102,5044,-1058,0.4525390274537951
MASURY,OH,1726,1588,-138,0.4791792395896198
MATAGORDA,TX,0,12,12,1
MATAMORAS,PA,1305,1600,295,0.5507745266781411
MATAWAN,NJ,8416,8439,23,0.5006822901216257
MATEWAN,WV,41,115,74,0.7371794871794872
MATHER,CA,1528,1453,-75,0.487420328748742
MATHER,PA,12,0,-12,0
MATHERVILLE,IL,68,11,-57,0.13924050632911392
MATHESON,CO,0,16,16,1
MATHEWS,AL,0,46,46,1
MATHEWS,LA,21,80,59,0.7920792079207921
MATHEWS,VA,418,587,169,0.5840796019900497
MATHIAS,WV,231,235,4,0.5042918454935622
MATHIS,TX,2721,2787,66,0.5059912854030502
MATHISTON,MS,535,462,-73,0.4633901705115346
MATLACHA,FL,967,1307,340,0.5747581354441513
MATLOCK,WA,0,14,14,1
MATOAKA,WV,0,12,12,1
MATTAPAN,MA,9376,7791,-1585,0.4538358478476146
MATTAPOISETT,MA,2754,2991,237,0.5206266318537859
MATTAPONI,VA,12,13,1,0.52
MATTAWA,WA,4115,3371,-744,0.45030724018167245
MATTAWAMKEAG,ME,58,36,-22,0.3829787234042553
MATTAWAN,MI,3760,3547,-213,0.48542493499384154
MATTESON,IL,7543,7519,-24,0.49920329305537114
MATTHEWS,IN,26,15,-11,0.36585365853658536
MATTHEWS,MO,98,117,19,0.5441860465116279
MATTHEWS,NC,25996,30265,4269,0.5379392474360569
MATTITUCK,NY,1809,1971,162,0.5214285714285715
MATTOON,IL,10558,9489,-1069,0.47333765650720805
MATTYDALE,NY,302,293,-9,0.492436974789916
MAUCKPORT,IN,80,102,22,0.5604395604395604
MAUD,OK,342,249,-93,0.4213197969543147
MAUD,TX,1124,1178,54,0.5117289313640313
MAUGANSVILLE,MD,616,405,-211,0.3966699314397649
MAUK,GA,315,445,130,0.5855263157894737
MAULDIN,SC,8129,7686,-443,0.4859943092001265
MAUMEE,OH,11041,11185,144,0.5032394492936201
MAUMELLE,AR,7682,7407,-275,0.4908874014182517
MAUNALOA,HI,53,180,127,0.7725321888412017
MAUPIN,OR,151,258,107,0.6308068459657702
MAUREPAS,LA,1022,1104,82,0.5192850423330198
MAURERTOWN,VA,533,718,185,0.5739408473221422
MAURICE,LA,2141,2793,652,0.5660721524118363
MAURICEVILLE,TX,67,135,68,0.6683168316831684
MAURY CITY,TN,0,12,12,1
MAUSTON,WI,4179,3708,-471,0.4701407379231647
MAX,ND,26,27,1,0.5094339622641509
MAX MEADOWS,VA,1398,1523,125,0.5213967819239986
MAXFIELD,ME,0,11,11,1
MAXTON,NC,2490,2137,-353,0.46185433326129244
MAXWELL,CA,67,39,-28,0.36792452830188677
MAXWELL,IA,740,665,-75,0.47330960854092524
MAXWELL,NE,59,39,-20,0.3979591836734694
MAXWELL,TX,722,1022,300,0.5860091743119266
MAXWELL AFB,AL,45,16,-29,0.26229508196721313
MAXWELTON,WV,26,23,-3,0.46938775510204084
MAY,TX,450,727,277,0.6176720475785896
MAYBEE,MI,487,379,-108,0.4376443418013857
MAYBROOK,NY,1238,1107,-131,0.4720682302771855
MAYER,AZ,2793,3139,346,0.5291638570465274
MAYER,MN,651,894,243,0.5786407766990291
MAYESVILLE,SC,103,50,-53,0.32679738562091504
MAYETTA,KS,733,575,-158,0.4396024464831804
MAYFIELD,KY,12101,9015,-3086,0.42692744838037505
MAYFIELD,NY,1490,1288,-202,0.4636429085673146
MAYFIELD,PA,365,329,-36,0.47406340057636887
MAYFIELD HEIGHTS,OH,5148,5356,208,0.5099009900990099
MAYFIELD HTS,OH,1591,1389,-202,0.46610738255033557
MAYFIELD TWP,ME,11,0,-11,0
MAYFIELD VILLAGE,OH,160,187,27,0.5389048991354467
MAYFLOWER,AR,2285,2308,23,0.5025038101458742
MAYHILL,NM,24,279,255,0.9207920792079208
MAYKING,KY,12,39,27,0.7647058823529411
MAYLENE,AL,610,660,50,0.5196850393700787
MAYNARD,AR,447,599,152,0.5726577437858509
MAYNARD,IA,61,0,-61,0
MAYNARD,MA,3843,3990,147,0.5093833780160858
MAYNARD,MN,60,33,-27,0.3548387096774194
MAYNARDVILLE,TN,3227,3894,667,0.5468333099283809
MAYO,FL,1521,1888,367,0.5538281020827222
MAYO,SC,0,11,11,1
MAYODAN,NC,1464,1304,-160,0.47109826589595377
MAYPEARL,TX,362,444,82,0.5508684863523573
MAYPORT,PA,160,168,8,0.5121951219512195
MAYS LANDING,NJ,10536,11394,858,0.5195622435020519
MAYSEL,WV,26,27,1,0.5094339622641509
MAYSLICK,KY,436,289,-147,0.3986206896551724
MAYSVILLE,GA,1833,1938,105,0.5139220365950676
MAYSVILLE,IA,15,26,11,0.6341463414634146
MAYSVILLE,KY,5888,5857,-31,0.4986802894848872
MAYSVILLE,MO,713,706,-7,0.4975334742776603
MAYSVILLE,NC,1727,2200,473,0.5602240896358543
MAYSVILLE,OK,601,624,23,0.5093877551020408
MAYSVILLE,WV,146,193,47,0.5693215339233039
MAYTOWN,PA,79,77,-2,0.4935897435897436
MAYVIEW,MO,38,25,-13,0.3968253968253968
MAYVILLE,MI,1709,1542,-167,0.4743155952014765
MAYVILLE,ND,1109,844,-265,0.4321556579621096
MAYVILLE,NY,1889,1908,19,0.5025019752436134
MAYVILLE,WI,2541,2153,-388,0.4586706433745207
MAYWOOD,CA,3944,3022,-922,0.43382141831754234
MAYWOOD,IL,7321,6696,-625,0.4777056431476065
MAYWOOD,MO,0,13,13,1
MAYWOOD,NE,12,11,-1,0.4782608695652174
MAYWOOD,NJ,2761,2687,-74,0.49320851688693096
MAZAMA,WA,0,11,11,1
MAZEPPA,MN,398,359,-39,0.47424042272126815
MAZOMANIE,WI,1214,1249,35,0.5071051563134389
MAZON,IL,507,288,-219,0.3622641509433962
MB,SC,144,123,-21,0.4606741573033708
MC ADENVILLE,NC,97,103,6,0.515
MC ALISTERVILLE,PA,840,818,-22,0.49336550060313633
MC ALISTERVLE,PA,15,14,-1,0.4827586206896552
MC ALLISTER,MT,255,231,-24,0.47530864197530864
MC ALPIN,FL,879,1217,338,0.5806297709923665
MC ANDREWS,KY,26,0,-26,0
MC ARTHUR,OH,2020,1807,-213,0.4721714136399268
MC BAIN,MI,941,906,-35,0.49052517596101786
MC BEE,SC,494,533,39,0.5189873417721519
MC CALL CREEK,MS,12,0,-12,0
MC CALLA,AL,4768,5583,815,0.5393681769877307
MC CALLSBURG,IA,0,31,31,1
MC CAMEY,TX,327,160,-167,0.32854209445585214
MC CARR,KY,24,13,-11,0.35135135135135137
MC CAYSVILLE,GA,765,793,28,0.5089858793324775
MC CLELLANDTOWN,PA,644,470,-174,0.42190305206463197
MC CLELLANVILLE,SC,491,562,71,0.533713200379867
MC CLURE,IL,256,52,-204,0.16883116883116883
MC CLURE,OH,357,262,-95,0.42326332794830374
MC CLURE,PA,1157,1084,-73,0.4837126282909415
MC COLL,SC,966,919,-47,0.48753315649867374
MC COMB,OH,922,680,-242,0.42446941323345816
MC CONNELLS,SC,198,426,228,0.6826923076923077
MC CONNELLSBG,PA,112,111,-1,0.4977578475336323
MC CONNELLSBURG,PA,1639,1541,-98,0.48459119496855346
MC COOK,NE,3210,2725,-485,0.45914069081718617
MC COOL,MS,114,110,-4,0.49107142857142855
MC COOL JUNCTION,NE,24,82,58,0.7735849056603774
MC CORMICK,SC,2433,2758,325,0.5313041803120786
MC CRACKEN,KS,12,0,-12,0
MC CRORY,AR,1168,976,-192,0.4552238805970149
MC CUNE,KS,143,99,-44,0.4090909090909091
MC CUTCHENVILLE,OH,37,24,-13,0.39344262295081966
MC DADE,TX,210,395,185,0.6528925619834711
MC DANIELS,KY,75,130,55,0.6341463414634146
MC DAVID,FL,410,670,260,0.6203703703703703
MC DERMOTT,OH,730,678,-52,0.4815340909090909
MC DONALD,OH,1076,1139,63,0.5142212189616253
MC DONALD,PA,3919,4563,644,0.5379627446356992
MC DONALD,TN,1481,1674,193,0.5305863708399366
MC DONOUGH,NY,539,298,-241,0.35603345280764637
MC DOWELL,KY,246,222,-24,0.47435897435897434
MC EWEN,TN,2283,2357,74,0.5079741379310345
MC FARLAND,CA,1867,1612,-255,0.46335153779821786
MC FARLAND,WI,1371,1640,269,0.5446695450016605
MC GAHEYSVILLE,VA,1378,1329,-49,0.49094939046915403
MC GEHEE,AR,2254,1776,-478,0.44069478908188586
MC GILL,NV,98,93,-5,0.4869109947643979
MC GRADY,NC,0,13,13,1
MC GRATH,MN,12,16,4,0.5714285714285714
MC GRAW,NY,1067,921,-146,0.46327967806841047
MC GREGOR,IA,736,642,-94,0.46589259796806964
MC GREGOR,TX,3511,3805,294,0.520092946965555
MC GUFFEY,OH,102,55,-47,0.3503184713375796
MC GUIRE AFB,NJ,129,96,-33,0.4266666666666667
MC HENRY,MD,816,808,-8,0.4975369458128079
MC HENRY,MS,505,758,253,0.6001583531274742
MC INTOSH,AL,242,343,101,0.5863247863247864
MC INTOSH,FL,45,62,17,0.5794392523364486
MC INTYRE,GA,60,0,-60,0
MC KEAN,PA,1631,1335,-296,0.45010114632501685
MC KEE,KY,1610,1659,49,0.5074946466809421
MC KEES ROCKS,PA,8700,7600,-1100,0.4662576687116564
MC KENNEY,VA,665,697,32,0.5117474302496329
MC KENZIE,AL,218,250,32,0.5341880341880342
MC KENZIE,TN,3501,3769,268,0.5184319119669876
MC KINNEY,TX,5397,6946,1549,0.562748116341246
MC KNIGHT,PA,305,282,-23,0.4804088586030664
MC LAIN,MS,48,111,63,0.6981132075471698
MC LAUGHLIN,SD,221,180,-41,0.4488778054862843
MC LEAN,IL,103,92,-11,0.4717948717948718
MC LEAN,NY,26,0,-26,0
MC LEAN,VA,26677,26545,-132,0.4987599113148698
MC LEANSBORO,IL,1891,1733,-158,0.47820088300220753
MC LEANSVILLE,NC,2665,2785,120,0.5110091743119266
MC LEOD,MT,49,30,-19,0.379746835443038
MC LOUTH,KS,765,782,17,0.5054945054945055
MC MILLAN,MI,571,553,-18,0.4919928825622776
MC MINNVILLE,TN,1093,969,-124,0.46993210475266733
MC NABB,IL,11,0,-11,0
MC NEAL,AZ,319,568,249,0.6403607666290868
MC NEIL,AR,25,26,1,0.5098039215686274
MC NEIL,TX,0,11,11,1
MC PHERSON,KS,858,817,-41,0.48776119402985074
MC QUEENEY,TX,1120,961,-159,0.46179721287842385
MC RAE,AR,931,848,-83,0.47667228780213605
MC RAE,GA,53,41,-12,0.43617021276595747
MC RAE HELENA,GA,2487,2171,-316,0.4660798626019751
MC ROBERTS,KY,0,11,11,1
MC SHERRYSTOWN,PA,1304,1002,-302,0.43451864700780574
MC VEYTOWN,PA,1131,1002,-129,0.469760900140647
MCADOO,PA,1579,1668,89,0.5137049584231599
MCALESTER,OK,12465,10880,-1585,0.4660526879417434
MCALLEN,TX,34867,33882,-985,0.4928362594365009
MCALLISTER,MT,31,0,-31,0
MCARTHUR,CA,638,383,-255,0.3751224289911851
MCCALL,ID,4810,4604,-206,0.4890588485234757
MCCAMEY,TX,80,63,-17,0.4405594405594406
MCCAMMON,ID,385,425,40,0.5246913580246914
MCCANNA,ND,49,37,-12,0.43023255813953487
MCCHORD AFB,WA,1390,1531,141,0.5241355700102704
MCCLEARY,WA,1279,1495,216,0.5389329488103821
MCCLELLAN,CA,193,35,-158,0.15350877192982457
MCCLELLANDTWN,PA,17,34,17,0.6666666666666666
MCCLELLANVLE,SC,54,56,2,0.509090909090909
MCCLOUD,CA,288,450,162,0.6097560975609756
MCCLURE,PA,21,35,14,0.625
MCCLUSKY,ND,12,0,-12,0
MCCOMB,MS,8244,6455,-1789,0.4391455201034084
MCCONNELL AFB,KS,935,546,-389,0.36866981769074947
MCCONNELLSBURG,PA,40,37,-3,0.4805194805194805
MCCONNELSVILLE,OH,2402,1999,-403,0.45421495114746646
MCCOOK,NE,1257,1067,-190,0.4591222030981067
MCCORDSVILLE,IN,4111,5529,1418,0.5735477178423236
MCCOY,TX,22,42,20,0.65625
MCCRORY,AR,221,171,-50,0.4362244897959184
MCCULLOM LAKE,IL,203,179,-24,0.468586387434555
MCCURTAIN,OK,69,108,39,0.6101694915254238
MCDADE,TX,68,140,72,0.6730769230769231
MCDONALD OBS,TX,50,0,-50,0
MCDONOUGH,GA,46686,50622,3936,0.5202244419780491
MCFARLAND,WI,3152,3433,281,0.521336370539104
MCGAHEYSVILLE,VA,62,89,27,0.5894039735099338
MCGEHEE,AR,84,65,-19,0.436241610738255
MCGREGOR,MN,1727,1627,-100,0.48509242695289206
MCHENRY,IL,18819,18863,44,0.5005838331298763
MCHENRY,MD,28,14,-14,0.3333333333333333
MCINTOSH,MN,141,46,-95,0.24598930481283424
MCINTOSH,NM,170,69,-101,0.28870292887029286
MCKEE,KY,347,331,-16,0.4882005899705015
MCKEESPORT,PA,11885,10032,-1853,0.45772687867865125
MCKENNA,WA,200,286,86,0.588477366255144
MCKENZIE,AL,38,49,11,0.5632183908045977
MCKENZIE BRIDGE,OR,69,56,-13,0.448
MCKINLEYVILLE,CA,6876,6537,-339,0.48736300603891747
MCKINNEY,TX,87734,96386,8652,0.5234955463827938
MCLEAN,TX,23,0,-23,0
MCLEAN,VA,6541,6605,64,0.5024342005172676
MCLOUD,OK,3168,3251,83,0.5064651814924443
MCMECHEN,WV,370,351,-19,0.4868238557558946
MCMINNVILLE,OR,16760,16264,-496,0.49249031007751937
MCMINNVILLE,TN,12342,12170,-172,0.4964915143603133
MCMURRAY,PA,888,978,90,0.5241157556270096
MCPHERSON,KS,7032,6238,-794,0.4700828937452901
MCQUEENEY,TX,42,19,-23,0.3114754098360656
MCSHERRYSTOWN,PA,479,366,-113,0.4331360946745562
MCVILLE,ND,44,28,-16,0.3888888888888889
MD CITY,MD,181,180,-1,0.4986149584487535
MEACHAM,OR,107,95,-12,0.47029702970297027
MEAD,CO,1460,2383,923,0.6200884725474889
MEAD,NE,98,85,-13,0.4644808743169399
MEAD,OK,1763,1533,-230,0.4651092233009709
MEAD,WA,3362,3736,374,0.5263454494223725
MEADE,KS,555,449,-106,0.44721115537848605
MEADOR,WV,22,34,12,0.6071428571428571
MEADOW,TX,12,14,2,0.5384615384615384
MEADOW BRIDGE,WV,230,328,98,0.5878136200716846
MEADOW CREEK,KY,11,13,2,0.5416666666666666
MEADOW GROVE,NE,11,22,11,0.6666666666666666
MEADOW LAKE,AK,79,144,65,0.6457399103139013
MEADOW LANDS,PA,141,52,-89,0.2694300518134715
MEADOW VALLEY,CA,26,0,-26,0
MEADOW VISTA,CA,1537,1868,331,0.5486049926578561
MEADOWBROOK,PA,375,383,8,0.5052770448548812
MEADOWLAKES,TX,372,374,2,0.5013404825737265
MEADOWLANDS,MN,37,33,-4,0.4714285714285714
MEADOWS OF DAN,VA,506,639,133,0.5580786026200873
MEADOWS PLACE,TX,327,286,-41,0.466557911908646
MEADOWVIEW,VA,1130,1168,38,0.5082680591818973
MEADVIEW,AZ,482,803,321,0.6249027237354086
MEADVILLE,MO,24,28,4,0.5384615384615384
MEADVILLE,MS,305,348,43,0.5329249617151608
MEADVILLE,PA,12634,11329,-1305,0.4727705212202145
MEANS,KY,25,23,-2,0.4791666666666667
MEANSVILLE,GA,622,774,152,0.5544412607449857
MEARS,MI,1322,1154,-168,0.46607431340872374
MEBANE,NC,11876,13668,1792,0.5350767303476355
MECCA,CA,696,895,199,0.562539283469516
MECHANIC FALLS,ME,1137,1181,44,0.5094909404659189
MECHANICSBURG,IL,186,157,-29,0.4577259475218659
MECHANICSBURG,OH,1443,1352,-91,0.48372093023255813
MECHANICSBURG,PA,30974,33411,2437,0.5189252155005047
MECHANICSTOWN,OH,23,12,-11,0.34285714285714286
MECHANICSVILLE,IA,429,390,-39,0.47619047619047616
MECHANICSVILLE,MD,5445,5459,14,0.5006419662509171
MECHANICSVILLE,VA,18782,21905,3123,0.5383783518077027
MECHANICSVLLE,MD,189,184,-5,0.4932975871313673
MECHANICVILLE,NY,6938,7237,299,0.5105467372134039
MECOSTA,MI,1601,1556,-45,0.49287298067785873
MEDARYVILLE,IN,735,539,-196,0.4230769230769231
MEDDYBEMPS,ME,0,14,14,1
MEDFIELD,MA,3037,3547,510,0.53873025516403406
MEDFORD,MA,28976,23882,-5094,0.4518142949033259
MEDFORD,ME,173,183,10,0.5140449438202247
MEDFORD,MN,733,649,-84,0.46960926193921854
MEDFORD,NJ,7426,8695,1269,0.5393586005830904
MEDFORD,NY,8820,8496,-324,0.49064449064449067
MEDFORD,OK,321,312,-9,0.4928909952606635
MEDFORD,OR,48178,46798,-1380,0.4927350067385445
MEDFORD,WI,4540,4261,-279,0.48414952846267467
MEDFORD LAKES,NJ,140,191,51,0.5770392749244713
MEDIA,PA,11609,12839,1230,0.5251554319371727
MEDIAPOLIS,IA,881,798,-83,0.4752829064919595
MEDICAL LAKE,WA,3327,3312,-15,0.49887031179394487
MEDICINE LAKE,MT,11,0,-11,0
MEDICINE LDG,KS,136,110,-26,0.44715447154471544
MEDICINE LODGE,KS,1099,936,-163,0.45995085995085994
MEDICINE PARK,OK,76,11,-65,0.12643678160919541
MEDINA,MN,687,1095,408,0.6144781144781145
MEDINA,ND,28,11,-17,0.28205128205128205
MEDINA,NY,3869,3811,-58,0.4962239583333333
MEDINA,OH,19683,20684,1001,0.5123987415463126
MEDINA,TN,2322,2677,355,0.535507101420284
MEDINA,TX,549,644,95,0.539815590947192
MEDINA,WA,1232,1239,7,0.5014164305949008
MEDINAH,IL,540,659,119,0.5496246872393661
MEDLEY,FL,2340,2264,-76,0.4917463075586447
MEDON,TN,483,475,-8,0.49582463465553234
MEDORA,IL,60,53,-7,0.4690265486725664
MEDORA,IN,750,748,-2,0.4993324432576769
MEDORA,ND,98,101,3,0.507537688442211
MEDUSA,NY,11,15,4,0.5769230769230769
MEDWAY,MA,3184,3426,242,0.5183055975794251
MEDWAY,ME,297,259,-38,0.4658273381294964
MEDWAY,OH,1161,1215,54,0.5113636363636364
MEEKER,CO,1763,1625,-138,0.47963400236127507
MEEKER,OK,1598,1562,-36,0.49430379746835446
MEETEETSE,WY,211,181,-30,0.461734693877551
MEGARGEL,TX,13,0,-13,0
MEHERRIN,VA,476,481,5,0.5026123301985371
MEHOOPANY,PA,483,336,-147,0.41025641025641024
MEIGS,GA,339,446,107,0.5681528662420382
MELBA,ID,900,1045,145,0.5372750642673522
MELBER,KY,39,30,-9,0.43478260869565216
MELBOURNE,AR,1680,1435,-245,0.4606741573033708
MELBOURNE,FL,95938,103922,7984,0.5199739817872511
MELBOURNE,IA,264,148,-116,0.3592233009708738
MELBOURNE,KY,588,567,-21,0.4909090909090909
MELBOURNE BCH,FL,1279,1281,2,0.500390625
MELBOURNE BEACH,FL,6618,8835,2217,0.5717336439526306
MELCHER,IA,152,79,-73,0.341991341991342
MELCHER DALLAS,IA,300,366,66,0.5495495495495496
MELDER,LA,19,23,4,0.5476190476190477
MELFA,VA,324,620,296,0.6567796610169492
MELISSA,TX,4926,8932,4006,0.6445374512916727
MELLEN,WI,283,277,-6,0.49464285714285716
MELLETTE,SD,0,11,11,1
MELROSE,FL,2040,2470,430,0.5476718403547672
MELROSE,IA,53,27,-26,0.3375
MELROSE,MA,10715,10216,-499,0.48807988151545556
MELROSE,MN,1552,1389,-163,0.472288337300238
MELROSE,MT,11,36,25,0.7659574468085106
MELROSE,NM,34,114,80,0.7702702702702703
MELROSE,NY,296,239,-57,0.44672897196261685
MELROSE,OH,15,30,15,0.6666666666666666
MELROSE,WI,558,504,-54,0.4745762711864407
MELROSE PARK,IL,8849,7463,-1386,0.4575159391858754
MELROSE PARK,PA,356,343,-13,0.4907010014306152
MELVERN,KS,116,87,-29,0.42857142857142855
MELVILLE,LA,22,22,0,0.5
MELVILLE,NY,8726,9355,629,0.5173939494496986
MELVIN,IL,124,26,-98,0.17333333333333334
MELVIN,KY,40,48,8,0.5454545454545454
MELVIN,MI,168,160,-8,0.4878048780487805
MELVIN VILLAGE,NH,306,422,116,0.5796703296703297
MELVIN VLG,NH,0,11,11,1
MELVINDALE,MI,4182,3401,-781,0.44850323091124883
MEMPHIS,IN,1141,1252,111,0.523192645215211
MEMPHIS,MI,791,618,-173,0.43860894251242016
MEMPHIS,MO,1210,1103,-107,0.47686986597492437
MEMPHIS,NY,403,452,49,0.5286549707602339
MEMPHIS,TN,258438,233801,-24637,0.4749745550433834
MEMPHIS,TX,721,712,-9,0.49685973482205165
MENA,AR,6355,6073,-282,0.488654650788542
MENAHGA,MN,1983,1828,-155,0.47966413014956705
MENAN,ID,544,511,-33,0.4843601895734597
MENANDS,NY,2100,1893,-207,0.4740796393688956
MENARD,TX,151,283,132,0.652073732718894
MENASHA,WI,12311,10936,-1375,0.47042629156450294
MENDENHALL,MS,2270,2237,-33,0.49633902817838915
MENDHAM,NJ,2392,3637,1245,0.6032509537236689
MENDOCINO,CA,1151,1219,68,0.5143459915611814
MENDON,IL,258,295,37,0.5334538878842676
MENDON,MA,1873,1875,2,0.5002668089647813
MENDON,MI,876,871,-5,0.4985689753863766
MENDON,NY,177,242,65,0.5775656324582339
MENDON,OH,390,204,-186,0.3434343434343434
MENDON,UT,424,484,60,0.5330396475770925
MENDOTA,CA,1281,974,-307,0.4319290465631929
MENDOTA,IL,3548,2926,-622,0.45196169292554833
MENDOTA HEIGHTS,MN,1524,1610,86,0.5137204850031908
MENDOTA HTS,MN,60,60,0,0.5
MENDPTA,IL,90,48,-42,0.34782608695652173
MENIFEE,CA,30447,38951,8504,0.5612697772270094
MENLO,GA,651,756,105,0.5373134328358209
MENLO,IA,13,23,10,0.6388888888888888
MENLO PARK,CA,22026,19287,-2739,0.46685062813158085
MENNO,SD,106,27,-79,0.20300751879699247
MENOKEN,ND,11,34,23,0.7555555555555555
MENOMINEE,MI,5869,4769,-1100,0.4482985523594661
MENOMONEE FALLS,WI,12814,13309,495,0.5094744095241741
MENOMONEE FLS,WI,686,513,-173,0.4278565471226022
MENOMONIE,WI,13514,10818,-2696,0.44459970409337496
MENTASTA LAKE,AK,0,16,16,1
MENTMORE,NM,145,0,-145,0
MENTONE,AL,647,885,238,0.5776762402088773
MENTONE,CA,2714,2732,18,0.501652589056188
MENTONE,IN,815,699,-116,0.4616908850726552
MENTOR,KS,15,0,-15,0
MENTOR,MN,371,216,-155,0.3679727427597956
MENTOR,OH,15953,16702,749,0.5114683815648445
MENTOR ON THE LAKE,OH,701,710,9,0.5031892274982283
MEQUON,WI,7876,8959,1083,0.5321651321651322
MER ROUGE,LA,401,350,-51,0.46604527296937415
MERAUX,LA,1199,1407,208,0.5399079048349962
MERCED,CA,36765,36019,-746,0.4948752473071005
MERCEDES,TX,4796,5984,1188,0.5551020408163265
MERCER,ME,209,188,-21,0.473551637279597
MERCER,MO,13,25,12,0.6578947368421053
MERCER,PA,4149,4064,-85,0.4948252769998782
MERCER,TN,39,45,6,0.5357142857142857
MERCER,WI,1059,1105,46,0.5106284658040665
MERCER ISLAND,WA,12358,12591,233,0.5046695258326988
MERCERSBURG,PA,2360,2201,-159,0.48256961192720893
MERCERVILLE,NJ,165,174,9,0.5132743362831859
MERCHANTVILLE,NJ,2482,2549,67,0.5066587159610415
MEREDITH,NH,3911,4074,163,0.5102066374452098
MEREDOSIA,IL,368,389,21,0.5138705416116248
MERIDEN,CT,27660,25279,-2381,0.47751185326507867
MERIDEN,IA,22,0,-22,0
MERIDEN,KS,883,1030,147,0.538421327757449
MERIDEN,NH,40,0,-40,0
MERIDIAN,CA,34,23,-11,0.40350877192982454
MERIDIAN,ID,53583,63081,9498,0.540706644723308
MERIDIAN,MS,19204,18099,-1105,0.48518885880492185
MERIDIAN,TX,837,914,77,0.5219874357509994
MERIDIANVILLE,AL,3441,5249,1808,0.6040276179516686
MERIGOLD,MS,22,76,54,0.7755102040816326
MERINO,CO,69,95,26,0.5792682926829268
MERION STATION,PA,1248,1640,392,0.5678670360110804
MERIT,TX,13,0,-13,0
MERKEL,TX,1516,1641,125,0.5197972758948368
MERLIN,OR,1409,1546,137,0.5231810490693739
MERMENTAU,LA,0,11,11,1
MERNA,NE,0,22,22,1
MEROM,IN,11,22,11,0.6666666666666666
MERRIAM,KS,1894,1694,-200,0.4721293199554069
MERRIAM WOODS VILLAGE,MO,496,413,-83,0.45434543454345433
MERRICK,NY,6681,7014,333,0.51215772179627606
MERRIFIELD,MN,1301,1454,153,0.5277676950998185
MERRIFIELD,VA,793,1152,359,0.5922879177377892
MERRILL,IA,376,158,-218,0.2958801498127341
MERRILL,ME,24,23,-1,0.48936170212765956
MERRILL,MI,1103,922,-181,0.4553086419753086
MERRILL,OR,336,295,-41,0.4675118858954041
MERRILL,WI,6920,6888,-32,0.49884125144843566
MERRILLAN,WI,731,582,-149,0.44325971058644326
MERRILLVILLE,IN,16916,16668,-248,0.4963077656026679
MERRIMAC,MA,1896,2223,327,0.5396941005098325
MERRIMAC,WI,871,836,-35,0.4897480960749854
MERRIMACK,NH,9327,9939,612,0.5158829025225786
MERRIONETTE PARK,IL,852,782,-70,0.4785801713586291
MERRITT,MI,0,32,32,1
MERRITT,NC,102,185,83,0.6445993031358885
MERRITT IS,FL,1644,1802,158,0.5229251305861868
MERRITT ISLAND,FL,20020,20757,737,0.5090369571081738
MERRY HILL,NC,138,132,-6,0.4888888888888889
MERRYVILLE,LA,945,910,-35,0.49056603773584906
MERSHON,GA,15,11,-4,0.4230769230769231
MERTON,WI,11,0,-11,0
MERTZON,TX,78,132,54,0.6285714285714286
MERTZTOWN,PA,1139,1051,-88,0.47990867579908675
MESA,AZ,311915,342498,30583,0.5233667424088458
MESA,CO,103,171,68,0.6240875912408759
MESA,WA,147,120,-27,0.449438202247191
MESCALERO,NM,286,68,-218,0.192090395480226
MESHOPPEN,PA,1080,880,-200,0.4489795918367347
MESIC,NC,18,15,-3,0.45454545454545453
MESICK,MI,1623,1597,-26,0.49596273291925463
MESILLA,NM,347,471,124,0.5757946210268948
MESILLA PARK,NM,1237,1318,81,0.5158512720156556
MESQUITE,NM,72,133,61,0.6487804878048781
MESQUITE,NV,14637,16462,1825,0.5293417794784399
MESQUITE,TX,51159,45972,-5187,0.47329894678321033
META,KY,105,90,-15,0.46153846153846156
META,MO,0,24,24,1
METAIRIE,LA,45864,39424,-6440,0.46224556795797767
METALINE FALLS,WA,70,111,41,0.6132596685082873
METAMORA,IL,1964,2136,172,0.5209756097560976
METAMORA,IN,299,219,-80,0.42277992277992277
METAMORA,MI,2481,2667,186,0.5180652680652681
METAMORA,OH,100,70,-30,0.4117647058823529
METCALF,GA,207,217,10,0.5117924528301887
METCALFE,MS,0,12,12,1
METHOW,WA,14,0,-14,0
METHUEN,MA,16492,16678,186,0.502803738317757
METOLIUS,OR,738,547,-191,0.42568093385214006
METROPOLIS,IL,4383,3819,-564,0.4656181419166057
METTER,GA,3162,3097,-65,0.4948074772327848
METUCHEN,NJ,5327,5352,25,0.501170521584418
MEXIA,TX,3710,3431,-279,0.48046492087942866
MEXICO,ME,1411,1449,38,0.5066433566433567
MEXICO,MO,7611,7456,-155,0.49485630848875023
MEXICO,NY,2896,2555,-341,0.46872133553476425
MEXICO BEACH,FL,581,489,-92,0.4570093457943925
MEYERSDALE,PA,1555,1427,-128,0.4785378940308518
MI WUK VILLAGE,CA,428,272,-156,0.38857142857142857
MI WUK VLG,CA,19,0,-19,0
MIAMI,AZ,1174,1233,59,0.5122559202326548
MIAMI,FL,603350,562335,-41015,0.4824073398902791
MIAMI,OK,8319,6889,-1430,0.45298527091004737
MIAMI,TX,40,56,16,0.5833333333333334
MIAMI BEACH,FL,67501,59952,-7549,0.4703851615889779
MIAMI GARDENS,FL,32735,30636,-2099,0.48343879692603875
MIAMI LAKES,FL,15954,14507,-1447,0.47624831752076424
MIAMI SHORES,FL,5752,5371,-381,0.4828733255416704
MIAMI SPRINGS,FL,4028,4086,58,0.5035740695094898
MIAMISBURG,OH,18663,16736,-1927,0.4727817169976553
MIAMITOWN,OH,12,0,-12,0
MIAMIVILLE,OH,11,13,2,0.5416666666666666
MICANOPY,FL,1330,1455,125,0.5224416517055656
MICAVILLE,NC,11,0,-11,0
MICCO,FL,240,576,336,0.7058823529411765
MICHIE,TN,801,860,59,0.5177603853100542
MICHIGAMME,MI,329,291,-38,0.4693548387096774
MICHIGAN CENTER,MI,1437,1327,-110,0.4801013024602026
MICHIGAN CITY,IN,22930,18783,-4147,0.4502912761009757
MICHIGAN CITY,MS,11,0,-11,0
MICHIGANTOWN,IN,248,117,-131,0.32054794520547947
MICKLETON,NJ,828,985,157,0.5432984004412575
MICO,TX,301,751,450,0.7138783269961977
MICRO,NC,124,79,-45,0.3891625615763547
MID CITY EAST,PA,394,206,-188,0.3433333333333333
MIDDLE BROOK,MO,13,15,2,0.5357142857142857
MIDDLE CITY EAST,PA,162,130,-32,0.4452054794520548
MIDDLE CITY WEST,PA,1304,990,-314,0.4315605928509154
MIDDLE GRANVILLE,NY,51,14,-37,0.2153846153846154
MIDDLE GROVE,NY,943,954,11,0.5028993147074328
MIDDLE HADDAM,CT,0,37,37,1
MIDDLE ISLAND,NY,5745,4831,-914,0.4567889561270802
MIDDLE POINT,OH,178,92,-86,0.34074074074074073
MIDDLE RIVER,MD,15960,15437,-523,0.4916711787750422
MIDDLE RIVER,MN,0,35,35,1
MIDDLE VILLAGE,NY,7832,6841,-991,0.4662304913787228
MIDDLE VLG,NY,151,140,-11,0.48109965635738833
MIDDLEBORO,MA,8393,8353,-40,0.4988056849396871
MIDDLEBOURNE,WV,644,506,-138,0.44
MIDDLEBROOK,VA,24,23,-1,0.48936170212765956
MIDDLEBRY CTR,PA,0,11,11,1
MIDDLEBURG,FL,22220,24051,1831,0.5197856108577726
MIDDLEBURG,KY,0,11,11,1
MIDDLEBURG,MD,0,11,11,1
MIDDLEBURG,PA,2429,2251,-178,0.480982905982906
MIDDLEBURG,VA,2055,1384,-671,0.4024425705146845
MIDDLEBURG HEIGHTS,OH,459,390,-69,0.45936395759717313
MIDDLEBURGH,NY,1525,1435,-90,0.4847972972972973
MIDDLEBURY,CT,2339,2783,444,0.5433424443576728
MIDDLEBURY,IN,3559,3531,-28,0.49802538787023976
MIDDLEBURY,VT,3785,3659,-126,0.4915368081676518
MIDDLEBURY CENTER,PA,212,137,-75,0.39255014326647564
MIDDLEFIELD,CT,879,828,-51,0.4850615114235501
MIDDLEFIELD,OH,2904,2630,-274,0.4752439465124684
MIDDLEPORT,NY,1205,1195,-10,0.4979166666666667
MIDDLEPORT,OH,1679,1348,-331,0.4453254046911133
MIDDLEPORT,PA,22,0,-22,0
MIDDLESBORO,KY,4860,4374,-486,0.47368421052631576
MIDDLESEX,NC,2009,2239,230,0.5270715630885122
MIDDLESEX,NJ,3878,3841,-37,0.49760331649177353
MIDDLESEX,NY,528,392,-136,0.4260869565217391
MIDDLESEX,VT,86,82,-4,0.4880952380952381
MIDDLETON,ID,5655,6577,922,0.5376880313930673
MIDDLETON,MA,2435,2680,245,0.5239491691104594
MIDDLETON,MI,117,28,-89,0.19310344827586207
MIDDLETON,NH,574,590,16,0.506872852233677
MIDDLETON,TN,1556,1097,-459,0.4134941575574821
MIDDLETON,WI,16759,16288,-471,0.4928737858201955
MIDDLETOWN,CA,1583,1250,-333,0.44122837980938934
MIDDLETOWN,CT,22679,19927,-2752,0.46770407923766605
MIDDLETOWN,DE,12498,17306,4808,0.5806603140518052
MIDDLETOWN,IA,104,37,-67,0.2624113475177305
MIDDLETOWN,IL,54,13,-41,0.19402985074626866
MIDDLETOWN,IN,2110,1842,-268,0.4660931174089069
MIDDLETOWN,KY,306,369,63,0.5466666666666666
MIDDLETOWN,MD,3105,3456,351,0.5267489711934157
MIDDLETOWN,MO,116,142,26,0.5503875968992248
MIDDLETOWN,NJ,5538,6141,603,0.525815566401233
MIDDLETOWN,NY,23095,21732,-1363,0.48479710888527006
MIDDLETOWN,OH,27049,27007,-42,0.4996115139854965
MIDDLETOWN,PA,9436,8823,-613,0.48321375759899227
MIDDLETOWN,RI,8510,8100,-410,0.4876580373269115
MIDDLETOWN,VA,1248,1578,330,0.5583864118895966
MIDDLETOWN SPRINGS,VT,143,188,45,0.56797583081571
MIDDLEVILLE,MI,4330,4507,177,0.5100147108747313
MIDDLEVILLE,NY,12,11,-1,0.4782608695652174
MIDFIELD,AL,592,566,-26,0.48877374784110533
MIDLAND,AR,12,0,-12,0
MIDLAND,GA,3697,4568,871,0.552692075015124
MIDLAND,MI,30010,27300,-2710,0.47635665677892164
MIDLAND,NC,2264,3238,974,0.58851326790258085
MIDLAND,OH,105,171,66,0.6195652173913043
MIDLAND,OR,0,13,13,1
MIDLAND,PA,1406,1186,-220,0.4575617283950617
MIDLAND,TX,74339,62362,-11977,0.4561927125624538
MIDLAND,VA,786,924,138,0.5403508771929825
MIDLAND CITY,AL,3680,3182,-498,0.4637132031477703
MIDLAND PARK,NJ,1959,1852,-107,0.485961689845185
MIDLOTHIAN,IL,4544,4016,-528,0.4691588785046729
MIDLOTHIAN,TX,13060,17546,4486,0.5732862837352153
MIDLOTHIAN,VA,35805,40674,4869,0.5318322676813243
MIDPINES,CA,55,88,33,0.6153846153846154
MIDVALE,ID,24,38,14,0.6129032258064516
MIDVALE,OH,55,0,-55,0
MIDVALE,UT,25386,21104,-4282,0.4539470853947085
MIDVILLE,GA,122,371,249,0.7525354969574036
MIDWAY,AL,28,46,18,0.6216216216216216
MIDWAY,AR,521,566,45,0.5206991720331187
MIDWAY,FL,1166,1229,63,0.5131524008350731
MIDWAY,GA,4330,4784,454,0.5249067368883037
MIDWAY,KY,1005,954,-51,0.4869831546707504
MIDWAY,PA,55,0,-55,0
MIDWAY,TN,636,660,24,0.5092592592592593
MIDWAY,TX,389,422,33,0.5203452527743526
MIDWAY,UT,3122,3336,214,0.516568597088882
MIDWAY,WV,0,12,12,1
MIDWAY CITY,CA,2763,2504,-259,0.4754129485475603
MIDWAY PARK,NC,4529,2979,-1550,0.3967767714437933
MIDWEST CITY,OK,8794,7261,-1533,0.45225786359389597
MIFFLIN,PA,706,603,-103,0.46065699006875477
MIFFLINBURG,PA,2914,2833,-81,0.4929528449625892
MIFFLINTOWN,PA,2350,2124,-226,0.4747429593205186
MIFFLINVILLE,PA,147,50,-97,0.25380710659898476
MIKADO,MI,283,226,-57,0.444007858546169
MIKANA,WI,101,64,-37,0.3878787878787879
MILACA,MN,3617,3771,154,0.5104223064428803
MILAM,TX,71,135,64,0.6553398058252428
MILAN,GA,172,206,34,0.544973544973545
MILAN,IL,4516,3750,-766,0.4536656181950157
MILAN,IN,1552,1660,108,0.5168119551681195
MILAN,MI,4030,3768,-262,0.48320082072326237
MILAN,MN,13,0,-13,0
MILAN,MO,1442,1397,-45,0.49207467418104966
MILAN,NH,414,438,24,0.5140845070422535
MILAN,NM,235,236,1,0.5010615711252654
MILAN,OH,1356,1045,-311,0.4352353186172428
MILAN,PA,98,177,79,0.6436363636363637
MILAN,TN,4594,4870,276,0.51458157227388
MILANO,TX,272,318,46,0.5389830508474577
MILANVILLE,PA,54,70,16,0.5645161290322581
MILBANK,SD,2380,1906,-474,0.4447036864209053
MILBRIDGE,ME,550,641,91,0.5382031905961377
MILBURN,OK,141,222,81,0.6115702479338843
MILDRED,PA,11,0,-11,0
MILES,IA,63,18,-45,0.2222222222222222
MILES,TX,114,251,137,0.6876712328767123
MILES CITY,MT,5249,5073,-176,0.49147452044177486
MILESBURG,PA,185,102,-83,0.3554006968641115
MILFAY,OK,0,16,16,1
MILFORD,CT,19034,19822,788,0.5101400041177682
MILFORD,DE,7448,8500,1052,0.5329821921244043
MILFORD,IA,2194,2231,37,0.504180790960452
MILFORD,IL,953,745,-208,0.4387514723203769
MILFORD,IN,1378,1345,-33,0.4939405067939772
MILFORD,KS,716,598,-118,0.4550989345509893
MILFORD,MA,11099,9474,-1625,0.46050648908763914
MILFORD,ME,1168,1111,-57,0.4874945151382185
MILFORD,MI,7795,7408,-387,0.4872722488982438
MILFORD,NE,1183,1093,-90,0.4802284710017575
MILFORD,NH,6542,6290,-252,0.49018079800498754
MILFORD,NJ,2035,2138,103,0.5123412413132039
MILFORD,NY,544,341,-203,0.38531073446327685
MILFORD,OH,11000,11265,265,0.5059510442398383
MILFORD,PA,5508,5606,98,0.5044088536980386
MILFORD,TX,472,299,-173,0.38780804150453957
MILFORD,UT,304,165,-139,0.35181236673773986
MILFORD,VA,402,646,244,0.6164122137404581
MILFORD CENTER,OH,299,302,3,0.502495840266223
MILFORD CTR,OH,25,19,-6,0.4318181818181818
MILILANI,HI,21376,14308,-7068,0.4009640174868288
MILL CITY,OR,961,997,36,0.5091930541368743
MILL CREEK,IN,11,37,26,0.7708333333333334
MILL CREEK,OK,11,14,3,0.56
MILL CREEK,PA,73,62,-11,0.45925925925925926
MILL CREEK,WA,16739,17059,320,0.5047340079294633
MILL CREEK,WV,602,135,-467,0.18317503392130258
MILL HALL,PA,2144,2093,-51,0.4939815907481709
MILL NECK,NY,52,83,31,0.6148148148148148
MILL RIVER,MA,16,22,6,0.5789473684210527
MILL RUN,PA,101,47,-54,0.31756756756756754
MILL SHOALS,IL,11,0,-11,0
MILL SPRING,NC,1353,1773,420,0.5671785028790787
MILL VALLEY,CA,12681,13078,397,0.5077060444893047
MILL VILLAGE,PA,0,24,24,1
MILLADORE,WI,66,50,-16,0.43103448275862066
MILLARD,NE,13,0,-13,0
MILLBORO,VA,231,247,16,0.5167364016736402
MILLBRAE,CA,8125,7492,-633,0.47973362361529104
MILLBROOK,AL,6913,5877,-1036,0.4594996090695856
MILLBROOK,NY,1680,1864,184,0.5259593679458239
MILLBURN,NJ,2719,2663,-56,0.4947974730583426
MILLBURY,MA,4624,4816,192,0.5101694915254237
MILLBURY,OH,1005,986,-19,0.49522852837769965
MILLCREEK,UT,1815,1662,-153,0.47799827437446074
MILLDALE,CT,60,52,-8,0.4642857142857143
MILLEDGEVILLE,GA,12489,11534,-955,0.4801232152520501
MILLEDGEVILLE,IL,369,319,-50,0.4636627906976744
MILLEN,GA,1817,1826,9,0.5012352456766401
MILLER,MI,29,25,-4,0.46296296296296297
MILLER,MO,854,716,-138,0.45605095541401275
MILLER,SD,805,684,-121,0.45936870382807254
MILLER PLACE,NY,3313,3362,49,0.5036704119850187
MILLERS COVE,TX,11,0,-11,0
MILLERS CREEK,NC,1558,1533,-25,0.4959560012940796
MILLERS FALLS,MA,48,77,29,0.616
MILLERSBURG,IN,687,504,-183,0.42317380352644834
MILLERSBURG,KY,41,72,31,0.6371681415929203
MILLERSBURG,MI,852,789,-63,0.48080438756855576
MILLERSBURG,OH,4209,3726,-483,0.46956521739130436
MILLERSBURG,PA,2539,2425,-114,0.48851732473811443
MILLERSPORT,OH,1369,1353,-16,0.497060984570169
MILLERSTOWN,PA,958,932,-26,0.49312169312169313
MILLERSVILLE,MD,5324,6288,964,0.5415087840165346
MILLERSVILLE,MO,60,90,30,0.6
MILLERSVILLE,PA,3972,3331,-641,0.4561139257839244
MILLERTON,NY,1048,1263,215,0.5465166594547815
MILLERTON,PA,602,626,24,0.509771986970684
MILLFIELD,OH,265,295,30,0.5267857142857143
MILLHEIM,PA,235,59,-176,0.20068027210884354
MILLICAN,TX,24,17,-7,0.4146341463414634
MILLIGAN,NE,11,0,-11,0
MILLIGAN,TN,12,0,-12,0
MILLIGAN COLLEGE,TN,90,0,-90,0
MILLIKEN,CO,3096,3714,618,0.5453744493392071
MILLINGTON,IL,41,0,-41,0
MILLINGTON,MD,518,544,26,0.512241054613936
MILLINGTON,MI,2524,2361,-163,0.4833162743091095
MILLINGTON,NJ,580,758,178,0.5665171898355755
MILLINGTON,TN,8825,9177,352,0.5097766914787246
MILLINOCKET,ME,2442,2321,-121,0.48729792147806006
MILLIS,MA,2463,2991,528,0.5484048404840484
MILLMONT,PA,528,486,-42,0.47928994082840237
MILLPORT,AL,583,685,102,0.5402208201892744
MILLPORT,NY,385,236,-149,0.38003220611916266
MILLRY,AL,439,471,32,0.5175824175824176
MILLS,WY,6795,7037,242,0.5087478311162522
MILLS RIVER,NC,2318,2717,399,0.539622641509434
MILLSAP,TX,1251,1835,584,0.5946208684381076
MILLSBORO,DE,13028,15647,2619,0.5456669572798605
MILLSTADT,IL,1703,1787,84,0.5120343839541547
MILLSTONE,WV,11,0,-11,0
MILLSTONE TOWNSHIP,NJ,1650,2184,534,0.5696400625978091
MILLSTONE TWP,NJ,166,262,96,0.6121495327102804
MILLTOWN,IN,509,666,157,0.5668085106382978
MILLTOWN,MT,37,25,-12,0.4032258064516129
MILLTOWN,NJ,1969,1998,29,0.5036551550289892
MILLTOWN,WI,894,741,-153,0.45321100917431195
MILLVALE,PA,317,210,-107,0.3984819734345351
MILLVILLE,CA,164,204,40,0.5543478260869565
MILLVILLE,DE,682,1369,687,0.6674792784007801
MILLVILLE,MA,866,816,-50,0.48513674197384066
MILLVILLE,MN,49,42,-7,0.46153846153846156
MILLVILLE,NJ,12895,12234,-661,0.4868478650165148
MILLVILLE,PA,1019,989,-30,0.49252988047808766
MILLVILLE,UT,718,273,-445,0.27547931382441976
MILLWOOD,GA,0,11,11,1
MILLWOOD,KY,11,12,1,0.5217391304347826
MILLWOOD,NY,262,246,-16,0.484251968503937
MILLWOOD,VA,12,13,1,0.52
MILLWOOD,WA,816,836,20,0.5060532687651331
MILLWOOD,WV,124,76,-48,0.38
MILMAY,NJ,0,13,13,1
MILMONT PARK,PA,207,154,-53,0.4265927977839335
MILNER,GA,1569,1901,332,0.5478386167146974
MILNOR,ND,275,156,-119,0.3619489559164733
MILO,IA,256,209,-47,0.44946236559139785
MILO,ME,1289,1340,51,0.5096995055154051
MILO,MO,25,82,57,0.7663551401869159
MILPITAS,CA,35138,33734,-1404,0.4898071785340922
MILROY,IN,474,256,-218,0.3506849315068493
MILROY,MN,30,0,-30,0
MILROY,PA,965,831,-134,0.4626948775055679
MILTON,DE,4697,6794,2097,0.5912453224262466
MILTON,FL,31421,36503,5082,0.5374094576291149
MILTON,GA,3173,3282,109,0.5084430673896204
MILTON,IA,25,25,0,0.5
MILTON,IL,0,11,11,1
MILTON,IN,132,98,-34,0.4260869565217391
MILTON,KS,0,23,23,1
MILTON,KY,1355,1311,-44,0.49174793698424607
MILTON,LA,37,0,-37,0
MILTON,MA,6328,6663,335,0.5128935416827034
MILTON,NC,40,76,36,0.6551724137931034
MILTON,NH,1632,1791,159,0.523225241016652
MILTON,NY,871,890,19,0.5053946621237932
MILTON,PA,5001,4069,-932,0.4486218302094818
MILTON,TN,124,288,164,0.6990291262135923
MILTON,VT,5352,4964,-388,0.48119426134160526
MILTON,WA,5738,5262,-476,0.4783636363636364
MILTON,WI,4040,4054,14,0.5008648381517173
MILTON,WV,2716,2660,-56,0.4947916666666667
MILTON FREEWATER,OR,4810,3226,-1584,0.4014435042309607
MILTON MILLS,NH,25,71,46,0.7395833333333334
MILTON TWP,ME,42,55,13,0.5670103092783505
MILTONA,MN,485,440,-45,0.4756756756756757
MILTONVALE,KS,82,26,-56,0.24074074074074073
MILWAUKEE,WI,386744,328301,-58443,0.4591333412582425
MILWAUKIE,OR,9430,8490,-940,0.47377232142857145
MIMBRES,NM,243,393,150,0.6179245283018868
MIMS,FL,5937,7173,1236,0.5471395881006865
MINA,SD,287,286,-1,0.49912739965095987
MINATARE,NE,584,446,-138,0.4330097087378641
MINBURN,IA,48,47,-1,0.49473684210526314
MINCO,OK,626,719,93,0.5345724907063197
MINDEN,IA,149,128,-21,0.4620938628158845
MINDEN,LA,7270,6503,-767,0.4721556668844841
MINDEN,NE,1462,1283,-179,0.4673952641165756
MINDEN,NV,4504,5010,506,0.5265923901618668
MINDEN CITY,MI,11,0,-11,0
MINDENMINES,MO,13,14,1,0.5185185185185185
MINDORO,WI,239,222,-17,0.48156182212581344
MINE HILL,NJ,932,972,40,0.5105042016806722
MINEOLA,NY,7667,6718,-949,0.4670142509558568
MINEOLA,TX,5007,5484,477,0.5227337718044037
MINERAL,IL,13,12,-1,0.48
MINERAL,VA,3311,4084,773,0.552265043948614
MINERAL,WA,58,60,2,0.5084745762711864
MINERAL BLUFF,GA,1518,1957,439,0.5631654676258993
MINERAL CITY,OH,859,759,-100,0.46909765142150806
MINERAL POINT,MO,1010,1089,79,0.5188184849928538
MINERAL POINT,PA,92,101,9,0.5233160621761658
MINERAL POINT,WI,1592,1623,31,0.5048211508553655
MINERAL RIDGE,OH,1213,1224,11,0.50225687320476
MINERAL SPGS,AR,0,14,14,1
MINERAL SPRINGS,AR,534,407,-127,0.43251859723698194
MINERAL SPRINGS,NC,27,17,-10,0.38636363636363635
MINERAL WELLS,TX,9460,9338,-122,0.4967549739333972
MINERAL WELLS,WV,1781,1848,67,0.5092311931661615
MINERS MILL,PA,162,173,11,0.5164179104477612
MINERSVILLE,PA,2347,2379,32,0.5033855268726195
MINERSVILLE,UT,11,0,-11,0
MINERVA,NY,47,30,-17,0.38961038961038963
MINERVA,OH,3619,3226,-393,0.4712929145361578
MINETTO,NY,15,0,-15,0
MINEVILLE,NY,118,147,29,0.5547169811320755
MINFORD,OH,1236,1080,-156,0.46632124352331605
MINGO,IA,49,37,-12,0.43023255813953487
MINGO JCT,OH,26,22,-4,0.4583333333333333
MINGO JUNCTION,OH,1913,1511,-402,0.4412967289719626
MINIER,IL,540,383,-157,0.41495124593716143
MINNEAPOLIS,KS,1102,972,-130,0.4686595949855352
MINNEAPOLIS,MN,519738,430136,-89602,0.45283479703623847
MINNEISKA,MN,38,0,-38,0
MINNEOLA,FL,5331,8330,2999,0.6097650245223629
MINNEOLA,KS,281,128,-153,0.31295843520782396
MINNEOTA,MN,651,327,-324,0.3343558282208589
MINNESOTA,MN,43,35,-8,0.44871794871794873
MINNESOTA CITY,MN,299,415,116,0.5812324929971989
MINNESOTA LAKE,MN,142,150,8,0.5136986301369864
MINNESOTT BEACH,NC,40,99,59,0.7122302158273381
MINNETONKA,MN,14970,13996,-974,0.4831871849754885
MINNETRISTA,MN,580,915,335,0.6120401337792643
MINNIE,KY,0,25,25,1
MINOA,NY,1176,1022,-154,0.46496815286624205
MINOCQUA,WI,4372,4158,-214,0.48745603751465416
MINONG,WI,1289,1220,-69,0.48624950179354326
MINONK,IL,1090,839,-251,0.43494038361845516
MINOOKA,IL,4606,4395,-211,0.4882790801022109
MINOR HILL,TN,154,155,1,0.5016181229773463
MINOT,ME,686,832,146,0.5480895915678524
MINOT,ND,35625,26564,-9061,0.4271494958915564
MINOT AFB,ND,2903,2139,-764,0.4242364141213804
MINOTOLA,NJ,642,559,-83,0.46544546211490423
MINSTER,OH,1199,1114,-85,0.4816255944660614
MINT HILL,NC,11475,11434,-41,0.49910515517918724
MINTER,AL,0,12,12,1
MINTO,ND,186,65,-121,0.2589641434262948
MINTURN,CO,662,239,-423,0.26526082130965595
MIO,MI,2777,2093,-684,0.4297741273100616
MIRA LOMA,CA,1228,1153,-75,0.48425031499370014
MIRADA,CA,440,410,-30,0.4823529411764706
MIRAMAR,FL,53149,50553,-2596,0.4874833657981524
MIRAMAR BEACH,FL,7622,10026,2404,0.5681097008159565
MIRAMONTE,CA,22,24,2,0.5217391304347826
MIRANDA,CA,0,47,47,1
MIROMAR LAKES,FL,332,1291,959,0.7954405422057917
MIRROR LAKE,NH,669,536,-133,0.44481327800829873
MISHAWAKA,IN,34054,26440,-7614,0.43706813898899066
MISHICOT,WI,755,741,-14,0.49532085561497324
MISSION,KS,9151,8117,-1034,0.47006022700949734
MISSION,SD,1547,730,-817,0.32059727711901626
MISSION,TX,30178,37069,6891,0.5512364863860097
MISSION HILL,MA,1853,1137,-716,0.3802675585284281
MISSION HILL,SD,41,42,1,0.5060240963855421
MISSION HILLS,CA,4086,3921,-165,0.4896965155488947
MISSION HILLS,KS,601,654,53,0.5211155378486055
MISSION VIEJO,CA,31471,32842,1371,0.5106588092609581
MISSISSIPPI STATE,MS,3916,199,-3717,0.04835965978128797
MISSOULA,MT,59009,53357,-5652,0.47485004360749694
MISSOURI CITY,TX,29637,37674,8037,0.5597004947185452
MISSOURI VALLEY,IA,2206,1983,-223,0.4733826688947243
MITCHELL,GA,57,49,-8,0.46226415094339623
MITCHELL,IN,4170,3794,-376,0.4763937719738825
MITCHELL,NE,1182,1144,-38,0.49183147033533964
MITCHELL,OR,23,0,-23,0
MITCHELL,SD,11431,8405,-3026,0.42372454123815284
MITCHELLVILLE,IA,899,899,0,0.5
MITCHELLVILLE,MD,1935,2180,245,0.5297691373025516
MITCHELLVILLE,TN,40,54,14,0.574468085106383
MIZE,MS,323,399,76,0.5526315789473685
MOAB,UT,6360,5485,-875,0.463064584212748
MOAPA,NV,11,36,25,0.7659574468085106
MOATSVILLE,WV,88,23,-65,0.2072072072072072
MOBERLY,MO,8964,8049,-915,0.47310879915358844
MOBILE,AL,98642,91873,-6769,0.4822349946198462
MOBRIDGE,SD,1682,1315,-367,0.4387721054387721
MOCANAQUA,PA,193,242,49,0.5563218390804597
MOCKSVILLE,NC,7412,8110,698,0.5224842159515526
MOCLIPS,WA,0,13,13,1
MODALE,IA,11,0,-11,0
MODENA,NY,372,314,-58,0.4577259475218659
MODENA,PA,40,0,-40,0
MODESTO,CA,86910,77371,-9539,0.47096742776097056
MODESTO,IL,13,11,-2,0.4583333333333333
MODOC,IN,83,33,-50,0.28448275862068967
MOFFAT,CO,252,262,10,0.5097276264591439
MOGADORE,OH,3569,3346,-223,0.4838756326825741
MOHALL,ND,91,50,-41,0.3546099290780142
MOHAVE VALLEY,AZ,3349,4007,658,0.5447253942359979
MOHAWK,MI,681,761,80,0.5277392510402219
MOHAWK,NY,1776,1548,-228,0.4657039711191336
MOHAWK,TN,424,433,9,0.5052508751458576
MOHEGAN LAKE,NY,2111,2254,143,0.5163802978235968
MOHNTON,PA,3025,3261,236,0.518771874005727
MOHRSVILLE,PA,926,998,72,0.5187110187110187
MOIESE,MT,36,13,-23,0.2653061224489796
MOIRA,NY,760,765,5,0.5016393442622951
MOJAVE,CA,2180,1888,-292,0.464110127826942
MOKANE,MO,81,75,-6,0.4807692307692308
MOKELUMNE HILL,CA,602,747,145,0.5537435137138621
MOKELUMNE HL,CA,16,11,-5,0.4074074074074074
MOKENA,IL,6378,6554,176,0.5068048252397155
MOLALLA,OR,6584,6188,-396,0.4844973379267147
MOLENA,GA,530,740,210,0.5826771653543307
MOLINE,IL,21888,18302,-3586,0.4553869121672058
MOLINE,KS,24,24,0,0.5
MOLINO,FL,1271,1553,282,0.5499291784702549
MOLT,MT,12,25,13,0.6756756756756757
MOLUNKUS TWP,ME,0,14,14,1
MOMENCE,IL,2179,1847,-332,0.45876800794833583
MONA,UT,281,373,92,0.5703363914373089
MONACA,PA,4749,4460,-289,0.4843088283201216
MONAHANS,TX,5373,3292,-2081,0.3799192152336988
MONANGO,ND,17,15,-2,0.46875
MONARCH,MT,0,13,13,1
MONCKS CORNER,SC,14328,16225,1897,0.5310444146237685
MONCLOVA,OH,964,1210,246,0.5565777368905244
MONCURE,NC,453,691,238,0.6040209790209791
MONDAMIN,IA,103,120,17,0.5381165919282511
MONDOVI,WI,2652,2407,-245,0.4757857284048231
MONEE,IL,2801,3068,267,0.5227466348611348
MONESSEN,PA,2966,2597,-369,0.4668344418479238
MONETA,VA,4750,5077,327,0.5166378345374987
MONETT,MO,5514,4958,-556,0.4734530175706646
MONETTA,SC,38,85,47,0.6910569105691057
MONETTE,AR,603,593,-10,0.49581939799331104
MONGAUP VALLEY,NY,50,0,-50,0
MONHEGAN,ME,0,37,37,1
MONKEY ISLAND,OK,67,75,8,0.528169014084507
MONKTON,MD,1243,1311,68,0.5133124510571653
MONMOUTH,IA,0,11,11,1
MONMOUTH,IL,4472,3850,-622,0.4626291756789233
MONMOUTH,ME,1233,1280,47,0.5093513728611222
MONMOUTH,OR,7663,5640,-2023,0.4239645192813651
MONMOUTH BCH,NJ,185,317,132,0.6314741035856574
MONMOUTH BEACH,NJ,1734,1558,-176,0.4732685297691373
MONMOUTH JCT,NJ,635,598,-37,0.48499594484995945
MONMOUTH JUNCTION,NJ,5715,5596,-119,0.49473963398461673
MONON,IN,953,739,-214,0.4367612293144208
MONONA,IA,991,839,-152,0.45846994535519126
MONONA,WI,4958,4359,-599,0.4678544595899968
MONONGAH,WV,0,23,23,1
MONONGAHELA,PA,3103,2995,-108,0.4911446375860938
MONPONSETT,MA,198,11,-187,0.05263157894736842
MONROE,CT,4354,4760,406,0.522273425499232
MONROE,GA,14136,17016,2880,0.5462249614791987
MONROE,IA,1142,1000,-142,0.4668534080298786
MONROE,IN,480,228,-252,0.3220338983050847
MONROE,LA,34205,31969,-2236,0.48310514703660046
MONROE,ME,161,109,-52,0.40370370370370373
MONROE,MI,22529,20460,-2069,0.475935704482542
MONROE,NC,22804,25073,2269,0.5236961380203438
MONROE,NE,36,11,-25,0.23404255319148937
MONROE,NH,92,117,25,0.5598086124401914
MONROE,NJ,220,474,254,0.6829971181556196
MONROE,NY,9067,8134,-933,0.47287948375094474
MONROE,OH,3722,3971,249,0.5161835434810867
MONROE,OR,1006,1176,170,0.538955087076077
MONROE,TN,360,556,196,0.6069868995633187
MONROE,UT,925,1086,161,0.5400298359025361
MONROE,VA,1034,1227,193,0.5426802299867315
MONROE,WA,9767,10833,1066,0.5258737864077669
MONROE,WI,6609,5413,-1196,0.4502578605889203
MONROE CENTER,IL,116,76,-40,0.3958333333333333
MONROE CITY,IN,299,152,-147,0.3370288248337029
MONROE CITY,MO,1819,1626,-193,0.47198838896952106
MONROE TOWNSHIP,NJ,10236,11867,1631,0.5368954440573678
MONROE TOWNSHIP,PA,59,23,-36,0.2804878048780488
MONROE TWP,NJ,1139,1730,591,0.6029975601254792
MONROETON,PA,459,464,5,0.5027085590465872
MONROEVILLE,AL,2538,2440,-98,0.49015668943350743
MONROEVILLE,IN,909,887,-22,0.4938752783964365
MONROEVILLE,NJ,949,1020,71,0.5180294565769427
MONROEVILLE,OH,1055,904,-151,0.4614599285349668
MONROEVILLE,PA,11560,11015,-545,0.48792912513842746
MONROVIA,CA,15095,13277,-1818,0.46796137036514873
MONROVIA,IN,1158,1405,247,0.5481857198595396
MONROVIA,MD,1484,2843,1359,0.6570372082274093
MONSEY,NY,3471,2645,-826,0.43247220405493786
MONSON,MA,2331,2430,99,0.5103969754253308
MONSON,ME,98,204,106,0.6754966887417219
MONT ALTO,PA,595,485,-110,0.44907407407407407
MONT BELVIEU,TX,1296,727,-569,0.35936727632229365
MONT CLARE,PA,402,160,-242,0.2846975088967972
MONT VERNON,NH,579,741,162,0.5613636363636364
MONTAGUE,CA,1659,1580,-79,0.4878048780487805
MONTAGUE,MA,861,783,-78,0.4762773722627737
MONTAGUE,MI,3116,2660,-456,0.4605263157894737
MONTAGUE,NJ,1207,1273,66,0.5133064516129032
MONTAGUE,TX,37,60,23,0.6185567010309279
MONTALBA,TX,93,130,37,0.5829596412556054
MONTANA CITY,MT,81,89,8,0.5235294117647059
MONTANDON,PA,301,68,-233,0.1842818428184282
MONTARA,CA,514,669,155,0.5655114116652579
MONTAUK,NY,2868,2985,117,0.5099948744233727
MONTCHANIN,DE,0,61,61,1
MONTCLAIR,CA,9908,8856,-1052,0.4719675975271797
MONTCLAIR,NJ,13932,13259,-673,0.4876245816630503
MONTCLAIR,VA,617,627,10,0.5040192926045016
MONTE RIO,CA,645,431,-214,0.40055762081784385
MONTE SERENO,CA,1205,1163,-42,0.49113175675675674
MONTE VISTA,CO,2648,2588,-60,0.494270435446906
MONTEAGLE,TN,781,1017,236,0.5656284760845384
MONTEBELLO,CA,14822,12769,-2053,0.462795839222935
MONTECITO,CA,988,1092,104,0.525
MONTEGUT,LA,861,670,-191,0.43762246897452645
MONTELLO,WI,2461,2556,95,0.5094678094478772
MONTEREY,CA,19323,17190,-2133,0.4707912250431353
MONTEREY,IN,299,292,-7,0.494077834179357
MONTEREY,LA,480,292,-188,0.37823834196891193
MONTEREY,MA,389,485,96,0.5549199084668193
MONTEREY,TN,2859,3306,447,0.5362530413625304
MONTEREY,VA,206,305,99,0.5968688845401174
MONTEREY PARK,CA,18566,16212,-2354,0.4661567657714647
MONTESANO,WA,3005,3096,91,0.5074577938042943
MONTEVALLO,AL,4116,4469,353,0.5205591147350029
MONTEVIDEO,MN,3317,2855,-462,0.46257290991574856
MONTEVIEW,ID,23,11,-12,0.3235294117647059
MONTEZUMA,GA,1335,1189,-146,0.47107765451664024
MONTEZUMA,IA,1736,1444,-292,0.4540880503144654
MONTEZUMA,IN,523,387,-136,0.42527472527472526
MONTEZUMA,KS,120,46,-74,0.27710843373493976
MONTEZUMA,NC,0,38,38,1
MONTEZUMA,OH,16,12,-4,0.42857142857142855
MONTEZUMA CREEK,UT,22,12,-10,0.35294117647058826
MONTFORT,WI,175,98,-77,0.358974358974359
MONTGGOMERY,AL,549,475,-74,0.4638671875
MONTGOMERY,AL,91834,81105,-10729,0.46898039193010255
MONTGOMERY,IL,9869,8629,-1240,0.46648286301221753
MONTGOMERY,IN,644,596,-48,0.4806451612903226
MONTGOMERY,LA,689,590,-99,0.4612978889757623
MONTGOMERY,MA,302,346,44,0.5339506172839507
MONTGOMERY,MI,384,291,-93,0.4311111111111111
MONTGOMERY,MN,1880,1839,-41,0.4944877655283678
MONTGOMERY,NY,3043,3133,90,0.5072862694300518
MONTGOMERY,OH,2510,2648,138,0.5133772780147344
MONTGOMERY,PA,1593,1589,-4,0.49937146448774355
MONTGOMERY,TX,23810,29350,5540,0.5521068472535741
MONTGOMERY,VT,13,0,-13,0
MONTGOMERY,WV,502,481,-21,0.4893184130213632
MONTGOMERY CENTER,VT,238,146,-92,0.3802083333333333
MONTGOMERY CITY,MO,2159,1855,-304,0.46213253612356753
MONTGOMERY CREEK,CA,11,13,2,0.5416666666666666
MONTGOMERY VILLAGE,MD,13310,12106,-1204,0.4763141328297136
MONTGOMERYVILLE,PA,392,120,-272,0.234375
MONTGOMRY CTR,VT,13,15,2,0.5357142857142857
MONTGOMRY VLG,MD,365,325,-40,0.47101449275362317
MONTICELLO,AR,6406,5214,-1192,0.4487091222030981
MONTICELLO,FL,2866,3656,790,0.5605642440969028
MONTICELLO,GA,2731,3458,727,0.5587332363871385
MONTICELLO,IA,2913,2374,-539,0.4490259126158502
MONTICELLO,IL,2663,2681,18,0.5016841317365269
MONTICELLO,IN,7771,7563,-208,0.49321768618755707
MONTICELLO,KY,7294,6980,-314,0.48900098080425947
MONTICELLO,ME,46,81,35,0.6377952755905512
MONTICELLO,MN,7507,7610,103,0.5034067606006483
MONTICELLO,MS,1462,1418,-44,0.49236111111111114
MONTICELLO,NY,6591,5873,-718,0.47119704749679076
MONTICELLO,UT,749,468,-281,0.38455217748562037
MONTICELLO,WI,873,705,-168,0.4467680608365019
MONTMORENCI,SC,13,11,-2,0.4583333333333333
MONTOUR,IA,16,11,-5,0.4074074074074074
MONTOUR FALLS,NY,1300,1162,-138,0.4719740048740861
MONTOURSVILLE,PA,4025,3722,-303,0.48044404285529885
MONTPELIER,ID,1441,1421,-20,0.4965059399021663
MONTPELIER,IN,1153,1012,-141,0.4674364896073903
MONTPELIER,OH,3190,2761,-429,0.46395563770794823
MONTPELIER,VA,1581,1759,178,0.5266467065868263
MONTPELIER,VT,6251,5889,-362,0.48509060955518946
MONTREAL,CA,18,16,-2,0.47058823529411764
MONTREAL,MO,293,349,56,0.543613707165109
MONTREAL,WI,0,17,17,1
MONTREAT,NC,214,196,-18,0.47804878048780486
MONTROSE,AL,14,91,77,0.8666666666666667
MONTROSE,AR,14,0,-14,0
MONTROSE,CA,2951,3046,95,0.5079206269801567
MONTROSE,CO,18524,17656,-868,0.4880044223327805
MONTROSE,GA,77,45,-32,0.36885245901639346
MONTROSE,IA,476,445,-31,0.4831704668838219
MONTROSE,IL,12,23,11,0.6571428571428571
MONTROSE,MI,3010,2687,-323,0.47165174653326314
MONTROSE,MN,1908,1880,-28,0.4963041182682154
MONTROSE,MO,56,71,15,0.5590551181102362
MONTROSE,NY,758,879,121,0.5369578497251069
MONTROSE,PA,2955,2636,-319,0.47147200858522625
MONTROSE,SD,49,55,6,0.5288461538461539
MONTROSE,WV,97,125,28,0.5630630630630631
MONTROSS,VA,1606,1917,311,0.54413851830826
MONTVALE,NJ,2282,3206,924,0.5841836734693877
MONTVALE,VA,321,302,-19,0.48475120385232745
MONTVERDE,FL,1607,1935,328,0.5463015245623941
MONTVILLE,CT,11,13,2,0.5416666666666666
MONTVILLE,ME,163,261,98,0.6155660377358491
MONTVILLE,NJ,2618,2969,351,0.5314122069088957
MONTVILLE,OH,159,154,-5,0.49201277955271566
MONUMENT,CO,11395,13434,2039,0.5410608562567965
MONUMENT BEACH,MA,307,215,-92,0.4118773946360153
MOODUS,CT,1242,1193,-49,0.48993839835728953
MOODY,AL,4826,4525,-301,0.4839054646561865
MOODY,ME,1077,1126,49,0.5111211983658648
MOODY,TX,1569,1978,409,0.5576543557936284
MOODY AFB,GA,0,52,52,1
MOOERS,NY,501,635,134,0.5589788732394366
MOOERS FORKS,NY,186,138,-48,0.42592592592592593
MOON TOWNSHIP,PA,570,529,-41,0.4813466787989081
MOONACHIE,NJ,791,659,-132,0.45448275862068965
MOORCROFT,WY,1089,952,-137,0.466438020578148
MOORE,ID,135,183,48,0.5754716981132075
MOORE,MT,22,38,16,0.6333333333333333
MOORE,OK,28465,22906,-5559,0.44589359755504077
MOORE,SC,4641,5146,505,0.5257995299887606
MOORE,TX,136,303,167,0.6902050113895216
MOORE HAVEN,FL,3011,4497,1486,0.5989611081513053
MOOREFIELD,WV,2797,2558,-239,0.4776844070961718
MOORELAND,IN,179,205,26,0.5338541666666666
MOORELAND,OK,371,449,78,0.5475609756097561
MOORES HILL,IN,1107,916,-191,0.4527928818586258
MOORESBORO,NC,1735,1901,166,0.5228272827282728
MOORESBURG,TN,1249,1429,180,0.5336071695294996
MOORESTOWN,NJ,5977,7031,1054,0.5405135301353013
MOORESVILLE,IN,8972,8977,5,0.5001392835255446
MOORESVILLE,NC,39712,45314,5602,0.5329428645355538
MOORETON,ND,13,12,-1,0.48
MOOREVILLE,MS,1273,1416,143,0.5265898103384158
MOORHEAD,IA,0,37,37,1
MOORHEAD,MN,25241,20903,-4338,0.452994972260749
MOORHEAD,MS,66,41,-25,0.38317757009345793
MOORINGSPORT,LA,894,841,-53,0.4847262247838617
MOORPARK,CA,9747,10103,356,0.5089672544080605
MOOSE,WY,322,207,-115,0.391304347826087
MOOSE LAKE,MN,1597,1493,-104,0.4831715210355987
MOOSE PASS,AK,0,13,13,1
MOOSE RIVER,ME,27,41,14,0.6029411764705882
MOOSEHEART,IL,30,47,17,0.6103896103896104
MOOSIC,PA,1455,1510,55,0.5092748735244519
MOOSUP,CT,2440,2457,17,0.5017357565856647
MORA,MN,5100,4592,-508,0.4737928188196451
MORA,NM,11,50,39,0.819672131147541
MORAGA,CA,4092,4564,472,0.527264325323475
MORAINE,OH,2468,2426,-42,0.4957090314671026
MORAN,KS,374,378,4,0.5026595744680851
MORAN,MI,175,201,26,0.5345744680851063
MORAN,TX,30,33,3,0.5238095238095238
MORAN,WY,437,463,26,0.5144444444444445
MORAVIA,IA,460,558,98,0.5481335952848723
MORAVIA,NY,2225,2169,-56,0.4936276741010469
MORAVIAN FALLS,NC,972,1050,78,0.5192878338278932
MOREAUVILLE,LA,594,588,-6,0.49746192893401014
MOREHEAD,KY,9126,8354,-772,0.47791762013729977
MOREHEAD,NC,0,12,12,1
MOREHEAD CITY,NC,6715,7057,342,0.5124164972407784
MORELAND,GA,1088,1364,276,0.5562805872756933
MORELAND HILLS,OH,159,127,-32,0.44405594405594406
MORENCI,AZ,1674,1073,-601,0.39060793593010557
MORENCI,MI,1445,1303,-142,0.47416302765647744
MORENO VALLEY,CA,61432,58145,-3287,0.48625571807287354
MORETOWN,VT,355,496,141,0.5828437132784959
MORGAN,MN,457,213,-244,0.31791044776119404
MORGAN,PA,39,0,-39,0
MORGAN,TX,471,707,236,0.6001697792869269
MORGAN,UT,2626,2913,287,0.5259072034663297
MORGAN,VT,195,220,25,0.5301204819277109
MORGAN CITY,LA,6296,5547,-749,0.4683779447775057
MORGAN CITY,MS,11,0,-11,0
MORGAN HILL,CA,15268,16403,1135,0.5179186006125478
MORGAN MILL,TX,38,0,-38,0
MORGANFIELD,KY,2894,2624,-270,0.4755346139905763
MORGANTON,GA,1974,2430,456,0.5517711171662125
MORGANTON,NC,14052,15135,1083,0.5185527803474149
MORGANTOWN,IN,1899,2085,186,0.5233433734939759
MORGANTOWN,KY,4026,3777,-249,0.48404459823144946
MORGANTOWN,MS,23,33,10,0.5892857142857143
MORGANTOWN,PA,1530,1486,-44,0.4927055702917772
MORGANTOWN,WV,43476,33440,-10036,0.4347599979198086
MORGANVILLE,NJ,4605,5537,932,0.5459475448629462
MORGANZA,LA,42,69,27,0.6216216216216216
MORIAH,NY,38,88,50,0.6984126984126984
MORIARTY,NM,2803,1947,-856,0.40989473684210526
MORICHES,NY,2386,1986,-400,0.45425434583714547
MORLEY,MI,1686,1615,-71,0.4892456831263254
MORLEY,MO,36,23,-13,0.3898305084745763
MORMON LAKE,AZ,22,44,22,0.6666666666666666
MORNING SUN,IA,168,111,-57,0.3978494623655914
MORNING VIEW,KY,677,656,-21,0.49212303075768943
MORNINGSIDE,MD,1062,827,-235,0.43779777660137636
MORO,AR,54,24,-30,0.3076923076923077
MORO,IL,592,678,86,0.5338582677165354
MOROCCO,IN,769,740,-29,0.49039098740888004
MORONGO VALLEY,CA,1694,1537,-157,0.47570411637264004
MORONGO VLY,CA,150,145,-5,0.4915254237288136
MORONI,UT,162,153,-9,0.4857142857142857
MORRAL,OH,63,14,-49,0.18181818181818182
MORRICE,MI,688,674,-14,0.4948604992657856
MORRILL,ME,311,328,17,0.513302034428795
MORRILL,NE,770,576,-194,0.4279346210995542
MORRILTON,AR,5404,5087,-317,0.4848918120293585
MORRIS,AL,1174,1330,156,0.5311501597444089
MORRIS,CT,749,761,12,0.5039735099337749
MORRIS,IL,8267,7899,-368,0.488618087343808
MORRIS,MN,3353,2392,-961,0.4163620539599652
MORRIS,NY,515,587,72,0.5326678765880217
MORRIS,OK,852,984,132,0.5359477124183006
MORRIS,PA,35,0,-35,0
MORRIS CHAPEL,TN,92,113,21,0.551219512195122
MORRIS PLAI,NJ,153,129,-24,0.4574468085106383
MORRIS PLAINS,NJ,5946,6099,153,0.5063511830635118
MORRISDALE,PA,816,827,11,0.5033475349969568
MORRISON,CO,6172,6539,367,0.5144363150027536
MORRISON,IL,2673,2374,-299,0.4703784426391916
MORRISON,MO,13,11,-2,0.4583333333333333
MORRISON,OK,187,202,15,0.519280205655527
MORRISON,TN,1765,1927,162,0.5219393282773565
MORRISONVILLE,IL,424,185,-239,0.30377668308702793
MORRISONVILLE,NY,1983,1859,-124,0.4838625715773035
MORRISONVILLE,WI,11,0,-11,0
MORRISTON,FL,2494,3152,658,0.5582713425433935
MORRISTOWN,AZ,1217,1536,319,0.557936796222303
MORRISTOWN,IN,888,733,-155,0.4521900061690315
MORRISTOWN,MN,575,517,-58,0.4734432234432234
MORRISTOWN,NJ,16838,16222,-616,0.4906836055656382
MORRISTOWN,NY,296,312,16,0.5131578947368421
MORRISTOWN,TN,20422,18886,-1536,0.48046199246972626
MORRISTOWN,VT,211,232,21,0.5237020316027088
MORRISVILLE,MO,241,227,-14,0.48504273504273504
MORRISVILLE,NC,28134,27459,-675,0.4939290917921321
MORRISVILLE,NY,1034,843,-191,0.4491209376664891
MORRISVILLE,PA,10205,9985,-220,0.49455175829618625
MORRISVILLE,VT,2632,2563,-69,0.4933589990375361
MORRO BAY,CA,5588,6102,514,0.5219846022241231
MORROW,GA,12157,10468,-1689,0.46267403314917127
MORROW,OH,3794,4943,1149,0.5657548357559803
MORSE,LA,346,399,53,0.5355704697986577
MORTON,IL,7400,6628,-772,0.4724836042201312
MORTON,MN,190,132,-58,0.40993788819875776
MORTON,MS,2328,2300,-28,0.4969749351771824
MORTON,PA,1862,1732,-130,0.4819143016138008
MORTON,TX,133,150,17,0.5300353356890459
MORTON,WA,1120,914,-206,0.44936086529006886
MORTON GROVE,IL,5765,5994,229,0.5097372225529382
MORTONS GAP,KY,85,51,-34,0.375
MORVEN,GA,21,71,50,0.7717391304347826
MORVEN,NC,357,277,-80,0.43690851735015773
MOSBY,MO,114,138,24,0.5476190476190477
MOSCA,CO,41,11,-30,0.21153846153846154
MOSCOW,IA,36,11,-25,0.23404255319148937
MOSCOW,ID,18148,13965,-4183,0.4348706131473235
MOSCOW,KS,0,11,11,1
MOSCOW,ME,38,79,41,0.6752136752136753
MOSCOW,OH,171,285,114,0.625
MOSCOW,PA,2569,2671,102,0.5097328244274809
MOSCOW,TN,1027,988,-39,0.49032258064516127
MOSCOW,TX,0,22,22,1
MOSCOW MILLS,MO,3329,3973,644,0.544097507532183
MOSELEY,VA,3327,5955,2628,0.6415643180349063
MOSELLE,MS,834,915,81,0.5231560891938251
MOSES LAKE,WA,17745,18188,443,0.5061642501321905
MOSHEIM,TN,1594,1740,146,0.5218956208758249
MOSIER,OR,533,560,27,0.5123513266239708
MOSINEE,WI,3529,3596,67,0.5047017543859649
MOSS,TN,0,47,47,1
MOSS BEACH,CA,816,752,-64,0.47959183673469385
MOSS BLUFF,LA,732,685,-47,0.48341566690190546
MOSS LANDING,CA,267,209,-58,0.43907563025210083
MOSS POINT,MS,8489,7898,-591,0.481967413193385
MOSSVILLE,IL,0,13,13,1
MOSSYROCK,WA,1085,1219,134,0.5290798611111112
MOTLEY,MN,1583,1491,-92,0.4850357839947951
MOTT,ND,167,129,-38,0.4358108108108108
MOTTVILLE,MI,60,45,-15,0.42857142857142855
MOULTON,AL,3693,3665,-28,0.49809730905137267
MOULTON,IA,167,139,-28,0.4542483660130719
MOULTON,TX,339,297,-42,0.4669811320754717
MOULTONBORO,NH,228,475,247,0.6756756756756757
MOULTONBOROUGH,NH,2821,2756,-65,0.49417249417249415
MOULTRIE,GA,10751,10144,-607,0.4854749940177076
MOUND,MN,6719,6009,-710,0.47210873664362035
MOUND BAYOU,MS,443,366,-77,0.45241038318912236
MOUND CITY,IL,48,38,-10,0.4418604651162791
MOUND CITY,KS,644,717,73,0.526818515797208
MOUND CITY,MO,477,434,-43,0.47639956092206365
MOUND HOUSE,NV,186,204,18,0.5230769230769231
MOUND VALLEY,KS,56,51,-5,0.4766355140186916
MOUNDRIDGE,KS,1265,1249,-16,0.4968178202068417
MOUNDS,IL,264,165,-99,0.38461538461538464
MOUNDS,OK,1928,2205,277,0.5335107669973385
MOUNDSVILLE,WV,5080,4862,-218,0.48903641118487223
MOUNDVILLE,AL,1917,2191,274,0.5333495618305745
MOUNT AIRY,GA,1220,1429,209,0.5394488486221215
MOUNT AIRY,MD,6682,7688,1006,0.5350034794711204
MOUNT AIRY,NC,10794,10305,-489,0.48841177306981376
MOUNT ALTO,WV,0,11,11,1
MOUNT ANGEL,OR,1525,1417,-108,0.4816451393609789
MOUNT ARLINGTON,NJ,2252,2125,-127,0.48549234635595157
MOUNT AUBURN,IA,51,0,-51,0
MOUNT AUBURN,IL,23,12,-11,0.34285714285714286
MOUNT AUKUM,CA,23,0,-23,0
MOUNT AYR,IA,1083,1056,-27,0.49368863955119213
MOUNT BETHEL,PA,1362,1317,-45,0.4916013437849944
MOUNT BLANCHARD,OH,136,99,-37,0.42127659574468085
MOUNT CALM,TX,40,92,52,0.696969696969697
MOUNT CALVARY,WI,102,63,-39,0.38181818181818183
MOUNT CARMEL,IL,3925,3521,-404,0.4728713403169487
MOUNT CARMEL,PA,3810,3525,-285,0.48057259713701433
MOUNT CARMEL,TN,1371,1437,66,0.5117521367521367
MOUNT CARROLL,IL,884,844,-40,0.48842592592592593
MOUNT CHARLESTON,NV,0,15,15,1
MOUNT CHASE,ME,43,33,-10,0.4342105263157895
MOUNT CLARE,WV,412,453,41,0.5236994219653179
MOUNT CLEMENS,MI,8027,6764,-1263,0.4573051179771483
MOUNT CRAWFORD,VA,398,438,40,0.5239234449760766
MOUNT CROGHAN,SC,388,252,-136,0.39375
MOUNT DESERT,ME,1430,1263,-167,0.46899368733754176
MOUNT DORA,FL,16100,18805,2705,0.5387480303681421
MOUNT EATON,OH,12,0,-12,0
MOUNT EDEN,CA,0,13,13,1
MOUNT EDEN,KY,141,302,161,0.6817155756207675
MOUNT ENTERPRISE,TX,745,821,76,0.5242656449553001
MOUNT EPHRAIM,NJ,1517,1629,112,0.5178003814367451
MOUNT GAY,WV,30,13,-17,0.3023255813953488
MOUNT GILEAD,NC,1579,2000,421,0.5588153115395362
MOUNT GILEAD,OH,4009,3862,-147,0.4906619235167069
MOUNT GRETNA,PA,229,191,-38,0.45476190476190476
MOUNT HEALTHY,OH,602,692,90,0.5347758887171561
MOUNT HERMON,CA,86,24,-62,0.21818181818181817
MOUNT HERMON,KY,11,12,1,0.5217391304347826
MOUNT HERMON,LA,498,559,61,0.5288552507095553
MOUNT HOLLY,NC,7722,8884,1162,0.5349873539684451
MOUNT HOLLY,NJ,6653,6801,148,0.5055002229820128
MOUNT HOLLY,VT,101,144,43,0.5877551020408164
MOUNT HOLLY SPRINGS,PA,1379,1423,44,0.5078515346181299
MOUNT HOOD PARKDALE,OR,808,841,33,0.5100060642813826
MOUNT HOPE,AL,46,11,-35,0.19298245614035087
MOUNT HOPE,KS,255,220,-35,0.4631578947368421
MOUNT HOPE,WI,25,23,-2,0.4791666666666667
MOUNT HOPE,WV,1669,1551,-118,0.4816770186335404
MOUNT HOREB,WI,3659,3680,21,0.5014307126311487
MOUNT IDA,AR,1263,1526,263,0.5471495159555396
MOUNT JACKSON,VA,1759,1911,152,0.520708446866485
MOUNT JEWETT,PA,666,233,-433,0.25917686318131256
MOUNT JOY,PA,6897,6934,37,0.5013375750126527
MOUNT JUDEA,AR,11,0,-11,0
MOUNT JULIET,TN,19074,23097,4023,0.547698655474141
MOUNT KISCO,NY,3956,3959,3,0.5001895135818067
MOUNT LAUREL,NJ,15369,16535,1166,0.5182735707121364
MOUNT LOOKOUT,WV,67,52,-15,0.4369747899159664
MOUNT MARION,NY,11,12,1,0.5217391304347826
MOUNT MORRIS,IL,1750,1514,-236,0.4638480392156863
MOUNT MORRIS,MI,10703,8371,-2332,0.4388696655132641
MOUNT MORRIS,NY,2522,2219,-303,0.4680447163045771
MOUNT MORRIS,PA,518,246,-272,0.3219895287958115
MOUNT MOURNE,NC,0,13,13,1
MOUNT NEBO,WV,453,384,-69,0.45878136200716846
MOUNT OLIVE,AL,1381,1565,184,0.5312287847929396
MOUNT OLIVE,IL,1111,1086,-25,0.49431042330450614
MOUNT OLIVE,MS,993,1125,132,0.5311614730878187
MOUNT OLIVE,NC,3912,3552,-360,0.4758842443729904
MOUNT OLIVET,KY,489,561,72,0.5342857142857143
MOUNT ORAB,OH,3299,3330,31,0.5023382108915372
MOUNT PERRY,OH,365,430,65,0.5408805031446541
MOUNT PLEASANT,AR,28,39,11,0.582089552238806
MOUNT PLEASANT,IA,4116,3540,-576,0.46238244514106586
MOUNT PLEASANT,MI,20318,17903,-2415,0.4684074200047095
MOUNT PLEASANT,NC,1663,1864,201,0.5284944712220017
MOUNT PLEASANT,OH,11,0,-11,0
MOUNT PLEASANT,PA,4501,4357,-144,0.49187175434635355
MOUNT PLEASANT,SC,39352,42553,3201,0.5195409315670594
MOUNT PLEASANT,TN,2510,2512,2,0.5001991238550378
MOUNT PLEASANT,TX,5153,5282,129,0.5061811212266412
MOUNT PLEASANT,UT,1163,1300,137,0.5278116118554608
MOUNT PLEASANT,WI,10036,9207,-829,0.4784596996310347
MOUNT PLEASANT MILLS,PA,485,368,-117,0.43141852286049237
MOUNT POCONO,PA,1879,1971,92,0.5119480519480519
MOUNT PROSPECT,IL,15818,15318,-500,0.49197070914696817
MOUNT PULASKI,IL,531,494,-37,0.4819512195121951
MOUNT RAINIER,MD,4353,3456,-897,0.44256626968882057
MOUNT ROYAL,NJ,989,946,-43,0.4888888888888889
MOUNT SAVAGE,MD,178,186,8,0.510989010989011
MOUNT SHASTA,CA,4179,3877,-302,0.48125620655412116
MOUNT SIDNEY,VA,365,453,88,0.5537897310513448
MOUNT SINAI,NY,3495,4072,577,0.5381260737412449
MOUNT SNOW,VT,20,16,-4,0.4444444444444444
MOUNT SOLON,VA,351,314,-37,0.47218045112781953
MOUNT STERLING,IL,1189,1191,2,0.5004201680672269
MOUNT STERLING,KY,9814,9146,-668,0.48238396624472574
MOUNT STERLING,OH,1853,1935,82,0.5108236536430835
MOUNT SUNAPEE,NH,14,20,6,0.5882352941176471
MOUNT TABOR,NJ,60,12,-48,0.16666666666666666
MOUNT TREMPER,NY,138,217,79,0.6112676056338028
MOUNT ULLA,NC,427,705,278,0.622791519434629
MOUNT UNION,IA,11,0,-11,0
MOUNT UNION,PA,2158,2124,-34,0.4960298925735638
MOUNT UPTON,NY,494,294,-200,0.3730964467005076
MOUNT VERNON,AL,459,441,-18,0.49
MOUNT VERNON,AR,119,166,47,0.5824561403508772
MOUNT VERNON,GA,867,834,-33,0.49029982363315694
MOUNT VERNON,IA,1650,1703,53,0.5079033701163137
MOUNT VERNON,IL,11617,9908,-1709,0.4603019744483159
MOUNT VERNON,IN,4864,4438,-426,0.47710169855944956
MOUNT VERNON,KY,3068,2984,-84,0.4930601454064772
MOUNT VERNON,ME,659,715,56,0.5203784570596798
MOUNT VERNON,MO,3602,3605,3,0.5002081309837658
MOUNT VERNON,NY,20727,17506,-3221,0.45787670337143305
MOUNT VERNON,OH,12197,11964,-233,0.49517817971110467
MOUNT VERNON,OR,213,238,25,0.5277161862527716
MOUNT VERNON,SD,73,40,-33,0.35398230088495575
MOUNT VERNON,TX,2094,2183,89,0.5104044891278934
MOUNT VERNON,WA,20516,17548,-2968,0.4610130306851618
MOUNT VICTORY,OH,281,243,-38,0.4637404580152672
MOUNT VISION,NY,98,72,-26,0.4235294117647059
MOUNT WASHINGTON,KY,5856,5927,71,0.5030128150725621
MOUNT WASHINGTON,MD,893,899,6,0.5016741071428571
MOUNT WASHINGTON,OH,200,250,50,0.5555555555555556
MOUNT WASHINGTON,PA,1810,1394,-416,0.43508114856429464
MOUNT WOLF,PA,2028,1817,-211,0.47256176853055915
MOUNT ZION,IL,296,253,-43,0.46083788706739526
MOUNTAIN,WI,410,468,58,0.5330296127562643
MOUNTAIN BRK,AL,3860,3745,-115,0.49243918474687703
MOUNTAIN BROOK,AL,2181,2058,-123,0.4854918612880396
MOUNTAIN CENTER,CA,527,722,195,0.578062449959968
MOUNTAIN CITY,GA,12,0,-12,0
MOUNTAIN CITY,TN,4147,4464,317,0.5184066891185692
MOUNTAIN CTR,CA,29,26,-3,0.4727272727272727
MOUNTAIN DALE,NY,112,109,-3,0.49321266968325794
MOUNTAIN GREEN,UT,148,201,53,0.5759312320916905
MOUNTAIN GROVE,MO,5003,5018,15,0.5007484283005688
MOUNTAIN HOME,AR,15093,14319,-774,0.4868421052631579
MOUNTAIN HOME,ID,11407,10359,-1048,0.47592575576587337
MOUNTAIN HOME,NC,106,100,-6,0.4854368932038835
MOUNTAIN HOME,TN,15,41,26,0.7321428571428571
MOUNTAIN HOME,TX,206,427,221,0.674565560821485
MOUNTAIN HOME AFB,ID,2247,1765,-482,0.4399302093718844
MOUNTAIN HOUSE,CA,3293,5204,1911,0.6124514534541603
MOUNTAIN IRON,MN,922,903,-19,0.4947945205479452
MOUNTAIN LAKE,MN,1396,1058,-338,0.4311328443357783
MOUNTAIN LAKES,NJ,1250,1525,275,0.5495495495495496
MOUNTAIN LKS,NJ,52,60,8,0.5357142857142857
MOUNTAIN PINE,AR,549,602,53,0.5230234578627281
MOUNTAIN RANCH,CA,463,421,-42,0.4762443438914027
MOUNTAIN REST,SC,238,366,128,0.6059602649006622
MOUNTAIN TOP,PA,3354,3793,439,0.5307121869315797
MOUNTAIN VIEW,AR,3517,3979,462,0.5308164354322306
MOUNTAIN VIEW,CA,56523,48159,-8364,0.4600504384707973
MOUNTAIN VIEW,HI,1222,1505,283,0.5518885221855518
MOUNTAIN VIEW,MO,2599,2772,173,0.5161050083783281
MOUNTAIN VIEW,OK,320,173,-147,0.3509127789046653
MOUNTAIN VIEW,WY,394,316,-78,0.4450704225352113
MOUNTAIN VILLAGE,CO,440,320,-120,0.42105263157894735
MOUNTAINAIR,NM,439,464,25,0.5138427464008859
MOUNTAINBURG,AR,1262,1156,-106,0.47808105872622003
MOUNTAINSIDE,NJ,1512,1902,390,0.5571177504393673
MOUNTLAKE TERRACE,WA,11805,10620,-1185,0.4735785953177257
MOUNTVILLE,PA,3073,2871,-202,0.48300807537012114
MOUNTVILLE,SC,0,35,35,1
MOUSIE,KY,11,0,-11,0
MOUTH OF WILSON,VA,118,103,-15,0.4660633484162896
MOUTH WILSON,VA,0,18,18,1
MOUTHCARD,KY,0,11,11,1
MOVILLE,IA,850,747,-103,0.46775203506574825
MOWEAQUA,IL,759,774,15,0.5048923679060665
MOXEE,WA,1849,1956,107,0.514060446780552
MOYIE SPRINGS,ID,744,813,69,0.5221579961464354
MOYOCK,NC,3803,5146,1343,0.5750363169069169
MP,MN,360,280,-80,0.4375
MS STATE,MS,447,0,-447,0
MT ARLINGTON,NJ,415,350,-65,0.45751633986928103
MT BALDY,CA,0,11,11,1
MT BLANCHARD,OH,31,35,4,0.5303030303030303
MT CARMEL,TN,134,176,42,0.567741935483871
MT CLARE,WV,16,18,2,0.5294117647058824
MT CRAWFORD,VA,45,67,22,0.5982142857142857
MT ENTERPRISE,TX,47,58,11,0.5523809523809524
MT GRETNA,PA,14,28,14,0.6666666666666666
MT HOLLY,NC,376,452,76,0.5458937198067633
MT HOLLY SPGS,PA,51,60,9,0.5405405405405406
MT JULIET,TN,4359,5333,974,0.5502476269087908
MT LAUREL,NJ,395,443,48,0.5286396181384249
MT LEBANON,PA,548,554,6,0.5027223230490018
MT MADONNA,CA,310,274,-36,0.4691780821917808
MT MORRIS,IL,72,46,-26,0.3898305084745763
MT MORRIS,MI,217,174,-43,0.44501278772378516
MT MORRIS,PA,42,14,-28,0.25
MT PLEASANT,IA,1582,1135,-447,0.4177401545822598
MT PLEASANT,MI,1329,1299,-30,0.4942922374429224
MT PLEASANT,NC,23,37,14,0.6166666666666667
MT PLEASANT,PA,78,79,1,0.5031847133757962
MT PLEASANT,SC,6236,6503,267,0.510479629484261
MT PLEASANT,TN,503,514,11,0.5054080629301868
MT PLEASANT,TX,1737,1763,26,0.5037142857142857
MT PLEASANT,UT,191,227,36,0.5430622009569378
MT PLEASANT,WI,502,450,-52,0.4726890756302521
MT PLEASANT M,PA,17,16,-1,0.48484848484848486
MT PLEASANT MILLS,PA,196,181,-15,0.48010610079575594
MT PROSPECT,IL,3038,2804,-234,0.4799726121191373
MT STERLING,IL,95,102,7,0.5177664974619289
MT STERLING,KY,214,220,6,0.5069124423963134
MT STERLING,OH,117,146,29,0.5551330798479087
MT VERNON,NY,14,14,0,0.5
MT VERNON,TX,297,322,25,0.5201938610662359
MT WASHINGTON,KY,2168,2250,82,0.5092802172928927
MT WASHINGTON,MD,186,169,-17,0.476056338028169
MT WASHINGTON,PA,385,318,-67,0.4523470839260313
MT ZION,IL,1959,1849,-110,0.4855567226890756
MTN HOME,ID,1154,1053,-101,0.47711826008155866
MTN HOME,TN,0,11,11,1
MTN HOME AFB,ID,401,314,-87,0.43916083916083914
MTN HOUSE,CA,245,406,161,0.6236559139784946
MTN IRON,MN,19,18,-1,0.4864864864864865
MTN RANCH,CA,11,17,6,0.6071428571428571
MUENSTER,TX,883,896,13,0.5036537380550872
MUIR,MI,528,338,-190,0.3903002309468822
MUIR BEACH,CA,163,146,-17,0.47249190938511326
MUKILTEO,WA,11346,10550,-796,0.481823164048228
MUKWONAGO,WI,5555,5680,125,0.5055629728526925
MULBERRY,AR,1433,1453,20,0.5034650034650034
MULBERRY,FL,10161,10186,25,0.5006143411805181
MULBERRY,IN,796,713,-83,0.47249834327369117
MULBERRY,KS,212,155,-57,0.4223433242506812
MULBERRY,TN,36,0,-36,0
MULBERRY GROVE,IL,396,371,-25,0.48370273794002605
MULDRAUGH,KY,1172,931,-241,0.4427009034712316
MULDROW,OK,3977,3994,17,0.5010663655752101
MULESHOE,TX,1492,1397,-95,0.48355832467982
MULGA,AL,697,634,-63,0.4763335837716003
MULHALL,OK,0,22,22,1
MULINO,OR,931,950,19,0.5050505050505051
MULKEYTOWN,IL,225,237,12,0.512987012987013
MULLAN,ID,24,16,-8,0.4
MULLEN,NE,0,15,15,1
MULLENS,WV,441,254,-187,0.36546762589928056
MULLETT LAKE,MI,49,69,20,0.5847457627118644
MULLICA HILL,NJ,3648,4106,458,0.5295331441836472
MULLIKEN,MI,387,258,-129,0.4
MULLIN,TX,12,0,-12,0
MULLINS,SC,2985,2993,8,0.5006691201070592
MULLINVILLE,KS,38,11,-27,0.22448979591836735
MULVANE,KS,2973,2919,-54,0.4954175152749491
MUMFORD,NY,55,30,-25,0.35294117647058826
MUNCIE,IN,43390,35869,-7521,0.45255428405606934
MUNCY,PA,3681,3618,-63,0.4956843403205919
MUNCY VALLEY,PA,102,145,43,0.5870445344129555
MUNDAY,TX,101,254,153,0.7154929577464789
MUNDELEIN,IL,12613,11526,-1087,0.47748456854053606
MUNDS PARK,AZ,1891,2208,317,0.5386679677970236
MUNFORD,AL,1411,1474,63,0.5109185441941074
MUNFORD,TN,3414,3704,290,0.5203708906996347
MUNFORDVILLE,KY,2274,2111,-163,0.4814139110604333
MUNGER,MI,69,85,16,0.551948051948052
MUNHALL,PA,1640,1652,12,0.5018226002430134
MUNISING,MI,1901,1700,-201,0.4720910858094974
MUNITH,MI,990,743,-247,0.42873629544143105
MUNNSVILLE,NY,916,680,-236,0.42606516290726815
MUNROE FALLS,OH,1437,1457,20,0.5034554250172771
MUNSONVILLE,NH,0,49,49,1
MUNSTER,IN,6133,6315,182,0.507310411311054
MURCHISON,TX,1180,1452,272,0.5516717325227963
MURDOCK,FL,1296,1029,-267,0.4425806451612903
MURDOCK,MN,155,36,-119,0.18848167539267016
MURDOCK,NE,0,61,61,1
MURFREESBORO,AR,1130,812,-318,0.4181256436663234
MURFREESBORO,NC,1357,1320,-37,0.49308927904370564
MURFREESBORO,TN,101670,102900,1230,0.5030063059099574
MURPHY,ID,22,24,2,0.5217391304347826
MURPHY,NC,8744,10786,2042,0.5522785458269329
MURPHY,OR,80,194,114,0.708029197080292
MURPHY,TX,1722,2181,459,0.5588009223674096
MURPHYS,CA,1620,1744,124,0.5184304399524375
MURPHYSBORO,IL,6311,5820,-491,0.47976259170719643
MURRAY,IA,239,237,-2,0.49789915966386555
MURRAY,KY,16862,13544,-3318,0.4454384003157272
MURRAY,NE,124,34,-90,0.21518987341772153
MURRAY,UT,11625,9909,-1716,0.4601560323209808
MURRAY CITY,OH,0,13,13,1
MURRAYVILLE,GA,1529,1758,229,0.5348341953148767
MURRAYVILLE,IL,250,179,-71,0.4172494172494173
MURRELLS INLET,SC,15730,20323,4593,0.5636978892186503
MURRIETA,CA,50599,54186,3587,0.5171159994273989
MURRYSVILLE,PA,3941,3710,-231,0.484903934126258
MURTAUGH,ID,84,127,43,0.6018957345971564
MUSCADINE,AL,37,153,116,0.8052631578947368
MUSCATINE,IA,15652,12846,-2806,0.4507684749807004
MUSCLE SHOALS,AL,6559,7089,530,0.5194167643610785
MUSCODA,WI,1198,1142,-56,0.488034188034188
MUSE,PA,55,0,-55,0
MUSELLA,GA,11,23,12,0.6764705882352942
MUSKEGO,WI,6812,7588,776,0.5269444444444444
MUSKEGON,MI,44607,40764,-3843,0.47749235688934183
MUSKOGEE,OK,24361,18117,-6244,0.4265031310325345
MUSSEY,MI,696,586,-110,0.45709828393135726
MUSTANG,OK,8894,10495,1601,0.5412862963536026
MV,WA,367,276,-91,0.42923794712286156
MYAKKA CITY,FL,2051,2442,391,0.5435121299799689
MYERSTOWN,PA,4240,4228,-12,0.4992914501653283
MYERSVILLE,MD,1276,1300,24,0.5046583850931677
MYRTLE,MN,29,14,-15,0.32558139534883723
MYRTLE,MS,987,1152,165,0.5385694249649369
MYRTLE BEACH,SC,90900,101446,10546,0.5274141391034906
MYRTLE CREEK,OR,3697,4128,431,0.5275399361022364
MYRTLE POINT,OR,1868,1899,31,0.5041146801168038
MYSTIC,CT,5456,5996,540,0.5235766678309466
MYSTIC,IA,70,47,-23,0.4017094017094017
MYTON,UT,205,220,15,0.5176470588235295
N ARLINGTON,NJ,320,342,22,0.5166163141993958
N ATTLEBORO,MA,774,886,112,0.5337349397590362
N BENNINGTON,VT,62,107,45,0.6331360946745562
N BETHESDA,MD,1052,979,-73,0.48202855736090594
N BILLERICA,MA,182,206,24,0.5309278350515464
N BLOOMFIELD,OH,14,15,1,0.5172413793103449
N BRANFORD,CT,79,91,12,0.5352941176470588
N BROOKFIELD,MA,166,173,7,0.5103244837758112
N CALDWELL,NJ,152,208,56,0.5777777777777777
N CAMBRIA,PA,100,66,-34,0.39759036144578314
N CANTON,OH,73,90,17,0.5521472392638037
N CHARLESTON,SC,841,892,51,0.5147143681477208
N CHELMSFORD,MA,449,378,-71,0.4570737605804111
N CLARENDON,VT,12,0,-12,0
N DARTMOUTH,MA,786,931,145,0.5422248107163657
N DIGHTON,MA,187,161,-26,0.46264367816091956
N FALMOUTH,MA,35,46,11,0.5679012345679012
N FERRISBURGH,VT,11,37,26,0.7708333333333334
N FORT MYERS,FL,961,408,-553,0.29802775748721694
N FRANKLIN,CT,24,55,31,0.6962025316455697
N FT MYERS,FL,1056,1283,227,0.5485250106883284
N GROSVENORDL,CT,29,39,10,0.5735294117647058
N HAVERHILL,NH,72,51,-21,0.4146341463414634
N HIGHLANDS,CA,3987,3487,-500,0.46655070912496655
N HOLLYWOOD,CA,14873,12367,-2506,0.4540014684287812
N KINGSTOWN,RI,1239,1131,-108,0.4772151898734177
N LAS VEGAS,NV,7514,7967,453,0.5146308378011757
N LAUDERDALE,FL,513,449,-64,0.46673596673596673
N LAWRENCE,NY,11,20,9,0.6451612903225806
N LEWISBURG,OH,98,113,15,0.5355450236966824
N LITTLE ROCK,AR,902,854,-48,0.4863325740318907
N MANCHESTER,IN,51,66,15,0.5641025641025641
N MANHESTER,IN,46,63,17,0.5779816513761468
N MERRICK,NY,613,679,66,0.5255417956656346
N MIAMI BEACH,FL,2120,2018,-102,0.4876752054132431
N MIDDLESEX,VT,0,44,44,1
N MONMOUTH,ME,12,34,22,0.7391304347826086
N MYRTLE BCH,SC,149,431,282,0.743103448275862
N NEW HYDE PK,NY,189,281,92,0.597872340425532
N PALM BEACH,FL,273,218,-55,0.4439918533604888
N PALM SPGS,CA,0,20,20,1
N PALM SPRINGS,CA,0,34,34,1
N PARKERSBURG,WV,113,96,-17,0.45933014354066987
N PLAINFIELD,NJ,66,90,24,0.5769230769230769
N PROVIDENCE,RI,391,407,16,0.5100250626566416
N RICHLAND HILLS,TX,3494,3728,234,0.5162004984768762
N RIVERSIDE,IL,119,152,33,0.5608856088560885
N ROYALTON,OH,929,908,-21,0.49428415895481764
N SAINT PAUL,MN,354,360,6,0.5042016806722689
N SALT LAKE,UT,537,407,-130,0.4311440677966102
N SAN JUAN,CA,75,26,-49,0.25742574257425743
N SCITUATE,RI,172,190,18,0.5248618784530387
N SHAPLEIGH,ME,74,91,17,0.5515151515151515
N SIOUX CITY,SD,656,564,-92,0.46229508196721314
N SMITHFIELD,RI,696,752,56,0.5193370165745856
N SPRINGFIELD,VA,78,93,15,0.543859649122807
N SPRINGFIELD,VT,16,60,44,0.7894736842105263
N STONINGTON,CT,143,145,2,0.5034722222222222
N STRATFORD,NH,0,12,12,1
N TARRYTOWN,NY,284,260,-24,0.47794117647058826
N TAZEWELL,VA,181,181,0,0.5
N TOPSAIL BEACH,NC,1024,1092,68,0.5160680529300568
N UXBRIDGE,MA,17,0,-17,0
N VASSALBORO,ME,14,0,-14,0
N VERSAILLES,PA,107,62,-45,0.3668639053254438
N WATERBORO,ME,146,237,91,0.618798955613577
N WEYMOUTH,MA,184,169,-15,0.47875354107648727
N WHITE PLAINS,NY,276,218,-58,0.44129554655870445
N WILDWOOD,NJ,147,96,-51,0.3950617283950617
N WILKESBORO,NC,88,71,-17,0.44654088050314467
N WINDHAM,ME,451,512,61,0.5316718587746625
N WOODSTOCK,NH,97,39,-58,0.2867647058823529
N YARMOUTH,ME,100,119,19,0.54337899543379
NAALEHU,HI,926,1263,337,0.5769757880310644
NABB,IN,59,121,62,0.6722222222222223
NACHES,WA,2380,1554,-826,0.39501779359430605
NACO,AZ,0,26,26,1
NACOGDOCHES,TX,19217,16133,-3084,0.45637906647807636
NAGS HEAD,NC,1996,1910,-86,0.48899129544290837
NAHANT,MA,1412,1403,-9,0.4984014209591474
NAHCOTTA,WA,12,0,-12,0
NAHUNTA,GA,1759,1816,57,0.507972027972028
NAKINA,NC,102,128,26,0.5565217391304348
NAKNEK,AK,137,177,40,0.5636942675159236
NALCREST,FL,713,671,-42,0.4848265895953757
NAMPA,ID,52140,55575,3435,0.5159448544770924
NANCY,KY,2251,2341,90,0.5097996515679443
NANJEMOY,MD,486,462,-24,0.4873417721518987
NANTICOKE,MD,15,0,-15,0
NANTICOKE,PA,6000,5544,-456,0.4802494802494803
NANTUCKET,MA,8493,8828,335,0.5096703423589862
NANTY GLO,PA,1130,1052,-78,0.4821264894592117
NANUET,NY,6864,6564,-300,0.48882931188561213
NAOMA,WV,11,15,4,0.5769230769230769
NAPA,CA,34183,32514,-1669,0.48748819287224315
NAPANOCH,NY,1019,881,-138,0.4636842105263158
NAPAVINE,WA,522,456,-66,0.4662576687116564
NAPERVILLE,IL,57968,59210,1242,0.5052996296233081
NAPLES,FL,302889,339489,36600,0.5284878996478709
NAPLES,ID,660,775,115,0.5400696864111498
NAPLES,IL,13,0,-13,0
NAPLES,ME,2688,2884,196,0.5175879396984925
NAPLES,NC,28,0,-28,0
NAPLES,NY,2086,1840,-246,0.4686704024452369
NAPLES,TX,899,981,82,0.5218085106382979
NAPOLEON,MI,146,24,-122,0.1411764705882353
NAPOLEON,ND,201,68,-133,0.2527881040892193
NAPOLEON,OH,5083,4763,-320,0.48374974608978266
NAPOLEONVILLE,LA,1158,1224,66,0.5138539042821159
NAPPANEE,IN,4612,3900,-712,0.4581766917293233
NARANJA,FL,18,27,9,0.6
NARBERTH,PA,3154,3107,-47,0.4962466059734867
NARRAGANSETT,RI,7166,7407,241,0.5082687161188499
NARROWS,VA,1475,1537,62,0.5102921646746348
NARROWSBURG,NY,668,853,185,0.5608152531229454
NARVON,PA,1358,1345,-13,0.4975952645209027
NASELLE,WA,828,376,-452,0.3122923588039867
NASH,TX,3096,1949,-1147,0.3863230921704658
NASHOTAH,WI,1396,1447,51,0.5089693985226873
NASHPORT,OH,2177,2094,-83,0.49028330601732617
NASHUA,IA,899,681,-218,0.4310126582278481
NASHUA,MT,11,26,15,0.7027027027027027
NASHUA,NH,45255,40108,-5147,0.46985227791900475
NASHVILLE,AR,4832,3766,-1066,0.4380088392649453
NASHVILLE,GA,4330,4241,-89,0.4948080737370202
NASHVILLE,IL,1640,1629,-11,0.49831752829611503
NASHVILLE,IN,3298,3262,-36,0.4972560975609756
NASHVILLE,MI,1848,1789,-59,0.4918889194390982
NASHVILLE,NC,3837,4240,403,0.5249473814535099
NASHVILLE,OH,0,13,13,1
NASHVILLE,TN,295818,260168,-35650,0.4679398402118039
NASHWAUK,MN,875,929,54,0.5149667405764967
NASON,IL,0,12,12,1
NASSAU,DE,239,265,26,0.5257936507936508
NASSAU,NY,1727,1794,67,0.5095143425163305
NASSAWADOX,VA,39,25,-14,0.390625
NATALBANY,LA,72,237,165,0.7669902912621359
NATALIA,TX,1110,1399,289,0.5575926664009565
NATCHEZ,LA,34,137,103,0.8011695906432749
NATCHEZ,MS,7514,7361,-153,0.4948571428571429
NATCHITOCHES,LA,10100,8852,-1248,0.46707471506964965
NATHALIE,VA,1110,1112,2,0.5004500450045004
NATHROP,CO,719,777,58,0.5193850267379679
NATICK,MA,13727,13031,-696,0.48699454368786904
NATIONAL CITY,CA,21800,17718,-4082,0.44835264942557823
NATIONAL CITY,MI,1020,986,-34,0.4915254237288136
NATIONAL PARK,NJ,798,797,-1,0.49968652037617556
NATOMA,KS,22,0,-22,0
NATRONA HEIGHTS,PA,3663,3309,-354,0.47461273666092946
NATRONA HTS,PA,72,86,14,0.5443037974683544
NATURAL BRIDGE,NY,147,133,-14,0.475
NATURAL BRIDGE,VA,38,66,28,0.6346153846153846
NATURAL BRIDGE STATION,VA,218,196,-22,0.47342995169082125
NATURITA,CO,67,23,-44,0.25555555555555554
NAUBINWAY,MI,240,214,-26,0.4713656387665198
NAUGATUCK,CT,11195,10881,-314,0.4928882043848523
NAUVOO,AL,1593,1426,-167,0.4723418350447168
NAUVOO,IL,566,829,263,0.5942652329749104
NAVAJO,NM,14,0,-14,0
NAVAJO DAM,NM,15,0,-15,0
NAVAL AIR STATION JRB,TX,36,23,-13,0.3898305084745763
NAVAL BASE,VA,0,15,15,1
NAVARRE,FL,20796,22698,1902,0.5218650848392882
NAVARRE,OH,2779,2658,-121,0.4888725400036785
NAVASOTA,TX,4698,4579,-119,0.49358628867090654
NAVESINK,NJ,16,0,-16,0
NAYLOR,GA,368,410,42,0.5269922879177378
NAYLOR,MO,533,397,-136,0.4268817204301075
NAYTAHWAUSH,MN,105,49,-56,0.3181818181818182
NAZARETH,MI,13,11,-2,0.4583333333333333
NAZARETH,PA,6197,6981,784,0.5297465472757626
NAZARETH,TX,0,11,11,1
NE HARBOR,ME,0,21,21,1
NEAH BAY,WA,106,11,-95,0.09401709401709402
NEBO,IL,28,11,-17,0.28205128205128205
NEBO,KY,222,317,95,0.588126159554731
NEBO,NC,2276,2719,443,0.5443443443443443
NEBRASKA CITY,NE,4850,3903,-947,0.4459042613960928
NECEDAH,WI,1995,1876,-119,0.484629294755877
NECHE,ND,11,0,-11,0
NEDERLAND,CO,2385,1955,-430,0.4504608294930876
NEDERLAND,TX,9115,7892,-1223,0.46404421708708177
NEDROW,NY,545,492,-53,0.47444551591128253
NEEDHAM,AL,0,13,13,1
NEEDHAM,IN,0,12,12,1
NEEDHAM,MA,6100,7231,1131,0.5424199234866102
NEEDHAM HEIGHTS,MA,2969,3181,212,0.5172357723577236
NEEDHAM HGTS,MA,190,217,27,0.5331695331695332
NEEDLES,CA,3435,3099,-336,0.47428833792470154
NEEDMORE,PA,209,264,55,0.5581395348837209
NEEDVILLE,TX,2395,2816,421,0.5403953175973901
NEELYVILLE,MO,227,174,-53,0.4339152119700748
NEENAH,WI,18382,18042,-340,0.4953327476389194
NEESES,SC,401,489,88,0.549438202247191
NEFFS,PA,11,0,-11,0
NEGAUNEE,MI,3229,2915,-314,0.4744466145833333
NEGLEY,OH,261,230,-31,0.4684317718940937
NEHALEM,OR,1023,1125,102,0.5237430167597765
NEHAWKA,NE,23,0,-23,0
NEILLSVILLE,WI,2623,2387,-236,0.47644710578842314
NEKOOSA,WI,4539,4104,-435,0.4748351266921208
NELIGH,NE,681,708,27,0.509719222462203
NELLIS AFB,NV,3801,1353,-2448,0.26251455180442373
NELLISTON,NY,11,0,-11,0
NELLYSFORD,VA,782,926,144,0.5421545667447307
NELSON,MN,12,0,-12,0
NELSON,NE,93,83,-10,0.4715909090909091
NELSON,NH,108,119,11,0.5242290748898678
NELSON,VA,0,13,13,1
NELSON,WI,45,29,-16,0.3918918918918919
NELSONVILLE,NY,38,46,8,0.5476190476190477
NELSONVILLE,OH,4290,3423,-867,0.44379618825359785
NEMACOLIN,PA,166,98,-68,0.3712121212121212
NEMO,SD,91,76,-15,0.4550898203592814
NEMO,TX,0,36,36,1
NENANA,AK,72,77,5,0.5167785234899329
NEODESHA,KS,1744,1555,-189,0.47135495604728705
NEOGA,IL,1171,982,-189,0.45610775661867164
NEOLA,IA,296,307,11,0.5091210613598673
NEOLA,UT,0,23,23,1
NEON,KY,119,77,-42,0.39285714285714285
NEOPIT,WI,95,0,-95,0
NEOSHO,MO,10031,9738,-293,0.49258940765845516
NEOSHO,WI,313,251,-62,0.4450354609929078
NEOSHO RAPIDS,KS,13,22,9,0.6285714285714286
NEOTSU,OR,950,726,-224,0.4331742243436754
NEPHI,UT,1809,2048,239,0.5309826289862587
NEPONSET,IL,27,50,23,0.6493506493506493
NEPONSIT,NY,388,409,21,0.5131744040150564
NEPTUNE,NJ,8750,8842,92,0.5026148249204184
NEPTUNE BEACH,FL,3374,3113,-261,0.4798828426082935
NEPTUNE CITY,NJ,489,471,-18,0.490625
NERSTRAND,MN,23,46,23,0.6666666666666666
NESBIT,MS,2097,2933,836,0.5831013916500994
NESCONSET,NY,3497,3514,17,0.5012123805448581
NESCOPECK,PA,1371,1300,-71,0.4867090977162112
NESHANIC STA,NJ,39,35,-4,0.47297297297297297
NESHANIC STATION,NJ,245,325,80,0.5701754385964912
NESHKORO,WI,1138,1062,-76,0.4827272727272727
NESKOWIN,OR,496,498,2,0.5010060362173038
NESMITH,SC,0,23,23,1
NESPELEM,WA,48,56,8,0.5384615384615384
NESQUEHONING,PA,1838,1601,-237,0.4655423088107008
NESS CITY,KS,747,515,-232,0.4080824088748019
NETARTS,OR,0,12,12,1
NETAWAKA,KS,11,0,-11,0
NETCONG,NJ,1329,1251,-78,0.4848837209302326
NETTIE,WV,82,157,75,0.6569037656903766
NETTLETON,MS,2114,1690,-424,0.4442691903259727
NEVADA,IA,4087,3425,-662,0.455937167199148
NEVADA,MO,8606,7157,-1449,0.45403793694093764
NEVADA,OH,332,382,50,0.5350140056022409
NEVADA,TX,1946,2449,503,0.5572241183162685
NEVADA CITY,CA,7482,7346,-136,0.49541408146749394
NEVERSINK,NY,59,43,-16,0.4215686274509804
NEVILS,GA,105,105,0,0.5
NEVIS,MN,1881,1689,-192,0.473109243697479
NEW ALBANY,IN,26398,22242,-4156,0.4572779605263158
NEW ALBANY,MS,6132,5103,-1029,0.4542056074766355
NEW ALBANY,OH,12986,12971,-15,0.49971106060022347
NEW ALBANY,PA,631,458,-173,0.42056932966023874
NEW ALBIN,IA,36,11,-25,0.23404255319148937
NEW ALEXANDRI,PA,32,25,-7,0.43859649122807015
NEW ALEXANDRIA,PA,1107,945,-162,0.4605263157894737
NEW ATHENS,IL,891,795,-96,0.47153024911032027
NEW AUBURN,MN,34,0,-34,0
NEW AUBURN,WI,1577,1432,-145,0.4759056164838817
NEW AUGUSTA,MS,16,34,18,0.68
NEW BADEN,IL,1532,1297,-235,0.45846588900671614
NEW BALTIMORE,MI,8639,8050,-589,0.48235364611420695
NEW BALTIMORE,NY,12,0,-12,0
NEW BEDFORD,MA,39507,35314,-4193,0.47197979176969035
NEW BERLIN,IL,783,795,12,0.5038022813688213
NEW BERLIN,NY,1381,1285,-96,0.48199549887471865
NEW BERLIN,PA,237,109,-128,0.31502890173410403
NEW BERLIN,WI,13382,13565,183,0.5033955542360931
NEW BERN,NC,32014,29943,-2071,0.48328679568087546
NEW BETHLEHEM,PA,1348,1270,-78,0.4851031321619557
NEW BLAINE,AR,38,111,73,0.7449664429530202
NEW BLOOMFIELD,MO,940,1097,157,0.5385370643102602
NEW BLOOMFIELD,PA,1311,1322,11,0.5020888720091151
NEW BLOOMINGTON,OH,26,17,-9,0.3953488372093023
NEW BOSTON,IL,224,172,-52,0.43434343434343436
NEW BOSTON,MI,2586,2620,34,0.5032654629273915
NEW BOSTON,NH,1599,1726,127,0.5190977443609023
NEW BOSTON,PA,64,73,9,0.5328467153284672
NEW BOSTON,TX,4159,3365,-794,0.4472355130249867
NEW BRAINTREE,MA,33,43,10,0.5657894736842105
NEW BRAUNFELS,TX,55122,66395,11273,0.5463844564957989
NEW BREMEN,OH,909,790,-119,0.4649793996468511
NEW BRIGHTON,MN,4431,4076,-355,0.4791348301398848
NEW BRIGHTON,PA,4780,3886,-894,0.44841910916224326
NEW BRITAIN,CT,37032,33631,-3401,0.4759350721027978
NEW BRITAIN,PA,195,225,30,0.5357142857142857
NEW BROCKTON,AL,1180,1195,15,0.5031578947368421
NEW BRUNSWICK,NJ,16443,12259,-4184,0.4271130931642394
NEW BUFFALO,MI,2620,2418,-202,0.4799523620484319
NEW CAMBRIA,KS,0,12,12,1
NEW CAMBRIA,MO,15,11,-4,0.4230769230769231
NEW CANAAN,CT,7227,8528,1301,0.5412884798476674
NEW CANADA,ME,92,90,-2,0.4945054945054945
NEW CANEY,TX,8588,12984,4396,0.6018913406267383
NEW CANTON,IL,12,23,11,0.6571428571428571
NEW CANTON,VA,271,309,38,0.5327586206896552
NEW CARLISLE,IN,2113,2080,-33,0.4960648700214643
NEW CARLISLE,OH,5059,4753,-306,0.48440684875662454
NEW CARROLLTN,MD,746,649,-97,0.4652329749103943
NEW CARROLLTON,MD,5568,4510,-1058,0.44750942647350667
NEW CASTLE,CO,4028,2954,-1074,0.4230879404182183
NEW CASTLE,DE,18632,17300,-1332,0.4814649894244684
NEW CASTLE,IN,12748,11950,-798,0.4838448457364969
NEW CASTLE,KY,767,667,-100,0.46513249651324967
NEW CASTLE,NH,399,489,90,0.5506756756756757
NEW CASTLE,PA,18072,17198,-874,0.4876098667422739
NEW CASTLE,VA,1154,1188,34,0.5072587532023911
NEW CHURCH,VA,488,472,-16,0.49166666666666664
NEW CITY,NY,8041,8264,223,0.5068383931309415
NEW COLUMBIA,PA,987,871,-116,0.468783638320775
NEW CONCORD,KY,268,372,104,0.58125
NEW CONCORD,OH,1406,1311,-95,0.4825174825174825
NEW CREEK,WV,125,122,-3,0.4939271255060729
NEW CUMBERLAND,PA,6503,6491,-12,0.4995382484223488
NEW CUMBERLAND,WV,1444,1452,8,0.5013812154696132
NEW CUYAMA,CA,0,34,34,1
NEW DEAL,TX,0,68,68,1
NEW DERRY,PA,24,0,-24,0
NEW DOUGLAS,IL,33,23,-10,0.4107142857142857
NEW DURHAM,NH,1163,1089,-74,0.4835701598579041
NEW EAGLE,PA,630,620,-10,0.496
NEW EDINBURG,AR,12,37,25,0.7551020408163265
NEW EFFINGTON,SD,11,0,-11,0
NEW EGYPT,NJ,1624,1870,246,0.5352032054951346
NEW ELLENTON,SC,762,835,73,0.5228553537883531
NEW ENGLAND,ND,659,133,-526,0.16792929292929293
NEW ENTERPRISE,PA,153,128,-25,0.4555160142348754
NEW ERA,MI,788,803,15,0.5047140163419234
NEW FAIRFIELD,CT,3481,4165,684,0.544729270206644
NEW FLORENCE,MO,384,428,44,0.5270935960591133
NEW FLORENCE,PA,739,642,-97,0.46488052136133234
NEW FRANKEN,WI,1310,1204,-106,0.4789180588703262
NEW FRANKLIN,MO,448,373,-75,0.4543239951278928
NEW FRANKLIN,OH,2029,1836,-193,0.4750323415265201
NEW FREEDOM,PA,2108,2368,260,0.5290437890974083
NEW FREEPORT,PA,75,38,-37,0.336283185840708
NEW GALILEE,PA,233,147,-86,0.3868421052631579
NEW GERMANY,MN,67,36,-31,0.34951456310679613
NEW GLARUS,WI,1339,1326,-13,0.4975609756097561
NEW GLOUCESTER,ME,1794,1964,170,0.5226184140500266
NEW GRETNA,NJ,27,0,-27,0
NEW HAMPTON,IA,1749,1663,-86,0.48739742086752635
NEW HAMPTON,MO,43,25,-18,0.36764705882352944
NEW HAMPTON,NH,910,971,61,0.5162147793726741
NEW HAMPTON,NY,916,822,-94,0.47295742232451093
NEW HARBOR,ME,731,850,119,0.5376344086021505
NEW HARMONY,IN,630,552,-78,0.467005076142132
NEW HARMONY,UT,319,566,247,0.63954802259887
NEW HARTFORD,CT,1974,2110,136,0.5166503428011753
NEW HARTFORD,IA,231,181,-50,0.4393203883495146
NEW HARTFORD,MO,11,18,7,0.6206896551724138
NEW HARTFORD,NY,5820,5623,-197,0.4913921174517172
NEW HAVEN,CT,70605,58475,-12130,0.45301363495506664
NEW HAVEN,IL,47,34,-13,0.41975308641975306
NEW HAVEN,IN,7258,6239,-1019,0.462250870563829
NEW HAVEN,KY,1409,1351,-58,0.4894927536231884
NEW HAVEN,MI,3086,3336,250,0.5194643413266895
NEW HAVEN,MO,1218,1328,110,0.5216025137470542
NEW HAVEN,OH,11,0,-11,0
NEW HAVEN,VT,659,518,-141,0.44010195412064573
NEW HAVEN,WV,173,104,-69,0.37545126353790614
NEW HILL,NC,858,2455,1597,0.7410202233625113
NEW HOLLAND,IL,26,15,-11,0.36585365853658536
NEW HOLLAND,OH,469,403,-66,0.46215596330275227
NEW HOLLAND,PA,4160,4071,-89,0.4945936095249666
NEW HOLSTEIN,WI,1623,1462,-161,0.4739059967585089
NEW HOME,TX,49,104,55,0.6797385620915033
NEW HOPE,AL,1625,1707,82,0.5123049219687875
NEW HOPE,MN,2467,2195,-272,0.47082797082797084
NEW HOPE,PA,4725,5641,916,0.5441829056530967
NEW HUDSON,MI,3104,3056,-48,0.4961038961038961
NEW HYDE PARK,NY,7818,8010,192,0.5060652009097801
NEW IBERIA,LA,18121,16532,-1589,0.47707269211900843
NEW IPSWICH,NH,1557,1610,53,0.5083675402589201
NEW JERSEY,NJ,49,62,13,0.5585585585585585
NEW JOHNSONVILLE,TN,1313,1177,-136,0.47269076305220886
NEW JOHSONVLE,TN,20,34,14,0.6296296296296297
NEW KENSINGTON,PA,10103,10215,112,0.502756176789054
NEW KENT,VA,1113,2022,909,0.6449760765550239
NEW KINGSTON,NY,11,16,5,0.5925925925925926
NEW KINGSTOWN,PA,210,11,-199,0.049773755656108594
NEW KNOXVILLE,OH,144,223,79,0.6076294277929155
NEW LEBANON,NY,316,468,152,0.5969387755102041
NEW LEBANON,OH,2054,1929,-125,0.48430831031885513
NEW LENOX,IL,9186,9124,-62,0.49830693610049154
NEW LEXINGTON,OH,2948,2927,-21,0.4982127659574468
NEW LIBERTY,KY,0,11,11,1
NEW LIMERICK,ME,77,40,-37,0.3418803418803419
NEW LISBON,WI,2266,2265,-1,0.4998896490840874
NEW LLANO,LA,1300,1208,-92,0.48165869218500795
NEW LONDON,CT,17689,14282,-3407,0.4467173375871884
NEW LONDON,IA,1087,916,-171,0.45731402895656514
NEW LONDON,MN,1813,1794,-19,0.4973662323260327
NEW LONDON,MO,1349,1323,-26,0.49513473053892215
NEW LONDON,NC,1867,2285,418,0.5503371868978806
NEW LONDON,NH,2380,2467,87,0.5089746234784402
NEW LONDON,OH,1908,1826,-82,0.48901981788966253
NEW LONDON,WI,6271,5132,-1139,0.45005700254319037
NEW LOTHROP,MI,613,475,-138,0.4365808823529412
NEW MADISON,OH,504,419,-85,0.4539544962080173
NEW MADRID,MO,1556,1381,-175,0.47020769492679604
NEW MARKET,AL,4254,4680,426,0.5238415043653458
NEW MARKET,IA,43,12,-31,0.21818181818181817
NEW MARKET,IN,23,0,-23,0
NEW MARKET,MD,4082,6545,2463,0.6158840688811518
NEW MARKET,MN,50,59,9,0.5412844036697247
NEW MARKET,TN,2409,2572,163,0.5163621762698254
NEW MARKET,VA,1722,1713,-9,0.49868995633187774
NEW MARLBOROUGH,MA,104,66,-38,0.38823529411764707
NEW MARSHFIELD,OH,184,73,-111,0.2840466926070039
NEW MARTINSVILLE,WV,3237,2957,-280,0.47739748143364547
NEW MATAMORAS,OH,813,606,-207,0.427061310782241
NEW MEADOWS,ID,1053,882,-171,0.4558139534883721
NEW MIDDLETOWN,IN,0,11,11,1
NEW MIDDLETOWN,OH,1193,1111,-82,0.4822048611111111
NEW MILFORD,CT,9286,9262,-24,0.4993530299762778
NEW MILFORD,NJ,4801,4275,-526,0.4710224768620538
NEW MILFORD,PA,1399,1210,-189,0.46377922575699504
NEW MILLPORT,PA,0,11,11,1
NEW MONMOUTH,NJ,405,465,60,0.5344827586206896
NEW MUNICH,MN,13,0,-13,0
NEW ORLEANS,LA,162306,145184,-17122,0.4721584441770464
NEW OXFORD,PA,4421,4183,-238,0.4861692236169224
NEW PALESTINE,IN,3574,4500,926,0.5573445627941541
NEW PALTZ,NY,6178,5888,-290,0.4879827614785347
NEW PARIS,IN,961,1061,100,0.5247279920870426
NEW PARIS,OH,1602,1296,-306,0.4472049689440994
NEW PARIS,PA,677,493,-184,0.42136752136752137
NEW PARK,PA,87,39,-48,0.30952380952380953
NEW PHILADELPHIA,OH,10772,9397,-1375,0.46591303485547125
NEW PHILADELPHIA,PA,378,359,-19,0.4871099050203528
NEW PINE CREEK,OR,22,0,-22,0
NEW PLYMOUTH,ID,1855,1711,-144,0.4798093101514302
NEW PLYMOUTH,OH,51,37,-14,0.42045454545454547
NEW POINT,IN,27,0,-27,0
NEW PORT RICHEY,FL,72979,76680,3701,0.5123647759239337
NEW PORTLAND,ME,175,195,20,0.527027027027027
NEW PRAGUE,MN,4196,4197,1,0.5000595734540688
NEW PRESTON,CT,139,161,22,0.5366666666666666
NEW PRESTON MARBLE DALE,CT,403,337,-66,0.4554054054054054
NEW PROVIDENCE,IA,17,28,11,0.6222222222222222
NEW PROVIDENCE,NJ,3233,3592,359,0.5263003663003663
NEW PROVIDENCE,PA,1252,1251,-1,0.49980023971234516
NEW RICHLAND,MN,765,592,-173,0.43625644804716285
NEW RICHMOND,IN,11,24,13,0.6857142857142857
NEW RICHMOND,OH,2901,3208,307,0.5251268620068751
NEW RICHMOND,WI,7505,8349,844,0.5266178882300997
NEW RIEGEL,OH,12,49,37,0.8032786885245902
NEW RINGGOLD,PA,1100,1002,-98,0.47668886774500474
NEW RIVER,AZ,2978,4004,1026,0.5734746490976798
NEW ROADS,LA,2195,1923,-272,0.4669742593491986
NEW ROCHELLE,NY,20746,19964,-782,0.4903954802259887
NEW ROCKFORD,ND,783,634,-149,0.44742413549753
NEW ROSS,IN,74,74,0,0.5
NEW SALEM,MA,11,25,14,0.6944444444444444
NEW SALEM,ND,265,374,109,0.5852895148669797
NEW SALEM,PA,855,554,-301,0.39318665720369056
NEW SALISBURY,IN,1406,1307,-99,0.4817545152967195
NEW SHARON,IA,700,603,-97,0.46277820414428245
NEW SHARON,ME,439,462,23,0.5127635960044395
NEW SHOREHAM,RI,63,14,-49,0.18181818181818182
NEW SITE,AL,38,36,-2,0.4864864864864865
NEW SMYRNA,FL,83,90,7,0.5202312138728323
NEW SMYRNA BEACH,FL,28278,37837,9559,0.5722907055887468
NEW SPRINGFIELD,OH,409,403,-6,0.4963054187192118
NEW STANTON,PA,1276,1113,-163,0.4658853076601088
NEW STRAITSVILLE,OH,301,337,36,0.5282131661442007
NEW STRAITSVL,OH,18,13,-5,0.41935483870967744
NEW STRAWN,KS,121,111,-10,0.47844827586206895
NEW SUFFOLK,NY,34,15,-19,0.30612244897959184
NEW SWEDEN,ME,29,23,-6,0.4423076923076923
NEW TAZEWELL,TN,4024,3526,-498,0.4670198675496689
NEW TOWN,MA,12,0,-12,0
NEW TOWN,ND,1712,1304,-408,0.4323607427055703
NEW TRIER,MN,27,40,13,0.5970149253731343
NEW TRIPOLI,PA,1320,1442,122,0.5220854453294714
NEW ULM,MN,6582,5767,-815,0.4670013766296866
NEW ULM,TX,268,452,184,0.6277777777777778
NEW UNDERWOOD,SD,192,196,4,0.5051546391752577
NEW VERNON,NJ,235,309,74,0.5680147058823529
NEW VIENNA,IA,0,11,11,1
NEW VIENNA,OH,1087,1066,-21,0.4951230840687413
NEW VINEYARD,ME,92,121,29,0.568075117370892
NEW VIRGINIA,IA,348,346,-2,0.49855907780979825
NEW WASHINGTN,IN,12,0,-12,0
NEW WASHINGTON,IN,63,58,-5,0.4793388429752066
NEW WASHINGTON,OH,454,370,-84,0.44902912621359226
NEW WATERFORD,OH,852,808,-44,0.4867469879518072
NEW WAVERLY,TX,1632,1929,297,0.5417017691659646
NEW WHITELAND,IN,367,382,15,0.5100133511348465
NEW WILMINGTON,PA,1424,1349,-75,0.4864767399927876
NEW WILMNGTN,PA,23,30,7,0.5660377358490566
NEW WINDSOR,IL,245,150,-95,0.379746835443038
NEW WINDSOR,MD,1350,1635,285,0.5477386934673367
NEW WINDSOR,NY,9368,9145,-223,0.4939772052071517
NEW WOODSTOCK,NY,199,139,-60,0.41124260355029585
NEW YORK,NY,974013,681542,-292471,0.41166980257375924
NEW YORK CITY,NY,141,120,-21,0.45977011494252873
NEW YORK MILLS,MN,1194,1099,-95,0.4792847797645007
NEW YORK MILLS,NY,1102,974,-128,0.46917148362235067
NEW YORK MLS,NY,159,139,-20,0.4664429530201342
NEW ZION,SC,47,70,23,0.5982905982905983
NEWAGEN,ME,0,227,227,1
NEWALD,WI,0,14,14,1
NEWALLA,OK,2873,2963,90,0.5077107607950652
NEWARK,AR,1027,969,-58,0.48547094188376755
NEWARK,CA,15966,16782,816,0.5124587761084647
NEWARK,DE,51461,44547,-6914,0.4639925839513374
NEWARK,IL,698,858,160,0.5514138817480719
NEWARK,MD,14,56,42,0.8
NEWARK,NJ,83898,71935,-11963,0.4616159606758517
NEWARK,NY,6795,6215,-580,0.4777094542659493
NEWARK,OH,28966,25970,-2996,0.47273190621814476
NEWARK,TX,1655,2180,525,0.5684485006518905
NEWARK VALLEY,NY,1340,1293,-47,0.4910748195974174
NEWAYGO,MI,6159,6055,-104,0.4957425904699525
NEWBERG,OR,12643,11910,-733,0.48507310715594837
NEWBERN,AL,0,13,13,1
NEWBERN,TN,3859,2731,-1128,0.4144157814871017
NEWBERRY,FL,5675,7792,2117,0.578599539615356
NEWBERRY,IN,24,34,10,0.5862068965517241
NEWBERRY,MI,2168,1941,-227,0.47237770747140423
NEWBERRY,SC,5894,5632,-262,0.48863439180982127
NEWBERRY SPGS,CA,45,74,29,0.6218487394957983
NEWBERRY SPRINGS,CA,745,736,-9,0.49696151249155973
NEWBORN,GA,564,693,129,0.5513126491646778
NEWBURG,MD,730,960,230,0.5680473372781065
NEWBURG,MO,734,738,4,0.501358695652174
NEWBURG,PA,752,615,-137,0.4498902706656913
NEWBURG,WV,12,26,14,0.6842105263157895
NEWBURGH,IN,15542,15502,-40,0.49935575312459735
NEWBURGH,ME,405,406,1,0.5006165228113441
NEWBURGH,NY,20473,19498,-975,0.48780365765179756
NEWBURGH HEIGHTS,OH,336,293,-43,0.465818759936407
NEWBURY,CA,274,231,-43,0.45742574257425744
NEWBURY,MA,1294,1444,150,0.5273922571219869
NEWBURY,NH,1392,1232,-160,0.4695121951219512
NEWBURY,OH,1199,1119,-80,0.4827437446074202
NEWBURY,VT,171,132,-39,0.43564356435643564
NEWBURY PARK,CA,11962,11998,36,0.5007512520868114
NEWBURYPORT,MA,8181,7953,-228,0.4929341762737077
NEWCASTLE,CA,2419,2356,-63,0.49340314136125657
NEWCASTLE,ME,912,990,78,0.5205047318611987
NEWCASTLE,NE,11,13,2,0.5416666666666666
NEWCASTLE,OK,3451,5006,1555,0.5919356745890978
NEWCASTLE,TX,141,205,64,0.5924855491329479
NEWCASTLE,WA,4941,4935,-6,0.4996962332928311
NEWCASTLE,WY,2394,2216,-178,0.4806941431670282
NEWCOMB,NY,103,45,-58,0.30405405405405406
NEWCOMB,TN,0,11,11,1
NEWCOMERSTOWN,OH,2620,2621,1,0.5000954016409083
NEWDALE,ID,0,11,11,1
NEWELL,AL,134,162,28,0.5472972972972973
NEWELL,IA,296,333,37,0.5294117647058824
NEWELL,NC,0,11,11,1
NEWELL,PA,14,0,-14,0
NEWELL,SD,359,257,-102,0.4172077922077922
NEWELL,WV,668,232,-436,0.2577777777777778
NEWELLTON,LA,179,137,-42,0.43354430379746833
NEWFANE,NY,1795,1659,-136,0.48031268094962365
NEWFANE,VT,534,484,-50,0.47544204322200395
NEWFIELD,NJ,1361,1461,100,0.5177179305457122
NEWFIELD,NY,3126,2309,-817,0.42483900643974243
NEWFIELDS,NH,284,420,136,0.5965909090909091
NEWFOLDEN,MN,62,90,28,0.5921052631578947
NEWFOUNDLAND,NJ,736,881,145,0.5448361162646876
NEWFOUNDLAND,PA,993,775,-218,0.43834841628959276
NEWHALL,CA,9243,8576,-667,0.4812840226724283
NEWHALL,IA,268,105,-163,0.28150134048257375
NEWHEBRON,MS,165,228,63,0.5801526717557252
NEWINGTON,CT,9297,9190,-107,0.49710607453886513
NEWINGTON,GA,69,264,195,0.7927927927927928
NEWINGTON,NH,276,269,-7,0.4935779816513762
NEWINGTON,VA,14,11,-3,0.44
NEWKIRK,OK,1229,1275,46,0.509185303514377
NEWLAND,NC,3418,4174,756,0.5497892518440464
NEWMAN,CA,3157,3011,-146,0.4881647211413748
NEWMAN,IL,420,215,-205,0.33858267716535434
NEWMAN GROVE,NE,123,97,-26,0.4409090909090909
NEWMAN LAKE,WA,1640,1906,266,0.5375070501974055
NEWMANSTOWN,PA,1253,1332,79,0.5152804642166344
NEWMARKET,NH,5244,4599,-645,0.46723559890277355
NEWNAN,GA,36062,39479,3417,0.5226168570709946
NEWPORT,AR,5262,4238,-1024,0.4461052631578947
NEWPORT,DE,323,303,-20,0.4840255591054313
NEWPORT,IN,15,0,-15,0
NEWPORT,KY,9115,8117,-998,0.4710422469823584
NEWPORT,ME,2050,1961,-89,0.48890550984791825
NEWPORT,MI,5149,5367,218,0.5103651578546976
NEWPORT,MN,1796,2088,292,0.537590113285273
NEWPORT,NC,8125,8649,524,0.5156194109932037
NEWPORT,NH,3666,3498,-168,0.4882747068676717
NEWPORT,NJ,68,25,-43,0.26881720430107525
NEWPORT,NY,428,462,34,0.5191011235955056
NEWPORT,OH,450,235,-215,0.34306569343065696
NEWPORT,OR,7188,7458,270,0.5092175337976239
NEWPORT,PA,2762,2366,-396,0.46138845553822155
NEWPORT,RI,15596,14673,-923,0.4847533780435429
NEWPORT,TN,8746,9483,737,0.520215041966098
NEWPORT,VA,518,394,-124,0.43201754385964913
NEWPORT,VT,4194,3764,-430,0.47298316159839154
NEWPORT,WA,4476,4308,-168,0.49043715846994534
NEWPORT BEACH,CA,42575,41608,-967,0.49425656011308694
NEWPORT CENTER,VT,535,553,18,0.5082720588235294
NEWPORT COAST,CA,4087,4456,369,0.5215966288189161
NEWPORT CTR,VT,50,31,-19,0.38271604938271603
NEWPORT NEWS,VA,98206,87735,-10471,0.47184321908562393
NEWRY,ME,136,237,101,0.6353887399463807
NEWRY,PA,34,0,-34,0
NEWRY,SC,13,0,-13,0
NEWSOMS,VA,11,11,0,0.5
NEWTON,AL,2007,1849,-158,0.4795124481327801
NEWTON,GA,371,344,-27,0.4811188811188811
NEWTON,IA,10119,9583,-536,0.4863973200690285
NEWTON,IL,1868,1725,-143,0.4801001948232675
NEWTON,KS,11911,9393,-2518,0.4409031167855802
NEWTON,MA,8360,7692,-668,0.4791926239720907
NEWTON,MS,1401,1340,-61,0.488872674206494
NEWTON,NC,7759,7874,115,0.5036781168041963
NEWTON,NH,1317,1370,53,0.5098622999627838
NEWTON,NJ,7130,7744,614,0.5206400430281027
NEWTON,TX,1584,1356,-228,0.46122448979591835
NEWTON,UT,14,0,-14,0
NEWTON,WI,95,126,31,0.5701357466063348
NEWTON,WV,23,0,-23,0
NEWTON CENTER,MA,4691,5005,314,0.5161922442244224
NEWTON CENTRE,MA,451,488,37,0.5197018104366348
NEWTON FALLS,NY,27,0,-27,0
NEWTON FALLS,OH,3964,3548,-416,0.47231096911608095
NEWTON GROVE,NC,1014,1014,0,0.5
NEWTON HIGHLANDS,MA,2001,2090,89,0.5108775360547544
NEWTON HLDS,MA,97,82,-15,0.4581005586592179
NEWTON JUNCTION,NH,0,11,11,1
NEWTON L F,MA,52,35,-17,0.40229885057471265
NEWTON LOWER FALLS,MA,358,280,-78,0.438871473354232
NEWTON U F,MA,121,125,4,0.508130081300813
NEWTON UPPER FALLS,MA,1216,1046,-170,0.4624226348364279
NEWTONSVILLE,OH,11,11,0,0.5
NEWTONVILLE,MA,3687,3640,-47,0.4967926845912379
NEWTONVILLE,NJ,43,13,-30,0.23214285714285715
NEWTONVILLE,NY,17,0,-17,0
NEWTOWN,CT,4453,5235,782,0.5403592072667217
NEWTOWN,IN,52,0,-52,0
NEWTOWN,OH,353,320,-33,0.475482912332838
NEWTOWN,PA,8851,9674,823,0.5222132253711201
NEWTOWN,VA,0,12,12,1
NEWTOWN SQUARE,PA,7213,7685,472,0.5158410524902671
NEWVILLE,AL,234,280,46,0.5447470817120622
NEWVILLE,PA,3675,3331,-344,0.4754496146160434
NEY,OH,207,67,-140,0.24452554744525548
NEZPERCE,ID,0,11,11,1
NFD,CA,17,18,1,0.5142857142857142
NIAGARA,WI,1346,1339,-7,0.4986964618249534
NIAGARA FALLS,NY,28821,26548,-2273,0.4794740739402915
NIAGARA UNIVERSITY,NY,180,0,-180,0
NIANGUA,MO,713,820,107,0.5348988910632746
NIANTIC,CT,5477,5868,391,0.517232260907889
NIANTIC,IL,87,63,-24,0.42
NIBLEY,UT,1589,1115,-474,0.41235207100591714
NICASIO,CA,45,29,-16,0.3918918918918919
NICE,CA,838,866,28,0.5082159624413145
NICEVILLE,FL,15242,15704,462,0.5074646157823305
NICHOLASVILLE,KY,18159,18790,631,0.508538796719803
NICHOLLS,GA,1258,1422,164,0.5305970149253731
NICHOLS,IA,73,11,-62,0.13095238095238096
NICHOLS,NY,831,687,-144,0.4525691699604743
NICHOLS,SC,973,1148,175,0.5412541254125413
NICHOLS,WI,11,0,-11,0
NICHOLS HILLS,OK,1920,2073,153,0.5191585274229902
NICHOLSON,GA,1490,1511,21,0.5034988337220926
NICHOLSON,MS,26,13,-13,0.3333333333333333
NICHOLSON,PA,959,866,-93,0.4745205479452055
NICHOLVILLE,NY,13,13,0,0.5
NICKELSVILLE,VA,407,520,113,0.5609492988133765
NICKERSON,KS,619,443,-176,0.4171374764595104
NICKERSON,NE,125,55,-70,0.3055555555555556
NICOLAUS,CA,23,24,1,0.5106382978723404
NICOLLET,MN,594,386,-208,0.39387755102040817
NICOMA PARK,OK,13,0,-13,0
NIKISKI,AK,423,228,-195,0.35023041474654376
NIKOLAEVSK,AK,156,82,-74,0.3445378151260504
NILAND,CA,545,1387,842,0.7179089026915114
NILES,IL,8211,8150,-61,0.49813581076951285
NILES,MI,14942,13667,-1275,0.47771680240483766
NILES,OH,10134,8492,-1642,0.4559218297004188
NINE MILE FALLS,WA,3375,3652,277,0.51970969119112
NINETY SIX,SC,1982,2044,62,0.5076999503229012
NINEVEH,IN,1731,1700,-31,0.49548236665695133
NINEVEH,NY,91,98,7,0.5185185185185185
NINILCHIK,AK,1071,684,-387,0.38974358974358975
NINNEKAH,OK,235,279,44,0.5428015564202334
NIOBRARA,NE,232,173,-59,0.4271604938271605
NIOTA,IL,59,22,-37,0.2716049382716049
NIOTA,TN,1394,1675,281,0.5457803844900619
NIPOMO,CA,6976,7729,753,0.5256035362121727
NIPPA,KY,79,79,0,0.5
NISKAYUNA,NY,1437,1523,86,0.514527027027027
NISLAND,SD,11,12,1,0.5217391304347826
NISSWA,MN,3192,2952,-240,0.48046875
NITRO,WV,4186,2940,-1246,0.412573673870334
NIVERVILLE,NY,113,97,-16,0.46190476190476193
NIWOT,CO,2584,2190,-394,0.45873481357352325
NIXA,MO,14705,14969,264,0.5044483386129271
NIXON,TX,1276,1174,-102,0.4791836734693877
NL,CT,12,0,-12,0
NMB,SC,315,330,15,0.5116279069767442
NO ANDOVER,MA,211,190,-21,0.47381546134663344
NO FORT MYERS,FL,1273,3454,2181,0.7306960016924053
NO PALM SPRINGS,CA,33,0,-33,0
NOBLE,IL,540,490,-50,0.47572815533980584
NOBLE,LA,263,314,51,0.5441941074523396
NOBLE,OK,4989,5481,492,0.5234957020057307
NOBLEBORO,ME,713,953,240,0.5720288115246098
NOBLESVILLE,IN,30535,32793,2258,0.517827817079333
NOBLETON,FL,54,116,62,0.6823529411764706
NOCATEE,FL,102,34,-68,0.25
NOCONA,TX,2436,2430,-6,0.499383477188656
NOEL,MO,1524,1452,-72,0.4879032258064516
NOGAL,NM,39,61,22,0.61
NOGALES,AZ,5461,5333,-128,0.494070780062998
NOKESVILLE,VA,2285,2862,577,0.5560520691665047
NOKOMIS,FL,19237,24410,5173,0.559259513826838
NOKOMIS,IL,1264,1150,-114,0.4763877381938691
NOLANVILLE,TX,3214,3521,307,0.5227913882702302
NOLENSVILLE,TN,5492,8509,3017,0.6077423041211342
NOME,AK,1743,1227,-516,0.4131313131313131
NOME,TX,0,24,24,1
NONQUITT,MA,64,77,13,0.5460992907801419
NOOKSACK,WA,312,343,31,0.5236641221374045
NORA SPRINGS,IA,691,601,-90,0.4651702786377709
NORBORNE,MO,220,244,24,0.5258620689655172
NORCATUR,KS,13,0,-13,0
NORCO,CA,7135,7182,47,0.501641405322344
NORCO,LA,887,681,-206,0.4343112244897959
NORCROSS,GA,43377,33891,-9486,0.43861624475850286
NORDLAND,WA,151,346,195,0.6961770623742455
NORDMAN,ID,211,119,-92,0.3606060606060606
NORFOLK,CT,770,769,-1,0.4996751137102014
NORFOLK,MA,2196,2676,480,0.5492610837438424
NORFOLK,NE,15907,12363,-3544,0.4373187124159887
NORFOLK,NY,1296,1283,-13,0.49747964327258626
NORFOLK,VA,131538,112782,-18756,0.46161591355599213
NORFORK,AR,445,540,95,0.5482233502538071
NORLINA,NC,1263,1198,-65,0.48679398618447783
NORMAL,AL,62,11,-51,0.1506849315068493
NORMAL,IL,19798,16929,-2869,0.46094154164511125
NORMALVILLE,PA,578,271,-307,0.31919905771495877
NORMAN,AR,251,408,157,0.6191198786039454
NORMAN,IN,198,302,104,0.604
NORMAN,OK,59405,53988,-5417,0.47611404584057215
NORMAN PARK,GA,1298,1358,60,0.5112951807228916
NORMANDY,MO,192,185,-7,0.4907161803713528
NORMANDY,TN,328,407,79,0.5537414965986395
NORMANDY BEACH,NJ,285,278,-7,0.4937833037300178
NORMANDY PARK,WA,2553,2379,-174,0.48236009732360097
NORMANGEE,TX,1331,1256,-75,0.4855044453034403
NORMANNA,TX,0,14,14,1
NORRIDGE,IL,2758,2547,-211,0.48011310084825637
NORRIDGEWOCK,ME,1282,1310,28,0.5054012345679012
NORRIS,TN,194,390,196,0.6678082191780822
NORRIS CITY,IL,939,830,-109,0.46919163369135103
NORRISTOWN,PA,27348,25120,-2228,0.47876801097812
NORTH,SC,917,1043,126,0.5321428571428571
NORTH,VA,55,92,37,0.6258503401360545
NORTH ABINGTON TOWNSHIP,PA,62,69,7,0.5267175572519084
NORTH ADAMS,MA,6650,5855,-795,0.4682127149140344
NORTH ADAMS,MI,369,257,-112,0.41054313099041534
NORTH ANDOVER,MA,9438,9561,123,0.5032370124743407
NORTH ANSON,ME,506,541,35,0.5167144221585482
NORTH APOLLO,PA,471,195,-276,0.2927927927927928
NORTH ARLINGTON,NJ,4357,4109,-248,0.4853531774155445
NORTH ATTLEBORO,MA,7876,7592,-284,0.4908197569175071
NORTH AUGUSTA,SC,17483,17835,352,0.5049832946372954
NORTH AURORA,IL,6266,6126,-140,0.49435119431891544
NORTH BABYLON,NY,4542,4467,-75,0.4958374958374958
NORTH BALDWIN,NY,4536,4395,-141,0.4921061471279812
NORTH BALTIMORE,OH,1805,1521,-284,0.45730607336139506
NORTH BANGOR,NY,893,894,1,0.5002797985450476
NORTH BARRINGTON,IL,266,295,29,0.5258467023172906
NORTH BAY,NY,11,76,65,0.8735632183908046
NORTH BAY VILLAGE,FL,5423,4301,-1122,0.4423076923076923
NORTH BAY VLG,FL,593,587,-6,0.49745762711864405
NORTH BEACH,MD,2180,1995,-185,0.47784431137724553
NORTH BELLMORE,NY,5118,4919,-199,0.49008667928663946
NORTH BEND,NE,640,421,-219,0.39679547596606973
NORTH BEND,OH,1138,1096,-42,0.4905998209489705
NORTH BEND,OR,8098,7231,-867,0.4717202687716094
NORTH BEND,PA,11,11,0,0.5
NORTH BEND,WA,6047,6795,748,0.5291231895343405
NORTH BENNINGTON,VT,968,872,-96,0.47391304347826085
NORTH BENTON,OH,235,171,-64,0.4211822660098522
NORTH BERGEN,NJ,22128,18436,-3692,0.45449166748841335
NORTH BERWICK,ME,1530,1758,228,0.5346715328467153
NORTH BETHESDA,MD,2168,1970,-198,0.47607539874335425
NORTH BILLERICA,MA,3678,4134,456,0.5291858678955453
NORTH BLOOMFIELD,OH,223,133,-90,0.37359550561797755
NORTH BONNEVILLE,WA,878,159,-719,0.15332690453230471
NORTH BRANCH,MI,2660,2500,-160,0.4844961240310077
NORTH BRANCH,MN,4865,5311,446,0.5219143081761006
NORTH BRANCH,NY,12,58,46,0.8285714285714286
NORTH BRANFORD,CT,2129,2270,141,0.5160263696294612
NORTH BRENTWOOD,MD,32,34,2,0.5151515151515151
NORTH BRIDGTON,ME,0,32,32,1
NORTH BROOKFIELD,MA,1530,1513,-17,0.4972067039106145
NORTH BRUNSWICK,NJ,14472,13159,-1313,0.4762404545619051
NORTH CALDWELL,NJ,143,130,-13,0.47619047619047616
NORTH CANTON,OH,14652,14335,-317,0.49453203160037257
NORTH CAPE MAY,NJ,421,621,200,0.5959692898272553
NORTH CARVER,MA,44,0,-44,0
NORTH CASTLE,NY,36,47,11,0.5662650602409639
NORTH CHARLEROI,PA,95,73,-22,0.43452380952380953
NORTH CHARLESTON,SC,45853,40796,-5057,0.47081905157589815
NORTH CHATHAM,MA,934,1031,97,0.5246819338422392
NORTH CHELMSFORD,MA,3077,2677,-400,0.4652415710809871
NORTH CHESTERFIELD,VA,46729,45030,-1699,0.49074205255070347
NORTH CHICAGO,IL,6514,5354,-1160,0.451129086619481
NORTH CHILI,NY,2800,2670,-130,0.48811700182815354
NORTH CHITTENDEN,VT,12,20,8,0.625
NORTH CLARENDON,VT,660,575,-85,0.46558704453441296
NORTH COLLINS,NY,881,806,-75,0.47777119146413755
NORTH CONWAY,NH,2143,2071,-72,0.49145704793545325
NORTH COUNTY,MO,362,290,-72,0.4447852760736196
NORTH CREEK,NY,563,524,-39,0.48206071757129715
NORTH DARTMOUTH,MA,2571,2614,43,0.5041465766634523
NORTH DIGHTON,MA,861,924,63,0.5176470588235295
NORTH DINWIDDIE,VA,5164,5030,-134,0.4934275063762998
NORTH EAST,MD,7356,7426,70,0.5023677445541875
NORTH EAST,PA,4715,4213,-502,0.4718862007168459
NORTH EASTHAM,MA,1051,1025,-26,0.49373795761079
NORTH EASTON,MA,3294,3686,392,0.528080229226361
NORTH ENGLISH,IA,600,565,-35,0.48497854077253216
NORTH FAIRFIELD,OH,106,129,23,0.548936170212766
NORTH FALMOUTH,MA,2635,2508,-127,0.4876531207466459
NORTH FERRISBURGH,VT,626,598,-28,0.48856209150326796
NORTH FOND DU LAC,WI,3131,3139,8,0.5006379585326953
NORTH FORK,CA,1094,1082,-12,0.49724264705882354
NORTH FORK,ID,124,61,-63,0.32972972972972975
NORTH FORT MYERS,FL,46685,54463,7778,0.5384486099576857
NORTH FRANKLIN,CT,298,412,114,0.5802816901408451
NORTH FREEDOM,WI,809,636,-173,0.4401384083044983
NORTH GARDEN,VA,214,424,210,0.664576802507837
NORTH GRAFTON,MA,2280,2384,104,0.5111492281303602
NORTH GRANBY,CT,418,628,210,0.6003824091778203
NORTH GROSVENORDALE,CT,1455,1502,47,0.5079472438282042
NORTH HALEDON,NJ,3238,2942,-296,0.4760517799352751
NORTH HAMPTON,NH,1992,2219,227,0.5269532177630016
NORTH HATFIELD,MA,16,0,-16,0
NORTH HAVEN,CT,7208,7720,512,0.5171489817792069
NORTH HAVEN,ME,391,388,-3,0.4980744544287548
NORTH HAVERHILL,NH,517,671,154,0.5648148148148148
NORTH HERO,VT,738,849,111,0.5349716446124764
NORTH HIGHLANDS,CA,11122,9294,-1828,0.45523119122257055
NORTH HILLS,CA,11262,9570,-1692,0.459389400921659
NORTH HOLLYWOOD,CA,53319,43508,-9811,0.4493374781827383
NORTH HUNTINGDON,PA,216,246,30,0.5324675324675324
NORTH JACKSON,OH,858,853,-5,0.49853886616014026
NORTH JAVA,NY,0,11,11,1
NORTH JUDSON,IN,2121,1991,-130,0.48419260700389105
NORTH KANSAS CITY,MO,419,346,-73,0.4522875816993464
NORTH KINGSTOWN,RI,7322,7909,587,0.519269910051868
NORTH KINGSVILLE,OH,28,12,-16,0.3
NORTH LAKEWOOD,WA,14,23,9,0.6216216216216216
NORTH LAS VEGAS,NV,98475,108630,10155,0.5245165495763019
NORTH LAUDERDALE,FL,17193,14888,-2305,0.4640753093731492
NORTH LAWRENCE,NY,175,122,-53,0.4107744107744108
NORTH LAWRENCE,OH,605,564,-41,0.48246364414029086
NORTH LEWISBURG,OH,892,918,26,0.507182320441989
NORTH LIBERTY,IA,10791,10616,-175,0.4959125519689821
NORTH LIBERTY,IN,1758,1540,-218,0.46694966646452396
NORTH LIMA,OH,894,940,46,0.5125408942202835
NORTH LITTLE ROCK,AR,40436,38610,-1826,0.4884497634288895
NORTH LOUP,NE,11,0,-11,0
NORTH MAMCHESTER,IN,71,37,-34,0.3425925925925926
NORTH MANCHESTER,IN,2810,2607,-203,0.4812626915266753
NORTH MANKATO,MN,7207,5806,-1401,0.4461692153999846
NORTH MERRICK,NY,116,174,58,0.6
NORTH MIAMI,FL,21269,19442,-1827,0.4775613470560782
NORTH MIAMI,OK,25,0,-25,0
NORTH MIAMI BEACH,FL,19765,18852,-913,0.48817878136571974
NORTH MIDDLESEX,VT,0,13,13,1
NORTH MIDDLETOWN,NJ,292,273,-19,0.4831858407079646
NORTH MONMOUTH,ME,57,112,55,0.6627218934911243
NORTH MYRTLE BEACH,SC,14237,18823,4586,0.5693587416817907
NORTH NEW HYDE PARK,NY,0,11,11,1
NORTH NEWTON,KS,510,535,25,0.5119617224880383
NORTH OAKS,MN,1335,1357,22,0.5040861812778603
NORTH OGDEN,UT,3705,4266,561,0.5351900639819345
NORTH OLMSTED,OH,10954,10562,-392,0.4908905000929541
NORTH OXFORD,MA,888,905,17,0.5047406581148912
NORTH PALM BEACH,FL,11452,13281,1829,0.5369748918449035
NORTH PALM SPRINGS,CA,102,396,294,0.7951807228915663
NORTH PEMBROKE,MA,0,13,13,1
NORTH PLAINFIELD,NJ,6571,5514,-1057,0.45626810095159287
NORTH PLAINS,OR,2120,2534,414,0.5444778685002148
NORTH PLATTE,NE,15839,12904,-2935,0.4489440907351355
NORTH POLE,AK,9145,8102,-1043,0.4697628573085174
NORTH PORT,FL,48505,54756,6251,0.5302679617667851
NORTH POTOMAC,MD,4881,4691,-190,0.4900752193898872
NORTH POWDER,OR,148,105,-43,0.4150197628458498
NORTH PRAIRIE,WI,735,688,-47,0.48348559381588196
NORTH PRINCE GEORGE,VA,1880,1406,-474,0.42787583688374925
NORTH PROVIDENCE,RI,16129,15626,-503,0.4920799874035585
NORTH QUINCY,MA,236,173,-63,0.4229828850855746
NORTH READING,MA,4195,4648,453,0.525613479588375
NORTH REDINGTON BEACH,FL,373,240,-133,0.3915171288743883
NORTH RICHLAND HILLS,TX,25728,26205,477,0.5045924556640287
NORTH RICHMOND,CA,169,129,-40,0.43288590604026844
NORTH RIDGEVILLE,OH,10209,11629,1420,0.5325121348108801
NORTH RIVER,NY,13,39,26,0.75
NORTH RIVERSIDE,IL,421,492,71,0.5388828039430449
NORTH ROSE,NY,858,821,-37,0.4889815366289458
NORTH ROYALTON,OH,9595,9247,-348,0.4907653115380533
NORTH SAINT PAUL,MN,800,659,-141,0.4516792323509253
NORTH SALEM,IN,262,215,-47,0.45073375262054505
NORTH SALEM,NH,38,45,7,0.54216867469879515
NORTH SALEM,NY,1239,1358,119,0.522911051212938
NORTH SALT LAKE,UT,10973,8804,-2169,0.44516357384840977
NORTH SAN JUAN,CA,491,364,-127,0.4257309941520468
NORTH SANDWICH,NH,27,11,-16,0.2894736842105263
NORTH SCITUATE,MA,13,0,-13,0
NORTH SCITUATE,RI,1896,2242,346,0.541807636539391
NORTH SEVERN VILLAGE,MD,17,14,-3,0.45161290322580644
NORTH SIOUX CITY,SD,3429,3034,-395,0.46944143586569703
NORTH SMITHFIELD,RI,2340,2746,406,0.5399134880062918
NORTH SPRINGFIELD,VT,387,264,-123,0.4055299539170507
NORTH ST PAUL,MN,223,255,32,0.5334728033472803
NORTH STONINGTON,CT,1224,1394,170,0.5324675324675324
NORTH STRATFORD,NH,227,270,43,0.5432595573440644
NORTH STREET,MI,212,212,0,0.5
NORTH SULLIVAN,ME,0,20,20,1
NORTH SUTTON,NH,100,77,-23,0.4350282485875706
NORTH SYRACUSE,NY,471,465,-6,0.4967948717948718
NORTH TAZEWELL,VA,1558,1614,56,0.5088272383354351
NORTH TONAWANDA,NY,14121,13444,-677,0.48771993469980046
NORTH TROY,VT,636,608,-28,0.4887459807073955
NORTH TRURO,MA,1117,1446,329,0.5641825985173625
NORTH TUSTIN,CA,338,375,37,0.5259467040673211
NORTH UXBRIDGE,MA,58,0,-58,0
NORTH VENICE,FL,829,1570,741,0.6544393497290538
NORTH VERNON,IN,8825,8122,-703,0.4792588658759662
NORTH VERSAILLES,PA,3949,3228,-721,0.4497700989271283
NORTH WALES,PA,9315,8462,-853,0.4760083253642347
NORTH WALPOLE,NH,104,56,-48,0.35
NORTH WALTHAM,MA,1356,1070,-286,0.44105523495465787
NORTH WATERBORO,ME,995,998,3,0.5007526342197692
NORTH WEBSTER,IN,2082,1779,-303,0.46076146076146074
NORTH WEYMOUTH,MA,2105,2055,-50,0.49399038461538464
NORTH WILDWOOD,NJ,882,1046,164,0.5425311203319502
NORTH WILKESBORO,NC,5857,5506,-351,0.4845551350875649
NORTH WINDHAM,CT,814,819,5,0.5015309246785058
NORTH WOODSTOCK,NH,453,426,-27,0.48464163822525597
NORTH YARMOUTH,ME,878,1152,274,0.5674876847290641
NORTH ZULCH,TX,523,718,195,0.5785656728444802
NORTHAMPTON,MA,10597,8908,-1689,0.4567034093822097
NORTHAMPTON,PA,6148,6352,204,0.50816
NORTHBOROUGH,MA,5039,5147,108,0.5053013940702925
NORTHBRIDGE,MA,2410,2073,-337,0.4624135623466429
NORTHBROOK,IL,15793,32517,16724,0.6730904574622232
NORTHEAST HARBOR,ME,1190,656,-534,0.3553629469122427
NORTHERN CAMBRIA,PA,1814,1650,-164,0.47632794457274824
NORTHFIELD,CT,100,42,-58,0.29577464788732394
NORTHFIELD,IL,2869,2838,-31,0.4972840371473629
NORTHFIELD,MA,955,1014,59,0.5149822244794312
NORTHFIELD,ME,46,24,-22,0.34285714285714286
NORTHFIELD,MN,8604,7964,-640,0.48068565910188316
NORTHFIELD,NH,616,702,86,0.5326251896813353
NORTHFIELD,NJ,2355,2789,434,0.5421850699844479
NORTHFIELD,OH,4700,4791,91,0.5047940153829944
NORTHFIELD,VT,2133,2147,14,0.5016355140186916
NORTHFORD,CT,1941,1725,-216,0.4705400981996727
NORTHFORK,WV,46,13,-33,0.22033898305084745
NORTHGLENN,CO,21502,17442,-4060,0.4478738701725555
NORTHLAKE,IL,3553,3259,-294,0.47842043452730476
NORTHLAKE,TX,932,1231,299,0.5691169671752196
NORTHOME,MN,175,199,24,0.5320855614973262
NORTHPORT,AL,13332,13127,-205,0.49612608186250423
NORTHPORT,ME,745,818,73,0.5233525271912988
NORTHPORT,MI,1998,1633,-365,0.4497383640870284
NORTHPORT,NY,5783,6473,690,0.5281494778067886
NORTHPORT,WA,283,224,-59,0.4418145956607495
NORTHRIDGE,CA,26666,25867,-799,0.49239525631507813
NORTHUMBERLAND,NH,32,35,3,0.5223880597014925
NORTHUMBERLAND,PA,2839,2583,-256,0.47639247510143856
NORTHVALE,NJ,1060,1290,230,0.548936170212766
NORTHVILLE,MI,17270,16988,-282,0.4958841730398739
NORTHVILLE,NY,1994,1939,-55,0.49300788202390033
NORTHWEST PLAZA,MO,135,94,-41,0.4104803493449782
NORTHWOOD,IA,1013,1012,-1,0.4997530864197531
NORTHWOOD,ND,405,247,-158,0.37883435582822084
NORTHWOOD,NH,1780,1813,33,0.5045922627330921
NORTHWOOD,OH,2496,2261,-235,0.47529955854530165
NORTON,KS,1860,1832,-28,0.4962080173347779
NORTON,MA,4904,4925,21,0.5010682673720622
NORTON,OH,4125,4047,-78,0.49522760646108666
NORTON,VA,2092,1709,-383,0.44961852144172587
NORTON SHORES,MI,12471,11691,-780,0.4838589520735038
NORTONVILLE,KS,74,77,3,0.5099337748344371
NORTONVILLE,KY,1014,953,-61,0.48449415353329944
NORWALK,CA,20944,19016,-1928,0.4758758758758759
NORWALK,CT,35590,34402,-1188,0.49151331580752083
NORWALK,IA,5523,6518,995,0.54131716634831
NORWALK,OH,10562,9264,-1298,0.4672652073035408
NORWALK,WI,405,237,-168,0.3691588785046729
NORWAY,IA,22,60,38,0.7317073170731707
NORWAY,ME,2291,2556,265,0.5273364968021457
NORWAY,MI,1394,1259,-135,0.4745571051639653
NORWAY,OR,53,46,-7,0.46464646464646464
NORWAY,SC,25,40,15,0.6153846153846154
NORWELL,MA,2911,3187,276,0.5226303706133159
NORWICH,CT,22170,18881,-3289,0.4599400745414241
NORWICH,KS,12,36,24,0.75
NORWICH,NY,6612,6216,-396,0.4845650140318054
NORWICH,OH,203,87,-116,0.3
NORWICH,VT,1442,1490,48,0.5081855388813097
NORWOOD,CO,976,660,-316,0.4034229828850856
NORWOOD,GA,23,64,41,0.735632183908046
NORWOOD,MA,13511,12548,-963,0.4815226984918838
NORWOOD,MN,71,48,-23,0.40336134453781514
NORWOOD,MO,835,851,16,0.5047449584816133
NORWOOD,NC,1783,2044,261,0.5340998170891037
NORWOOD,NJ,1683,1743,60,0.5087565674255692
NORWOOD,NY,1152,1122,-30,0.49340369393139843
NORWOOD,OH,3169,2816,-353,0.4705096073517126
NORWOOD,PA,1847,1664,-183,0.47393904870407294
NORWOOD YOUNG AMERICA,MN,1029,951,-78,0.4803030303030303
NOTASULGA,AL,1004,994,-10,0.4974974974974975
NOTI,OR,45,38,-7,0.4578313253012048
NOTRE DAME,IN,135,330,195,0.7096774193548387
NOTTINGHAM,MD,14103,13931,-172,0.4969322964971106
NOTTINGHAM,NH,1331,1652,321,0.5538048944016091
NOTTINGHAM,PA,1487,1373,-114,0.4800699300699301
NOVA,OH,263,283,20,0.5183150183150184
NOVATO,CA,19641,19305,-336,0.49568633492528114
NOVELTY,OH,1035,1246,211,0.5462516440157825
NOVI,MI,28089,24615,-3474,0.46704234972677594
NOVINGER,MO,184,205,21,0.5269922879177378
NOWATA,OK,2559,2248,-311,0.4676513417932182
NOXAPATER,MS,482,347,-135,0.41857659831121835
NOXEN,PA,125,87,-38,0.41037735849056606
NOXON,MT,249,262,13,0.512720156555773
NPR,FL,20,27,7,0.574468085106383
NPRTH MANCHESTER,IN,61,45,-16,0.42452830188679247
NSUN,IL,21,24,3,0.5333333333333333
NU MINE,PA,23,0,-23,0
NUANGOLA,PA,87,80,-7,0.47904191616766467
NUCLA,CO,184,198,14,0.518324607329843
NUEVO,CA,2937,2692,-245,0.4782376976372357
NUMA,IA,174,152,-22,0.4662576687116564
NUNDA,NY,1272,987,-285,0.43691899070385126
NUNICA,MI,1301,1365,64,0.5120030007501876
NUNN,CO,453,475,22,0.5118534482758621
NUNNELLY,TN,1116,1198,82,0.5177182368193605
NUREMBERG,PA,11,0,-11,0
NURSERY,TX,0,15,15,1
NUTLEY,NJ,8328,8060,-268,0.4918232853307298
NUTRIOSO,AZ,160,156,-4,0.4936708860759494
NUTTER FORT,WV,556,465,-91,0.455435847208619
NY,NY,31,23,-8,0.42592592592592593
NYA,MN,78,74,-4,0.4868421052631579
NYACK,NY,6215,5723,-492,0.4793935332551516
NYC,NY,320,226,-94,0.4139194139194139
NYE,MT,57,80,23,0.583941605839416
NYSSA,OR,1992,1870,-122,0.4842050750906266
O BRIEN,FL,1540,1781,241,0.5362842517314061
O BRIEN,OR,61,47,-14,0.4351851851851852
O FALLON,IL,13506,14015,509,0.5092474837396896
O FALLON,MO,26341,28320,1979,0.5181024862333291
OACOMA,SD,11,11,0,0.5
OAK BEACH,NY,82,111,29,0.5751295336787565
OAK BLUFFS,MA,2598,2279,-319,0.46729546852573306
OAK BROOK,IL,4694,6016,1322,0.56171802054155
OAK CITY,NC,23,64,41,0.735632183908046
OAK CITY,UT,14,0,-14,0
OAK CREEK,CO,1358,1147,-211,0.45788423153692615
OAK CREEK,WI,16349,16183,-166,0.4974486659289315
OAK FOREST,IL,7432,6950,-482,0.48324294256709777
OAK GROVE,AR,0,28,28,1
OAK GROVE,KY,6908,5760,-1148,0.45468898010735714
OAK GROVE,LA,2202,2256,54,0.506056527590848
OAK GROVE,MN,179,166,-13,0.4811594202898551
OAK GROVE,MO,4734,4557,-177,0.49047465288989345
OAK GROVE,OR,70,37,-33,0.34579439252336447
OAK HALL,VA,11,26,15,0.7027027027027027
OAK HARBOR,OH,2994,2770,-224,0.48056904927133937
OAK HARBOR,WA,23574,19495,-4079,0.452645754486986
OAK HILL,FL,2873,2668,-205,0.4815015340191301
OAK HILL,OH,2025,1795,-230,0.4698952879581152
OAK HILL,TN,115,117,2,0.5043103448275862
OAK HILL,VA,490,517,27,0.5134061569016882
OAK HILL,WV,3261,3084,-177,0.48605200945626476
OAK HILLS,CA,2738,3269,531,0.5441984351589811
OAK ISLAND,NC,4683,5765,1082,0.55178024502297085
OAK LAWN,IL,15941,14145,-1796,0.4701522302732168
OAK PARK,CA,4627,4745,118,0.5062953478446436
OAK PARK,IL,24139,22748,-1391,0.48516646405186936
OAK PARK,MI,11487,10794,-693,0.48444863336475025
OAK PARK,MN,13,38,25,0.7450980392156863
OAK POINT,TX,470,621,151,0.5692025664527957
OAK RIDGE,LA,11,46,35,0.8070175438596491
OAK RIDGE,MO,108,142,34,0.568
OAK RIDGE,NC,1811,2551,740,0.5848234754699679
OAK RIDGE,NJ,2582,2832,250,0.523088289619505
OAK RIDGE,TN,13901,14803,902,0.5157120958751393
OAK RUN,CA,61,80,19,0.5673758865248227
OAK VALE,MS,11,23,12,0.6764705882352942
OAK VIEW,CA,2053,2005,-48,0.4940857565303105
OAKBORO,NC,1205,1478,273,0.5508758852031308
OAKBROOK TERRACE,IL,2572,2263,-309,0.46804550155118924
OAKDALE,CA,12170,11532,-638,0.4865412201501983
OAKDALE,CT,2164,2390,226,0.5248133509003075
OAKDALE,LA,2591,2277,-314,0.46774856203779785
OAKDALE,MN,5738,5627,-111,0.49511658600967884
OAKDALE,NE,77,40,-37,0.3418803418803419
OAKDALE,NY,3432,2936,-496,0.4610552763819096
OAKDALE,PA,4842,4686,-156,0.49181360201511337
OAKDALE,TN,291,291,0,0.5
OAKES,ND,990,895,-95,0.47480106100795755
OAKESDALE,WA,57,41,-16,0.41836734693877553
OAKFIELD,ME,108,103,-5,0.4881516587677725
OAKFIELD,NY,1160,1046,-114,0.4741613780598368
OAKFIELD,TN,94,137,43,0.5930735930735931
OAKFIELD,WI,342,335,-7,0.4948301329394387
OAKFORD,IL,24,11,-13,0.3142857142857143
OAKHAM,MA,515,550,35,0.5164319248826291
OAKHURST,CA,3971,3312,-659,0.45475765481257724
OAKHURST,NJ,2418,2017,-401,0.4547914317925592
OAKHURST,OK,258,15,-243,0.054945054945054944
OAKHURST,TX,24,55,31,0.6962025316455697
OAKLAND,AR,23,40,17,0.6349206349206349
OAKLAND,CA,181159,152034,-29125,0.45629409981602254
OAKLAND,FL,2838,3359,521,0.542036469259319
OAKLAND,IA,571,589,18,0.5077586206896552
OAKLAND,IL,386,244,-142,0.3873015873015873
OAKLAND,KY,256,140,-116,0.35353535353535354
OAKLAND,MD,4682,4548,-134,0.49274106175514626
OAKLAND,ME,3541,3178,-363,0.47298705164459
OAKLAND,MI,1417,1859,442,0.5674603174603174
OAKLAND,MS,221,436,215,0.6636225266362252
OAKLAND,NE,536,536,0,0.5
OAKLAND,NJ,2755,3040,285,0.5245901639344263
OAKLAND,OR,1588,1524,-64,0.4897172236503856
OAKLAND,PA,298,139,-159,0.3180778032036613
OAKLAND,TN,3746,5010,1264,0.5721790772042028
OAKLAND CITY,IN,1793,1711,-82,0.4882990867579909
OAKLAND GARDENS,NY,5200,4929,-271,0.48662256886168426
OAKLAND PARK,FL,17899,17125,-774,0.48895043398812243
OAKLAND TOWNSHIP,MI,1086,1186,100,0.5220070422535211
OAKLEY,CA,12832,13360,528,0.5100794135613927
OAKLEY,ID,112,132,20,0.5409836065573771
OAKLEY,IL,102,106,4,0.5096153846153846
OAKLEY,KS,1199,1019,-180,0.4594229035166817
OAKLEY,MI,287,277,-10,0.49113475177304966
OAKLEY,UT,394,461,67,0.5391812865497077
OAKLYN,NJ,3759,3322,-437,0.4691427764440051
OAKMAN,AL,733,698,-35,0.48777078965758214
OAKMONT,PA,3010,2951,-59,0.4950511659117598
OAKRIDGE,OR,2415,2022,-393,0.4557133198106829
OAKS,OK,0,13,13,1
OAKS,PA,60,31,-29,0.34065934065934067
OAKS CORNERS,NY,14,13,-1,0.48148148148148145
OAKTON,VA,5334,6019,685,0.5301682374702722
OAKTOWN,IN,465,464,-1,0.49946178686759957
OAKVILLE,CT,2818,2538,-280,0.47386109036594476
OAKVILLE,IA,23,0,-23,0
OAKVILLE,IN,14,0,-14,0
OAKVILLE,MO,334,350,16,0.5116959064327485
OAKVILLE,WA,578,691,113,0.5445232466509062
OAKWOOD,GA,4434,5005,571,0.5302468481830702
OAKWOOD,IL,1007,950,-57,0.4854368932038835
OAKWOOD,OH,4301,4129,-172,0.4897983392645314
OAKWOOD,TX,395,702,307,0.6399270738377393
OAKWOOD,VA,121,103,-18,0.45982142857142855
OAKWOOD HILLS,IL,959,1037,78,0.5195390781563126
OARK,AR,0,12,12,1
OASIS,NV,0,25,25,1
OASIS,UT,65,72,7,0.5255474452554745
OATMAN,AZ,0,12,12,1
OBERLIN,KS,1238,991,-247,0.4445939883355765
OBERLIN,LA,513,486,-27,0.4864864864864865
OBERLIN,OH,3271,3119,-152,0.48810641627543033
OBERLIN,PA,424,397,-27,0.4835566382460414
OBETZ,OH,752,773,21,0.5068852459016393
OBION,TN,585,549,-36,0.48412698412698413
OBLONG,IL,973,886,-87,0.4766003227541689
OBSERVATORY,PA,150,120,-30,0.4444444444444444
OCALA,FL,125184,139921,14737,0.5277946474038588
OCCIDENTAL,CA,796,866,70,0.5210589651022864
OCCOQUAN,VA,880,582,-298,0.39808481532147744
OCEAN,NJ,9585,8742,-843,0.47700114585038467
OCEAN BEACH,NY,510,538,28,0.5133587786259542
OCEAN BLUFF,MA,0,38,38,1
OCEAN BREEZE,FL,333,341,8,0.5059347181008902
OCEAN CITY,MD,9472,9768,296,0.5076923076923077
OCEAN CITY,NJ,9386,10170,784,0.520044998977296
OCEAN GATE,NJ,1133,797,-336,0.4129533678756477
OCEAN GROVE,NJ,2314,2449,135,0.5141717404996851
OCEAN ISL BCH,NC,402,573,171,0.5876923076923077
OCEAN ISLE BEACH,NC,4145,5957,1812,0.5896852108493368
OCEAN PARK,ME,311,571,260,0.6473922902494331
OCEAN PARK,WA,3499,3623,124,0.5087054198258916
OCEAN PINES,MD,170,187,17,0.5238095238095238
OCEAN RIDGE,FL,2370,1135,-1235,0.3238231098430813
OCEAN SHORES,WA,5708,5763,55,0.5023973498387238
OCEAN SPRINGS,MS,17027,18301,1274,0.5180310235507246
OCEAN VIEW,DE,4820,5952,1132,0.5525436316375789
OCEAN VIEW,HI,836,1086,250,0.5650364203954215
OCEAN VIEW,NJ,1746,2182,436,0.5554989816700611
OCEANA,WV,476,215,-261,0.3111432706222865
OCEANO,CA,2141,1908,-233,0.47122746357125217
OCEANPORT,NJ,1859,2163,304,0.5377921432123322
OCEANSIDE,CA,90853,82938,-7915,0.4772283950262096
OCEANSIDE,NY,7465,7687,222,0.5073257655755016
OCHELATA,OK,373,393,20,0.5130548302872062
OCHEYEDAN,IA,38,25,-13,0.3968253968253968
OCHLOCKNEE,GA,1700,1415,-285,0.45425361155698235
OCHLOCKONEE BAY,FL,25,35,10,0.5833333333333334
OCHOPEE,FL,0,11,11,1
OCILLA,GA,1862,1944,82,0.5107724645296899
OCKLAWAHA,FL,4449,5659,1210,0.5598535813217254
OCOEE,FL,19839,19815,-24,0.4996973823573914
OCOEE,TN,308,529,221,0.6320191158900836
OCONEE,IL,11,0,-11,0
OCONOMOWOC,WI,13687,14969,1282,0.5223687883863763
OCONTO,WI,3230,2946,-284,0.47700777202072536
OCONTO FALLS,WI,2007,1848,-159,0.4793774319066148
OCOTILLO,CA,16,0,-16,0
OCQUEOC,MI,24,16,-8,0.4
OCRACOKE,NC,117,171,54,0.59375
ODANAH,WI,11,0,-11,0
ODEBOLT,IA,253,225,-28,0.4707112970711297
ODELL,IL,425,285,-140,0.4014084507042254
ODELL,NE,100,0,-100,0
ODELL,OR,11,0,-11,0
ODEM,TX,1254,1245,-9,0.49819927971188477
ODEN,AR,40,12,-28,0.23076923076923078
ODEN,MI,36,12,-24,0.25
ODENTON,MD,17640,18463,823,0.5113979447691328
ODENVILLE,AL,5083,5854,771,0.535247325592027
ODESSA,DE,27,0,-27,0
ODESSA,FL,12455,19387,6932,0.6088499466113938
ODESSA,MO,3899,3902,3,0.5001922830406358
ODESSA,NY,294,243,-51,0.45251396648044695
ODESSA,TX,66163,53318,-12845,0.4462466835731204
ODESSA,WA,387,301,-86,0.4375
ODIN,IL,701,676,-25,0.49092229484386346
ODON,IN,1119,1068,-51,0.4883401920438957
ODONNELL,TX,49,0,-49,0
ODUM,GA,855,844,-11,0.4967628016480283
OELWEIN,IA,4563,3704,-859,0.44804644973992985
OFALLON,IL,273,251,-22,0.47900763358778625
OFFERLE,KS,12,0,-12,0
OFFUTT,KY,48,43,-5,0.4725274725274725
OFFUTT AFB,NE,395,434,39,0.5235223160434258
OGALLALA,NE,2841,2452,-389,0.4632533534857359
OGDEN,IA,1354,1012,-342,0.42772612003381233
OGDEN,IL,213,91,-122,0.2993421052631579
OGDEN,KS,1510,1369,-141,0.47551233067037163
OGDEN,UT,78094,71667,-6427,0.47854247768110525
OGDENSBURG,NJ,540,484,-56,0.47265625
OGDENSBURG,NY,8788,6721,-2067,0.4333612740989103
OGDENSBURG,WI,80,89,9,0.5266272189349113
OGEMA,MN,252,206,-46,0.4497816593886463
OGEMA,WI,274,267,-7,0.49353049907578556
OGILVIE,MN,1281,1160,-121,0.4752150757886112
OGLESBY,IL,1609,1504,-105,0.4831352393189849
OGLESBY,TX,142,123,-19,0.4641509433962264
OGLETHORPE,GA,821,766,-55,0.48267170762444866
OGUNQUIT,ME,1862,1858,-4,0.49946236559139784
OHATCHEE,AL,1846,1794,-52,0.4928571428571429
OHIO,IL,192,89,-103,0.3167259786476868
OHIO CITY,OH,463,373,-90,0.4461722488038278
OHIOPYLE,PA,11,13,2,0.5416666666666666
OHKAY OWINGEH,NM,124,38,-86,0.2345679012345679
OIL CITY,LA,491,438,-53,0.4714747039827772
OIL CITY,PA,6269,6013,-256,0.48957824458557236
OIL SPRINGS,KY,44,28,-16,0.3888888888888889
OIL TROUGH,AR,0,15,15,1
OILTON,OK,266,17,-249,0.06007067137809187
OILVILLE,VA,0,12,12,1
OJAI,CA,7947,8402,455,0.5139152241727323
OJO CALIENTE,NM,0,23,23,1
OJUS,FL,0,12,12,1
OKABENA,MN,13,0,-13,0
OKAHUMPKA,FL,335,370,35,0.524822695035461
OKANOGAN,WA,1805,1373,-432,0.4320327249842668
OKARCHE,OK,360,305,-55,0.45864661654135336
OKATIE,SC,4022,5725,1703,0.5873602133989946
OKAUCHEE,WI,294,230,-64,0.4389312977099237
OKAWVILLE,IL,684,496,-188,0.42033898305084744
OKAY,OK,0,38,38,1
OKC,OK,403,382,-21,0.48662420382165605
OKEANA,OH,305,484,179,0.6134347275031685
OKEECHOBEE,FL,20558,25964,5406,0.5581015433558316
OKEENE,OK,296,204,-92,0.408
OKEMAH,OK,2347,2091,-256,0.4711581793600721
OKEMOS,MI,10239,9832,-407,0.48986099347317025
OKLAHOMA CITY,OK,286743,248802,-37941,0.4645772063972215
OKLEE,MN,37,53,16,0.5888888888888889
OKMULGEE,OK,6703,6150,-553,0.47848751264296274
OKOBOJI,IA,1348,968,-380,0.41796200345423146
OKOLONA,KY,0,64,64,1
OKOLONA,MS,1489,1350,-139,0.4755195491370201
OKTAHA,OK,187,198,11,0.5142857142857142
OLA,AR,959,903,-56,0.4849624060150376
OLA,ID,0,13,13,1
OLALLA,WA,2012,1917,-95,0.48791040977347927
OLANTA,PA,11,0,-11,0
OLANTA,SC,180,217,37,0.5465994962216625
OLAR,SC,103,86,-17,0.455026455026455
OLATHE,CO,1649,1523,-126,0.4801387137452711
OLATHE,KS,47994,50278,2284,0.5116208075545425
OLCOTT,NY,366,99,-267,0.2129032258064516
OLD BETHPAGE,NY,1047,1171,124,0.5279531109107304
OLD BRIDGE,NJ,10656,11038,382,0.5088042776804647
OLD CHATHAM,NY,69,248,179,0.7823343848580442
OLD FIELDS,WV,14,29,15,0.6744186046511628
OLD FORGE,NY,1283,958,-325,0.427487728692548
OLD FORGE,PA,2789,2669,-120,0.4890069622572371
OLD FORT,NC,2041,2142,101,0.5120726751135549
OLD FORT,TN,1068,1246,178,0.5384615384615384
OLD GREENWICH,CT,2726,2822,96,0.5086517664023071
OLD HICKORY,TN,9153,9404,251,0.5067629465969715
OLD LAGUNA,NM,11,0,-11,0
OLD LYME,CT,4205,4618,413,0.5234047376175904
OLD MILL CRK,IL,83,73,-10,0.46794871794871795
OLD MONROE,MO,693,968,275,0.5827814569536424
OLD MYSTIC,CT,0,46,46,1
OLD ORCHARD BEACH,ME,6981,6940,-41,0.49852740464047124
OLD RIVER WINFREE,TX,539,579,40,0.5178890876565295
OLD SAYBROOK,CT,5575,5975,400,0.5173160173160173
OLD TAPPAN,NJ,719,842,123,0.5393978219090326
OLD TOWN,FL,4132,5219,1087,0.5581221259758314
OLD TOWN,ME,4575,3595,-980,0.44002447980416154
OLD WESTBURY,NY,840,1066,226,0.559286463798531
OLDENBURG,IN,13,58,45,0.8169014084507042
OLDFIELD,MO,13,22,9,0.6285714285714286
OLDS,IA,17,0,-17,0
OLDSMAR,FL,12324,12479,155,0.5031246220215296
OLDTOWN,ID,716,872,156,0.5491183879093199
OLDTOWN,MD,110,176,66,0.6153846153846154
OLDWICK,NJ,89,123,34,0.5801886792452831
OLEAN,MO,18,25,7,0.5813953488372093
OLEAN,NY,8774,7884,-890,0.4732861087765638
OLEY,PA,1275,1251,-24,0.49524940617577196
OLGA,WA,408,426,18,0.5107913669064749
OLIN,IA,418,246,-172,0.3704819277108434
OLIN,NC,240,337,97,0.584055459272097
OLIVE BRANCH,MS,16944,19692,2748,0.5375040943334425
OLIVE HILL,KY,3214,3114,-100,0.4920986093552465
OLIVEBRIDGE,NY,517,714,197,0.5800162469536961
OLIVEHILL,TN,35,48,13,0.5783132530120482
OLIVEHURST,CA,2385,2823,438,0.5420506912442397
OLIVER SPGS,TN,165,167,2,0.5030120481927711
OLIVER SPRINGS,TN,2481,2639,158,0.5154296875
OLIVET,MI,1604,1287,-317,0.4451746800415081
OLIVET,SD,12,12,0,0.5
OLIVETTE,MO,1213,1145,-68,0.4855810008481764
OLIVIA,MN,1463,1276,-187,0.46586345381526106
OLIVIA,NC,51,25,-26,0.32894736842105265
OLLA,LA,889,923,34,0.5093818984547461
OLLIE,IA,47,44,-3,0.4835164835164835
OLMITO,TX,592,734,142,0.5535444947209653
OLMSTEAD,KY,11,0,-11,0
OLMSTED,IL,11,0,-11,0
OLMSTED FALLS,OH,3028,3337,309,0.5242733699921446
OLMSTED TWP,OH,3862,4079,217,0.5136632665911094
OLMSTEDVILLE,NY,44,24,-20,0.35294117647058826
OLNEY,IL,5967,5366,-601,0.47348451425041915
OLNEY,MD,6443,6157,-286,0.48865079365079367
OLNEY,MT,27,0,-27,0
OLNEY,TX,1704,1599,-105,0.4841053587647593
OLNEY SPRINGS,CO,90,115,25,0.5609756097560976
OLPE,KS,20,12,-8,0.375
OLSBURG,KS,0,11,11,1
OLTON,TX,245,74,-171,0.23197492163009403
OLUSTEE,OK,26,0,-26,0
OLYMPIA,KY,11,34,23,0.7555555555555555
OLYMPIA,WA,68324,67269,-1055,0.4961096811782319
OLYMPIA FIELDS,IL,1616,1723,107,0.5160227613057802
OLYMPIA FLDS,IL,93,87,-6,0.48333333333333334
OLYMPIA HEIGHTS,FL,828,734,-94,0.469910371318822
OLYMPIC VALLEY,CA,624,588,-36,0.48514851485148514
OLYMPIC VLY,CA,48,13,-35,0.21311475409836064
OLYPHANT,PA,2152,2224,72,0.5082266910420475
OMAHA,AR,1150,1307,157,0.531949531949532
OMAHA,IA,81,101,20,0.554945054945055
OMAHA,IL,12,12,0,0.5
OMAHA,NE,283155,245878,-37277,0.46476873843408634
OMAHA,TX,729,865,136,0.5426599749058971
OMAK,WA,4768,3042,-1726,0.3895006402048656
OMAR,WV,11,0,-11,0
OMEGA,GA,588,334,-254,0.36225596529284165
OMENA,MI,165,125,-40,0.43103448275862066
OMER,MI,340,240,-100,0.41379310344827586
OMRO,WI,2364,2490,126,0.5129789864029666
ONA,FL,26,36,10,0.5806451612903226
ONA,WV,1010,1132,122,0.5284780578898226
ONAGA,KS,250,328,78,0.5674740484429066
ONALASKA,TX,2840,3330,490,0.539708265802269
ONALASKA,WA,1556,1705,149,0.5228457528365532
ONALASKA,WI,10964,10368,-596,0.48603037689855616
ONAMIA,MN,2263,1961,-302,0.4642518939393939
ONANCOCK,VA,1556,1372,-184,0.4685792349726776
ONARGA,IL,255,125,-130,0.32894736842105265
ONAWA,IA,1759,1428,-331,0.4480702855349859
ONAWAY,MI,1915,1779,-136,0.481591770438549
ONCHIOTA,NY,35,14,-21,0.2857142857142857
ONECO,CT,12,12,0,0.5
ONECO,FL,341,480,139,0.584652862362972
ONEIDA,IL,198,119,-79,0.3753943217665615
ONEIDA,KY,56,27,-29,0.3253012048192771
ONEIDA,NY,6226,5771,-455,0.4810369258981412
ONEIDA,TN,3137,3152,15,0.5011925584353634
ONEIDA,WI,3923,3866,-57,0.4963409937090769
ONEILL,NE,2511,2039,-472,0.4481318681318681
ONEKAMA,MI,645,703,58,0.521513353115727
ONEONTA,AL,4564,4785,221,0.511819445930046
ONEONTA,NY,8518,7592,-926,0.471260086902545
ONIDA,SD,82,74,-8,0.47435897435897434
ONLEY,VA,218,144,-74,0.39779005524861877
ONO,PA,41,0,-41,0
ONONDAGA,MI,373,368,-5,0.4966261808367072
ONSET,MA,1279,1278,-1,0.49980445834962844
ONSLOW,IA,29,0,-29,0
ONSTED,MI,1740,1757,17,0.5024306548470118
ONTARIO,CA,53090,52569,-521,0.4975345214321544
ONTARIO,NY,3767,4004,237,0.515249002702355
ONTARIO,OH,2446,2123,-323,0.4646530969577588
ONTARIO,OR,8664,7434,-1230,0.46179649645918747
ONTARIO,WI,217,150,-67,0.4087193460490463
ONTONAGON,MI,1401,1246,-155,0.4707215715904798
ONYX,CA,24,56,32,0.7
OOLITIC,IN,294,226,-68,0.4346153846153846
OOLOGAH,OK,1494,1596,102,0.516504854368932
OOLTEWAH,TN,15060,17221,2161,0.5334717016201481
OOSTBURG,WI,1358,1246,-112,0.478494623655914
OPA LOCKA,FL,10324,9967,-357,0.4912029964023459
OPDYKE,IL,61,56,-5,0.47863247863247865
OPELIKA,AL,14948,15336,388,0.506406022982433
OPELOUSAS,LA,10844,9535,-1309,0.46788360567250603
OPHIR,UT,0,12,12,1
OPP,AL,4255,4094,-161,0.4903581267217631
OPTIMA,OK,54,38,-16,0.41304347826086957
OQUAWKA,IL,936,640,-296,0.40609137055837563
OQUOSSOC,ME,722,495,-227,0.4067378800328677
ORACLE,AZ,3143,3944,801,0.5565119232397348
ORADELL,NJ,1658,1996,338,0.5462506841817186
ORAN,MO,930,823,-107,0.4694808899030234
ORANGE,CA,43966,41294,-2672,0.484330283837673
ORANGE,CT,3521,4173,652,0.5423706784507408
ORANGE,MA,3136,3158,22,0.5017476962186209
ORANGE,NH,225,209,-16,0.4815668202764977
ORANGE,NJ,9088,7638,-1450,0.4566543106540715
ORANGE,TX,14122,13829,-293,0.49475868484132945
ORANGE,VA,3990,3836,-154,0.49016100178890876
ORANGE,VT,107,146,39,0.5770750988142292
ORANGE BEACH,AL,9000,12751,3751,0.5862259206473266
ORANGE CITY,FL,12563,14756,2193,0.5401369010578718
ORANGE CITY,IA,2120,2068,-52,0.49379178605539636
ORANGE COVE,CA,2280,1887,-393,0.4528437724982001
ORANGE GROVE,TX,1342,1672,330,0.5547445255474452
ORANGE LAKE,FL,11,69,58,0.8625
ORANGE PARK,FL,40293,40138,-155,0.49903644117317947
ORANGEBURG,NY,1159,1319,160,0.5322841000807103
ORANGEBURG,SC,13458,12180,-1278,0.475076058974959
ORANGEFIELD,TX,25,13,-12,0.34210526315789475
ORANGEVALE,CA,12276,11965,-311,0.4935852481333278
ORANGEVILLE,IL,329,248,-81,0.42980935875216636
ORANGEVILLE,PA,980,867,-113,0.46940985381700057
ORANGEVILLE,UT,60,74,14,0.5522388059701493
ORBISONIA,PA,262,346,84,0.569078947368421
ORCAS,WA,141,186,45,0.5688073394495413
ORCHARD,NE,47,72,25,0.6050420168067226
ORCHARD BEACH,MD,201,175,-26,0.4654255319148936
ORCHARD GRASS HILLS,KY,105,108,3,0.5070422535211268
ORCHARD HILL,GA,25,23,-2,0.4791666666666667
ORCHARD LAKE,MI,889,795,-94,0.47209026128266035
ORCHARD PARK,NY,10168,10367,199,0.504845385926467
ORCUTT,CA,549,676,127,0.5518367346938775
ORD,NE,1395,1178,-217,0.4578313253012048
ORDWAY,CO,1008,842,-166,0.45513513513513515
ORE CITY,TX,1733,1548,-185,0.47180737580006094
OREANA,IL,259,245,-14,0.4861111111111111
OREFIELD,PA,1998,2218,220,0.5260910815939279
OREGON,IL,2768,2760,-8,0.4992764109985528
OREGON,MO,127,151,24,0.5431654676258992
OREGON,OH,7599,6953,-646,0.477803738317757
OREGON,WI,4476,4851,375,0.5201029269861692
OREGON CITY,OR,22277,21883,-394,0.4955389492753623
OREGON HOUSE,CA,562,260,-302,0.31630170316301703
OREGONIA,OH,383,473,90,0.552570093457944
ORELAND,PA,1249,1422,173,0.5323848745788095
OREM,UT,42786,32905,-9881,0.4347280390006738
ORESTES,IN,59,0,-59,0
ORFORD,NH,458,577,119,0.557487922705314
ORFORDVILLE,WI,751,777,26,0.5085078534031413
ORGAN,NM,27,13,-14,0.325
ORICK,CA,23,12,-11,0.34285714285714286
ORIENT,IA,76,39,-37,0.3391304347826087
ORIENT,IL,11,0,-11,0
ORIENT,ME,29,51,22,0.6375
ORIENT,NY,386,642,256,0.6245136186770428
ORIENT,OH,2713,2645,-68,0.4936543486375513
ORIENTAL,NC,1452,1670,218,0.5349135169762973
ORINDA,CA,5114,6455,1341,0.5579566081770249
ORION,IL,1027,834,-193,0.44814615797958085
ORION,MI,958,1036,78,0.5195586760280843
ORISKANY,NY,715,610,-105,0.46037735849056605
ORISKANY FALLS,NY,717,419,-298,0.36883802816901406
ORISKANY FLS,NY,85,72,-13,0.4585987261146497
ORLA,TX,0,11,11,1
ORLAND,CA,4859,4316,-543,0.47040871934604905
ORLAND,IN,623,557,-66,0.47203389830508474
ORLAND,ME,1059,997,-62,0.48492217898832685
ORLAND HILLS,IL,1562,1542,-20,0.49677835051546393
ORLAND PARK,IL,17569,18715,1146,0.5157920846654173
ORLANDO,FL,643973,584610,-59363,0.4758408670802054
ORLANDO,KY,11,11,0,0.5
ORLEANS,CA,13,0,-13,0
ORLEANS,IN,1734,1679,-55,0.49194257251684737
ORLEANS,MA,3018,3860,842,0.5612096539691771
ORLEANS,MI,685,544,-141,0.44263628966639545
ORLEANS,NE,24,62,38,0.7209302325581395
ORLEANS,VT,1160,1067,-93,0.4791198922317018
ORLINDA,TN,107,113,6,0.5136363636363637
ORMA,WV,12,11,-1,0.4782608695652174
ORMOND BEACH,FL,38186,43980,5794,0.5352578925589659
ORNEVILLE TWP,ME,67,83,16,0.5533333333333333
ORO GRANDE,CA,157,252,95,0.6161369193154034
ORO VALLEY,AZ,16786,19950,3164,0.5430640243902439
OROFINO,ID,2730,2620,-110,0.4897196261682243
ORONDO,WA,626,724,98,0.5362962962962963
ORONO,ME,3763,2962,-801,0.4404460966542751
ORONO,MN,208,196,-12,0.48514851485148514
ORONOCO,MN,862,994,132,0.5355603448275862
ORONOGO,MO,760,933,173,0.5510927347903131
OROSI,CA,1594,1297,-297,0.4486336907644414
OROVILLE,CA,20377,19557,-820,0.48973305954825463
OROVILLE,WA,2087,2216,129,0.5149895421798745
ORR,MN,895,637,-258,0.4157963446475196
ORRICK,MO,714,468,-246,0.39593908629441626
ORRINGTON,ME,1411,1568,157,0.5263511245384357
ORRS ISLAND,ME,392,497,105,0.5590551181102362
ORRSTOWN,PA,569,521,-48,0.4779816513761468
ORRTANNA,PA,597,729,132,0.5497737556561086
ORRUM,NC,252,303,51,0.5459459459459459
ORRVILLE,AL,150,105,-45,0.4117647058823529
ORRVILLE,OH,4873,4684,-189,0.4901119598200272
ORTING,WA,5559,5961,402,0.5174479166666667
ORTONVILLE,MI,3898,3941,43,0.5027426967725476
ORTONVILLE,MN,1239,1118,-121,0.474331777683496
ORWELL,OH,1669,1356,-313,0.44826446280991733
ORWELL,VT,226,295,69,0.5662188099808061
ORWIGSBURG,PA,2474,2364,-110,0.4886316659776767
OSAGE,IA,2045,1960,-85,0.4893882646691635
OSAGE,MN,345,437,92,0.5588235294117647
OSAGE,OK,78,0,-78,0
OSAGE BEACH,MO,4965,4789,-176,0.4909780602829608
OSAGE CITY,KS,1768,1853,85,0.5117370892018779
OSAKIS,MN,1734,1648,-86,0.4872856298048492
OSAWATOMIE,KS,2621,2305,-316,0.46792529435647584
OSBORN,MO,40,24,-16,0.375
OSBORNE,KS,774,641,-133,0.4530035335689046
OSBURN,ID,718,816,98,0.5319426336375489
OSCAR,LA,13,70,57,0.8433734939759037
OSCEOLA,AR,3754,2910,-844,0.4366746698679472
OSCEOLA,IA,3988,3346,-642,0.4562312517043905
OSCEOLA,IN,4694,4656,-38,0.4979679144385027
OSCEOLA,MO,1590,1724,134,0.52021726010863
OSCEOLA,NE,291,164,-127,0.36043956043956044
OSCEOLA,PA,129,85,-44,0.397196261682243
OSCEOLA,WI,2801,2929,128,0.5111692844677138
OSCEOLA MILLS,PA,764,795,31,0.5099422706863374
OSCODA,MI,6733,5477,-1256,0.44856674856674855
OSGOOD,IN,1456,1389,-67,0.4882249560632689
OSHKOSH,NE,412,251,-161,0.37858220211161386
OSHKOSH,WI,40455,34340,-6115,0.4591215990373688
OSHOTO,WY,44,46,2,0.5111111111111111
OSHTEMO,MI,40,49,9,0.550561797752809
OSKALOOSA,IA,7113,6225,-888,0.46671165092217726
OSKALOOSA,KS,888,906,18,0.5050167224080268
OSLO,MN,78,23,-55,0.22772277227722773
OSMOND,NE,182,104,-78,0.36363636363636365
OSPREY,FL,6931,7641,710,0.5243617897337359
OSSEO,MI,1149,1093,-56,0.4875111507582516
OSSEO,MN,4262,4247,-15,0.4991185803267129
OSSEO,WI,1698,1598,-100,0.4848300970873786
OSSIAN,IA,184,180,-4,0.4945054945054945
OSSIAN,IN,2299,2164,-135,0.4848756441855254
OSSINEKE,MI,969,1021,52,0.5130653266331658
OSSINING,NY,8857,8011,-846,0.47492293099359734
OSSIPEE,NH,762,946,184,0.5538641686182669
OSTEEN,FL,1631,2038,407,0.5554647042790951
OSTERBURG,PA,85,121,36,0.587378640776699
OSTERVILLE,MA,3477,3416,-61,0.49557522123893805
OSTRANDER,MN,12,0,-12,0
OSTRANDER,OH,979,1357,378,0.5809075342465754
OSWEGO,IL,12581,12764,183,0.5036101795225882
OSWEGO,KS,1196,987,-209,0.4521300961978928
OSWEGO,NY,16638,14718,-1920,0.4693838499808649
OSYKA,MS,288,303,15,0.5126903553299492
OTEGO,NY,1168,1053,-115,0.4741107609185052
OTHELLO,WA,3565,3257,-308,0.47742597478745236
OTHO,IA,22,0,-22,0
OTIS,CO,81,98,17,0.547486033519553
OTIS,KS,12,0,-12,0
OTIS,LA,11,0,-11,0
OTIS,MA,686,672,-14,0.4948453608247423
OTIS,OR,1914,1721,-193,0.4734525447042641
OTIS ANGB,MA,0,11,11,1
OTIS ORCHARDS,WA,1866,2042,176,0.522517911975435
OTISCO,IN,225,291,66,0.563953488372093
OTISFIELD,ME,624,543,-81,0.4652956298200514
OTISVILLE,MI,1522,1355,-167,0.47097671185262424
OTISVILLE,NY,852,909,57,0.5161839863713799
OTLEY,IA,11,12,1,0.5217391304347826
OTSEGO,MI,3830,3475,-355,0.4757015742642026
OTSEGO,MN,1341,1625,284,0.547875927174646
OTTAWA,IL,10180,9181,-999,0.47420071277310055
OTTAWA,KS,7909,7159,-750,0.4751128218741704
OTTAWA,OH,2655,2257,-398,0.4594869706840391
OTTAWA HILLS,OH,1558,1440,-118,0.48032021347565046
OTTAWA LAKE,MI,1081,1102,21,0.5048098946404032
OTTER LAKE,MI,654,652,-2,0.4992343032159265
OTTERBEIN,IN,673,675,2,0.5007418397626113
OTTERTAIL,MN,1527,1327,-200,0.4649614576033637
OTTERVILLE,MO,280,137,-143,0.328537170263789
OTTO,NC,1254,1404,150,0.5282167042889391
OTTOVILLE,OH,70,12,-58,0.14634146341463414
OTTSVILLE,PA,721,823,102,0.5330310880829016
OTTUMWA,IA,19148,14880,-4268,0.4372869401669214
OTWAY,OH,623,485,-138,0.43772563176895307
OTWELL,IN,392,413,21,0.5130434782608696
OURAY,CO,1461,1012,-449,0.40921957137080467
OUTING,MN,313,302,-11,0.49105691056910566
OUTLOOK,MT,13,0,-13,0
OUTLOOK,WA,93,102,9,0.5230769230769231
OVALO,TX,23,150,127,0.8670520231213873
OVANDO,MT,13,14,1,0.5185185185185185
OVAPA,WV,14,0,-14,0
OVERBROOK,KS,804,802,-2,0.49937733499377335
OVERBROOK,OK,48,23,-25,0.323943661971831
OVERGAARD,AZ,2923,3276,353,0.5284723342474593
OVERLAND,MO,2092,1869,-223,0.47185054279222416
OVERLAND PARK,KS,91176,89937,-1239,0.49657948352685893
OVERTON,NE,69,60,-9,0.46511627906976744
OVERTON,NV,1905,1756,-149,0.4796503687517072
OVERTON,TX,1950,1951,1,0.5001281722635221
OVETT,MS,303,349,46,0.5352760736196319
OVID,CO,30,35,5,0.5384615384615384
OVID,ID,66,57,-9,0.4634146341463415
OVID,MI,1770,1478,-292,0.45504926108374383
OVID,NY,1395,1200,-195,0.4624277456647399
OVIEDO,FL,30688,28190,-2498,0.478786643568056
OVILLA,TX,580,721,141,0.5541890853189854
OWANECO,IL,12,0,-12,0
OWASSO,OK,20492,19643,-849,0.4894231967111
OWATONNA,MN,13545,12085,-1460,0.47151775263363244
OWEGO,NY,5087,4571,-516,0.4732863946986954
OWEN,WI,805,660,-145,0.45051194539249145
OWENDALE,MI,53,0,-53,0
OWENS CROSS ROADS,AL,5941,8188,2247,0.5795173048340293
OWENSBORO,KY,38181,34213,-3968,0.47259441390170454
OWENSVILLE,IN,1429,1184,-245,0.4531190202831994
OWENSVILLE,MO,2213,2379,166,0.518074912891986
OWENSVILLE,OH,422,198,-224,0.3193548387096774
OWENTON,KY,2365,2405,40,0.5041928721174004
OWINGS,MD,1978,2296,318,0.5372016846045858
OWINGS MILLS,MD,29619,27952,-1667,0.4855222247312015
OWINGSVILLE,KY,2468,2514,46,0.504616619831393
OWLS HEAD,ME,562,822,260,0.5939306358381503
OWLS HEAD,NY,96,173,77,0.6431226765799256
OWOSSO,MI,12711,11549,-1162,0.47605111294311625
OWYHEE,NV,121,63,-58,0.3423913043478261
OXBOW,ND,49,103,54,0.6776315789473685
OXFORD,AL,6467,6609,142,0.505429795044356
OXFORD,AR,231,273,42,0.5416666666666666
OXFORD,CT,3016,4037,1021,0.5723805472848433
OXFORD,FL,3893,4611,718,0.5422154280338665
OXFORD,GA,3714,4220,506,0.5318880766322158
OXFORD,IA,761,725,-36,0.4878869448183042
OXFORD,IN,539,596,57,0.5251101321585903
OXFORD,KS,481,328,-153,0.4054388133498146
OXFORD,MA,3399,3386,-13,0.4990420044215181
OXFORD,MD,399,464,65,0.5376593279258401
OXFORD,ME,2071,2427,356,0.5395731436193864
OXFORD,MI,10082,8729,-1353,0.4640369996278773
OXFORD,MS,22261,16891,-5370,0.43142112791172865
OXFORD,NC,7164,6559,-605,0.4779567150040079
OXFORD,NE,256,87,-169,0.2536443148688047
OXFORD,NJ,1099,1045,-54,0.48740671641791045
OXFORD,NY,1900,1770,-130,0.4822888283378747
OXFORD,OH,7848,5800,-2048,0.4249706916764361
OXFORD,PA,4173,4069,-104,0.49369085173501576
OXFORD,WI,1429,1429,0,0.5
OXFORD JUNCTION,IA,61,54,-7,0.46956521739130436
OXNARD,CA,50756,45755,-5001,0.47409103625493465
OXON HILL,MD,12615,11949,-666,0.48644357596482657
OYSTER BAY,NY,3065,3120,55,0.5044462409054163
OYSTERVILLE,WA,13,0,-13,0
OZARK,AL,8096,7818,-278,0.49126555234384817
OZARK,AR,4084,4169,85,0.5051496425542227
OZARK,IL,30,0,-30,0
OZARK,MO,15255,14554,-701,0.48824180616592305
OZAWKIE,KS,725,792,67,0.5220830586684245
OZONA,FL,84,72,-12,0.46153846153846156
OZONA,TX,700,270,-430,0.27835051546391754
OZONE,AR,11,34,23,0.7555555555555555
OZONE PARK,NY,13487,10394,-3093,0.4352414053012855
P C BEACH,FL,1801,2121,320,0.5407955124936257
PA,PA,11,0,-11,0
PA FURNACE,PA,28,25,-3,0.4716981132075472
PAAUILO,HI,28,41,13,0.5942028985507246
PABLO,MT,225,249,24,0.5253164556962026
PACE,FL,6042,7358,1316,0.5491044776119403
PACHECO,CA,4216,4359,143,0.508338192419825
PACHUTA,MS,36,186,150,0.8378378378378378
PACIFIC,MO,5739,5160,-579,0.4734379300853289
PACIFIC,WA,3567,2608,-959,0.4223481781376518
PACIFIC BEACH,WA,121,167,46,0.5798611111111112
PACIFIC CITY,OR,837,848,11,0.5032640949554896
PACIFIC GROVE,CA,8301,7826,-475,0.48527314441619646
PACIFIC JCT,IA,110,0,-110,0
PACIFIC JUNCTION,IA,515,82,-433,0.1373534338358459
PACIFIC PALISADES,CA,7636,8502,866,0.5268310819184533
PACIFIC PLSDS,CA,260,314,54,0.5470383275261324
PACIFICA,CA,13652,12146,-1506,0.4708116908287464
PACKWAUKEE,WI,12,0,-12,0
PACKWOOD,IA,15,16,1,0.5161290322580645
PACKWOOD,WA,678,483,-195,0.4160206718346253
PACOIMA,CA,8787,7381,-1406,0.45651904997525977
PACOLET,SC,1180,1415,235,0.5452793834296724
PACOLET MILLS,SC,11,0,-11,0
PADEN,OK,110,115,5,0.5111111111111111
PADEN CITY,WV,825,730,-95,0.4694533762057878
PADUCAH,KY,28498,25990,-2508,0.4769857583321098
PADUCAH,TX,744,486,-258,0.3951219512195122
PAEONIAN SPRINGS,VA,16,34,18,0.68
PAGE,AZ,2286,1910,-376,0.4551954242135367
PAGE,ND,12,0,-12,0
PAGELAND,SC,2790,2734,-56,0.4949312092686459
PAGOSA SPRINGS,CO,9247,8854,-393,0.4891442461742445
PAHALA,HI,12,0,-12,0
PAHOA,HI,5813,7058,1245,0.5483645404397482
PAHOKEE,FL,2023,1860,-163,0.47901107391192377
PAHRUMP,NV,21650,25270,3620,0.5385763000852515
PAIA,HI,2888,2155,-733,0.42732500495736664
PAICINES,CA,36,26,-10,0.41935483870967744
PAIGE,TX,1040,1442,402,0.580983078162772
PAINESDALE,MI,25,0,-25,0
PAINESVILLE,OH,15012,15598,586,0.5095720352825874
PAINT LICK,KY,554,655,101,0.5417700578990902
PAINT ROCK,TX,0,24,24,1
PAINTED POST,NY,4449,4180,-269,0.48441302584308726
PAINTER,VA,425,500,75,0.5405405405405406
PAINTSVILLE,KY,2670,2679,9,0.5008412787436904
PAISLEY,FL,1689,1573,-116,0.4822194972409565
PALA,CA,49,65,16,0.5701754385964912
PALACIOS,TX,2019,2036,17,0.5020961775585696
PALATINE,IL,28255,25925,-2330,0.47849760059062385
PALATINE BRG,NY,12,20,8,0.625
PALATINE BRIDGE,NY,332,410,78,0.5525606469002695
PALATKA,FL,10627,10561,-66,0.49844251463092315
PALCO,KS,0,13,13,1
PALENVILLE,NY,621,405,-216,0.39473684210526316
PALERMO,CA,664,709,45,0.5163874726875455
PALERMO,ME,517,593,76,0.5342342342342342
PALESTINE,AR,240,129,-111,0.34959349593495936
PALESTINE,IL,801,673,-128,0.45658073270013566
PALESTINE,OH,13,0,-13,0
PALESTINE,TX,12158,11999,-159,0.4967090284389618
PALESTINE,WV,26,0,-26,0
PALISADE,CO,2747,2461,-286,0.472542242703533
PALISADE,MN,363,402,39,0.5254901960784314
PALISADE,NE,16,11,-5,0.4074074074074074
PALISADES,NY,77,142,65,0.6484018264840182
PALISADES PARK,NJ,8228,7587,-641,0.4797344293392349
PALISADES PK,NJ,138,133,-5,0.4907749077490775
PALL MALL,TN,25,33,8,0.5689655172413793
PALM,PA,0,11,11,1
PALM BAY,FL,60898,67755,6857,0.5266492036718926
PALM BCH GDNS,FL,4630,5096,466,0.5239564055110014
PALM BEACH,FL,15966,15750,-216,0.4965947786606129
PALM BEACH GARDENS,FL,39804,46065,6261,0.5364566956643259
PALM BEACH SHORES,FL,1652,1772,120,0.5175233644859814
PALM CITY,FL,16929,18297,1368,0.5194174757281553
PALM COAST,FL,52408,61836,9428,0.5412625608347047
PALM DESERT,CA,45091,52274,7183,0.5368869717044112
PALM HARBOR,FL,41842,44253,2411,0.5140019745629828
PALM SPRINGS,CA,39709,45606,5897,0.5345601594092481
PALM SPRINGS,FL,5809,5563,-246,0.48918396060499475
PALMA CEIA,FL,582,532,-50,0.47755834829443444
PALMDALE,CA,49122,47852,-1270,0.49345185307401984
PALMDALE,FL,11,231,220,0.9545454545454546
PALMER,AK,9452,10626,1174,0.529235979679251
PALMER,IL,0,11,11,1
PALMER,MA,3133,3044,-89,0.4927958555933301
PALMER,MI,0,11,11,1
PALMER,NE,133,55,-78,0.2925531914893617
PALMER,TN,221,233,12,0.513215859030837
PALMER,TX,1441,1548,107,0.5178989628638341
PALMER LAKE,CO,1106,1141,35,0.5077881619937694
PALMER TOWNSHIP,PA,175,200,25,0.5333333333333333
PALMERSVILLE,TN,82,0,-82,0
PALMERTON,PA,3688,3755,67,0.5045008733037754
PALMETTO,FL,27172,35009,7837,0.5630176420449977
PALMETTO,GA,4211,4482,271,0.5155872541125043
PALMETTO,LA,25,13,-12,0.34210526315789475
PALMETTO BAY,FL,2015,2309,294,0.5339962997224792
PALMHURST,TX,131,170,39,0.5647840531561462
PALMS,MI,0,11,11,1
PALMVIEW,TX,1690,2582,892,0.6044007490636704
PALMYRA,IL,389,231,-158,0.3725806451612903
PALMYRA,IN,1354,1368,14,0.5025716385011021
PALMYRA,ME,706,737,31,0.5107415107415108
PALMYRA,MI,115,75,-40,0.39473684210526316
PALMYRA,MO,2222,1913,-309,0.4626360338573156
PALMYRA,NE,35,148,113,0.8087431693989071
PALMYRA,NJ,2782,2635,-147,0.48643160420897175
PALMYRA,NY,4202,3498,-704,0.4542857142857143
PALMYRA,PA,7867,7648,-219,0.4929423138897841
PALMYRA,TN,379,603,224,0.6140529531568228
PALMYRA,VA,5374,5973,599,0.5263946417555301
PALMYRA,WI,1114,1070,-44,0.4899267399267399
PALO,IA,664,826,162,0.5543624161073826
PALO,MI,50,18,-32,0.2647058823529412
PALO ALTO,CA,37216,31690,-5526,0.45990189533567466
PALO CEDRO,CA,1538,1663,125,0.5195251483911277
PALO PINTO,TX,106,167,61,0.6117216117216118
PALOMAR PARK,CA,163,134,-29,0.4511784511784512
PALOS HEIGHTS,IL,3446,3974,528,0.5355795148247978
PALOS HILLS,IL,5383,4874,-509,0.47518767670858925
PALOS PARK,IL,2249,2772,523,0.5520812587134037
PALOS VERDES ESTATES,CA,4119,5102,983,0.5533022448758269
PALOS VERDES PENINSULA,CA,859,1114,255,0.5646224024328433
PALOUSE,WA,423,351,-72,0.45348837209302323
PAMPA,TX,6860,6251,-609,0.4767752269087026
PAMPLICO,SC,752,903,151,0.545619335347432
PAMPLIN,VA,694,777,83,0.5282121006118287
PANA,IL,3258,2632,-626,0.4468590831918506
PANACA,NV,0,50,50,1
PANACEA,FL,1065,1066,1,0.5002346316283435
PANAMA,IL,28,0,-28,0
PANAMA,NY,372,322,-50,0.46397694524495675
PANAMA,OK,264,298,34,0.5302491103202847
PANAMA CITY,FL,57030,60934,3904,0.5165474212471601
PANAMA CITY BEACH,FL,27032,30726,3694,0.5319782540946709
PANDORA,OH,462,316,-146,0.40616966580976865
PANGBURN,AR,965,986,21,0.5053818554587391
PANGUITCH,UT,653,705,52,0.5191458026509573
PANHANDLE,TX,647,599,-48,0.48073836276083465
PANORA,IA,1310,1275,-35,0.4932301740812379
PANORAMA CITY,CA,16145,12094,-4051,0.4282729558412125
PANSEY,AL,50,73,23,0.5934959349593496
PANTEGO,NC,225,181,-44,0.4458128078817734
PANTEGO,TX,989,840,-149,0.4592673592126845
PANTHER,WV,0,12,12,1
PAOLA,KS,4098,4233,135,0.5081022686352179
PAOLI,IN,3105,2880,-225,0.48120300751879697
PAOLI,OK,102,157,55,0.6061776061776062
PAOLI,PA,2847,2897,50,0.5043523676880223
PAONIA,CO,1797,1898,101,0.5136671177266576
PAPAALOA,HI,14,12,-2,0.46153846153846156
PAPAIKOU,HI,302,294,-8,0.49328859060402686
PAPILLION,NE,15299,17963,2664,0.5400456977932776
PARACHUTE,CO,4137,3541,-596,0.46118780932534514
PARADIS,LA,267,158,-109,0.37176470588235294
PARADISE,CA,26485,8837,-17648,0.2501840212898477
PARADISE,MI,226,200,-26,0.4694835680751174
PARADISE,MT,11,0,-11,0
PARADISE,PA,997,894,-103,0.4727657324167107
PARADISE,TX,1840,2618,778,0.5872588604755495
PARADISE,UT,243,248,5,0.505091649694501
PARADISE VALLEY,AZ,8528,9120,592,0.5167724388032638
PARADISE VLY,AZ,222,205,-17,0.48009367681498827
PARAGON,IN,710,789,79,0.5263509006004002
PARAGOULD,AR,18611,17369,-1242,0.48274041133963314
PARAMOUNT,CA,11610,10096,-1514,0.46512485027181427
PARAMUS,NJ,6335,6420,85,0.5033320266562132
PARCHMENT,MI,255,238,-17,0.4827586206896552
PARDEEVILLE,WI,2357,2359,2,0.5002120441051738
PARIS,AR,2569,2405,-164,0.4835142742259751
PARIS,ID,39,22,-17,0.36065573770491804
PARIS,IL,5585,5076,-509,0.4761279429697027
PARIS,KY,7090,6965,-125,0.49555318392031306
PARIS,MI,764,755,-9,0.4970375246872943
PARIS,MO,1087,927,-160,0.4602780536246276
PARIS,MS,0,14,14,1
PARIS,OH,123,106,-17,0.462882096069869
PARIS,TN,9493,8859,-634,0.4827266782911944
PARIS,TX,15340,14357,-983,0.48344950668417686
PARIS CROSSING,IN,11,0,-11,0
PARISH,NY,1615,1476,-139,0.4775153671950825
PARISHVILLE,NY,238,106,-132,0.3081395348837209
PARK,KS,67,61,-6,0.4765625
PARK CITY,KS,2634,2211,-423,0.4563467492260062
PARK CITY,KY,749,834,85,0.5268477574226152
PARK CITY,MT,640,739,99,0.5358955765047135
PARK CITY,UT,18209,19593,1384,0.5183059097402254
PARK FALLS,WI,2313,2300,-13,0.4985909386516367
PARK FOREST,IL,9032,8199,-833,0.4758284487261331
PARK HALL,MD,11,12,1,0.5217391304347826
PARK HILL,OK,1343,1599,256,0.5435078178110129
PARK HILLS,MO,4551,3658,-893,0.4456084784992082
PARK RAPIDS,MN,7221,6802,-419,0.4850602581473294
PARK RIDGE,IL,10276,10766,490,0.5116433799068529
PARK RIDGE,NJ,2261,2720,459,0.5460750853242321
PARK RIVER,ND,588,541,-47,0.479185119574845
PARK ROW,TX,40,32,-8,0.4444444444444444
PARKDALE,OH,456,403,-53,0.4691501746216531
PARKER,AZ,4397,6159,1762,0.5834596438044714
PARKER,CO,49048,53502,4454,0.5217162359824475
PARKER,FL,328,393,65,0.5450762829403606
PARKER,KS,34,57,23,0.6263736263736264
PARKER,PA,941,926,-15,0.4959828602035351
PARKER,SD,361,473,112,0.5671462829736211
PARKER,TX,250,333,83,0.5711835334476844
PARKER,WA,0,12,12,1
PARKER CITY,IN,1060,800,-260,0.43010752688172044
PARKER DAM,CA,509,886,377,0.6351254480286739
PARKER FORD,PA,11,0,-11,0
PARKERS LAKE,KY,47,23,-24,0.32857142857142857
PARKERS PRAIRIE,MN,913,801,-112,0.46732788798133024
PARKERSBURG,IA,873,814,-59,0.4825133372851215
PARKERSBURG,WV,17375,16083,-1292,0.4806922111303724
PARKESBURG,PA,2167,2170,3,0.500345861194374
PARKFIELD,CA,0,11,11,1
PARKIN,AR,459,459,0,0.5
PARKLAND,FL,10229,11378,1149,0.5265886055444995
PARKMAN,ME,75,100,25,0.5714285714285714
PARKS,AZ,249,440,191,0.6386066763425254
PARKS,LA,144,161,17,0.5278688524590164
PARKS COMM PO,AZ,22,14,-8,0.3888888888888889
PARKSLEY,VA,764,787,23,0.5074145712443585
PARKSTON,SD,586,571,-15,0.49351771823681934
PARKSVILLE,KY,137,116,-21,0.45849802371541504
PARKSVILLE,NY,341,311,-30,0.47699386503067487
PARKSVILLE,SC,0,14,14,1
PARKTON,MD,1291,1620,329,0.5565097904500171
PARKTON,NC,2774,2793,19,0.5017064846416383
PARKVILLE,MD,24289,22664,-1625,0.48269546141886566
PARKVILLE,MO,1486,1470,-16,0.4972936400541272
PARLIER,CA,2442,2131,-311,0.46599606385305054
PARLIN,NJ,7654,6740,-914,0.46825065999722104
PARLIN PD TWP,ME,21,20,-1,0.4878048780487805
PARMA,ID,2203,2330,127,0.5140083829693359
PARMA,MI,1983,1857,-126,0.48359375
PARMA,MO,48,62,14,0.5636363636363636
PARMA,OH,11219,10722,-497,0.48867417164213117
PARNELL,IA,35,28,-7,0.4444444444444444
PARON,AR,155,223,68,0.58994708994709
PAROWAN,UT,888,1207,319,0.5761336515513127
PARRISH,AL,1384,1210,-174,0.4664610639938319
PARRISH,FL,12605,19077,6472,0.6021400164131052
PARROTT,GA,12,0,-12,0
PARROTT,VA,13,0,-13,0
PARROTTSVILLE,TN,1210,1234,24,0.5049099836333879
PARSHALL,CO,65,38,-27,0.36893203883495146
PARSHALL,ND,315,258,-57,0.450261780104712
PARSIPPANY,NJ,11749,9639,-2110,0.45067327473349544
PARSONS,KS,7223,5646,-1577,0.43872872795088974
PARSONS,TN,2284,2351,67,0.50722761596548
PARSONS,WV,834,885,51,0.5148342059336823
PARSONSBURG,MD,902,871,-31,0.4912577552171461
PARSONSFIELD,ME,755,873,118,0.5362407862407862
PARTLOW,VA,673,913,240,0.5756620428751577
PARTRIDGE,KS,12,26,14,0.6842105263157895
PASADENA,CA,69323,64036,-5287,0.4801775658185799
PASADENA,MD,17183,17734,551,0.5078901394736088
PASADENA,TX,40785,35863,-4922,0.46789218244442127
PASCAGOULA,MS,9665,8594,-1071,0.47067199737115945
PASCO,WA,29040,26869,-2171,0.4805845212756443
PASCOAG,RI,2085,2187,102,0.511938202247191
PASO ROBLES,CA,16989,16923,-66,0.4990268931351734
PASS CHRISTIAN,MS,4887,5120,233,0.5116418507045069
PASS CHRISTIN,MS,131,130,-1,0.49808429118773945
PASSADUMKEAG,ME,0,11,11,1
PASSAIC,NJ,20226,16235,-3991,0.44527028880173336
PATAGONIA,AZ,754,753,-1,0.4996682149966821
PATASKALA,OH,7094,8221,1127,0.5367939928174992
PATCHOGUE,NY,8037,7162,-875,0.47121521152707413
PATEROS,WA,235,229,-6,0.49353448275862066
PATERSON,NJ,44367,37101,-7266,0.45540580350567095
PATOKA,IL,111,76,-35,0.40641711229946526
PATOKA,IN,217,222,5,0.5056947608200456
PATON,IA,0,12,12,1
PATRICK,SC,313,449,136,0.589238845144357
PATRICK AFB,FL,1251,931,-320,0.42667277726856095
PATRICK AIR FORCE BASE,FL,510,306,-204,0.375
PATRICK SPGS,VA,11,39,28,0.78
PATRICK SPRINGS,VA,537,677,140,0.557660626029654
PATRIOT,IN,228,198,-30,0.4647887323943662
PATRIOT,OH,346,380,34,0.5234159779614325
PATSEY,KY,46,51,5,0.5257731958762887
PATTEN,ME,518,437,-81,0.45759162303664924
PATTERSON,AR,13,0,-13,0
PATTERSON,CA,6875,6955,80,0.5028922631959508
PATTERSON,GA,978,926,-52,0.48634453781512604
PATTERSON,LA,2609,2428,-181,0.4820329561246774
PATTERSON,MO,95,125,30,0.5681818181818182
PATTERSON,NY,1645,1818,173,0.5249783424776205
PATTERSONVILLE,NY,319,336,17,0.5129770992366413
PATTERSONVLE,NY,0,24,24,1
PATTISON,TX,25,0,-25,0
PATTON,CA,25,137,112,0.845679012345679
PATTON,MO,177,253,76,0.5883720930232558
PATTON,PA,899,890,-9,0.4974846282839575
PATTONSBURG,MO,163,157,-6,0.490625
PATTONVILLE,TX,40,11,-29,0.21568627450980393
PATUXENT RIVER,MD,1118,698,-420,0.3843612334801762
PAUL,ID,1054,928,-126,0.4682139253279516
PAULDEN,AZ,1633,2234,601,0.5777088182053272
PAULDING,OH,2483,2340,-143,0.48517520215633425
PAULINA,LA,183,210,27,0.5343511450381679
PAULINE,SC,669,862,193,0.5630306988896147
PAULLINA,IA,624,407,-217,0.3947623666343356
PAULS VALLEY,OK,3918,3552,-366,0.4755020080321285
PAULSBORO,NJ,2858,2684,-174,0.48430169613857815
PAUMA VALLEY,CA,891,811,-80,0.4764982373678026
PAUPACK,PA,71,87,16,0.5506329113924051
PAVILION,NY,582,588,6,0.5025641025641026
PAVILLION,WY,88,93,5,0.5138121546961326
PAVO,GA,632,663,31,0.511969111969112
PAW CREEK,NC,140,186,46,0.5705521472392638
PAW PAW,IL,310,113,-197,0.26713947990543735
PAW PAW,KY,12,11,-1,0.4782608695652174
PAW PAW,MI,5193,4974,-219,0.4892298613160224
PAW PAW,WV,537,570,33,0.5149051490514905
PAWCATUCK,CT,3039,3268,229,0.5181544315839544
PAWHUSKA,OK,1744,1769,25,0.5035582123541132
PAWLET,VT,148,179,31,0.5474006116207951
PAWLEYS ISL,SC,590,706,116,0.5447530864197531
PAWLEYS ISLAND,SC,7236,9551,2315,0.5689521653660571
PAWLING,NY,2071,2278,207,0.5237985743849161
PAWNEE,IL,1413,1245,-168,0.4683972911963883
PAWNEE,OK,1088,1214,126,0.527367506516073
PAWNEE CITY,NE,497,504,7,0.5034965034965035
PAWNEE ROCK,KS,34,23,-11,0.40350877192982454
PAWTUCKET,RI,31408,29380,-2028,0.4833190761334474
PAX,WV,14,0,-14,0
PAXICO,KS,24,11,-13,0.3142857142857143
PAXINOS,PA,103,291,188,0.7385786802030457
PAXTON,FL,88,0,-88,0
PAXTON,IL,2230,2001,-229,0.47293783975419523
PAXTON,IN,25,19,-6,0.4318181818181818
PAXTON,MA,994,1173,179,0.541301338255653
PAXTON,NE,115,63,-52,0.3539325842696629
PAYETTE,ID,5618,4969,-649,0.4693492018513271
PAYNE,OH,681,643,-38,0.48564954682779454
PAYNE SPRINGS,TX,40,41,1,0.5061728395061729
PAYNESVILLE,MN,2471,2380,-91,0.4906204906204906
PAYNESVILLE,WV,19,0,-19,0
PAYNEVILLE,KY,166,97,-69,0.3688212927756654
PAYSON,AZ,14322,14243,-79,0.4986171888674952
PAYSON,IL,217,194,-23,0.4720194647201946
PAYSON,UT,6944,7782,838,0.5284530761917696
PE ELL,WA,93,115,22,0.5528846153846154
PEA RIDGE,AR,3312,4225,913,0.5605678651983548
PEABODY,KS,526,484,-42,0.4792079207920792
PEABODY,MA,19053,17596,-1457,0.48012224071598136
PEACE DALE,RI,170,181,11,0.5156695156695157
PEACE VALLEY,MO,12,11,-1,0.4782608695652174
PEACH BOTTOM,PA,999,799,-200,0.44438264738598443
PEACH SPRINGS,AZ,12,11,-1,0.4782608695652174
PEACHAM,VT,11,28,17,0.717948717948718
PEACHLAND,NC,458,470,12,0.5064655172413793
PEACHTREE CITY,GA,14386,16337,1951,0.5317514565634867
PEACHTREE COR,GA,90,133,43,0.5964125560538116
PEACHTREE CORNERS,GA,14333,12911,-1422,0.4739025106445456
PEAKS ISLAND,ME,680,835,155,0.5511551155115512
PEAPACK,NJ,0,43,43,1
PEARBLOSSOM,CA,482,617,135,0.5614194722474978
PEARCE,AZ,1546,1541,-5,0.49919015225137675
PEARCY,AR,1182,1203,21,0.5044025157232704
PEARISBURG,VA,1797,1881,84,0.5114192495921697
PEARL,MS,10761,10139,-622,0.4851196172248804
PEARL CITY,HI,11312,9423,-1889,0.4544489992765855
PEARL CITY,IL,234,230,-4,0.4956896551724138
PEARL RIVER,LA,3561,3845,284,0.5191736429921685
PEARL RIVER,NY,3784,3671,-113,0.49242119382964455
PEARLAND,TX,44195,46427,2232,0.5123148904239588
PEARLINGTON,MS,59,68,9,0.5354330708661418
PEARSALL,TX,2340,2229,-111,0.48785292186474066
PEARSON,GA,897,996,99,0.526148969889065
PEARSON,WI,14,0,-14,0
PEBBLE BEACH,CA,2365,2236,-129,0.48598130841121495
PECAN GAP,TX,59,56,-3,0.48695652173913045
PECATONICA,IL,1092,1057,-35,0.49185667752442996
PECK,ID,35,24,-11,0.4067796610169492
PECK,KS,111,171,60,0.6063829787234043
PECK,MI,357,295,-62,0.45245398773006135
PECKS MILL,WV,12,12,0,0.5
PECKVILLE,PA,1227,1321,94,0.5184458398744113
PECONIC,NY,173,216,43,0.5552699228791774
PECOS,NM,325,449,124,0.5801033591731266
PECOS,TX,2618,2517,-101,0.4901655306718598
PECULIAR,MO,3299,3918,619,0.5428848552029929
PEDRICKTOWN,NJ,153,234,81,0.6046511627906976
PEDRO,OH,359,404,45,0.5294888597640891
PEEBLES,OH,3287,3010,-277,0.478005399396538
PEEKSKILL,NY,7847,7173,-674,0.47756324900133157
PEEL,AR,21,36,15,0.631578947368421
PEEPLES VALLEY,AZ,190,251,61,0.5691609977324263
PEEPLES VLY,AZ,19,42,23,0.6885245901639344
PEGRAM,TN,1098,1176,78,0.5171503957783641
PEKIN,IL,17580,15884,-1696,0.47465933540521155
PEKIN,IN,2376,2176,-200,0.4780316344463972
PEL RAPIDS,MN,49,48,-1,0.4948453608247423
PELAHATCHIE,MS,1428,1365,-63,0.48872180451127817
PELHAM,AL,7575,8045,470,0.515044814340589
PELHAM,GA,3790,2707,-1083,0.41665384023395413
PELHAM,NC,677,768,91,0.5314878892733564
PELHAM,NH,3649,3934,285,0.5187920348147171
PELHAM,NY,3440,3478,38,0.5027464585140214
PELHAM,TN,53,27,-26,0.3375
PELICAN LAKE,WI,273,202,-71,0.42526315789473684
PELICAN RAPIDS,MN,2931,2629,-302,0.47284172661870505
PELICEDO,TX,0,11,11,1
PELION,SC,2927,2297,-630,0.43970137825421135
PELKIE,MI,246,221,-25,0.4732334047109208
PELL CITY,AL,7616,7690,74,0.5024173526721547
PELL LAKE,WI,103,27,-76,0.2076923076923077
PELLA,IA,5735,5222,-513,0.47659030756593956
PELLSTON,MI,929,726,-203,0.43867069486404836
PELZER,SC,4003,4770,767,0.5437136669326342
PEMAQUID,ME,75,84,9,0.5283018867924528
PEMBERTON,NJ,2729,2553,-176,0.4833396440742143
PEMBERVILLE,OH,1015,936,-79,0.4797539723218862
PEMBINA,ND,213,69,-144,0.24468085106382978
PEMBINE,WI,867,723,-144,0.4547169811320755
PEMBROKE,GA,2083,2241,158,0.5182701202590194
PEMBROKE,IL,0,17,17,1
PEMBROKE,KY,607,625,18,0.5073051948051948
PEMBROKE,MA,4282,4767,485,0.526798541275279
PEMBROKE,ME,207,299,92,0.5909090909090909
PEMBROKE,NC,2535,2428,-107,0.48922022969977835
PEMBROKE,NH,1961,1966,5,0.5006366182836771
PEMBROKE,VA,1161,1220,59,0.5123897522049559
PEMBROKE PINES,FL,54267,54371,104,0.5004786538780169
PEMBROKE PNES,FL,393,435,42,0.5253623188405797
PEMBROKE TOWNSHIP,IL,424,299,-125,0.4135546334716459
PEMBROKE TWP,IL,12,0,-12,0
PEN ARGYL,PA,2268,2186,-82,0.49079479119892233
PENA BLANCA,NM,31,0,-31,0
PENACOOK,NH,2855,2890,35,0.5030461270670148
PENDER,NE,414,401,-13,0.4920245398773006
PENDERGRASS,GA,1610,2383,773,0.59679439018282
PENDLETN CNTY,KY,48,53,5,0.5247524752475248
PENDLETON,IN,5536,6396,860,0.5360375460945357
PENDLETON,KY,358,485,127,0.575326215895611
PENDLETON,OR,11495,9766,-1729,0.45933869526362825
PENDLETON,SC,3425,3786,361,0.525031202329774
PENFIELD,IL,11,0,-11,0
PENFIELD,NY,6293,6769,476,0.5182207931404073
PENFIELD,PA,280,274,-6,0.49458483754512633
PENGILLY,MN,322,290,-32,0.4738562091503268
PENHOOK,VA,1080,1080,0,0.5
PENINSULA,OH,870,1002,132,0.5352564102564102
PENITAS,TX,908,1041,133,0.5341200615700359
PENLLYN,PA,171,134,-37,0.43934426229508194
PENN,PA,88,99,11,0.5294117647058824
PENN HILLS,PA,885,868,-17,0.49515116942384485
PENN LAIRD,VA,346,459,113,0.5701863354037268
PENN RUN,PA,111,152,41,0.5779467680608364
PENN VALLEY,CA,4134,4571,437,0.525100516944285
PENN VALLEY,PA,453,457,4,0.5021978021978022
PENN WYNNE,PA,87,83,-4,0.48823529411764705
PENN YAN,NY,5843,5372,-471,0.4790013374944271
PENNDEL,PA,1221,1274,53,0.51062124248497
PENNELLVILLE,NY,1409,1337,-72,0.4868900218499636
PENNEY FARMS,FL,68,59,-9,0.4645669291338583
PENNGROVE,CA,1538,1577,39,0.5062600321027287
PENNINGTN GAP,VA,108,130,22,0.5462184873949579
PENNINGTON,NJ,3558,4097,539,0.5352057478772044
PENNINGTON GAP,VA,1706,1764,58,0.5083573487031701
PENNOCK,MN,83,91,8,0.5229885057471264
PENNS GROVE,NJ,3462,3393,-69,0.4949671772428884
PENNS PARK,PA,0,11,11,1
PENNSAUKEN,NJ,9613,9958,345,0.5088140616217873
PENNSBORO,WV,888,848,-40,0.48847926267281105
PENNSBURG,PA,2665,3136,471,0.5405964488881227
PENNSDALE,PA,94,87,-7,0.48066298342541436
PENNSVILLE,NJ,4605,4639,34,0.5018390307226309
PENNSVILLE,OH,18,12,-6,0.4
PENNSYLVANIA FURNACE,PA,93,101,8,0.520618556701031
PENNVILLE,IN,387,233,-154,0.3758064516129032
PENOBSCOT,ME,397,402,5,0.5031289111389237
PENROSE,CO,1995,2001,6,0.5007507507507507
PENROSE,NC,284,376,92,0.5696969696969697
PENRYN,CA,850,974,124,0.5339912280701754
PENSACOLA,FL,132971,133010,39,0.5000733135073558
PENSACOLA,OK,108,82,-26,0.43157894736842106
PENSACOLA BCH,FL,686,572,-114,0.4546899841017488
PENSACOLA BEACH,FL,475,556,81,0.539282250242483
PENTWATER,MI,2891,2321,-570,0.4453184957789716
PEORIA,AZ,89218,101442,12224,0.5320570649323403
PEORIA,IL,69936,55749,-14187,0.44356128416278795
PEORIA HEIGHTS,IL,2902,2323,-579,0.4445933014354067
PEORIA HTS,IL,375,276,-99,0.423963133640553
PEOSTA,IA,1301,1433,132,0.5241404535479152
PEOTONE,IL,1912,1829,-83,0.4889067094359797
PEPEEKEO,HI,634,401,-233,0.38743961352657
PEPIN,WI,606,511,-95,0.4574753804834378
PEPPER PIKE,OH,634,527,-107,0.45391903531438416
PEPPERELL,MA,3509,3775,266,0.5182591982427238
PEQUANNOCK,NJ,888,1030,142,0.5370177267987487
PEQUEA,PA,647,559,-88,0.4635157545605307
PEQUOT LAKES,MN,5285,5158,-127,0.49391937182801876
PERALTA,NM,1103,999,-104,0.4752616555661275
PERCIVAL,IA,18,0,-18,0
PERCY,IL,385,291,-94,0.43047337278106507
PERDIDO,AL,134,209,75,0.60932944606414
PERHAM,ME,13,0,-13,0
PERHAM,MN,3850,3526,-324,0.4780368763557484
PERIDOT,AZ,452,82,-370,0.15355805243445692
PERKASIE,PA,6396,6944,548,0.5205397301349325
PERKINS,GA,155,181,26,0.5386904761904762
PERKINS,OK,2185,2417,232,0.525206431986093
PERKINSTON,MS,2922,2917,-5,0.49957184449392017
PERKINSVILLE,VT,200,308,108,0.6062992125984252
PERKIOMENVILLE,PA,1108,1297,189,0.5392931392931393
PERLEY,MN,11,0,-11,0
PERRIN,TX,163,329,166,0.6686991869918699
PERRINE,FL,12,0,-12,0
PERRINEVILLE,NJ,98,142,44,0.5916666666666667
PERRINTON,MI,613,680,67,0.525908739365816
PERRIS,CA,27903,27122,-781,0.49290322580645163
PERRY,AR,111,111,0,0.5
PERRY,FL,5830,5815,-15,0.49935594675826533
PERRY,GA,7915,9467,1552,0.5446438844781958
PERRY,IA,4156,3895,-261,0.48379083343684015
PERRY,IL,12,0,-12,0
PERRY,KS,512,712,200,0.5816993464052288
PERRY,ME,365,444,79,0.5488257107540173
PERRY,MI,2466,2471,5,0.5005063803929511
PERRY,MO,380,469,89,0.552414605418139
PERRY,NY,2524,2175,-349,0.462864439242392
PERRY,OH,1669,1830,161,0.523006573306659
PERRY,OK,2236,2333,97,0.5106150142263077
PERRY,UT,151,133,-18,0.46830985915492956
PERRY HALL,MD,4054,4590,536,0.531004164738547
PERRY PARK,KY,0,12,12,1
PERRY POINT,MD,90,52,-38,0.36619718309859156
PERRYOPOLIS,PA,907,924,17,0.5046422719825232
PERRYSBURG,NY,320,140,-180,0.30434782608695654
PERRYSBURG,OH,17576,17274,-302,0.4956671449067432
PERRYSVILLE,IN,183,195,12,0.5158730158730159
PERRYSVILLE,OH,968,752,-216,0.4372093023255814
PERRYTON,TX,2666,2067,-599,0.43672089583773505
PERRYVILLE,AR,1954,1558,-396,0.44362186788154895
PERRYVILLE,KY,484,654,170,0.5746924428822495
PERRYVILLE,MD,2203,2198,-5,0.499431947284708
PERRYVILLE,MO,7431,6325,-1106,0.4597993602791509
PERSHING,IN,50,0,-50,0
PERSIA,IA,11,0,-11,0
PERTH AMBOY,NJ,18032,15324,-2708,0.45940760283007553
PERU,IL,3888,3436,-452,0.4691425450573457
PERU,IN,13179,10499,-2680,0.4434073823802686
PERU,MA,150,104,-46,0.4094488188976378
PERU,ME,522,569,47,0.5215398716773603
PERU,NE,155,38,-117,0.19689119170984457
PERU,NY,2343,2198,-145,0.48403435366659325
PERU,VT,50,132,82,0.7252747252747253
PESCADERO,CA,78,73,-5,0.48344370860927155
PESHASTIN,WA,502,369,-133,0.42365097588978184
PESHTIGO,WI,2126,1993,-133,0.4838553046856033
PESOTUM,IL,23,13,-10,0.3611111111111111
PETAL,MS,7947,7421,-526,0.48288651743883393
PETALUMA,CA,24822,24894,72,0.500724112961622
PETERBOROUGH,NH,2577,2878,301,0.5275893675527039
PETERMAN,AL,0,11,11,1
PETERSBURG,AK,1063,930,-133,0.46663321625689913
PETERSBURG,IL,2129,2086,-43,0.4948991696322657
PETERSBURG,IN,2290,2176,-114,0.4872369010300045
PETERSBURG,KY,239,132,-107,0.3557951482479784
PETERSBURG,MI,1472,1398,-74,0.4871080139372822
PETERSBURG,NY,761,660,-101,0.4644616467276566
PETERSBURG,OH,12,14,2,0.5384615384615384
PETERSBURG,PA,474,357,-117,0.4296028880866426
PETERSBURG,TN,927,1107,180,0.5442477876106194
PETERSBURG,TX,13,0,-13,0
PETERSBURG,VA,13937,13706,-231,0.4958217270194986
PETERSBURG,WV,1952,1834,-118,0.4844162704701532
PETERSBURGH,NY,153,193,40,0.5578034682080925
PETERSHAM,MA,63,255,192,0.8018867924528302
PETERSON,IA,16,11,-5,0.4074074074074074
PETERSON,MN,23,23,0,0.5
PETERSTOWN,WV,1186,1159,-27,0.49424307036247334
PETOSKEY,MI,12189,11228,-961,0.47948071913567064
PETROLEUM,WV,0,11,11,1
PETROLIA,CA,36,0,-36,0
PETROLIA,PA,170,118,-52,0.4097222222222222
PETROLIA,TX,13,17,4,0.5666666666666667
PETTUS,TX,0,23,23,1
PEVELY,MO,3031,3066,35,0.5028702640642939
PEWAMO,MI,88,86,-2,0.4942528735632184
PEWAUKEE,WI,11725,11220,-505,0.48899542383961647
PEWEE VALLEY,KY,1056,1119,63,0.5144827586206897
PEYTON,CO,13055,16242,3187,0.554391234597399
PEYTONA,WV,0,11,11,1
PFAFFTOWN,NC,3195,4200,1005,0.5679513184584178
PFLUGERVILLE,TX,48642,56269,7627,0.5363498584514493
PHARR,TX,14853,15516,663,0.5109157364417662
PHEBA,MS,24,22,-2,0.4782608695652174
PHELAN,CA,6091,5470,-621,0.4731424617247643
PHELPS,KY,621,518,-103,0.4547848990342406
PHELPS,NY,1548,1534,-14,0.49772874756651525
PHELPS,WI,697,685,-12,0.4956584659913169
PHENIX,VA,49,22,-27,0.30985915492957744
PHENIX CITY,AL,24848,23473,-1375,0.4857722315349434
PHIL CAMPBELL,AL,1663,1480,-183,0.47088768692332167
PHILA,PA,13635,11616,-2019,0.46002138529167164
PHILADELPHIA,MO,12,0,-12,0
PHILADELPHIA,MS,5409,5193,-216,0.4898132427843803
PHILADELPHIA,NY,1560,1222,-338,0.4392523364485981
PHILADELPHIA,PA,577617,483896,-93721,0.4558549918842256
PHILADELPHIA,TN,1256,1491,235,0.5427739352020385
PHILIP,SD,101,92,-9,0.47668393782383417
PHILIPP,MS,13,0,-13,0
PHILIPPI,WV,1926,1931,5,0.5006481721545243
PHILIPSBURG,MT,1119,718,-401,0.3908546543277082
PHILIPSBURG,PA,3025,2733,-292,0.4746439736019451
PHILLIPS,ME,774,479,-295,0.3822825219473264
PHILLIPS,NE,25,62,37,0.7126436781609196
PHILLIPS,WI,2477,2180,-297,0.4681125187889199
PHILLIPS RANCH,CA,274,286,12,0.5107142857142857
PHILLIPSBURG,KS,1508,1240,-268,0.4512372634643377
PHILLIPSBURG,MO,400,520,120,0.5652173913043478
PHILLIPSBURG,NJ,10348,10564,216,0.5051644988523336
PHILLIPSBURG,OH,68,0,-68,0
PHILMONT,NY,583,641,58,0.5236928104575164
PHILO,CA,551,128,-423,0.18851251840942562
PHILO,IL,323,207,-116,0.3905660377358491
PHILO,OH,524,471,-53,0.4733668341708543
PHILOMATH,OR,4062,4222,160,0.5096571704490584
PHILPOT,KY,1265,1409,144,0.5269259536275243
PHIPPSBURG,ME,1051,1341,290,0.56061872909699
PHOENICIA,NY,450,479,29,0.5156081808396125
PHOENIX,AZ,719474,683573,-35901,0.48720605938361294
PHOENIX,IL,579,486,-93,0.4563380281690141
PHOENIX,MD,1447,1962,515,0.5755353476092696
PHOENIX,NY,2505,2465,-40,0.4959758551307847
PHOENIX,OR,3150,2682,-468,0.45987654320987653
PHOENIXVILLE,PA,15147,15178,31,0.5005111294311624
PHX,AZ,917,789,-128,0.46248534583821804
PICAYUNE,MS,10621,9509,-1112,0.47237953303527075
PICKENS,MS,214,200,-14,0.4830917874396135
PICKENS,SC,5364,5778,414,0.518578352180937
PICKENSVILLE,AL,139,117,-22,0.45703125
PICKEREL,WI,181,181,0,0.5
PICKERINGTON,OH,13755,16536,2781,0.5459047241754976
PICKETT,WI,68,66,-2,0.4925373134328358
PICKFORD,MI,477,459,-18,0.49038461538461536
PICKRELL,NE,27,0,-27,0
PICKTON,TX,66,175,109,0.7261410788381742
PICKWICK DAM,TN,26,0,-26,0
PICO RIVERA,CA,11529,10389,-1140,0.4739939775526964
PIE TOWN,NM,22,74,52,0.7708333333333334
PIEDMONT,AL,3909,3605,-304,0.47977109395794515
PIEDMONT,CA,3143,3134,-9,0.4992830970208698
PIEDMONT,MO,2404,2329,-75,0.49207690682442423
PIEDMONT,OH,13,0,-13,0
PIEDMONT,OK,3204,4324,1120,0.5743889479277364
PIEDMONT,SC,9941,11431,1490,0.5348586936178177
PIEDMONT,SD,1544,1668,124,0.5193026151930261
PIEDMONT,WV,58,50,-8,0.46296296296296297
PIERCE,CO,829,763,-66,0.4792713567839196
PIERCE,ID,62,0,-62,0
PIERCE,NE,940,792,-148,0.45727482678983833
PIERCE CITY,MO,1414,1336,-78,0.4858181818181818
PIERCEFIELD,NY,35,0,-35,0
PIERCETON,IN,1942,1806,-136,0.4818569903948773
PIERMONT,NH,102,164,62,0.6165413533834586
PIERMONT,NY,1323,1130,-193,0.4606604158173665
PIERPONT,OH,185,137,-48,0.4254658385093168
PIERPONT,SD,12,0,-12,0
PIERRE,SD,7360,6963,-397,0.48614117154227465
PIERRE PART,LA,1208,1258,50,0.5101378751013788
PIERSON,FL,975,1174,199,0.5463006049325267
PIERSON,IA,23,25,2,0.5208333333333334
PIERSON,MI,967,863,-104,0.4715846994535519
PIERSON STATION,IL,11,0,-11,0
PIERZ,MN,1662,1600,-62,0.49049662783568365
PIFFARD,NY,201,250,49,0.5543237250554324
PIGEON,MI,1542,1252,-290,0.44810307802433785
PIGEON,WV,35,39,4,0.527027027027027
PIGEON FORGE,TN,3842,3323,-519,0.4637822749476622
PIGGOTT,AR,2321,2419,98,0.510337552742616
PIKE,NY,25,0,-25,0
PIKE ROAD,AL,3965,5102,1137,0.5626999007389434
PIKESVILLE,MD,11508,12225,717,0.5151055492352421
PIKETON,OH,3042,2920,-122,0.48976853404897686
PIKEVILLE,KY,7151,6511,-640,0.47657736788171573
PIKEVILLE,NC,3892,4325,433,0.526347815504442
PIKEVILLE,TN,3136,3709,573,0.5418553688823959
PILESGROVE,NJ,982,1057,75,0.5183913683178029
PILGRIM,KY,11,0,-11,0
PILGRIM GDNS,PA,208,192,-16,0.48
PILLAGER,MN,1481,1519,38,0.5063333333333333
PILLOW,PA,12,0,-12,0
PILOT,VA,131,200,69,0.6042296072507553
PILOT GROVE,MO,453,291,-162,0.3911290322580645
PILOT HILL,CA,148,327,179,0.6884210526315789
PILOT KNOB,MO,247,225,-22,0.4766949152542373
PILOT KNOB,NY,0,42,42,1
PILOT MOUNTAIN,NC,1803,1779,-24,0.4966499162479062
PILOT MTN,NC,364,367,3,0.5020519835841313
PILOT POINT,TX,2448,3025,577,0.5527133199342226
PILOT ROCK,OR,643,620,-23,0.4908946951702296
PIMA,AZ,1260,1216,-44,0.4911147011308562
PINCKARD,AL,106,60,-46,0.3614457831325301
PINCKNEY,MI,6525,6524,-1,0.4999616828875776
PINCKNEYVILLE,IL,1863,1799,-64,0.4912616056799563
PINCONNING,MI,2540,2139,-401,0.4571489634537294
PINE,AZ,2571,1916,-655,0.4270113661689325
PINE,CO,1591,1627,36,0.5055935363579863
PINE APPLE,AL,12,11,-1,0.4782608695652174
PINE BEACH,NJ,819,909,90,0.5260416666666666
PINE BLUFF,AR,15843,14698,-1145,0.481254706787597
PINE BLUFFS,WY,547,337,-210,0.38122171945701355
PINE BROOK,NJ,2013,1912,-101,0.48713375796178343
PINE BUSH,NY,3072,3358,286,0.5222395023328149
PINE CITY,MN,4506,4305,-201,0.4885938032005448
PINE CITY,NY,1443,1186,-257,0.45112209965766453
PINE GROVE,CA,1789,1928,139,0.518697874630078
PINE GROVE,LA,11,78,67,0.8764044943820225
PINE GROVE,PA,2798,2704,-94,0.4914576517629953
PINE GROVE,WV,27,12,-15,0.3076923076923077
PINE GROVE MILLS,PA,168,75,-93,0.30864197530864196
PINE HAVEN,WY,109,81,-28,0.4263157894736842
PINE HILL,AL,183,178,-5,0.4930747922437673
PINE HILL,NJ,805,769,-36,0.48856416772554
PINE HILL,NY,12,0,-12,0
PINE HILLS,FL,510,369,-141,0.4197952218430034
PINE ISLAND,MN,1917,1980,63,0.5080831408775982
PINE ISLAND,NY,154,234,80,0.6030927835051546
PINE KNOLL SHORES,NC,245,253,8,0.5080321285140562
PINE KNOT,KY,1039,1007,-32,0.4921798631476051
PINE LAKE,GA,850,1536,686,0.6437552388935457
PINE LEVEL,NC,49,104,55,0.6797385620915033
PINE MEADOW,CT,21,0,-21,0
PINE MOUNTAIN,GA,1789,2110,321,0.5411644011284945
PINE MOUNTAIN CLUB,CA,770,695,-75,0.47440273037542663
PINE MOUNTAIN VALLEY,GA,0,24,24,1
PINE MTN CLB,CA,16,13,-3,0.4482758620689655
PINE PLAINS,NY,877,1031,154,0.540356394129979
PINE PRAIRIE,LA,141,110,-31,0.43824701195219123
PINE RIDGE,SD,303,230,-73,0.43151969981238275
PINE RIVER,MN,2295,2165,-130,0.4854260089686099
PINE RIVER,WI,75,51,-24,0.40476190476190477
PINE VALLEY,CA,577,447,-130,0.4365234375
PINE VALLEY,NY,84,67,-17,0.44370860927152317
PINE VILLAGE,IN,11,24,13,0.6857142857142857
PINEBLUFF,NC,757,904,147,0.5442504515352198
PINECREST,CA,12,0,-12,0
PINECREST,FL,5636,5646,10,0.5004431838326537
PINEDALE,AZ,62,99,37,0.6149068322981367
PINEDALE,CA,261,239,-22,0.478
PINEDALE,WY,1735,1969,234,0.5315874730021598
PINEHURST,GA,12,0,-12,0
PINEHURST,ID,839,1014,175,0.5472207231516459
PINEHURST,NC,7957,9808,1851,0.5520968195890796
PINEHURST,TX,2194,3085,891,0.5843909831407463
PINELAND,FL,106,170,64,0.6159420289855072
PINELAND,SC,27,52,25,0.6582278481012658
PINELAND,TX,393,333,-60,0.45867768595041325
PINELLAS PARK,FL,27163,28459,1296,0.5116500665204415
PINEOLA,NC,97,77,-20,0.4425287356321839
PINETOP,AZ,7218,7349,131,0.5044964646117938
PINETOPS,NC,1025,1080,55,0.5130641330166271
PINETOWN,NC,265,182,-83,0.407158836689038
PINETTA,FL,266,264,-2,0.4981132075471698
PINEVIEW,GA,29,50,21,0.6329113924050633
PINEVILLE,AR,26,12,-14,0.3157894736842105
PINEVILLE,KY,1701,1773,72,0.5103626943005182
PINEVILLE,LA,13159,12527,-632,0.48769757844740325
PINEVILLE,MO,1414,1358,-56,0.4898989898989899
PINEVILLE,NC,6416,6951,535,0.5200119697763148
PINEVILLE,SC,238,372,134,0.6098360655737705
PINEVILLE,WV,285,251,-34,0.46828358208955223
PINEWOOD,MN,22,11,-11,0.3333333333333333
PINEWOOD,SC,453,476,23,0.5123789020452099
PINEY CREEK,NC,0,24,24,1
PINEY FLATS,TN,2955,3593,638,0.5487171655467318
PINEY POINT,MD,157,190,33,0.547550432276657
PINGREE,ID,186,104,-82,0.3586206896551724
PINGREE,ND,0,11,11,1
PINGREE GROVE,IL,2552,3171,619,0.554080027957365
PINK HILL,NC,1379,1335,-44,0.4918938835666912
PINNACLE,NC,1428,1759,331,0.5519297144650142
PINOLA,MS,34,38,4,0.5277777777777778
PINOLE,CA,5820,5572,-248,0.48911516853932585
PINON,AZ,13,95,82,0.8796296296296297
PINON HILLS,CA,1356,1777,421,0.5671879987232684
PINOPOLIS,SC,12,0,-12,0
PINOS ALTOS,NM,12,0,-12,0
PINSON,AL,6240,6704,464,0.5179233621755254
PINSON,TN,514,625,111,0.5487269534679543
PINSONFORK,KY,14,0,-14,0
PIOCHE,NV,39,98,59,0.7153284671532847
PIONEER,CA,2534,2521,-13,0.49871414441147377
PIONEER,LA,227,241,14,0.5149572649572649
PIONEER,OH,1020,931,-89,0.47719118400820093
PIONEER,TN,547,461,-86,0.4573412698412698
PIONEERTOWN,CA,79,145,66,0.6473214285714286
PIPE CREEK,TX,1614,1886,272,0.5388571428571428
PIPER CITY,IL,182,170,-12,0.48295454545454547
PIPERSVILLE,PA,1378,1513,135,0.5233483223797993
PIPERTON,TN,370,354,-16,0.4889502762430939
PIPESTEM,WV,35,33,-2,0.4852941176470588
PIPESTONE,MN,3123,2668,-455,0.46071490243481267
PIQUA,OH,10799,10087,-712,0.4829550895336589
PIRTLEVILLE,AZ,11,11,0,0.5
PIRU,CA,43,145,102,0.7712765957446809
PISCATAWAY,NJ,17207,16184,-1023,0.48468150100326435
PISECO,NY,205,175,-30,0.4605263157894737
PISGAH,AL,949,1008,59,0.515074092999489
PISGAH,IA,79,22,-57,0.21782178217821782
PISGAH FOREST,NC,1959,2375,416,0.5479926165205353
PISMO BEACH,CA,4303,4741,438,0.5242149491375497
PISSTBURGH,PA,98,95,-3,0.49222797927461137
PITCAIRN,PA,1354,1213,-141,0.4725360342812622
PITCHER,NY,0,12,12,1
PITKIN,CO,106,154,48,0.5923076923076923
PITKIN,LA,822,925,103,0.529479107040641
PITMAN,NJ,2712,2609,-103,0.49032136816387895
PITMAN,PA,11,0,-11,0
PITSBURG,OH,47,0,-47,0
PITTS,GA,87,135,48,0.6081081081081081
PITTSBORO,IN,2053,2512,459,0.5502738225629792
PITTSBORO,NC,6007,8315,2308,0.5805753386398548
PITTSBURG,CA,27783,24836,-2947,0.4719968072369296
PITTSBURG,IL,268,192,-76,0.41739130434782606
PITTSBURG,KS,16113,12329,-3784,0.43347865832219956
PITTSBURG,MO,595,746,151,0.5563012677106637
PITTSBURG,NH,331,401,70,0.5478142076502732
PITTSBURG,TX,4684,4442,-242,0.4867411790488714
PITTSBURGH,PA,278169,237606,-40563,0.4606776210556929
PITTSFIELD,IL,2360,2189,-171,0.4812046603649154
PITTSFIELD,MA,20140,18429,-1711,0.4778189737872385
PITTSFIELD,ME,1619,1616,-3,0.49953632148377125
PITTSFIELD,NH,1933,1981,48,0.50613183444047
PITTSFIELD,PA,409,337,-72,0.4517426273458445
PITTSFIELD,VT,24,36,12,0.6
PITTSFORD,MI,608,650,42,0.5166931637519873
PITTSFORD,NY,10772,11303,531,0.5120271800679501
PITTSFORD,VT,890,793,-97,0.471182412358883
PITTSGROVE,NJ,357,351,-6,0.4957627118644068
PITTSTON,ME,675,727,52,0.5185449358059915
PITTSTON,PA,5212,5274,62,0.5029563227160023
PITTSTOWN,NJ,1195,1304,109,0.5218087234893958
PITTSVIEW,AL,59,103,44,0.6358024691358025
PITTSVILLE,MD,926,939,13,0.503485254691689
PITTSVILLE,WI,807,667,-140,0.4525101763907734
PIXLEY,CA,703,498,-205,0.414654454621149
PL HILL,IA,345,293,-52,0.4592476489028213
PLACEDO,TX,15,11,-4,0.4230769230769231
PLACENTIA,CA,16544,14856,-1688,0.47312101910828025
PLACERVILLE,CA,12680,13224,544,0.5105003088326128
PLACERVILLE,CO,198,136,-62,0.40718562874251496
PLACIDA,FL,4928,5431,503,0.5242784052514722
PLACITAS,NM,1993,2446,453,0.551025005631899
PLAIN,WI,383,178,-205,0.3172905525846702
PLAIN CITY,OH,4253,6680,2427,0.610994237629196
PLAIN DEALING,LA,805,896,91,0.5267489711934157
PLAINFIELD,CT,3168,2749,-419,0.4645935440256887
PLAINFIELD,IA,66,90,24,0.5769230769230769
PLAINFIELD,IL,27856,27877,21,0.5001883982559704
PLAINFIELD,IN,17117,18240,1123,0.5158808722459485
PLAINFIELD,MA,49,69,20,0.5847457627118644
PLAINFIELD,NH,324,330,6,0.5045871559633027
PLAINFIELD,NJ,11293,10142,-1151,0.47315138791695827
PLAINFIELD,VT,936,957,21,0.5055467511885895
PLAINFIELD,WI,735,507,-228,0.4082125603864734
PLAINS,GA,133,232,99,0.6356164383561644
PLAINS,KS,200,71,-129,0.26199261992619927
PLAINS,MT,1702,1939,237,0.5325460038450975
PLAINS,PA,1444,1307,-137,0.47509996364958196
PLAINS,TX,0,61,61,1
PLAINSBORO,NJ,11864,10008,-1856,0.45757132406730067
PLAINVIEW,AR,239,205,-34,0.4617117117117117
PLAINVIEW,IL,66,51,-15,0.4358974358974359
PLAINVIEW,MN,1647,1277,-370,0.43673050615595077
PLAINVIEW,NE,743,563,-180,0.43108728943338437
PLAINVIEW,NY,7590,8603,1013,0.5312789476934477
PLAINVIEW,TX,7560,6512,-1048,0.46276293348493464
PLAINVILLE,CT,6444,6322,-122,0.49522168259439137
PLAINVILLE,GA,485,568,83,0.5394112060778727
PLAINVILLE,IN,34,54,20,0.6136363636363636
PLAINVILLE,KS,949,933,-16,0.4957492029755579
PLAINVILLE,MA,3893,3550,-343,0.47695821577320974
PLAINWELL,MI,5803,5571,-232,0.48980130121329346
PLAISTOW,NH,2681,2805,124,0.511301494713817
PLANADA,CA,253,249,-4,0.4960159362549801
PLANDOME,NY,255,244,-11,0.48897795591182364
PLANKINTON,SD,241,109,-132,0.31142857142857144
PLANO,IA,0,11,11,1
PLANO,IL,4836,4736,-100,0.4947764312578354
PLANO,TX,137651,136850,-801,0.4985409889217161
PLANT CITY,FL,32419,28813,-3606,0.4705546119675986
PLANTATION,FL,42773,42432,-341,0.49799894372395986
PLANTERSVILLE,AL,46,142,96,0.7553191489361702
PLANTERSVILLE,MS,542,616,74,0.531951640759931
PLANTERSVILLE,TX,1171,1386,215,0.5420414548298788
PLANTSVILLE,CT,2793,3172,379,0.5317686504610226
PLAQUEMINE,LA,4378,4003,-375,0.47762796802290897
PLATO,MN,0,13,13,1
PLATO,MO,760,798,38,0.5121951219512195
PLATTE,SD,305,438,133,0.5895020188425303
PLATTE CENTER,NE,38,32,-6,0.45714285714285713
PLATTE CITY,MO,6452,6368,-84,0.4967238689547582
PLATTEKILL,NY,63,44,-19,0.411214953271028
PLATTENVILLE,LA,23,12,-11,0.34285714285714286
PLATTEVILLE,CO,1829,1674,-155,0.4778761061946903
PLATTEVILLE,WI,7290,5720,-1570,0.4396617986164489
PLATTSBURG,MO,1300,1420,120,0.5220588235294118
PLATTSBURGH,NY,20224,17145,-3079,0.45880275094329526
PLATTSMOUTH,NE,5171,5179,8,0.5003864734299517
PLAUCHEVILLE,LA,232,323,91,0.581981981981982
PLAYA DEL REY,CA,8967,7650,-1317,0.46037190828669433
PLAYA VISTA,CA,8394,7142,-1252,0.45970648815653964
PLAZA,ND,41,29,-12,0.4142857142857143
PLEASANT CITY,OH,426,388,-38,0.47665847665847666
PLEASANT DALE,NE,59,74,15,0.556390977443609
PLEASANT GAP,PA,1547,1474,-73,0.4879179079774909
PLEASANT GARDEN,NC,1615,1676,61,0.5092676997872987
PLEASANT GDN,NC,243,191,-52,0.4400921658986175
PLEASANT GROVE,AL,2319,2332,13,0.501397548914212
PLEASANT GROVE,AR,0,11,11,1
PLEASANT GROVE,CA,36,29,-7,0.4461538461538462
PLEASANT GROVE,UT,11861,11535,-326,0.4930329970935203
PLEASANT GRV,AL,427,473,46,0.5255555555555556
PLEASANT GRV,UT,1389,1316,-73,0.4865064695009242
PLEASANT HILL,CA,14599,14036,-563,0.49016937314475295
PLEASANT HILL,IA,5059,5168,109,0.5053290309963822
PLEASANT HILL,IL,786,505,-281,0.3911696359411309
PLEASANT HILL,LA,70,61,-9,0.46564885496183206
PLEASANT HILL,MO,5091,4978,-113,0.4943887178468567
PLEASANT HILL,OH,555,371,-184,0.4006479481641469
PLEASANT HILL,OR,814,970,156,0.5437219730941704
PLEASANT HILLS,PA,408,382,-26,0.4835443037974684
PLEASANT HLS,PA,235,251,16,0.5164609053497943
PLEASANT HOPE,MO,777,865,88,0.5267965895249695
PLEASANT LAKE,IN,774,625,-149,0.44674767691208006
PLEASANT LAKE,MI,948,812,-136,0.46136363636363636
PLEASANT MOUNT,PA,68,47,-21,0.40869565217391307
PLEASANT MT,PA,12,23,11,0.6571428571428571
PLEASANT PLAIN,OH,424,480,56,0.5309734513274337
PLEASANT PLAINS,AR,524,536,12,0.5056603773584906
PLEASANT PLAINS,IL,508,402,-106,0.44175824175824174
PLEASANT PLN,OH,24,29,5,0.5471698113207547
PLEASANT PLNS,AR,11,0,-11,0
PLEASANT PLNS,IL,111,68,-43,0.37988826815642457
PLEASANT POINT,ME,12,38,26,0.76
PLEASANT PR,WI,126,95,-31,0.4298642533936652
PLEASANT PRAIRIE,WI,6752,7110,358,0.5129129995671621
PLEASANT RDG,MI,33,52,19,0.611764705882353
PLEASANT RIDGE,MI,621,568,-53,0.47771236333052985
PLEASANT RIDGE PLT,ME,14,16,2,0.5333333333333333
PLEASANT SHADE,TN,517,639,122,0.5527681660899654
PLEASANT UNITY,PA,13,0,-13,0
PLEASANT VALLEY,CT,44,62,18,0.5849056603773585
PLEASANT VALLEY,IA,14,13,-1,0.48148148148148145
PLEASANT VALLEY,MO,3128,3213,85,0.5067024128686327
PLEASANT VALLEY,NY,3759,3475,-284,0.48037047276748684
PLEASANT VIEW,TN,2531,3058,527,0.5471461799964216
PLEASANT VIEW,UT,357,437,80,0.5503778337531486
PLEASANT VLY,CT,42,41,-1,0.4939759036144578
PLEASANTHILL,CA,246,222,-24,0.47435897435897434
PLEASANTON,CA,32119,31574,-545,0.49572166486113073
PLEASANTON,KS,668,717,49,0.5176895306859206
PLEASANTON,NE,0,34,34,1
PLEASANTON,TX,5484,6017,533,0.5231718980958178
PLEASANTVILLE,IA,1266,1172,-94,0.4807219031993437
PLEASANTVILLE,NJ,7362,6847,-515,0.4818776831585615
PLEASANTVILLE,NY,3078,3285,207,0.5162659123055162
PLEASANTVILLE,OH,770,738,-32,0.48938992042440316
PLEASANTVILLE,PA,532,431,-101,0.4475597092419522
PLEASANTVILLE,TN,52,76,24,0.59375
PLEASURE RIDGE PARK,KY,0,21,21,1
PLEASUREVILLE,KY,1274,1129,-145,0.4698293799417395
PLENTYWOOD,MT,963,831,-132,0.46321070234113715
PLINY,WV,0,11,11,1
PLOVER,WI,7404,6681,-723,0.4743343982960596
PLUM,PA,665,656,-9,0.49659348978046935
PLUM BRANCH,SC,39,45,6,0.5357142857142857
PLUM CITY,WI,50,111,61,0.6894409937888198
PLUMAS LAKE,CA,7080,8250,1170,0.538160469667319
PLUMERVILLE,AR,592,674,82,0.5323854660347551
PLUMMER,ID,589,785,196,0.5713245997088792
PLUMSTEADVILLE,PA,52,0,-52,0
PLUMVILLE,PA,25,0,-25,0
PLYMOUTH,CA,834,840,6,0.5017921146953405
PLYMOUTH,CT,690,706,16,0.505730659025788
PLYMOUTH,FL,51,61,10,0.5446428571428571
PLYMOUTH,IA,78,30,-48,0.2777777777777778
PLYMOUTH,IL,256,139,-117,0.3518987341772152
PLYMOUTH,IN,9877,8566,-1311,0.4644580599685518
PLYMOUTH,MA,23644,25859,2215,0.52237238147183
PLYMOUTH,ME,239,193,-46,0.44675925925925924
PLYMOUTH,MI,14946,14655,-291,0.49508462551940813
PLYMOUTH,MN,17899,17843,-56,0.4992166079122601
PLYMOUTH,NC,1973,2019,46,0.5057615230460922
PLYMOUTH,NE,0,12,12,1
PLYMOUTH,NH,3511,2633,-878,0.4285481770833333
PLYMOUTH,NY,35,11,-24,0.2391304347826087
PLYMOUTH,OH,1561,1124,-437,0.4186219739292365
PLYMOUTH,PA,4101,3595,-506,0.4671257796257796
PLYMOUTH,VT,0,77,77,1
PLYMOUTH,WA,11,0,-11,0
PLYMOUTH,WI,5308,5085,-223,0.4892716251323006
PLYMOUTH MEETING,PA,4975,5126,151,0.5074745074745075
PLYMPTON,MA,672,773,101,0.5349480968858131
POCA,WV,1386,1411,25,0.5044690740078656
POCAHONTAS,AR,7788,6057,-1731,0.4374864572047671
POCAHONTAS,IA,1202,971,-231,0.44684767602393005
POCAHONTAS,IL,883,903,20,0.5055991041433371
POCAHONTAS,TN,108,116,8,0.5178571428571429
POCAHONTAS,VA,23,0,-23,0
POCASSET,MA,2163,2051,-112,0.4867109634551495
POCATELLO,ID,38273,31811,-6462,0.45389817932766396
POCOLA,OK,1480,1518,38,0.5063375583722481
POCOMOKE CITY,MD,2667,2557,-110,0.48947166921898927
POCONO LAKE,PA,1561,1428,-133,0.477751756440281
POCONO PINES,PA,1648,1455,-193,0.4689010634869481
POCONO SUMMIT,PA,1521,1107,-414,0.4212328767123288
POESTENKILL,NY,230,195,-35,0.4588235294117647
POINCIANA,FL,470,441,-29,0.4840834248079034
POINT,TX,1335,1645,310,0.552013422818792
POINT ARENA,CA,232,160,-72,0.40816326530612246
POINT CLEAR,AL,182,270,88,0.5973451327433629
POINT COMFORT,TX,25,0,-25,0
POINT HARBOR,NC,38,53,15,0.5824175824175825
POINT LOOKOUT,MO,2217,159,-2058,0.06691919191919192
POINT LOOKOUT,NY,720,678,-42,0.48497854077253216
POINT MARION,PA,665,648,-17,0.49352627570449353
POINT MUGU NAWC,CA,318,270,-48,0.45918367346938777
POINT OF ROCKS,MD,201,325,124,0.6178707224334601
POINT PLEASANT,OH,14,16,2,0.5333333333333333
POINT PLEASANT,PA,14,0,-14,0
POINT PLEASANT,WV,2760,2551,-209,0.48032385614761813
POINT PLEASANT BEACH,NJ,2155,2369,214,0.5236516357206012
POINT PLEASANT BORO,NJ,4952,5174,222,0.5109618803081177
POINT REYES STATION,CA,152,227,75,0.5989445910290238
POINT RICHMOND,CA,1298,1095,-203,0.4575846218136231
POINT ROBERTS,WA,830,973,143,0.5396561286744315
POINT VENTURE,TX,167,240,73,0.5896805896805897
POINTBLANK,TX,915,1177,262,0.5626195028680688
POINTE AUX PINS,MI,40,127,87,0.7604790419161677
POLACCA,AZ,23,24,1,0.5106382978723404
POLAND,IN,993,1041,48,0.5117994100294986
POLAND,ME,2042,2242,200,0.523342670401494
POLAND,NY,442,353,-89,0.4440251572327044
POLAND,OH,1474,1779,305,0.5468798032585306
POLARIS,MT,0,11,11,1
POLEBRIDGE,MT,27,36,9,0.5714285714285714
POLK,NE,43,12,-31,0.21818181818181817
POLK,OH,243,268,25,0.5244618395303327
POLK,PA,294,394,100,0.5726744186046512
POLK CITY,FL,5679,7077,1398,0.5547977422389464
POLK CITY,IA,2022,2550,528,0.5577427821522309
POLKTON,NC,701,755,54,0.5185439560439561
POLLARD,AR,24,0,-24,0
POLLOCK,ID,0,20,20,1
POLLOCK,LA,1775,1814,39,0.5054332683198662
POLLOCK,SD,24,14,-10,0.3684210526315789
POLLOCK PINES,CA,3872,3679,-193,0.4872202357303668
POLLOCKSVILLE,NC,315,367,52,0.5381231671554252
POLLOK,TX,894,883,-11,0.49690489589195275
POLO,IL,1256,1171,-85,0.4824886691388546
POLO,MO,889,787,-102,0.46957040572792363
POLSON,MT,7165,6865,-300,0.48930862437633643
POMARIA,SC,401,511,110,0.5603070175438597
POMEROY,IA,184,62,-122,0.25203252032520324
POMEROY,OH,2364,1990,-374,0.45705098759761137
POMEROY,WA,806,672,-134,0.4546684709066306
POMFRET,MD,308,413,105,0.5728155339805825
POMFRET CENTER,CT,1087,1152,65,0.5145154086645825
POMFRET CTR,CT,68,58,-10,0.4603174603174603
POMONA,CA,37380,33235,-4145,0.470650711605183
POMONA,KS,681,660,-21,0.49217002237136465
POMONA,MO,628,555,-73,0.4691462383770076
POMONA,NJ,66,24,-42,0.26666666666666666
POMONA,NY,3636,3214,-422,0.4691970802919708
POMONA PARK,FL,1186,1339,153,0.5302970297029703
POMPANO BEACH,FL,68033,67120,-913,0.4966223465257893
POMPEY,NY,14,0,-14,0
POMPTON LAKES,NJ,3128,3218,90,0.5070910809959029
POMPTON PLAINS,NJ,3336,3210,-126,0.4903758020164986
PONCA,NE,319,170,-149,0.3476482617586912
PONCA CITY,OK,15103,12156,-2947,0.4459444587108845
PONCE DE LEON,FL,1283,1409,126,0.5234026745913819
PONCE INLET,FL,614,978,364,0.614321608040201
PONCHA SPGS,CO,11,37,26,0.7708333333333334
PONCHA SPRINGS,CO,578,691,113,0.5445232466509062
PONCHATOULA,LA,9512,11205,1693,0.5408601631510354
POND CREEK,OK,76,127,51,0.625615763546798
PONDER,TX,1972,2820,848,0.5884808013355592
PONDERAY,ID,1286,1480,194,0.5350686912509038
PONETO,IN,52,49,-3,0.48514851485148514
PONSFORD,MN,149,135,-14,0.4753521126760563
PONTE VEDRA,FL,7911,11872,3961,0.600111206591518
PONTE VEDRA BEACH,FL,17121,20073,2952,0.539683819970963
PONTIAC,IL,5588,5173,-415,0.48071740544559055
PONTIAC,MI,28182,22035,-6147,0.4387956269789115
PONTOON BEACH,IL,444,332,-112,0.42783505154639173
PONTOTOC,MS,8024,6283,-1741,0.4391556580694765
PONY,MT,13,0,-13,0
POOLER,GA,16665,17627,962,0.5140265951242272
POOLESVILLE,MD,1464,1951,487,0.5713030746705711
POOLVILLE,TX,1020,1627,607,0.6146581035134114
POPE,MS,452,449,-3,0.4983351831298557
POPE VALLEY,CA,36,11,-25,0.23404255319148937
POPLAR,MT,686,487,-199,0.4151747655583973
POPLAR,WI,132,178,46,0.5741935483870968
POPLAR BLUFF,MO,18721,17200,-1521,0.4788285404081178
POPLAR GROVE,IL,3388,3384,-4,0.49970466627288834
POPLARVILLE,MS,3816,3718,-98,0.49349615078311654
POQUOSON,VA,3539,3877,338,0.5227885652642934
PORT ALLEGANY,PA,1940,1669,-271,0.4624549736769188
PORT ALLEN,LA,3780,3770,-10,0.49933774834437084
PORT ALSWORTH,AK,0,11,11,1
PORT ANGELES,WA,16628,16694,66,0.5009903367144829
PORT ARANSAS,TX,3325,5443,2118,0.620780109489051
PORT ARTHUR,TX,16923,15965,-958,0.48543541717343713
PORT AUSTIN,MI,2238,1675,-563,0.428060311781242
PORT BARRE,LA,1070,1132,62,0.5140781108083561
PORT BARRINGTON,IL,236,396,160,0.6265822784810127
PORT BOLIVAR,TX,805,592,-213,0.42376521116678595
PORT BYRON,IL,1563,1580,17,0.5027044225262488
PORT BYRON,NY,1570,1475,-95,0.48440065681444994
PORT CARBON,PA,723,618,-105,0.4608501118568233
PORT CHARLES,FL,154,132,-22,0.46153846153846156
PORT CHARLOTTE,FL,58974,66783,7809,0.5310479734726496
PORT CHESTER,NY,6953,6621,-332,0.48777073817592453
PORT CLINTON,OH,8076,7397,-679,0.4780585536095133
PORT CLYDE,ME,194,226,32,0.5380952380952381
PORT COSTA,CA,29,0,-29,0
PORT CRANE,NY,1726,1581,-145,0.4780768067735107
PORT DEPOSIT,MD,2093,2038,-55,0.4933430162188332
PORT EDWARDS,WI,618,617,-1,0.49959514170040487
PORT EWEN,NY,1122,1126,4,0.5008896797153025
PORT GIBSON,MS,1023,973,-50,0.4874749498997996
PORT HADLOCK,WA,1959,2018,59,0.5074176514961026
PORT HAYWOOD,VA,51,112,61,0.6871165644171779
PORT HENRY,NY,581,528,-53,0.47610459873760147
PORT HOPE,MI,326,274,-52,0.45666666666666667
PORT HUENEME,CA,8641,7523,-1118,0.4654169759960406
PORT HUENEME CBC BASE,CA,65,44,-21,0.4036697247706422
PORT HURON,MI,23842,19490,-4352,0.4497830702483153
PORT ISABEL,TX,2102,2053,-49,0.4941034897713598
PORT JEFF STA,NY,611,563,-48,0.479557069846678
PORT JEFFERSON,NY,4099,3781,-318,0.4798223350253807
PORT JEFFERSON,OH,39,0,-39,0
PORT JEFFERSON STATION,NY,7181,6890,-291,0.48965958354061545
PORT JERVIS,NY,6069,5480,-589,0.4744999567062083
PORT KENT,NY,81,15,-66,0.15625
PORT LAVACA,TX,4184,3815,-369,0.47693461682710336
PORT LEYDEN,NY,686,496,-190,0.4196277495769882
PORT LUDLOW,WA,2759,2989,230,0.5200069589422408
PORT MANSFIELD,TX,22,76,54,0.7755102040816326
PORT MATILDA,PA,1801,1950,149,0.519861370301253
PORT MONMOUTH,NJ,1228,1333,105,0.5204998047637641
PORT MURRAY,NJ,633,835,202,0.5688010899182562
PORT NECHES,TX,5027,4115,-912,0.4501203237803544
PORT NORRIS,NJ,294,340,46,0.5362776025236593
PORT O CONNOR,TX,459,407,-52,0.46997690531177827
PORT ORANGE,FL,37753,40572,2819,0.5179955314395148
PORT ORCHARD,WA,29641,27430,-2211,0.48062939145976064
PORT ORFORD,OR,1376,1261,-115,0.47819491846795603
PORT READING,NJ,947,1133,186,0.5447115384615384
PORT REPUBLIC,MD,864,953,89,0.5244909190974133
PORT REPUBLIC,NJ,62,28,-34,0.3111111111111111
PORT REPUBLIC,VA,82,77,-5,0.48427672955974843
PORT RICHEY,FL,38574,36525,-2049,0.48635800743019214
PORT ROYAL,PA,1007,791,-216,0.43993325917686316
PORT ROYAL,SC,4006,2583,-1423,0.39201699802701473
PORT ROYAL,VA,34,36,2,0.5142857142857142
PORT SAINT JOE,FL,3380,4422,1042,0.5667777492950525
PORT SAINT JOHN,FL,493,503,10,0.5050200803212851
PORT SAINT LUCIE,FL,112116,131549,19433,0.5398764697432951
PORT SALERNO,FL,408,428,20,0.5119617224880383
PORT SANILAC,MI,805,634,-171,0.4405837387074357
PORT ST JOE,FL,1162,1582,420,0.576530612244898
PORT ST LUCIE,FL,3155,4516,1361,0.5887107287185503
PORT SULPHUR,LA,298,180,-118,0.37656903765690375
PORT TOBACCO,MD,605,844,239,0.5824706694271912
PORT TOWNSEND,WA,9040,9538,498,0.5134029497254817
PORT TREVORTN,PA,12,28,16,0.7
PORT TREVORTON,PA,328,325,-3,0.49770290964777947
PORT WASHINGTON,NY,9257,9055,-202,0.49448449104412406
PORT WASHINGTON,OH,218,169,-49,0.43669250645994834
PORT WASHINGTON,WI,5171,4895,-276,0.48629048281343135
PORT WENTWORTH,GA,6870,6785,-85,0.4968875869644819
PORT WILLIAM,OH,11,0,-11,0
PORT WING,WI,88,30,-58,0.2542372881355932
PORTAGE,IN,19751,16242,-3509,0.45125441057983495
PORTAGE,ME,12,80,68,0.8695652173913043
PORTAGE,MI,23195,21314,-1881,0.4788694421352985
PORTAGE,OH,173,132,-41,0.43278688524590164
PORTAGE,PA,1615,1561,-54,0.49149874055415615
PORTAGE,WI,7725,6882,-843,0.4711439720681865
PORTAGE DES SIOUX,MO,70,13,-57,0.1566265060240964
PORTAGEVILLE,MO,1694,1616,-78,0.4882175226586103
PORTAGEVILLE,NY,11,25,14,0.6944444444444444
PORTAL,AZ,100,124,24,0.5535714285714286
PORTAL,GA,834,830,-4,0.4987980769230769
PORTALES,NM,7263,6559,-704,0.474533352626248
PORTER,ME,368,363,-5,0.49658002735978113
PORTER,MN,12,0,-12,0
PORTER,OK,828,973,145,0.5402554136590783
PORTER,TX,11329,14601,3272,0.5630929425376012
PORTER CORNERS,NY,574,551,-23,0.48977777777777776
PORTER RANCH,CA,7965,9497,1532,0.5438666819379223
PORTERDALE,GA,1473,1113,-360,0.43039443155452434
PORTERFIELD,WI,178,155,-23,0.46546546546546547
PORTERSVILLE,PA,845,714,-131,0.4579858883899936
PORTERVILLE,CA,16740,15821,-919,0.4858880255520408
PORTIA,AR,11,0,-11,0
PORTLAND,CT,3243,3142,-101,0.49209083790133124
PORTLAND,IN,5154,4425,-729,0.46194801127466334
PORTLAND,ME,53459,42070,-11389,0.44038982926650544
PORTLAND,MI,4077,3953,-124,0.49227895392278953
PORTLAND,ND,121,53,-68,0.3045977011494253
PORTLAND,NY,111,114,3,0.5066666666666667
PORTLAND,OH,11,0,-11,0
PORTLAND,OR,535650,484506,-51144,0.47493324550362886
PORTLAND,PA,11,11,0,0.5
PORTLAND,TN,10690,9589,-1101,0.47285369101040486
PORTLAND,TX,8909,8860,-49,0.49862119421464346
PORTOLA,CA,2536,2040,-496,0.4458041958041958
PORTOLA HILLS,CA,143,213,70,0.598314606741573
PORTOLA VALLEY,CA,1822,2186,364,0.5454091816367266
PORTOLA VALLY,CA,26,28,2,0.5185185185185185
PORTRICHEY,FL,677,603,-74,0.47109375
PORTSMOUTH,IA,27,12,-15,0.3076923076923077
PORTSMOUTH,NH,15398,14532,-866,0.48553291012362176
PORTSMOUTH,OH,11928,11047,-881,0.4808269858541893
PORTSMOUTH,RI,6970,7178,208,0.5073508623126943
PORTSMOUTH,VA,45775,43344,-2431,0.48636093313434847
PORTVILLE,NY,1013,966,-47,0.4881253158160687
PORUM,OK,675,801,126,0.5426829268292683
POSEN,IL,1165,1166,1,0.5002145002145002
POSEN,MI,387,377,-10,0.49345549738219896
POSEYVILLE,IN,736,663,-73,0.4739099356683345
POST,TX,1753,1317,-436,0.42899022801302933
POST FALLS,ID,23516,27403,3887,0.5381684636383275
POST MILLS,VT,34,0,-34,0
POSTVILLE,IA,1910,1580,-330,0.45272206303724927
POTEAU,OK,5439,5177,-262,0.4876601356443105
POTEET,TX,2423,2781,358,0.5343966179861644
POTH,TX,275,263,-12,0.4888475836431227
POTLATCH,ID,533,628,95,0.540913006029285
POTOMAC,IL,243,167,-76,0.4073170731707317
POTOMAC,MD,11986,14807,2821,0.5526443474041728
POTOMAC,MT,18,19,1,0.5135135135135135
POTOMAC FALLS,VA,1338,1401,63,0.511500547645126
POTOSI,MO,3611,3513,-98,0.49312184166198764
POTOSI,WI,806,760,-46,0.48531289910600256
POTRERO,CA,114,74,-40,0.39361702127659576
POTSDAM,NY,6255,5232,-1023,0.45547140245494905
POTTER,NE,132,81,-51,0.38028169014084506
POTTER VALLEY,CA,471,171,-300,0.26635514018691586
POTTERSVILLE,MO,11,24,13,0.6857142857142857
POTTERSVILLE,NJ,13,0,-13,0
POTTERSVILLE,NY,246,195,-51,0.4421768707482993
POTTERVILLE,MI,1808,1605,-203,0.4702607676530911
POTTS CAMP,MS,523,585,62,0.5279783393501805
POTTSBORO,TX,3341,3999,658,0.5448228882833788
POTTSTOWN,PA,22319,22797,478,0.5052974554481781
POTTSVILLE,AR,1336,1163,-173,0.4653861544617847
POTTSVILLE,PA,10053,9664,-389,0.49013541613835776
POUGHKEEPSIE,AR,13,0,-13,0
POUGHKEEPSIE,NY,31489,30707,-782,0.49371342208502156
POUGHQUAG,NY,1672,1778,106,0.5153623188405797
POULAN,GA,208,168,-40,0.44680851063829785
POULSBO,WA,13176,13338,162,0.5030549898167006
POULTNEY,VT,1411,1372,-39,0.49299317283507005
POUND,VA,734,665,-69,0.4753395282344532
POUND,WI,1068,948,-120,0.47023809523809523
POUND RIDGE,NY,1516,1862,346,0.5512137359384252
POUNDING MILL,VA,1050,838,-212,0.4438559322033898
POWAY,CA,15100,15776,676,0.5109470138618992
POWDER SPRINGS,GA,20200,22505,2305,0.5269874721929516
POWDERHORN,CO,0,31,31,1
POWDERLY,KY,104,106,2,0.5047619047619047
POWDERLY,TX,1204,1362,158,0.5307872174590803
POWELL,OH,12423,15381,2958,0.5531937850668969
POWELL,TN,8695,9531,836,0.5229342697245692
POWELL,TX,15,0,-15,0
POWELL,WY,5217,5273,56,0.5026692087702573
POWELL BUTTE,OR,1338,1642,304,0.5510067114093959
POWELLS CROSSROADS,TN,93,88,-5,0.4861878453038674
POWELLS POINT,NC,420,341,-79,0.4480946123521682
POWER,MT,12,0,-12,0
POWERS,MI,74,67,-7,0.475177304964539
POWERS,OR,88,60,-28,0.40540540540540543
POWERS LAKE,ND,63,61,-2,0.49193548387096775
POWHATAN,AR,24,43,19,0.6417910447761194
POWHATAN,VA,8013,8283,270,0.5082842415316642
POWHATAN POINT,OH,494,459,-35,0.48163693599160545
POWHATAN PT,OH,0,21,21,1
POWNAL,ME,239,405,166,0.6288819875776398
POWNAL,VT,904,805,-99,0.47103569338794615
POY SIPPI,WI,50,24,-26,0.32432432432432434
POYEN,AR,158,73,-85,0.31601731601731603
POYNETTE,WI,2132,2024,-108,0.4870067372473532
PR DU CHIEN,WI,67,64,-3,0.48854961832061067
PR DU SAC,WI,43,77,34,0.6416666666666667
PRAGUE,NE,15,0,-15,0
PRAGUE,OK,1689,1849,160,0.5226116449971735
PRAIRIE,MS,91,112,21,0.5517241379310345
PRAIRIE CITY,IA,827,756,-71,0.4775742261528743
PRAIRIE CITY,OR,302,350,48,0.5368098159509203
PRAIRIE DU CHIEN,WI,3517,3036,-481,0.4632992522508775
PRAIRIE DU ROCHER,IL,135,34,-101,0.20118343195266272
PRAIRIE DU SAC,WI,2428,2286,-142,0.4849384811200679
PRAIRIE FARM,WI,178,124,-54,0.4105960264900662
PRAIRIE GROVE,AR,4799,4969,170,0.5087018837018837
PRAIRIE GROVE,IL,235,315,80,0.5727272727272728
PRAIRIE HOME,MO,15,34,19,0.6938775510204082
PRAIRIE LEA,TX,0,12,12,1
PRAIRIE VIEW,TX,740,382,-358,0.3404634581105169
PRAIRIE VILLAGE,KS,9117,9284,167,0.5045377968588663
PRAIRIETON,IN,11,0,-11,0
PRAIRIEVILLE,LA,11195,12960,1765,0.5365348789070585
PRATHER,CA,545,394,-151,0.41959531416400425
PRATT,KS,4084,3630,-454,0.4705729841845994
PRATT,WV,11,0,-11,0
PRATTSBURGH,NY,1106,969,-137,0.4669879518072289
PRATTSVILLE,AR,128,205,77,0.6156156156156156
PRATTSVILLE,NY,359,353,-6,0.4957865168539326
PRATTVILLE,AL,19374,18632,-742,0.4902383834131453
PRAY,MT,12,38,26,0.76
PREBLE,NY,63,66,3,0.5116279069767442
PREMONT,TX,405,451,46,0.5268691588785047
PRENTICE,WI,282,170,-112,0.37610619469026546
PRENTISS,MS,1206,1270,64,0.5129240710823909
PRENTISS TWP,ME,42,65,23,0.6074766355140186
PRESCOTT,AR,2299,2063,-236,0.4729481889041724
PRESCOTT,AZ,36581,39997,3416,0.5223040559951945
PRESCOTT,IA,14,0,-14,0
PRESCOTT,KS,0,11,11,1
PRESCOTT,MI,2165,2210,45,0.5051428571428571
PRESCOTT,WA,383,253,-130,0.3977987421383648
PRESCOTT,WI,2469,2577,108,0.5107015457788348
PRESCOTT VALLEY,AZ,22357,25840,3483,0.53613295433325725
PRESCOTT VLY,AZ,592,692,100,0.5389408099688473
PRESHO,SD,12,0,-12,0
PRESIDIO,TX,141,194,53,0.5791044776119403
PRESQUE ISLE,ME,4493,4273,-220,0.48745151722564456
PRESQUE ISLE,MI,1187,1028,-159,0.46410835214446955
PRESQUE ISLE,WI,763,607,-156,0.44306569343065694
PRESTO,PA,1323,1209,-114,0.4774881516587678
PRESTON,CT,1212,1359,147,0.5285880980163361
PRESTON,GA,75,175,100,0.7
PRESTON,IA,449,251,-198,0.3585714285714286
PRESTON,ID,2928,3164,236,0.5193696651346028
PRESTON,KS,16,27,11,0.627906976744186
PRESTON,MD,1157,1242,85,0.5177157148812005
PRESTON,MN,721,843,122,0.539002557544757
PRESTON,MO,11,52,41,0.8253968253968254
PRESTON,MS,43,89,46,0.6742424242424242
PRESTON,WA,64,24,-40,0.2727272727272727
PRESTON HOLLOW,NY,196,71,-125,0.26591760299625467
PRESTON HOLW,NY,97,17,-80,0.14912280701754385
PRESTON PARK,PA,11,13,2,0.5416666666666666
PRESTONSBURG,KY,4096,3616,-480,0.46887966804979253
PRETTY PRAIRE,KS,0,28,28,1
PRETTY PRAIRIE,KS,163,196,33,0.5459610027855153
PREWITT,NM,12,25,13,0.6756756756756757
PRICE,UT,4779,4731,-48,0.4974763406940063
PRICHARD,AL,922,779,-143,0.45796590241034685
PRICHARD,WV,119,95,-24,0.4439252336448598
PRIDE,LA,856,877,21,0.5060588574725908
PRIDES CROSSING,MA,30,24,-6,0.4444444444444444
PRIEST LAKE,ID,201,136,-65,0.4035608308605341
PRIEST RIVER,ID,2972,3245,273,0.5219559272961235
PRIMGHAR,IA,343,317,-26,0.4803030303030303
PRIMM,NV,95,108,13,0.5320197044334976
PRIMM SPRINGS,TN,25,40,15,0.6153846153846154
PRINCE FREDERICK,MD,3827,4486,659,0.539636713581138
PRINCE GEORGE,VA,5213,5394,181,0.5085321014424437
PRINCESS ANNE,MD,3715,3812,97,0.5064434701740401
PRINCETON,FL,1546,1917,371,0.5535662720184811
PRINCETON,IA,127,189,62,0.5981012658227848
PRINCETON,ID,14,95,81,0.8715596330275229
PRINCETON,IL,4292,4171,-121,0.49285123478671866
PRINCETON,IN,5712,5460,-252,0.48872180451127817
PRINCETON,KS,91,77,-14,0.4583333333333333
PRINCETON,KY,4406,4355,-51,0.49708937335920556
PRINCETON,LA,1800,1298,-502,0.41897998708844414
PRINCETON,MA,991,1136,145,0.5340855665256229
PRINCETON,ME,389,330,-59,0.45897079276773295
PRINCETON,MN,6101,6238,137,0.5055515033633196
PRINCETON,MO,988,887,-101,0.4730666666666667
PRINCETON,NC,2404,2660,256,0.5252764612954186
PRINCETON,NJ,23132,22079,-1053,0.48835460396806085
PRINCETON,TX,9565,16461,6896,0.6324829017136709
PRINCETON,WI,1245,1272,27,0.5053635280095352
PRINCETON,WV,10307,9506,-801,0.4797859990915056
PRINCETON JCT,NJ,968,1059,91,0.5224469659595461
PRINCETON JUNCTION,NJ,3106,3308,202,0.5157468038665419
PRINCEVILLE,HI,2026,2102,76,0.5092054263565892
PRINCEVILLE,IL,982,807,-175,0.4510899944102851
PRINEVILLE,OR,12699,12215,-484,0.4902865858553424
PRINSBURG,MN,38,23,-15,0.3770491803278688
PRINTER,KY,23,25,2,0.5208333333333334
PRIOR LAKE,MN,12979,13090,111,0.5021289654378764
PRITCHETT,CO,22,0,-22,0
PROCIOUS,WV,54,27,-27,0.3333333333333333
PROCTOR,AR,224,230,6,0.5066079295154186
PROCTOR,MN,993,921,-72,0.48119122257053293
PROCTOR,OK,13,12,-1,0.48
PROCTOR,VT,465,461,-4,0.4978401727861771
PROCTOR,WV,109,41,-68,0.2733333333333333
PROCTORSVILLE,VT,324,114,-210,0.2602739726027397
PROCTORVILLE,OH,3435,2979,-456,0.4644527595884004
PROGRESO,TX,33,55,22,0.625
PROLE,IA,23,94,71,0.8034188034188035
PROPHETSTOWN,IL,1132,1089,-43,0.49031967582170194
PROSPECT,CT,2312,2680,368,0.5368589743589743
PROSPECT,KY,7140,8348,1208,0.5389979338842975
PROSPECT,ME,178,149,-29,0.45565749235474007
PROSPECT,OH,960,945,-15,0.49606299212598426
PROSPECT,OR,201,205,4,0.5049261083743842
PROSPECT,PA,636,578,-58,0.47611202635914335
PROSPECT,TN,792,829,37,0.5114127082048119
PROSPECT,VA,413,464,51,0.5290763968072976
PROSPECT HARBOR,ME,120,91,-29,0.4312796208530806
PROSPECT HEIGHTS,IL,4923,4515,-408,0.47838525111252383
PROSPECT HILL,NC,0,28,28,1
PROSPECT HTS,IL,1057,926,-131,0.4669692385274836
PROSPECT PARK,NJ,194,209,15,0.5186104218362283
PROSPECT PARK,PA,2653,2050,-603,0.4358919838401021
PROSPER,TX,12284,21504,9220,0.6364389724162425
PROSPERITY,PA,51,26,-25,0.33766233766233766
PROSPERITY,SC,2046,2683,637,0.5673503912032142
PROSPERITY,WV,28,0,-28,0
PROSSER,NE,26,13,-13,0.3333333333333333
PROSSER,WA,3619,3648,29,0.501995321315536
PROTEM,MO,12,58,46,0.8285714285714286
PROTIVIN,IA,20,0,-20,0
PROVDENCE FRG,VA,117,160,43,0.5776173285198556
PROVENCAL,LA,14,24,10,0.631578947368421
PROVIDENCE,KY,1824,1812,-12,0.49834983498349833
PROVIDENCE,NC,114,225,111,0.6637168141592921
PROVIDENCE,RI,81935,72224,-9711,0.468503298542414
PROVIDENCE,UT,2510,2962,452,0.5413011695906432
PROVIDENCE FORGE,VA,1600,2062,462,0.5630802839978154
PROVIDENCE NEW,PA,24,26,2,0.52
PROVIDENCE VILLAGE,TX,480,728,248,0.6026490066225165
PROVINCETOWN,MA,5032,5348,316,0.5152215799614643
PROVO,UT,45056,31807,-13249,0.41381418888151644
PRUDENCE ISLAND,RI,13,43,30,0.7678571428571429
PRUDENVILLE,MI,3325,2865,-460,0.462843295638126
PRUNEDALE,CA,684,681,-3,0.4989010989010989
PRYOR,MT,12,0,-12,0
PRYOR,OK,6404,6411,7,0.5002731174404994
PT BYRON,IL,11,0,-11,0
PT CHARLOTTE,FL,4081,3632,-449,0.47089329703098665
PT OF ROCKS,MD,20,16,-4,0.4444444444444444
PT ORANGE,FL,3766,3968,202,0.513059219032842
PT PLEASANT,WV,168,158,-10,0.48466257668711654
PT PLEASANT BEACH,NJ,1058,1076,18,0.5042174320524836
PUEBLO,CO,67343,63620,-3723,0.4857860617120866
PUEBLO OF ACOMA,NM,11,25,14,0.6944444444444444
PUEBLO WEST,CO,3461,3964,503,0.5338720538720538
PUKALANI,HI,756,446,-310,0.37104825291181365
PUKWANA,SD,26,25,-1,0.49019607843137253
PULASKI,MS,22,73,51,0.7684210526315789
PULASKI,NY,3502,3439,-63,0.49546174902751766
PULASKI,PA,636,532,-104,0.4554794520547945
PULASKI,TN,8605,7521,-1084,0.4663896812600769
PULASKI,VA,5700,4953,-747,0.4649394536750211
PULASKI,WI,2672,2872,200,0.5180375180375181
PULLMAN,MI,1195,1008,-187,0.4575578756241489
PULLMAN,WA,20981,15024,-5957,0.41727537841966394
PULLMAN,WV,11,0,-11,0
PUMPKIN CENTER,CA,0,11,11,1
PUNGOTEAGUE,VA,11,0,-11,0
PUNTA GORDA,FL,68575,82097,13522,0.5448723054051184
PUNXSUTAWNEY,PA,4907,4679,-228,0.48810765699979136
PURCELL,MO,0,11,11,1
PURCELL,OK,3880,3376,-504,0.4652701212789416
PURCELLVILLE,VA,3371,4037,666,0.544951403887689
PURCHASE,NY,976,1531,555,0.6106900678101316
PURDIN,MO,15,0,-15,0
PURDON,TX,176,429,253,0.7090909090909091
PURDY,MO,1009,1002,-7,0.49825957235206364
PURDYS,NY,11,49,38,0.8166666666666667
PURGITSVILLE,WV,0,22,22,1
PURLEAR,NC,445,581,136,0.5662768031189084
PURLING,NY,39,60,21,0.6060606060606061
PURSGLOVE,WV,11,0,-11,0
PURVIS,MS,4286,4202,-84,0.49505183788878415
PURYEAR,TN,1050,962,-88,0.47813121272365805
PUT IN BAY,OH,833,435,-398,0.3430599369085173
PUTNAM,CT,4538,4315,-223,0.4874053992996724
PUTNAM,IL,49,76,27,0.608
PUTNAM STA,NY,27,27,0,0.5
PUTNAM STATION,NY,119,270,151,0.6940874035989717
PUTNAM VALLEY,NY,2214,2403,189,0.52046783625731
PUTNEY,VT,1656,1704,48,0.5071428571428571
PUUNENE,HI,469,172,-297,0.26833073322932915
PUXICO,MO,1134,1109,-25,0.4944271065537227
PUYALLUP,WA,64552,65291,739,0.502845744476021
PYATT,AR,11,13,2,0.5416666666666666
PYLESVILLE,MD,376,586,210,0.6091476091476091
QUAIL HEIGHTS,FL,108,268,160,0.7127659574468085
QUAIL VALLEY,CA,312,304,-8,0.4935064935064935
QUAKER CITY,OH,1002,681,-321,0.40463458110516937
QUAKER HILL,CT,1386,1350,-36,0.4934210526315789
QUAKERTOWN,PA,9477,10111,634,0.5161833775781091
QUALITY,KY,58,54,-4,0.48214285714285715
QUANAH,TX,1082,1108,26,0.5059360730593607
QUANTICO,MD,59,37,-22,0.3854166666666667
QUANTICO,VA,4480,2722,-1758,0.3779505692863094
QUAPAW,OK,1097,1076,-21,0.49516797054763
QUARRYVILLE,PA,3090,3058,-32,0.4973975276512687
QUARTZ HILL,CA,890,1030,140,0.5364583333333334
QUARTZSITE,AZ,6309,8013,1704,0.5594888981985756
QUASQUETON,IA,36,11,-25,0.23404255319148937
QUEBECK,TN,241,154,-87,0.389873417721519
QUECHEE,VT,1919,1509,-410,0.4401983663943991
QUEEN ANNE,MD,106,53,-53,0.3333333333333333
QUEEN CITY,MO,246,167,-79,0.4043583535108959
QUEEN CITY,OH,62,88,26,0.5866666666666667
QUEEN CITY,TX,1568,1300,-268,0.45327754532775455
QUEEN CREEK,AZ,31062,44261,13199,0.5876160004248371
QUEEN VALLEY,AZ,944,214,-730,0.1848013816925734
QUEENS,NY,55,39,-16,0.4148936170212766
QUEENS VILLAGE,NY,14066,11737,-2329,0.454869588807503
QUEENS VLG,NY,743,611,-132,0.45125553914327915
QUEENSBURY,NY,10509,10731,222,0.505225988700565
QUEENSTOWN,MD,1295,1506,211,0.5376651196001428
QUEMADO,NM,632,489,-143,0.4362176628010705
QUENEMO,KS,49,81,32,0.6230769230769231
QUESTA,NM,377,457,80,0.5479616306954437
QUICKSBURG,VA,0,25,25,1
QUIL CEDA VILLAGE,WA,262,253,-9,0.4912621359223301
QUILCENE,WA,1074,866,-208,0.4463917525773196
QUIMBY,IA,26,0,-26,0
QUINBY,VA,13,0,-13,0
QUINCY,CA,3495,2397,-1098,0.40682281059063136
QUINCY,FL,5167,5637,470,0.5217512032580526
QUINCY,IL,22557,19327,-3230,0.4614411231019005
QUINCY,IN,40,117,77,0.7452229299363057
QUINCY,KY,14,11,-3,0.44
QUINCY,MA,50817,43942,-6875,0.4637237623866862
QUINCY,MI,2821,2195,-626,0.43759968102073366
QUINCY,OH,68,42,-26,0.38181818181818183
QUINCY,WA,4441,3524,-917,0.44243565599497803
QUINCY,WV,21,11,-10,0.34375
QUINEBAUG,CT,70,11,-59,0.13580246913580246
QUINLAN,TX,5560,6103,543,0.5232787447483495
QUINNESEC,MI,71,49,-22,0.4083333333333333
QUINTER,KS,139,114,-25,0.4505928853754941
QUINTON,AL,762,712,-50,0.4830393487109905
QUINTON,NJ,23,0,-23,0
QUINTON,OK,505,375,-130,0.42613636363636365
QUINTON,VA,2294,2788,494,0.5486029122392759
QUINWOOD,WV,32,22,-10,0.4074074074074074
QUITMAN,AR,1572,1811,239,0.5353236772095773
QUITMAN,GA,3303,3033,-270,0.4786931818181818
QUITMAN,LA,472,452,-20,0.48917748917748916
QUITMAN,MS,1919,1689,-230,0.46812638580931265
QUITMAN,TX,3061,3633,572,0.5427248282043621
QULIN,MO,489,337,-152,0.40799031476997577
QUOGUE,NY,2179,1547,-632,0.4151905528717123
RABUN GAP,GA,882,797,-85,0.47468731387730795
RACCOON,KY,136,211,75,0.6080691642651297
RACELAND,KY,394,345,-49,0.4668470906630582
RACELAND,LA,3072,3042,-30,0.4975466143277723
RACINE,OH,976,1030,54,0.5134596211365903
RACINE,WI,43069,39561,-3508,0.4787728427931744
RADCLIFF,KY,16590,13037,-3553,0.4400378033550478
RADCLIFFE,IA,130,74,-56,0.3627450980392157
RADFORD,VA,9618,8603,-1015,0.4721475220898963
RADISSON,WI,94,30,-64,0.24193548387096775
RADIUM SPRINGS,NM,0,11,11,1
RADNOR,OH,218,96,-122,0.3057324840764331
RADNOR,PA,737,781,44,0.5144927536231884
RAEFORD,NC,18902,19502,600,0.5078116862826789
RAGLAND,AL,1587,1315,-272,0.4531357684355617
RAGLEY,LA,1441,1519,78,0.5131756756756757
RAHWAY,NJ,10450,9765,-685,0.4830571357902548
RAIFORD,FL,339,300,-39,0.4694835680751174
RAIL ROAD FLAT,CA,27,0,-27,0
RAINBOW,TX,13,14,1,0.5185185185185185
RAINBOW CITY,AL,4216,3832,-384,0.4761431411530815
RAINBOW LAKE,NY,70,13,-57,0.1566265060240964
RAINELLE,WV,1028,999,-29,0.49284657128761716
RAINIER,OR,2860,2490,-370,0.4654205607476635
RAINIER,WA,1968,2123,155,0.5189440234661452
RAINSVILLE,AL,2698,2839,141,0.5127325266389742
RAISIN CITY,CA,0,12,12,1
RAKE,IA,12,15,3,0.5555555555555556
RALEIGH,IL,11,11,0,0.5
RALEIGH,MS,478,600,122,0.5565862708719852
RALEIGH,NC,282713,261604,-21109,0.48060964474745416
RALEIGH,WV,0,11,11,1
RALLS,TX,329,340,11,0.5082212257100149
RALPH,AL,23,84,61,0.7850467289719626
RALSTON,NE,302,235,-67,0.4376163873370577
RALSTON,OK,0,34,34,1
RALSTON,PA,24,11,-13,0.3142857142857143
RAMAH,CO,53,50,-3,0.4854368932038835
RAMAH,NM,474,563,89,0.5429122468659595
RAMER,AL,272,304,32,0.5277777777777778
RAMER,TN,565,737,172,0.5660522273425499
RAMEY,PA,11,0,-11,0
RAMONA,CA,13381,13915,534,0.509781652989449
RAMONA,OK,428,474,46,0.5254988913525499
RAMONA,SD,11,0,-11,0
RAMROD KEY,FL,107,130,23,0.5485232067510548
RAMSAY,MI,24,0,-24,0
RAMSEUR,NC,1854,1783,-71,0.49023920813857574
RAMSEY,IL,619,635,16,0.5063795853269537
RAMSEY,IN,518,413,-105,0.44360902255639095
RAMSEY,MN,2741,2369,-372,0.46360078277886496
RAMSEY,NJ,4014,4490,476,0.5279868297271872
RANBURNE,AL,716,659,-57,0.4792727272727273
RANCHESTER,WY,421,459,38,0.5215909090909091
RANCHO CASCADES,CA,336,301,-35,0.4725274725274725
RANCHO CORDOVA,CA,30858,31791,933,0.5074462481444237
RANCHO CUCAMONGA,CA,59981,57671,-2310,0.4901829123176827
RANCHO DOMINGUEZ,CA,912,766,-146,0.4564958283671037
RANCHO MIRAGE,CA,15665,19245,3580,0.5512747063878545
RANCHO MISSION VIEJO,CA,4701,5850,1149,0.554449815183395
RANCHO MURIETA,CA,1571,2073,502,0.568880351262349
RANCHO PALOS VERDES,CA,9342,10658,1316,0.5329
RANCHO PARK,CA,588,685,97,0.5380989787902593
RANCHO SANTA FE,CA,3460,5251,1791,0.60280105613592
RANCHO SANTA MARGARITA,CA,15930,15097,-833,0.48657620781899635
RANCHO STA MARG,CA,300,281,-19,0.4836488812392427
RANCHO VIEJO,TX,730,982,252,0.5735981308411215
RANCHOS DE TAOS,NM,1297,1347,50,0.5094553706505295
RANCOCAS,NJ,23,0,-23,0
RANDALL,MN,396,348,-48,0.46774193548387094
RANDALLSTOWN,MD,10741,10325,-416,0.49012626981866514
RANDLE,WA,878,855,-23,0.4933641084824005
RANDLEMAN,NC,4764,4954,190,0.5097756740069973
RANDLETT,OK,23,27,4,0.54
RANDOLPH,AL,11,13,2,0.5416666666666666
RANDOLPH,IA,11,0,-11,0
RANDOLPH,KS,11,0,-11,0
RANDOLPH,MA,12175,11667,-508,0.48934653133126416
RANDOLPH,ME,638,622,-16,0.4936507936507937
RANDOLPH,MN,73,22,-51,0.23157894736842105
RANDOLPH,MO,149,110,-39,0.4247104247104247
RANDOLPH,MS,259,150,-109,0.36674816625916873
RANDOLPH,NE,322,146,-176,0.31196581196581197
RANDOLPH,NH,90,74,-16,0.45121951219512196
RANDOLPH,NJ,6719,7006,287,0.5104553734061931
RANDOLPH,NY,1311,1238,-73,0.4856806590819929
RANDOLPH,TX,11,0,-11,0
RANDOLPH,VA,0,11,11,1
RANDOLPH,VT,2120,2058,-62,0.4925801819052178
RANDOLPH,WI,995,848,-147,0.46011937059142705
RANDOLPH CENTER,VT,392,587,195,0.599591419816139
RANDOLPH CTR,VT,0,12,12,1
RANDOM LAKE,WI,1164,963,-201,0.4527503526093089
RANGELEY,ME,1779,1248,-531,0.4122893954410307
RANGELY,CO,1606,1354,-252,0.4574324324324324
RANGER,GA,711,1066,355,0.5998874507597074
RANGER,TX,1348,1315,-33,0.4938039804731506
RANGER,WV,11,0,-11,0
RANIER,MN,46,92,46,0.6666666666666666
RANKIN,IL,429,178,-251,0.2932454695222405
RANKIN,PA,99,58,-41,0.36942675159235666
RANKIN,TX,26,22,-4,0.4583333333333333
RANSHAW,PA,100,110,10,0.5238095238095238
RANSOM,IL,15,0,-15,0
RANSOM,KY,0,13,13,1
RANSOM CANYON,TX,13,72,59,0.8470588235294118
RANSOM TOWNSHIP,PA,622,598,-24,0.4901639344262295
RANSOMVILLE,NY,1409,1393,-16,0.4971448965024982
RANSON,WV,3322,3074,-248,0.48061288305190747
RANTOUL,IL,7709,7362,-347,0.48848782429832127
RANTOUL,KS,13,25,12,0.6578947368421053
RAPHINE,VA,688,661,-27,0.4899925871015567
RAPID CITY,MI,2465,2092,-373,0.45907395216150976
RAPID CITY,SD,53526,47572,-5954,0.4705533244970227
RAPID RIVER,MI,1739,1649,-90,0.4867178276269185
RAPIDAN,VA,67,144,77,0.6824644549763034
RAPIDS CITY,IL,72,0,-72,0
RAQUETTE LAKE,NY,79,157,78,0.6652542372881356
RARITAN,IL,12,0,-12,0
RARITAN,NJ,3232,2889,-343,0.47198170233621956
RATCLIFF,AR,87,76,-11,0.4662576687116564
RATHDRUM,ID,7709,8684,975,0.5297383029341792
RATLIFF CITY,OK,45,104,59,0.697986577181208
RATON,NM,2835,2909,74,0.5064415041782729
RATTAN,OK,45,52,7,0.5360824742268041
RAVALLI,MT,0,11,11,1
RAVEN,VA,785,633,-152,0.4464033850493653
RAVENA,NY,1829,1704,-125,0.4823096518539485
RAVENDEN,AR,175,276,101,0.6119733924611973
RAVENDEN SPRINGS,AR,25,59,34,0.7023809523809523
RAVENEL,SC,1277,1655,378,0.5644611186903138
RAVENNA,KY,64,118,54,0.6483516483516484
RAVENNA,MI,1759,1681,-78,0.48866279069767443
RAVENNA,NE,816,728,-88,0.47150259067357514
RAVENNA,OH,11812,11519,-293,0.4937208006514937
RAVENNA,TX,62,146,84,0.7019230769230769
RAVENSDALE,WA,1302,1349,47,0.5088645794039985
RAVENSWOOD,WV,3067,2788,-279,0.4761742100768574
RAVENWOOD,MO,38,68,30,0.6415094339622641
RAVIA,OK,46,29,-17,0.38666666666666666
RAVINIA,SD,15,0,-15,0
RAWLINGS,MD,147,182,35,0.5531914893617021
RAWLINS,WY,4264,3641,-623,0.46059456040480706
RAWSON,OH,238,146,-92,0.3802083333333333
RAY,MI,652,791,139,0.5481635481635482
RAY,MN,0,38,38,1
RAY,ND,384,302,-82,0.4402332361516035
RAY,OH,135,204,69,0.6017699115044248
RAY BROOK,NY,11,0,-11,0
RAY CITY,GA,2031,2187,156,0.5184921763869133
RAY TWP,MI,47,124,77,0.7251461988304093
RAYLAND,OH,716,744,28,0.5095890410958904
RAYLE,GA,33,47,14,0.5875
RAYMOND,CA,61,80,19,0.5673758865248227
RAYMOND,IA,92,12,-80,0.11538461538461539
RAYMOND,IL,395,346,-49,0.4669365721997301
RAYMOND,ME,2497,3283,786,0.5679930795847751
RAYMOND,MN,136,146,10,0.5177304964539007
RAYMOND,MS,1717,1922,205,0.5281670788678209
RAYMOND,NE,244,267,23,0.5225048923679061
RAYMOND,NH,4078,4127,49,0.5029859841560025
RAYMOND,OH,156,290,134,0.6502242152466368
RAYMOND,WA,2404,2345,-59,0.4937881659296694
RAYMONDVILLE,MO,230,263,33,0.5334685598377282
RAYMONDVILLE,TX,2235,2366,131,0.5142360356444251
RAYMORE,MO,8982,10242,1260,0.5327715355805244
RAYNE,LA,5129,4874,-255,0.48725382385284416
RAYNHAM,MA,4113,4688,575,0.5326667424156346
RAYNHAM,NC,28,14,-14,0.3333333333333333
RAYNHAM CENTER,MA,170,23,-147,0.11917098445595854
RAYTOWN,MO,15873,14317,-1556,0.4742298774428619
RAYVILLE,LA,3420,3469,49,0.5035563942517056
RAYVILLE,MO,234,249,15,0.515527950310559
RAYWICK,KY,58,73,15,0.5572519083969466
RAYWOOD,TX,14,31,17,0.6888888888888889
RC,CA,161,157,-4,0.4937106918238994
RCH CUCAMONGA,CA,241,297,56,0.5520446096654275
RCH PALOS VRD,CA,293,280,-13,0.4886561954624782
RCHO SANTA FE,CA,198,455,257,0.6967840735068913
READER,WV,12,0,-12,0
READFIELD,ME,764,923,159,0.5471250740960285
READING,KS,0,11,11,1
READING,MA,6074,6819,745,0.5288916466299542
READING,MI,1278,1219,-59,0.4881858229875851
READING,OH,306,324,18,0.5142857142857142
READING,PA,81001,72500,-8501,0.4723096266473834
READING,VT,24,34,10,0.5862068965517241
READLYN,IA,115,59,-56,0.3390804597701149
READSBORO,VT,138,72,-66,0.34285714285714286
READSTOWN,WI,130,114,-16,0.4672131147540984
READVILLE,MA,0,32,32,1
READYVILLE,TN,559,642,83,0.5345545378850958
REAGAN,TN,300,381,81,0.5594713656387665
REALITOS,TX,0,31,31,1
REARDAN,WA,335,414,79,0.5527369826435247
REASNOR,IA,0,13,13,1
REBECCA,GA,34,49,15,0.5903614457831325
REBERSBURG,PA,162,91,-71,0.35968379446640314
RECTOR,AR,1307,1243,-64,0.48745098039215684
RED BANK,NJ,8447,8604,157,0.504603835552167
RED BANKS,MS,161,284,123,0.6382022471910113
RED BAY,AL,1675,1451,-224,0.46417146513115803
RED BLNG SPGS,TN,91,97,6,0.5159574468085106
RED BLUFF,CA,13203,12428,-775,0.48488158870118214
RED BOILING SPRINGS,TN,1692,1744,52,0.5075669383003493
RED BUD,IL,1969,1851,-118,0.48455497382198953
RED CLOUD,NE,704,569,-135,0.4469756480754124
RED CREEK,NY,1084,1102,18,0.5041171088746569
RED FE LKS,CO,162,106,-56,0.39552238805970147
RED FEATHER LAKES,CO,608,485,-123,0.44373284537968893
RED HILL,PA,870,853,-17,0.4950667440510737
RED HOOK,NY,3175,3284,109,0.5084378386747175
RED HOUSE,WV,369,451,82,0.55
RED LAKE FALLS,MN,888,745,-143,0.45621555419473364
RED LEVEL,AL,787,840,53,0.5162876459741856
RED LION,PA,9442,8566,-876,0.4756774766770324
RED LODGE,MT,2280,2247,-33,0.4963552021206097
RED OAK,GA,34,523,489,0.9389587073608617
RED OAK,IA,3731,3358,-373,0.4736916349273522
RED OAK,OK,284,321,37,0.5305785123966942
RED OAK,TX,8105,9956,1851,0.5512430098001219
RED OAK,VA,0,12,12,1
RED RIVER,NM,421,407,-14,0.4915458937198068
RED ROCK,AZ,1237,1559,322,0.5575822603719599
RED ROCK,OK,73,22,-51,0.23157894736842105
RED ROCK,TX,651,803,152,0.5522696011004127
RED SPRINGS,NC,3845,2150,-1695,0.3586321934945788
RED WING,MN,9354,8048,-1306,0.4624755775198253
REDAN,GA,235,675,440,0.7417582417582418
REDBY,MN,24,0,-24,0
REDDICK,FL,2529,2259,-270,0.4718045112781955
REDDICK,IL,13,52,39,0.8
REDDING,CA,59223,51458,-7765,0.46492171194694665
REDDING,CT,2206,2614,408,0.5423236514522821
REDDING,IA,16,12,-4,0.42857142857142855
REDFIELD,AR,1368,1241,-127,0.47566117286316595
REDFIELD,IA,352,248,-104,0.41333333333333333
REDFIELD,NY,34,25,-9,0.423728813559322
REDFIELD,SD,1635,1354,-281,0.45299431247909
REDFORD,MI,17182,16542,-640,0.49051120863480013
REDGRANITE,WI,1345,1170,-175,0.46520874751491054
REDINGTON BCH,FL,433,561,128,0.5643863179074446
REDINGTON BEACH,FL,328,255,-73,0.43739279588336194
REDINGTON SHORES,FL,1293,1363,70,0.5131777108433735
REDKEY,IN,1067,712,-355,0.40022484541877457
REDLAKE,MN,187,111,-76,0.3724832214765101
REDLAND,FL,30,40,10,0.5714285714285714
REDLANDS,CA,30112,28940,-1172,0.4900765427081217
REDMOND,OR,24022,25519,1497,0.5151086978462284
REDMOND,UT,38,36,-2,0.4864864864864865
REDMOND,WA,58920,56834,-2086,0.49098951224147763
REDONDO BEACH,CA,33659,32433,-1226,0.49072504993040006
REDSTONE,CO,129,122,-7,0.4860557768924303
REDVALE,CO,13,0,-13,0
REDWAY,CA,596,275,-321,0.3157290470723307
REDWOOD,NY,1201,1095,-106,0.4769163763066202
REDWOOD CITY,CA,45921,40047,-5874,0.46583612506979344
REDWOOD FALLS,MN,2946,2596,-350,0.468422952002887
REDWOOD VALLEY,CA,1635,1503,-132,0.4789674952198853
REED,KY,66,37,-29,0.3592233009708738
REED CITY,MI,3597,2947,-650,0.4503361858190709
REED POINT,MT,49,59,10,0.5462962962962963
REEDER,ND,0,11,11,1
REEDERS,PA,88,0,-88,0
REEDLEY,CA,6013,5851,-162,0.4931726230613621
REEDS,MO,175,130,-45,0.4262295081967213
REEDS SPRING,MO,3236,3474,238,0.5177347242921013
REEDSBURG,WI,6494,6273,-221,0.49134487350199735
REEDSPORT,OR,2510,2631,121,0.5117681384944563
REEDSVILLE,OH,214,229,15,0.5169300225733634
REEDSVILLE,PA,921,1056,135,0.5341426403641881
REEDSVILLE,WI,987,923,-64,0.48324607329842934
REEDSVILLE,WV,868,671,-197,0.4359974009096816
REEDVILLE,VA,750,987,237,0.5682210708117443
REEDY,WV,12,42,30,0.7777777777777778
REELSVILLE,IN,286,471,185,0.6221928665785997
REESE,MI,1118,1002,-116,0.47264150943396227
REESEVILLE,WI,431,284,-147,0.3972027972027972
REEVES,LA,48,64,16,0.5714285714285714
REEVESVILLE,SC,103,34,-69,0.24817518248175183
REFORM,AL,755,746,-9,0.49700199866755496
REFUGIO,TX,1087,1092,5,0.5011473152822395
REGINA,KY,11,11,0,0.5
REGINA,NM,15,0,-15,0
REGISTER,GA,137,281,144,0.6722488038277512
REGO PARK,NY,14888,11759,-3129,0.441287949863024
REHOBOTH,MA,3109,3605,496,0.5369377420315758
REHOBOTH,NM,0,13,13,1
REHOBOTH BCH,DE,502,541,39,0.5186960690316395
REHOBOTH BEACH,DE,9004,10778,1774,0.5448387422909716
REHRERSBURG,PA,16,0,-16,0
REIDSVILLE,GA,2454,1998,-456,0.44878706199460916
REIDSVILLE,NC,11902,11593,-309,0.49342413279421155
REIDVILLE,SC,161,157,-4,0.4937106918238994
REINBECK,IA,844,758,-86,0.4731585518102372
REINHOLDS,PA,1486,1435,-51,0.49127011297500855
REISTERSTOWN,MD,11734,11541,-193,0.49585392051557464
REKLAW,TX,11,11,0,0.5
RELIANCE,TN,75,65,-10,0.4642857142857143
REMBERT,SC,757,922,165,0.5491363907087552
REMER,MN,1128,1006,-122,0.47141518275538896
REMINDERVILLE,OH,294,228,-66,0.4367816091954023
REMINGTON,IN,1036,918,-118,0.46980552712384854
REMINGTON,VA,1155,1177,22,0.5047169811320755
REMLAP,AL,878,988,110,0.5294748124330118
REMSEN,IA,802,649,-153,0.4472777394900069
REMSEN,NY,1201,1149,-52,0.488936170212766
REMSENBURG,NY,905,959,54,0.5144849785407726
REMUS,MI,1369,1295,-74,0.4861111111111111
RENFREW,PA,1109,1089,-20,0.49545040946314833
RENICK,WV,151,96,-55,0.38866396761133604
RENNER,SD,112,61,-51,0.35260115606936415
RENO,NV,162179,157980,-4199,0.4934423208468292
RENO,OH,39,13,-26,0.25
RENO,PA,65,0,-65,0
RENO,TX,945,950,5,0.5013192612137203
RENOVO,PA,896,817,-79,0.47694103911266783
RENSSELAER,IN,4977,4299,-678,0.46345407503234154
RENSSELAER,NY,9821,9178,-643,0.4830780567398284
RENSSELAER FALLS,NY,210,77,-133,0.2682926829268293
RENSSELAERVILLE,NY,48,39,-9,0.4482758620689655
RENTON,WA,72757,66862,-5895,0.47888897642870953
RENTZ,GA,570,601,31,0.5132365499573015
RENVILLE,MN,471,430,-41,0.4772475027746948
REPTON,AL,163,248,85,0.6034063260340633
REPUBLIC,MI,361,381,20,0.5134770889487871
REPUBLIC,MO,8474,9437,963,0.5268829211099324
REPUBLIC,OH,351,399,48,0.532
REPUBLIC,PA,262,147,-115,0.3594132029339853
REPUBLIC,WA,2110,1918,-192,0.47616683217477657
REPUBLICAN CITY,NE,11,12,1,0.5217391304347826
RESACA,GA,2388,2123,-265,0.47062735535358013
RESCUE,CA,1479,1573,94,0.515399737876802
RESEARCH TRIANGLE PARK,NC,118,200,82,0.6289308176100629
RESEDA,CA,21087,17925,-3162,0.45947400799753924
RESERVE,LA,1657,1618,-39,0.49404580152671757
RESERVE,NM,13,114,101,0.8976377952755905
RESTON,VA,40218,37741,-2477,0.4841134442463346
REUNION,FL,637,797,160,0.5557880055788006
REVA,VA,155,306,151,0.6637744034707158
REVERE,MA,25254,21836,-3418,0.4637077935867488
REVERE,MN,12,0,-12,0
REWEY,WI,51,25,-26,0.32894736842105265
REX,GA,7979,6696,-1283,0.4562862010221465
REXBURG,ID,23577,16583,-6994,0.4129233067729084
REXFORD,KS,133,72,-61,0.35121951219512193
REXFORD,MT,193,442,249,0.6960629921259842
REXFORD,NY,1432,1576,144,0.523936170212766
REXVILLE,NY,11,12,1,0.5217391304347826
REY,VA,137,113,-24,0.452
REYNO,AR,35,0,-35,0
REYNOLDS,GA,647,467,-180,0.41921005385996407
REYNOLDS,IL,98,42,-56,0.3
REYNOLDS,IN,330,184,-146,0.35797665369649806
REYNOLDS,ND,39,37,-2,0.4868421052631579
REYNOLDS STATION,KY,39,90,51,0.6976744186046512
REYNOLDSBURG,OH,28034,26489,-1545,0.4858316673697339
REYNOLDSVILLE,PA,2255,2033,-222,0.47411380597014924
RHINE,GA,15,46,31,0.7540983606557377
RHINEBECK,NY,3690,4355,665,0.5413300186451212
RHINELAND,MO,0,22,22,1
RHINELANDER,WI,9613,9247,-366,0.49029692470837755
RHOADESVILLE,VA,468,562,94,0.545631067961165
RHODES,IA,37,35,-2,0.4861111111111111
RHODES,MI,214,152,-62,0.41530054644808745
RHODESDALE,MD,25,33,8,0.5689655172413793
RHODHISS,NC,0,11,11,1
RHODODENDRON,OR,955,672,-283,0.4130301167793485
RHOME,TX,2707,2729,22,0.5020235467255335
RIALTO,CA,26151,24751,-1400,0.4862480845546344
RIB LAKE,WI,789,613,-176,0.4372325249643367
RIBERA,NM,28,24,-4,0.46153846153846156
RICE,MN,2035,2030,-5,0.4993849938499385
RICE,TX,889,830,-59,0.4828388598022106
RICE,VA,562,505,-57,0.4732895970009372
RICE,WA,73,100,27,0.5780346820809249
RICE LAKE,WI,8377,7508,-869,0.47264715140069247
RICEBORO,GA,131,261,130,0.6658163265306123
RICES LANDING,PA,167,120,-47,0.4181184668989547
RICEVILLE,IA,398,337,-61,0.45850340136054424
RICEVILLE,TN,1435,1665,230,0.5370967741935484
RICH CREEK,VA,186,244,58,0.5674418604651162
RICH HILL,MO,887,782,-105,0.46854403834631514
RICH SQUARE,NC,235,193,-42,0.45093457943925236
RICHARDS,TX,118,279,161,0.7027707808564232
RICHARDSON,TX,56957,54085,-2872,0.4870679562687992
RICHARDSVILLE,VA,11,11,0,0.5
RICHARDTON,ND,168,123,-45,0.422680412371134
RICHBORO,PA,1809,2151,342,0.5431818181818182
RICHBURG,SC,458,510,52,0.5268595041322314
RICHEYVILLE,PA,103,12,-91,0.10434782608695652
RICHFIELD,ID,87,117,30,0.5735294117647058
RICHFIELD,MN,10648,9132,-1516,0.4616784630940344
RICHFIELD,NC,601,844,243,0.5840830449826989
RICHFIELD,NE,14,17,3,0.5483870967741935
RICHFIELD,OH,1696,1953,257,0.5352151274321731
RICHFIELD,PA,429,367,-62,0.4610552763819096
RICHFIELD,UT,3153,3209,56,0.504401131719585
RICHFIELD,WI,744,858,114,0.5355805243445693
RICHFIELD SPRINGS,NY,1419,1370,-49,0.4912154894227322
RICHFORD,NY,343,247,-96,0.4186440677966102
RICHFORD,VT,1603,1346,-257,0.4564259070871482
RICHGROVE,CA,11,11,0,0.5
RICHLAND,GA,178,266,88,0.5990990990990991
RICHLAND,IA,130,54,-76,0.29347826086956524
RICHLAND,IN,395,447,52,0.5308788598574822
RICHLAND,MI,3141,3356,215,0.5165460981991689
RICHLAND,MO,2068,2152,84,0.5099526066350711
RICHLAND,MS,2659,2257,-402,0.45911310008136696
RICHLAND,NJ,27,23,-4,0.46
RICHLAND,NY,473,380,-93,0.4454865181711606
RICHLAND,OR,84,47,-37,0.35877862595419846
RICHLAND,PA,638,489,-149,0.4338952972493345
RICHLAND,WA,30347,29678,-669,0.4944273219491878
RICHLAND CENTER,WI,3910,3905,-5,0.4996801023672425
RICHLAND CTR,WI,189,166,-23,0.4676056338028169
RICHLAND HILLS,TX,3126,3191,65,0.5051448472376128
RICHLAND SPRINGS,TX,23,66,43,0.7415730337078652
RICHLANDS,NC,8562,8003,-559,0.48312707515846665
RICHLANDS,VA,1822,1642,-180,0.4740184757505774
RICHLANDTOWN,PA,436,439,3,0.5017142857142857
RICHMOMD,CA,304,211,-93,0.4097087378640777
RICHMOND,CA,25282,22169,-3113,0.4671977408273798
RICHMOND,IL,1724,1657,-67,0.4900916888494528
RICHMOND,IN,27835,20128,-7707,0.4196568187978233
RICHMOND,KS,165,131,-34,0.44256756756756754
RICHMOND,KY,30202,29295,-907,0.4923777669462326
RICHMOND,MA,281,379,98,0.5742424242424242
RICHMOND,ME,1359,1488,129,0.5226554267650158
RICHMOND,MI,2990,2897,-93,0.4921012400203839
RICHMOND,MN,1730,1496,-234,0.46373217606943584
RICHMOND,MO,4352,3892,-460,0.4721009218825813
RICHMOND,NH,357,353,-4,0.4971830985915493
RICHMOND,OH,405,416,11,0.5066991473812423
RICHMOND,RI,144,206,62,0.5885714285714285
RICHMOND,TX,48623,70482,21859,0.5917635699592796
RICHMOND,UT,853,767,-86,0.4734567901234568
RICHMOND,VA,170536,155879,-14657,0.4775485195226935
RICHMOND,VT,1601,1740,139,0.5208021550434002
RICHMOND DALE,OH,13,0,-13,0
RICHMOND HEIGHTS,MO,992,891,-101,0.4731810939989379
RICHMOND HEIGHTS,OH,558,620,62,0.5263157894736842
RICHMOND HILL,GA,15596,17987,2391,0.5355983682220171
RICHMOND HILL,NY,8093,5914,-2179,0.4222174626972228
RICHMOND HTS,MO,86,77,-9,0.4723926380368098
RICHMOND HTS,OH,2180,1888,-292,0.464110127826942
RICHMONDVILLE,NY,1074,1004,-70,0.48315688161693937
RICHTON,MS,1407,1521,114,0.5194672131147541
RICHTON PARK,IL,5232,5022,-210,0.4897600936220012
RICHVILLE,MN,544,466,-78,0.4613861386138614
RICHVILLE,NY,151,69,-82,0.31363636363636366
RICHWOOD,OH,2221,1931,-290,0.4650770712909441
RICHWOOD,TX,1357,1086,-271,0.4445354072861236
RICHWOOD,WV,1109,797,-312,0.4181532004197272
RICHWOODS,MO,130,137,7,0.5131086142322098
RICKMAN,TN,525,773,248,0.5955315870570108
RICKREALL,OR,59,120,61,0.6703910614525139
RICO,CO,43,86,43,0.6666666666666666
RIDDLE,OR,1241,922,-319,0.42625982431807674
RIDDLETON,TN,12,0,-12,0
RIDERWOOD,MD,0,15,15,1
RIDGE,MD,47,25,-22,0.3472222222222222
RIDGE,NY,5117,5100,-17,0.49916805324459235
RIDGE FARM,IL,343,268,-75,0.4386252045826514
RIDGE SPRING,SC,446,574,128,0.5627450980392157
RIDGECREST,CA,15748,13961,-1787,0.4699249385708035
RIDGECREST,LA,157,153,-4,0.4935483870967742
RIDGEDALE,MO,318,366,48,0.5350877192982456
RIDGEFIELD,CT,7338,8699,1361,0.5424331234021326
RIDGEFIELD,NJ,4280,4036,-244,0.48532948532948533
RIDGEFIELD,WA,9979,12983,3004,0.5654124205208606
RIDGEFIELD PARK,NJ,4259,3700,-559,0.4648825229300163
RIDGEFIELD PK,NJ,110,76,-34,0.40860215053763443
RIDGELAND,MS,12817,11144,-1673,0.46508910312591295
RIDGELAND,SC,5265,5001,-264,0.48714202220923436
RIDGELAND,WI,136,62,-74,0.31313131313131315
RIDGELEY,WV,1521,1516,-5,0.4991768192295028
RIDGELY,MD,1230,1330,100,0.51953125
RIDGELY,TN,1037,1146,109,0.5249656436097114
RIDGEVILLE,IN,517,477,-40,0.4798792756539235
RIDGEVILLE,SC,2134,2670,536,0.5557868442964197
RIDGEVILLE CORNERS,OH,11,0,-11,0
RIDGEWAY,CT,211,152,-59,0.418732782369146
RIDGEWAY,IA,38,63,25,0.6237623762376238
RIDGEWAY,MO,91,145,54,0.614406779661017
RIDGEWAY,OH,12,0,-12,0
RIDGEWAY,SC,1392,1800,408,0.5639097744360902
RIDGEWAY,VA,2386,2063,-323,0.46369970779950553
RIDGEWAY,WI,145,216,71,0.5983379501385041
RIDGEWOOD,NJ,6379,6878,499,0.5188202459078223
RIDGEWOOD,NY,21870,17047,-4823,0.4380347919932163
RIDGWAY,CO,2318,2286,-32,0.4965247610773241
RIDGWAY,IL,214,104,-110,0.3270440251572327
RIDGWAY,PA,2326,2174,-152,0.4831111111111111
RIDLEY PARK,PA,3217,3114,-103,0.4918654241036171
RIDOTT,IL,0,23,23,1
RIEGELSVILLE,PA,777,659,-118,0.45891364902506965
RIEGELWOOD,NC,695,692,-3,0.4989185291997116
RIENZI,MS,1013,1117,104,0.5244131455399061
RIESEL,TX,954,1015,61,0.5154900964956831
RIFLE,CO,6529,5464,-1065,0.45559909947469357
RIGA,MI,92,23,-69,0.2
RIGBY,ID,6862,7795,933,0.5318277955925497
RIGGINS,ID,250,325,75,0.5652173913043478
RIGGSTON,IL,29,20,-9,0.40816326530612246
RILEY,IN,41,0,-41,0
RILEY,KS,226,299,73,0.5695238095238095
RILEY,MI,481,412,-69,0.46136618141097424
RILEY,TN,17,17,0,0.5
RILEYVILLE,VA,22,15,-7,0.40540540540540543
RILLITO,AZ,0,11,11,1
RILLTON,PA,11,12,1,0.5217391304347826
RIMERSBURG,PA,978,856,-122,0.46673936750272627
RIMFOREST,CA,91,0,-91,0
RIMROCK,AZ,2520,2753,233,0.5220936848094064
RINCON,GA,11672,10126,-1546,0.46453803101201946
RINDGE,NH,1962,2158,196,0.5237864077669903
RINER,VA,955,986,31,0.5079855744461618
RINEYVILLE,KY,2087,2126,39,0.5046285307381914
RINGGOLD,GA,13111,14180,1069,0.5195852112418013
RINGGOLD,LA,808,866,58,0.5173237753882916
RINGGOLD,VA,1271,1255,-16,0.49683293745051466
RINGLE,WI,132,167,35,0.5585284280936454
RINGLING,OK,468,363,-105,0.4368231046931408
RINGOES,NJ,1339,1547,208,0.536036036036036
RINGSTED,IA,27,29,2,0.5178571428571429
RINGTOWN,PA,571,621,50,0.5209731543624161
RINGWOOD,IL,222,113,-109,0.3373134328358209
RINGWOOD,NJ,2566,2882,316,0.5290014684287812
RINGWOOD,OK,173,105,-68,0.3776978417266187
RIO,IL,17,0,-17,0
RIO,WI,1033,991,-42,0.48962450592885376
RIO COMM,NM,125,120,-5,0.4897959183673469
RIO COMMUNITIES,NM,842,941,99,0.5277621985417835
RIO DELL,CA,1230,1125,-105,0.47770700636942676
RIO GRANDE,NJ,1736,1935,199,0.5271043312448924
RIO GRANDE,OH,0,11,11,1
RIO GRANDE CITY,TX,5580,3399,-2181,0.37854994988306045
RIO HONDO,TX,910,1626,716,0.6411671924290221
RIO LINDA,CA,5843,5373,-470,0.4790477888730385
RIO MEDINA,TX,12,23,11,0.6571428571428571
RIO NIDO,CA,39,0,-39,0
RIO OSO,CA,62,26,-36,0.29545454545454547
RIO RANCHO,NM,35292,38942,3650,0.5245844222324002
RIO RICO,AZ,4383,5006,623,0.5331771221642347
RIO VERDE,AZ,4545,5866,1321,0.5634425127269235
RIO VISTA,CA,3979,4785,806,0.5459835691465085
RIO VISTA,TX,1074,1155,81,0.5181695827725438
RIPLEY,CA,782,691,-91,0.46911065852002715
RIPLEY,MS,3106,2988,-118,0.4903183459140138
RIPLEY,NY,858,824,-34,0.48989298454221164
RIPLEY,OH,1433,1385,-48,0.4914833215046132
RIPLEY,OK,133,111,-22,0.45491803278688525
RIPLEY,TN,5582,5413,-169,0.49231468849477034
RIPLEY,WV,3395,3121,-274,0.47897483118477596
RIPON,CA,5325,5393,68,0.5031722336256764
RIPON,WI,5149,4257,-892,0.45258345736763766
RIPPLEMEAD,VA,11,11,0,0.5
RIPTON,VT,11,48,37,0.8135593220338984
RIRIE,ID,298,268,-30,0.4734982332155477
RISCO,MO,0,11,11,1
RISING CITY,NE,11,0,-11,0
RISING FAWN,GA,854,1160,306,0.5759682224428997
RISING STAR,TX,387,502,115,0.5646794150731158
RISING SUN,IN,1898,1874,-24,0.4968186638388123
RISING SUN,MD,2721,2735,14,0.5012829912023461
RISINGSUN,OH,189,209,20,0.5251256281407035
RISON,AR,1341,1310,-31,0.4941531497548095
RITTMAN,OH,3290,2796,-494,0.45941505093657575
RITZVILLE,WA,1033,1144,111,0.5254937988056959
RIVA,MD,992,1032,40,0.5098814229249012
RIVER EDGE,NJ,2810,3050,240,0.5204778156996587
RIVER FALLS,WI,9576,9157,-419,0.4888165269844659
RIVER FOREST,IL,3000,3461,461,0.5356755920136201
RIVER GROVE,IL,3767,3182,-585,0.4579076126061304
RIVER HILLS,WI,173,133,-40,0.434640522875817
RIVER OAKS,TX,3733,3599,-134,0.4908619749045281
RIVER RANCH,FL,14,239,225,0.9446640316205533
RIVER RIDGE,LA,2691,2510,-181,0.48259950009613534
RIVER ROUGE,MI,2601,2269,-332,0.4659137577002053
RIVER VALE,NJ,1894,2011,117,0.5149807938540333
RIVERBANK,CA,6230,6152,-78,0.4968502665159102
RIVERDALE,CA,2131,1199,-932,0.3600600600600601
RIVERDALE,GA,26961,25785,-1176,0.48885223524058696
RIVERDALE,IL,6135,5421,-714,0.4691069574247144
RIVERDALE,MD,6784,5259,-1525,0.43668521132608157
RIVERDALE,MI,778,699,-79,0.4732566012186865
RIVERDALE,ND,17,0,-17,0
RIVERDALE,NE,13,0,-13,0
RIVERDALE,NJ,1767,1637,-130,0.4809048178613396
RIVERDALE PARK,MD,842,711,-131,0.4578235672891178
RIVERHEAD,NY,9055,8054,-1001,0.4707463907884739
RIVERSIDE,AL,751,824,73,0.5231746031746032
RIVERSIDE,CA,116931,114315,-2616,0.49434368594483796
RIVERSIDE,CT,2442,2756,314,0.5302039245863793
RIVERSIDE,IA,891,963,72,0.5194174757281553
RIVERSIDE,IL,3733,3766,33,0.5022002933724496
RIVERSIDE,MO,2482,1809,-673,0.42158005127010023
RIVERSIDE,NJ,1358,1211,-147,0.4713896457765668
RIVERSIDE,OH,115,102,-13,0.4700460829493088
RIVERSIDE,PA,11,0,-11,0
RIVERSIDE,RI,5849,5911,62,0.5026360544217687
RIVERSIDE,TX,180,169,-11,0.48424068767908307
RIVERSIDE,WA,186,285,99,0.6050955414012739
RIVERSIDE,WY,42,0,-42,0
RIVERTON,CT,38,46,8,0.5476190476190477
RIVERTON,IL,1770,1731,-39,0.4944301628106255
RIVERTON,KS,191,112,-79,0.3696369636963696
RIVERTON,NJ,1017,1124,107,0.5249883232134517
RIVERTON,UT,17439,20272,2833,0.5375619845668372
RIVERTON,WY,6654,6497,-157,0.49403087217702074
RIVERVIEW,FL,66394,78772,12378,0.5426339500985079
RIVERVIEW,MI,5630,4338,-1292,0.43519261637239165
RIVERWOODS,IL,1002,859,-143,0.461579795808705
RIVES,TN,72,100,28,0.5813953488372093
RIVES JCT,MI,62,66,4,0.515625
RIVES JUNCTION,MI,869,712,-157,0.450347881087919
RIVESVILLE,WV,645,604,-41,0.4835868694955965
RIVIERA,TX,469,719,250,0.6052188552188552
RIVIERA BEACH,FL,18506,20484,1978,0.5253654783277764
RIVIERA BEACH,MD,342,340,-2,0.49853372434017595
RIXEYVILLE,VA,721,975,254,0.5748820754716981
RIXFORD,PA,37,0,-37,0
RNCH DE TAOS,NM,28,41,13,0.5942028985507246
RNCHO CORDOVA,CA,168,225,57,0.5725190839694656
ROACH,MO,785,626,-159,0.443656980864635
ROACHDALE,IN,800,781,-19,0.4939911448450348
ROAD FORKS,NM,22,18,-4,0.45
ROAMING SHORES,OH,438,417,-21,0.48771929824561405
ROAN MOUNTAIN,TN,1159,1311,152,0.5307692307692308
ROANN,IN,151,218,67,0.5907859078590786
ROANOKE,AL,3418,3359,-59,0.49564704146377453
ROANOKE,IL,793,689,-104,0.4649122807017544
ROANOKE,IN,2337,2587,250,0.5253858651502843
ROANOKE,LA,40,52,12,0.5652173913043478
ROANOKE,TX,14973,16265,1292,0.5206799410973814
ROANOKE,VA,76750,72745,-4005,0.4866049031740192
ROANOKE,WV,49,52,3,0.5148514851485149
ROANOKE APTS,KY,13,20,7,0.6060606060606061
ROANOKE RAPIDS,NC,8634,7978,-656,0.48025523717794366
ROARING BRANCH,PA,196,84,-112,0.3
ROARING BROOK TWP,PA,47,55,8,0.5392156862745098
ROARING GAP,NC,211,328,117,0.608534322820037
ROARING RIVER,NC,413,496,83,0.5456545654565457
ROARING SPG,PA,107,80,-27,0.42780748663101603
ROARING SPRING,PA,1426,1356,-70,0.4874191229331416
ROBARDS,KY,500,466,-34,0.4824016563146998
ROBBINS,IL,1774,1539,-235,0.4645336552973136
ROBBINS,NC,1251,1048,-203,0.4558503697259678
ROBBINS,TN,636,761,125,0.5447387258410881
ROBBINSDALE,MN,1537,1366,-171,0.47054770926627626
ROBBINSTON,ME,35,165,130,0.825
ROBBINSVILLE,NC,1729,1883,154,0.5213178294573644
ROBBINSVILLE,NJ,2868,3267,399,0.532518337408313
ROBELINE,LA,665,743,78,0.5276988636363636
ROBERSONVILLE,NC,1016,1067,51,0.5122419587133942
ROBERT,LA,592,1145,553,0.6591824985607369
ROBERT LEE,TX,492,657,165,0.5718015665796344
ROBERTA,GA,839,834,-5,0.4985056784219964
ROBERTS,ID,93,197,104,0.6793103448275862
ROBERTS,IL,12,15,3,0.5555555555555556
ROBERTS,MT,305,551,246,0.6436915887850467
ROBERTS,WI,1691,1718,27,0.5039601056028161
ROBERTSDALE,AL,5147,5746,599,0.5274947213807032
ROBERTSDALE,PA,15,12,-3,0.4444444444444444
ROBERTSVILLE,MO,792,973,181,0.5512747875354108
ROBESONIA,PA,1313,1434,121,0.5220240262104113
ROBINS,IA,637,664,27,0.5103766333589547
ROBINS A F B,GA,237,240,3,0.5031446540880503
ROBINS AFB,GA,156,133,-23,0.4602076124567474
ROBINSON,IL,4618,4057,-561,0.4676657060518732
ROBINSON,KS,22,0,-22,0
ROBINSON,PA,0,12,12,1
ROBINSON,TX,9428,7759,-1669,0.4514458602432071
ROBINSON CREEK,KY,11,0,-11,0
ROBINSONVILLE,MS,2027,1542,-485,0.43205379658167553
ROBSTOWN,TX,5284,5562,278,0.5128157846210585
ROBY,TX,98,189,91,0.6585365853658537
ROCA,NE,139,511,372,0.7861538461538462
ROCFORD,IL,37,24,-13,0.39344262295081966
ROCHDALE,MA,745,626,-119,0.4566010211524435
ROCHE HARBOR,WA,79,139,60,0.6376146788990825
ROCHELLE,GA,510,579,69,0.5316804407713499
ROCHELLE,IL,6034,5578,-456,0.48036513951085086
ROCHELLE,TX,46,11,-35,0.19298245614035087
ROCHELLE,VA,60,73,13,0.5488721804511278
ROCHELLE PARK,NJ,1759,1768,9,0.5012758718457613
ROCHEPORT,MO,229,287,58,0.5562015503875969
ROCHERT,MN,123,146,23,0.5427509293680297
ROCHESTER,IL,1766,1705,-61,0.49121290694324404
ROCHESTER,IN,6578,6062,-516,0.4795886075949367
ROCHESTER,MA,1300,1472,172,0.5310245310245311
ROCHESTER,MI,12039,11129,-910,0.48036084254143646
ROCHESTER,MN,70742,64545,-6197,0.4770968385728119
ROCHESTER,NH,16056,15364,-692,0.48898790579248885
ROCHESTER,NY,233037,207859,-25178,0.47144678110030486
ROCHESTER,PA,3414,3021,-393,0.4694638694638695
ROCHESTER,TX,0,25,25,1
ROCHESTER,VT,351,474,123,0.5745454545454546
ROCHESTER,WA,5223,4726,-497,0.47502261533822493
ROCHESTER,WI,56,0,-56,0
ROCHESTER HILLS,MI,23588,22544,-1044,0.48868464406485734
ROCHESTER MILLS,PA,0,12,12,1
ROCIADA,NM,114,106,-8,0.4818181818181818
ROCK,MI,113,182,69,0.6169491525423729
ROCK,WV,391,398,7,0.5044359949302915
ROCK CAVE,WV,38,60,22,0.6122448979591837
ROCK CITY,IL,51,11,-40,0.1774193548387097
ROCK CITY FALLS,NY,0,14,14,1
ROCK CREEK,OH,810,867,57,0.516994633273703
ROCK FALLS,IL,6940,5662,-1278,0.4492937628947786
ROCK HALL,MD,1098,1127,29,0.5065168539325843
ROCK HILL,NY,1687,1412,-275,0.45563084866085835
ROCK HILL,SC,47871,45635,-2236,0.48804354800761446
ROCK ISLAND,IL,18702,15033,-3669,0.44562027567807916
ROCK ISLAND,TN,1442,1458,16,0.5027586206896552
ROCK ISLAND,WA,426,607,181,0.5876089060987415
ROCK PORT,MO,532,538,6,0.502803738317757
ROCK RAPIDS,IA,1126,1098,-28,0.493705035971223
ROCK RIVER,WY,23,0,-23,0
ROCK SPRING,GA,1621,1972,351,0.548844976342889
ROCK SPRINGS,WI,11,11,0,0.5
ROCK SPRINGS,WY,13676,12243,-1433,0.47235618658127243
ROCK STREAM,NY,123,121,-2,0.4959016393442623
ROCK TAVERN,NY,426,531,105,0.554858934169279
ROCK VALLEY,IA,1619,1229,-390,0.4315308988764045
ROCKAWAY,NJ,5274,5725,451,0.5205018638058005
ROCKAWAY BCH,MO,204,79,-125,0.2791519434628975
ROCKAWAY BCH,OR,72,55,-17,0.4330708661417323
ROCKAWAY BEACH,MO,1833,1469,-364,0.4448818897637795
ROCKAWAY BEACH,NY,2244,2215,-29,0.4967481498093743
ROCKAWAY BEACH,OR,1677,1399,-278,0.4548114434330299
ROCKAWAY BOROUGH,NJ,264,267,3,0.5028248587570622
ROCKAWAY PARK,NY,2853,2903,50,0.5043432939541348
ROCKAWAY POINT,NY,163,379,216,0.6992619926199262
ROCKBRIDGE,OH,699,512,-187,0.4227910817506193
ROCKBRIDGE BATHS,VA,0,84,84,1
ROCKDALE,IL,272,227,-45,0.45490981963927857
ROCKDALE,TX,4074,3660,-414,0.4732350659425912
ROCKFALL,CT,178,185,7,0.509641873278237
ROCKFIELD,KY,495,600,105,0.547945205479452
ROCKFORD,AL,433,339,-94,0.43911917098445596
ROCKFORD,IA,229,163,-66,0.41581632653061223
ROCKFORD,IL,91414,79158,-12256,0.4640738221982506
ROCKFORD,MI,11806,12288,482,0.5100024902465344
ROCKFORD,MN,2197,2199,2,0.5002274795268425
ROCKFORD,OH,736,649,-87,0.46859205776173285
ROCKFORD,TN,1668,1129,-539,0.4036467643904183
ROCKFORD,WA,191,104,-87,0.3525423728813559
ROCKHAM,SD,0,12,12,1
ROCKHILL FURNACE,PA,11,0,-11,0
ROCKHOLDS,KY,487,525,38,0.5187747035573123
ROCKINGHAM,NC,7603,6888,-715,0.47532951487129943
ROCKINGHAM,VA,2614,2180,-434,0.4547350855235711
ROCKLAND,DE,11,61,50,0.8472222222222222
ROCKLAND,MA,5746,5426,-320,0.4856784819190834
ROCKLAND,ME,4602,4386,-216,0.48798397863818427
ROCKLAND,WI,110,159,49,0.5910780669144982
ROCKLEDGE,FL,21343,21795,452,0.5052390004172655
ROCKLEDGE,GA,11,12,1,0.5217391304347826
ROCKLEDGE,PA,116,119,3,0.5063829787234042
ROCKLEIGH,NJ,71,81,10,0.5328947368421053
ROCKLIN,CA,28745,29977,1232,0.5104901059228228
ROCKMART,GA,8757,6973,-1784,0.44329307056579786
ROCKPORT,IL,13,0,-13,0
ROCKPORT,IN,2130,1986,-144,0.48250728862973763
ROCKPORT,MA,3683,3550,-133,0.4908060279275543
ROCKPORT,ME,2330,2301,-29,0.49686892679766786
ROCKPORT,TX,9466,13232,3766,0.5829588510000882
ROCKPORT,WA,59,12,-47,0.16901408450704225
ROCKSPRINGS,TX,383,168,-215,0.30490018148820325
ROCKTON,IL,3153,3373,220,0.5168556543058536
ROCKTON,PA,49,11,-38,0.18333333333333332
ROCKVALE,CO,0,12,12,1
ROCKVALE,TN,1586,1757,171,0.5255758300927311
ROCKVILLE,IN,2884,2871,-13,0.4988705473501303
ROCKVILLE,MD,71991,67573,-4418,0.4841721360809378
ROCKVILLE,MN,465,24,-441,0.049079754601226995
ROCKVILLE,RI,0,16,16,1
ROCKVILLE,VA,403,699,296,0.6343012704174229
ROCKVILLE CENTRE,NY,7126,7044,-82,0.49710656316160906
ROCKVILLE CTR,NY,612,632,20,0.5080385852090032
ROCKWALL,TX,20389,26901,6512,0.5688517657009938
ROCKWELL,IA,327,229,-98,0.4118705035971223
ROCKWELL,NC,2639,3146,507,0.5438202247191011
ROCKWELL CITY,IA,1076,920,-156,0.46092184368737477
ROCKWELLCITY,IA,19,13,-6,0.40625
ROCKWOOD,ME,277,176,-101,0.38852097130242824
ROCKWOOD,MI,2748,2237,-511,0.44874623871614844
ROCKWOOD,PA,1177,1047,-130,0.47077338129496404
ROCKWOOD,TN,5113,5400,287,0.5136497669551984
ROCKY,OK,22,0,-22,0
ROCKY COMFORT,MO,189,234,45,0.5531914893617021
ROCKY FACE,GA,2411,2419,8,0.5008281573498965
ROCKY FORD,CO,2441,2109,-332,0.4635164835164835
ROCKY FORD,GA,0,12,12,1
ROCKY GAP,VA,65,11,-54,0.14473684210526316
ROCKY HILL,CT,9357,9053,-304,0.49174361759913093
ROCKY HILL,NJ,249,157,-92,0.3866995073891626
ROCKY MOUNT,MO,805,848,43,0.5130066545674531
ROCKY MOUNT,NC,24101,23955,-146,0.49848093890461126
ROCKY MOUNT,VA,6283,6012,-271,0.4889792598617324
ROCKY POINT,NC,3525,3872,347,0.52345545491415435
ROCKY POINT,NY,3987,3788,-199,0.4872025723472669
ROCKY RIDGE,MD,29,42,13,0.5915492957746479
ROCKY RIVER,OH,7935,7714,-221,0.4929388459326475
ROCKY TOP,TN,2132,2035,-97,0.48836093112550993
RODANTHE,NC,156,292,136,0.6517857142857143
RODEO,CA,2444,2228,-216,0.4768835616438356
RODEO,NM,66,47,-19,0.415929203539823
RODMAN,NY,36,34,-2,0.4857142857142857
RODNEY,MI,583,600,17,0.5071851225697379
ROEBLING,NJ,1114,1080,-34,0.49225159525979945
ROEBUCK,SC,2429,2705,276,0.5268796260225944
ROELAND PARK,KS,2063,1832,-231,0.47034659820282415
ROFF,OK,145,167,22,0.5352564102564102
ROGERS,AR,36561,35855,-706,0.4951253866548829
ROGERS,CT,16,0,-16,0
ROGERS,MN,4895,5883,988,0.5458341065132678
ROGERS,OH,337,233,-104,0.4087719298245614
ROGERS,TX,677,829,152,0.550464807436919
ROGERS CITY,MI,2111,2015,-96,0.4883664566165778
ROGERSVILLE,AL,2440,2933,493,0.5458775358272846
ROGERSVILLE,MO,5217,5322,105,0.5049814972957586
ROGERSVILLE,TN,7189,7802,613,0.5204456006937496
ROGGEN,CO,12,0,-12,0
ROGUE RIVER,OR,3455,3612,157,0.5111079666053489
ROHNERT PARK,CA,19820,18908,-912,0.48822557322867177
ROHRERSVILLE,MD,27,0,-27,0
ROLAND,AR,709,749,40,0.5137174211248285
ROLAND,IA,338,297,-41,0.46771653543307085
ROLAND,OK,2709,2247,-462,0.4533898305084746
ROLESVILLE,NC,2250,3037,787,0.5744278418763004
ROLETTE,ND,56,49,-7,0.4666666666666667
ROLFE,IA,110,36,-74,0.2465753424657534
ROLLA,KS,11,0,-11,0
ROLLA,MO,16122,14921,-1201,0.48065586444609093
ROLLA,ND,569,144,-425,0.20196353436185133
ROLLING FORK,MS,546,422,-124,0.4359504132231405
ROLLING HILLS,CA,274,366,92,0.571875
ROLLING HILLS,KY,69,73,4,0.5140845070422535
ROLLING HILLS ESTATES,CA,2910,3632,722,0.5551819015591563
ROLLING MDWS,IL,922,901,-21,0.494240263302249
ROLLING MEADOWS,IL,7480,7384,-96,0.4967707212055974
ROLLING PR,IN,67,57,-10,0.4596774193548387
ROLLING PRAIRIE,IN,883,879,-4,0.4988649262202043
ROLLINGBAY,WA,77,25,-52,0.24509803921568626
ROLLINGSTONE,MN,73,48,-25,0.39669421487603307
ROLLINS,MT,95,162,67,0.6303501945525292
ROLLINSFORD,NH,982,1062,80,0.5195694716242661
ROLLINSVILLE,CO,48,59,11,0.5514018691588785
ROMA,TX,1052,1206,154,0.5341009743135519
ROMANCE,AR,461,648,187,0.5843101893597836
ROME,GA,32571,27035,-5536,0.4535617219742979
ROME,IL,12,0,-12,0
ROME,ME,290,223,-67,0.4346978557504873
ROME,NY,18482,17076,-1406,0.4802294842229597
ROME,OH,697,584,-113,0.4558938329430133
ROME,PA,913,823,-90,0.4740783410138249
ROME CITY,IN,847,777,-70,0.47844827586206895
ROMEO,MI,1763,1961,198,0.5265843179377014
ROMEOVILLE,IL,12882,11650,-1232,0.47488993967063425
ROMNEY,IN,24,51,27,0.68
ROMNEY,WV,2352,2088,-264,0.4702702702702703
ROMOLAND,CA,325,445,120,0.577922077922078
ROMULUS,MI,11968,10993,-975,0.4787683463263795
ROMULUS,NY,1136,880,-256,0.4365079365079365
RONALD,WA,342,244,-98,0.41638225255972694
RONAN,MT,2708,2722,14,0.5012891344383057
RONCEVERTE,WV,1308,1211,-97,0.48074632790789995
RONCO,PA,31,0,-31,0
RONDA,NC,563,517,-46,0.4787037037037037
RONKONKOMA,NY,13029,11732,-1297,0.4738096199668834
RONKS,PA,860,788,-72,0.47815533980582525
ROODHOUSE,IL,864,873,9,0.5025906735751295
ROOPVILLE,GA,621,934,313,0.6006430868167203
ROOSEVELT,AZ,316,396,80,0.5561797752808989
ROOSEVELT,MN,0,36,36,1
ROOSEVELT,NJ,60,27,-33,0.3103448275862069
ROOSEVELT,NY,5702,5016,-686,0.4679977607762642
ROOSEVELT,OK,0,11,11,1
ROOSEVELT,UT,3813,3827,14,0.5009162303664921
ROOSEVELT,WA,0,11,11,1
ROOSEVELT ISL,NY,525,369,-156,0.412751677852349
ROOSEVELT ISLAND,NY,530,576,46,0.5207956600361664
ROOTSTOWN,OH,1739,1505,-234,0.46393341553637485
ROPER,NC,431,583,152,0.5749506903353058
ROPESVILLE,TX,23,165,142,0.8776595744680851
ROQUE BLUFFS,ME,242,205,-37,0.45861297539149887
ROSALIA,WA,177,205,28,0.5366492146596858
ROSAMOND,CA,7740,8094,354,0.511178476695718
ROSAMOND,IL,49,46,-3,0.4842105263157895
ROSANKY,TX,101,190,89,0.6529209621993127
ROSBURG,WA,39,14,-25,0.2641509433962264
ROSCOE,IL,6777,6700,-77,0.49714328114565554
ROSCOE,MT,37,13,-24,0.26
ROSCOE,NY,1135,852,-283,0.4287871162556618
ROSCOE,PA,96,25,-71,0.2066115702479339
ROSCOE,SD,14,0,-14,0
ROSCOE,TX,204,201,-3,0.4962962962962963
ROSCOMMON,MI,5846,5379,-467,0.47919821826280623
ROSE,OK,216,180,-36,0.45454545454545453
ROSE BUD,AR,744,910,166,0.5501813784764208
ROSE CITY,MI,1235,1145,-90,0.48109243697478993
ROSE CREEK,MN,69,62,-7,0.4732824427480916
ROSE HILL,IA,11,11,0,0.5
ROSE HILL,KS,2124,2283,159,0.5180394826412525
ROSE HILL,NC,1242,1315,73,0.5142745404771216
ROSE HILL,VA,519,594,75,0.5336927223719676
ROSE VALLEY,PA,183,206,23,0.5295629820051414
ROSEAU,MN,2058,1919,-139,0.4825245159668092
ROSEBORO,NC,1734,1714,-20,0.4970997679814385
ROSEBUD,MO,97,221,124,0.6949685534591195
ROSEBUD,MT,44,0,-44,0
ROSEBUD,SD,323,337,14,0.5106060606060606
ROSEBUD,TX,760,832,72,0.5226130653266332
ROSEBURG,OR,22836,22674,-162,0.4982201713909031
ROSEBUSH,MI,345,391,46,0.53125
ROSEDALE,IN,1029,1006,-23,0.49434889434889434
ROSEDALE,MD,10590,9851,-739,0.48192358495181253
ROSEDALE,MS,112,43,-69,0.27741935483870966
ROSEDALE,NY,7447,6181,-1266,0.4535515115937775
ROSEDALE,VA,0,13,13,1
ROSELAND,FL,134,114,-20,0.4596774193548387
ROSELAND,LA,339,376,37,0.5258741258741259
ROSELAND,NJ,2197,2446,249,0.5268145595520138
ROSELAND,VA,594,707,113,0.5434281322059954
ROSELAWN,IN,11,14,3,0.56
ROSELLE,IL,7391,7229,-162,0.4944596443228454
ROSELLE,NJ,7255,6984,-271,0.490483882295105
ROSELLE PARK,NJ,3681,3599,-82,0.4943681318681319
ROSEMARY BEACH,FL,597,846,249,0.5862785862785863
ROSEMEAD,CA,13923,11526,-2397,0.4529058116232465
ROSEMONT,IL,4906,4782,-124,0.49360033030553263
ROSEMOUNT,MN,10091,10555,464,0.511237043495108
ROSENBERG,TX,14217,14640,423,0.5073292442041792
ROSENDALE,MO,0,11,11,1
ROSENDALE,NY,576,565,-11,0.49517966695880805
ROSENDALE,WI,181,129,-52,0.4161290322580645
ROSEPINE,LA,377,396,19,0.5122897800776197
ROSETO,PA,937,973,36,0.5094240837696336
ROSEVILLE,CA,60784,67511,6727,0.5262169219377216
ROSEVILLE,IL,340,308,-32,0.47530864197530864
ROSEVILLE,MI,19513,17564,-1949,0.4737168595085902
ROSEVILLE,MN,7061,6514,-547,0.4798526703499079
ROSEVILLE,OH,1827,1563,-264,0.46106194690265484
ROSEWOOD,CA,135,101,-34,0.4279661016949153
ROSHARON,TX,8263,16065,7802,0.6603502137454784
ROSHOLT,SD,233,72,-161,0.2360655737704918
ROSHOLT,WI,551,493,-58,0.4722222222222222
ROSICLARE,IL,334,98,-236,0.22685185185185186
ROSIE,AR,0,12,12,1
ROSLINDALE,MA,11660,10145,-1515,0.465260261407934
ROSLYN,NY,3507,4027,520,0.5345102203344837
ROSLYN,PA,267,319,52,0.5443686006825939
ROSLYN,WA,491,412,-79,0.45625692137320045
ROSLYN HEIGHTS,NY,3134,3292,158,0.5122938064114535
ROSLYN HTS,NY,69,44,-25,0.3893805309734513
ROSMAN,NC,520,468,-52,0.47368421052631576
ROSS,CA,462,433,-29,0.48379888268156424
ROSS,ND,27,0,-27,0
ROSS,OH,0,11,11,1
ROSSBURG,OH,37,44,7,0.5432098765432098
ROSSFORD,OH,2331,2118,-213,0.476062036412677
ROSSITER,PA,237,268,31,0.5306930693069307
ROSSLYN,VA,1444,1131,-313,0.4392233009708738
ROSSMOOR,CA,570,618,48,0.5202020202020202
ROSSTON,AR,73,79,6,0.5197368421052632
ROSSVILLE,GA,11556,11646,90,0.5019394879751745
ROSSVILLE,IL,601,520,-81,0.463871543264942
ROSSVILLE,IN,940,903,-37,0.4899620184481823
ROSSVILLE,KS,582,408,-174,0.4121212121212121
ROSSVILLE,TN,743,1129,386,0.6030982905982906
ROSTRAVER TOWNSHIP,PA,1917,1913,-4,0.4994778067885117
ROSTRAVER TWP,PA,119,134,15,0.5296442687747036
ROSWELL,GA,36941,38390,1449,0.5096175545260252
ROSWELL,NM,20508,17936,-2572,0.4665487462282801
ROTAN,TX,855,611,-244,0.41678035470668484
ROTHBURY,MI,806,717,-89,0.47078135259356535
ROTHSAY,MN,35,35,0,0.5
ROTHSCHILD,WI,1800,1608,-192,0.47183098591549294
ROTONDA WEST,FL,9883,11775,1892,0.5436790100655647
ROTTERDAM,NY,779,820,41,0.5128205128205128
ROTTERDAM JCT,NY,39,0,-39,0
ROTTERDAM JUNCTION,NY,125,147,22,0.5404411764705882
ROUGEMONT,NC,1333,1598,265,0.5452064141931081
ROUGH AND READY,CA,561,365,-196,0.3941684665226782
ROUGH READY,CA,24,26,2,0.52
ROULETTE,PA,392,337,-55,0.46227709190672156
ROUND HILL,VA,1807,2505,698,0.5809369202226345
ROUND LAKE,IL,8842,7587,-1255,0.46180534420841196
ROUND LAKE,MN,15,15,0,0.5
ROUND LAKE,NY,149,220,71,0.5962059620596206
ROUND LAKE BEACH,IL,5168,4433,-735,0.46172273721487345
ROUND LAKE HEIGHTS,IL,406,348,-58,0.46153846153846156
ROUND LAKE PARK,IL,3915,3296,-619,0.4570794619331577
ROUND MOUNTAIN,NV,1343,1195,-148,0.47084318360914107
ROUND MOUNTAIN,TX,65,152,87,0.7004608294930875
ROUND O,SC,682,583,-99,0.4608695652173913
ROUND POND,ME,211,246,35,0.5382932166301969
ROUND ROCK,TX,82311,83223,912,0.5027547210844902
ROUND TOP,NY,210,206,-4,0.4951923076923077
ROUND TOP,TX,259,273,14,0.5131578947368421
ROUNDHILL,KY,12,58,46,0.8285714285714286
ROUNDUP,MT,2189,2445,256,0.5276219249028917
ROUSES POINT,NY,1532,1149,-383,0.42857142857142855
ROUSEVILLE,PA,37,0,-37,0
ROUZERVILLE,PA,0,26,26,1
ROVER,AR,0,12,12,1
ROWAN,IA,0,14,14,1
ROWDY,KY,15,0,-15,0
ROWE,MA,12,0,-12,0
ROWENA,TX,13,0,-13,0
ROWESVILLE,SC,0,22,22,1
ROWLAND,NC,977,1097,120,0.5289296046287367
ROWLAND HEIGHTS,CA,11512,10511,-1001,0.4772737592516914
ROWLESBURG,WV,95,82,-13,0.4632768361581921
ROWLETT,TX,21175,23262,2087,0.523482683349461
ROWLEY,MA,1666,1941,275,0.5381203215968949
ROXANA,IL,672,378,-294,0.36
ROXBORO,NC,6523,6967,444,0.5164566345441067
ROXBOROUGH,CO,100,169,69,0.6282527881040892
ROXBURY,CT,918,1057,139,0.5351898734177215
ROXBURY,MA,12314,9530,-2784,0.4362754074345358
ROXBURY,ME,80,58,-22,0.42028985507246375
ROXBURY,NY,244,294,50,0.5464684014869888
ROXBURY,VT,22,30,8,0.5769230769230769
ROXBURY CROSSING,MA,3817,2134,-1683,0.3585951940850277
ROXIE,MS,252,293,41,0.5376146788990825
ROXTON,TX,84,34,-50,0.288135593220339
ROY,NM,11,0,-11,0
ROY,UT,15668,13174,-2494,0.4567644407461341
ROY,WA,3797,4000,203,0.5130178273695011
ROYAL,AR,1428,1608,180,0.5296442687747036
ROYAL,IA,121,36,-85,0.22929936305732485
ROYAL,IL,0,12,12,1
ROYAL CENTER,IN,570,506,-64,0.47026022304832715
ROYAL CITY,WA,581,361,-220,0.3832271762208068
ROYAL LAKES,IL,51,40,-11,0.43956043956043955
ROYAL OAK,MD,58,123,65,0.6795580110497238
ROYAL OAK,MI,30550,25731,-4819,0.4571880385920648
ROYAL OAKS,CA,2346,2043,-303,0.4654818865345181
ROYAL PALM BEACH,FL,23910,25615,1705,0.517213528520949
ROYAL PLM BCH,FL,956,867,-89,0.47558968732857926
ROYALSTON,MA,115,202,87,0.637223974763407
ROYALTON,IL,540,520,-20,0.49056603773584906
ROYALTON,MN,905,834,-71,0.4795859689476711
ROYERSFORD,PA,7538,6845,-693,0.47590905930612526
ROYSE CITY,TX,11864,19216,7352,0.6182754182754183
ROYSTON,GA,3168,2797,-371,0.4689019279128248
ROZET,WY,288,440,152,0.6043956043956044
RTP,NC,12,12,0,0.5
RUBICON,WI,118,119,1,0.5021097046413502
RUBIO,IA,28,33,5,0.5409836065573771
RUBY,MI,24,43,19,0.6417910447761194
RUBY,SC,264,271,7,0.5065420560747663
RUCKERSVILLE,VA,3259,3726,467,0.5334287759484609
RUDD,IA,23,12,-11,0.34285714285714286
RUDOLPH,OH,194,176,-18,0.4756756756756757
RUDOLPH,WI,140,67,-73,0.32367149758454106
RUDY,AR,482,670,188,0.5815972222222222
RUDYARD,MI,444,453,9,0.5050167224080268
RUFFIN,NC,771,894,123,0.5369369369369369
RUFFIN,SC,470,514,44,0.5223577235772358
RUFFS DALE,PA,752,669,-83,0.4707952146375792
RUFUS,OR,75,0,-75,0
RUGBY,ND,1422,1207,-215,0.4591099277291746
RUIDOSO,NM,6019,5202,-817,0.4635950450049015
RUIDOSO DOWNS,NM,1259,1146,-113,0.47650727650727653
RULE,TX,62,46,-16,0.42592592592592593
RULEVILLE,MS,708,631,-77,0.47124719940253923
RUMA,IL,40,49,9,0.550561797752809
RUMFORD,ME,3154,2871,-283,0.47651452282157675
RUMFORD,RI,2845,2969,124,0.5106639146886824
RUMNEY,NH,989,892,-97,0.47421584263689526
RUMSON,NJ,3039,3458,419,0.5322456518393105
RUNAWAY BAY,TX,582,644,62,0.5252854812398042
RUNGE,TX,70,29,-41,0.29292929292929293
RUNNELLS,IA,644,682,38,0.5143288084464555
RUNNEMEDE,NJ,2368,2306,-62,0.4933675652545999
RUNNING SPGS,CA,575,497,-78,0.46361940298507465
RUNNING SPRINGS,CA,1373,1301,-72,0.48653702318623787
RUPERT,ID,3385,3711,326,0.5229706877113867
RUPERT,WV,478,400,-78,0.45558086560364464
RURAL HALL,NC,3141,3711,570,0.5415936952714536
RURAL RETREAT,VA,1581,1558,-23,0.49633641287034086
RURAL VALLEY,PA,591,426,-165,0.41887905604719766
RUSH,CO,28,63,35,0.6923076923076923
RUSH,KY,530,482,-48,0.4762845849802372
RUSH,NY,792,859,67,0.5202907328891581
RUSH CITY,MN,2328,2038,-290,0.4667888227210261
RUSH SPRINGS,OK,1007,823,-184,0.44972677595628413
RUSH VALLEY,UT,0,11,11,1
RUSHFORD,MN,975,849,-126,0.4654605263157895
RUSHFORD,NY,297,233,-64,0.439622641509434
RUSHMORE,MN,13,39,26,0.75
RUSHSYLVANIA,OH,92,78,-14,0.4588235294117647
RUSHVILLE,IL,2149,1859,-290,0.4638223552894212
RUSHVILLE,IN,4987,4338,-649,0.46520107238605896
RUSHVILLE,MO,199,65,-134,0.24621212121212122
RUSHVILLE,NE,70,36,-34,0.33962264150943394
RUSHVILLE,NY,745,659,-86,0.46937321937321935
RUSHVILLE,OH,480,510,30,0.5151515151515151
RUSK,TX,3262,3236,-26,0.49799938442597724
RUSKIN,FL,17145,24255,7110,0.5858695652173913
RUSSELL,AR,24,22,-2,0.4782608695652174
RUSSELL,IA,134,191,57,0.5876923076923077
RUSSELL,KS,2869,2516,-353,0.46722376973073354
RUSSELL,KY,1259,1292,33,0.506468051744414
RUSSELL,MA,266,203,-63,0.43283582089552236
RUSSELL,MN,52,11,-41,0.1746031746031746
RUSSELL,NY,172,159,-13,0.48036253776435045
RUSSELL,OH,75,93,18,0.5535714285714286
RUSSELL,PA,957,980,23,0.5059370160041301
RUSSELL SPGS,KY,653,593,-60,0.47592295345104335
RUSSELL SPRINGS,KY,4922,4246,-676,0.4631326352530541
RUSSELLS POINT,OH,1346,1182,-164,0.4675632911392405
RUSSELLTON,PA,101,26,-75,0.2047244094488189
RUSSELLVILLE,AL,6037,5118,-919,0.4588077095472882
RUSSELLVILLE,AR,20070,16262,-3808,0.4475944071342068
RUSSELLVILLE,IN,11,0,-11,0
RUSSELLVILLE,KY,6972,6251,-721,0.4727368978295394
RUSSELLVILLE,MO,659,730,71,0.5255579553635709
RUSSELLVILLE,OH,180,157,-23,0.4658753709198813
RUSSELLVILLE,TN,1556,1429,-127,0.47872696817420435
RUSSIA,OH,87,23,-64,0.20909090909090908
RUSSIAVILLE,IN,1276,1409,133,0.5247672253258845
RUSTBURG,VA,2626,2704,78,0.5073170731707317
RUSTON,LA,13444,10702,-2742,0.4432204091775035
RUTH,MI,0,25,25,1
RUTH,MS,38,22,-16,0.36666666666666664
RUTH,NV,176,185,9,0.5124653739612188
RUTHER GLEN,VA,5628,6141,513,0.5217945449910782
RUTHERFORD,CA,63,22,-41,0.25882352941176473
RUTHERFORD,NJ,5855,6024,169,0.5071133933832814
RUTHERFORD,TN,662,706,44,0.5160818713450293
RUTHERFORD COLLEGE,NC,39,15,-24,0.2777777777777778
RUTHERFORDTON,NC,6419,6619,200,0.5076698880196349
RUTHTON,MN,23,0,-23,0
RUTHVEN,IA,323,333,10,0.5076219512195121
RUTLAND,IL,12,15,3,0.5555555555555556
RUTLAND,MA,2410,2699,289,0.5282834214131924
RUTLAND,OH,419,191,-228,0.31311475409836065
RUTLAND,VT,10533,9507,-1026,0.47440119760479044
RUTLEDGE,AL,116,11,-105,0.08661417322834646
RUTLEDGE,GA,851,871,20,0.5058072009291521
RUTLEDGE,MN,0,36,36,1
RUTLEDGE,MO,12,0,-12,0
RUTLEDGE,PA,87,88,1,0.5028571428571429
RUTLEDGE,TN,2426,2884,458,0.5431261770244821
RYAN,IA,12,52,40,0.8125
RYAN,OK,89,79,-10,0.47023809523809523
RYDAL,GA,1091,1309,218,0.5454166666666667
RYDAL,PA,294,287,-7,0.4939759036144578
RYDER,ND,14,0,-14,0
RYDERWOOD,WA,36,0,-36,0
RYE,CO,1075,1138,63,0.5142340713962946
RYE,NH,2762,2576,-186,0.4825777444735856
RYE,NY,5523,6172,649,0.5277469003847798
RYE,TX,35,145,110,0.8055555555555556
RYE BEACH,NH,189,225,36,0.5434782608695652
RYE BROOK,NY,2648,2462,-186,0.4818003913894325
RYEGATE,MT,27,11,-16,0.2894736842105263
RYLAND HGHT,KY,162,191,29,0.5410764872521246
S BETHANY,DE,104,55,-49,0.34591194968553457
S BLOOMINGVIL,OH,13,11,-2,0.4583333333333333
S BLOOMINGVILLE,OH,51,14,-37,0.2153846153846154
S BOARDMAN,MI,31,11,-20,0.2619047619047619
S CHARLESTON,OH,92,73,-19,0.44242424242424244
S CHARLESTON,WV,535,558,23,0.5105215004574566
S CHICAGO HEIGHTS,IL,357,303,-54,0.4590909090909091
S CLE ELUM,WA,54,31,-23,0.36470588235294116
S COFFEYVILLE,OK,78,300,222,0.7936507936507936
S DARTMOUTH,MA,316,307,-9,0.492776886035313
S DEERFIELD,MA,200,274,74,0.5780590717299579
S EGREMONT,MA,22,0,-22,0
S EL MONTE,CA,120,111,-9,0.4805194805194805
S FALLSBURG,NY,73,11,-62,0.13095238095238096
S FREEPORT,ME,0,13,13,1
S GLASTONBURY,CT,186,211,25,0.5314861460957179
S GLENS FALLS,NY,277,277,0,0.5
S HACKENSACK,NJ,167,128,-39,0.43389830508474575
S HAMILTON,MA,419,402,-17,0.48964677222898906
S HUTCHINSON,KS,38,12,-26,0.24
S JAMESPORT,NY,0,20,20,1
S KINGSTOWN,RI,805,874,69,0.5205479452054794
S LAKE TAHOE,CA,1933,1450,-483,0.4286136565178835
S LONDONDERRY,VT,45,24,-21,0.34782608695652173
S NEW BERLIN,NY,0,12,12,1
S OZONE PARK,NY,1479,1290,-189,0.4658721560130011
S PADRE ISLE,TX,62,776,714,0.9260143198090692
S PALM BCH,FL,199,231,32,0.5372093023255814
S PASADENA,CA,1244,1286,42,0.508300395256917
S PLAINFIELD,NJ,674,662,-12,0.49550898203592814
S PORTLAND,ME,876,810,-66,0.4804270462633452
S RICHMOND HL,NY,2011,1298,-713,0.3922635237231792
S ROCKWOOD,MI,202,148,-54,0.4228571428571429
S ROYALTON,VT,285,287,2,0.5017482517482518
S SALT LAKE,UT,36,53,17,0.5955056179775281
S SAN FRAN,CA,811,736,-75,0.47575953458306397
S SEAVILLE,NJ,0,11,11,1
S SIOUX CITY,NE,901,676,-225,0.42866201648700064
S THOMASTON,ME,16,34,18,0.68
S VINELAND,NJ,64,102,38,0.6144578313253012
S WELLFLEET,MA,69,72,3,0.5106382978723404
S WEYMOUTH,MA,570,640,70,0.5289256198347108
S WILLIAMSPOR,PA,181,170,-11,0.4843304843304843
S WILLIAMSPORT,PA,102,82,-20,0.44565217391304346
S YARMOUTH,MA,846,912,66,0.5187713310580204
S ZANESVILLE,OH,16,20,4,0.5555555555555556
SA,TX,1370,1630,260,0.5433333333333333
SABAEL,NY,25,11,-14,0.3055555555555556
SABATTUS,ME,2411,2376,-35,0.4963442657196574
SABETHA,KS,1337,1256,-81,0.4843810258387968
SABILLASVILLE,MD,174,171,-3,0.4956521739130435
SABIN,MN,25,37,12,0.5967741935483871
SABINA,OH,1787,1624,-163,0.476106713573732
SABINAL,TX,139,204,65,0.5947521865889213
SABINE PASS,TX,0,15,15,1
SABINSVILLE,PA,38,35,-3,0.4794520547945205
SABULA,IA,89,92,3,0.5082872928176796
SAC CITY,IA,1123,1053,-70,0.48391544117647056
SACATON,AZ,569,644,75,0.5309150865622424
SACHSE,TX,7236,9407,2171,0.5652226161148831
SACKETS HARBOR,NY,2142,1773,-369,0.4528735632183908
SACO,ME,9138,9694,556,0.5147621070518267
SACRAMENTO,CA,365562,327757,-37805,0.4727362152198339
SACRAMENTO,KY,396,336,-60,0.45901639344262296
SACRAMENTO,NM,0,11,11,1
SACRAMENTO,PA,0,11,11,1
SACRED HEART,MN,110,71,-39,0.39226519337016574
SADDLE BROOK,NJ,4086,4033,-53,0.49673605123783715
SADDLE RIVER,NJ,1785,2207,422,0.5528557114228457
SADDLEBROOKE,AZ,2845,2619,-226,0.47931918008784774
SADDLEBROOKE,MO,0,11,11,1
SADIEVILLE,KY,749,856,107,0.5333333333333333
SADLER,TX,273,473,200,0.6340482573726541
SADORUS,IL,29,0,-29,0
SADSBURYVILLE,PA,11,22,11,0.6666666666666666
SAEGERTOWN,PA,1642,1493,-149,0.4762360446570973
SAFB,TX,32,26,-6,0.4482758620689655
SAFETY HARBOR,FL,9790,9943,153,0.50387675467491
SAFFORD,AZ,8859,6981,-1878,0.440719696969697
SAG HARBOR,NY,4917,5632,715,0.5338894681960376
SAGAMORE,MA,89,77,-12,0.463855421686747
SAGAMORE BCH,MA,169,185,16,0.5225988700564972
SAGAMORE BEACH,MA,1311,1420,109,0.5199560600512633
SAGAMORE HILLS,OH,678,658,-20,0.49251497005988026
SAGAPONACK,NY,506,396,-110,0.43902439024390244
SAGE,AR,0,12,12,1
SAGINAW,MI,59023,51420,-7603,0.4655795297121592
SAGINAW,MN,1274,1212,-62,0.48753016894609813
SAGINAW,MO,13,0,-13,0
SAGINAW,TX,20259,24568,4309,0.5480625515872131
SAGLE,ID,4056,4281,225,0.5134940626124506
SAGOLA,MI,25,0,-25,0
SAGUACHE,CO,130,161,31,0.5532646048109966
SAHUARITA,AZ,12331,13151,820,0.5160897888705753
SAINT AGATHA,ME,87,81,-6,0.48214285714285715
SAINT ALBANS,ME,751,879,128,0.5392638036809816
SAINT ALBANS,MO,36,57,21,0.6129032258064516
SAINT ALBANS,NY,8717,7528,-1189,0.46340412434595263
SAINT ALBANS,VT,8620,7669,-951,0.4708085210878507
SAINT ALBANS,WV,8340,7421,-919,0.47084575851786054
SAINT ALBANS BAY,VT,201,164,-37,0.44931506849315067
SAINT AMANT,LA,2456,2495,39,0.5039385982629772
SAINT ANN,MO,6599,6106,-493,0.4805981896890988
SAINT ANNE,IL,1570,1344,-226,0.4612216884008236
SAINT ANSGAR,IA,599,468,-131,0.4386129334582943
SAINT ANTHONY,IA,13,11,-2,0.4583333333333333
SAINT ANTHONY,ID,2367,2356,-11,0.4988354859199661
SAINT ANTHONY,IN,63,0,-63,0
SAINT ANTHONY,MN,439,283,-156,0.39196675900277006
SAINT AUGUSTA,MN,529,574,45,0.5203989120580236
SAINT AUGUSTINE,FL,64891,77640,12749,0.5447236039879044
SAINT AUGUSTINE,IL,12,0,-12,0
SAINT BENEDICT,LA,24,0,-24,0
SAINT BENEDICT,OR,17,0,-17,0
SAINT BERNARD,LA,996,1065,69,0.5167394468704513
SAINT BERNARD,OH,214,179,-35,0.455470737913486
SAINT BONAVENTURE,NY,16,0,-16,0
SAINT BONIFACIUS,MN,1041,919,-122,0.4688775510204082
SAINT CHARLES,IA,537,611,74,0.5322299651567944
SAINT CHARLES,ID,22,13,-9,0.37142857142857144
SAINT CHARLES,IL,18582,17706,-876,0.4879298941798942
SAINT CHARLES,LA,77,78,1,0.5032258064516129
SAINT CHARLES,MD,221,242,21,0.5226781857451404
SAINT CHARLES,MI,1983,1885,-98,0.4873319544984488
SAINT CHARLES,MN,1783,1679,-104,0.4849797804737146
SAINT CHARLES,MO,46672,45166,-1506,0.49180077963370283
SAINT CHARLES,VA,11,13,2,0.5416666666666666
SAINT CLAIR,MI,4776,4657,-119,0.4936923566203753
SAINT CLAIR,MO,5017,4798,-219,0.4888436067244014
SAINT CLAIR,PA,1412,1303,-109,0.479926335174954
SAINT CLAIR SHORES,MI,18893,18214,-679,0.4908507828711564
SAINT CLAIRSVILLE,OH,4716,4453,-263,0.48565819609553934
SAINT CLOUD,FL,39284,53930,14646,0.5785611603407214
SAINT CLOUD,MN,49434,41609,-7825,0.4570258009951342
SAINT CLOUD,WI,121,102,-19,0.45739910313901344
SAINT CROIX FALLS,WI,1778,1884,106,0.5144729655925724
SAINT DAVID,AZ,1136,1234,98,0.5206751054852321
SAINT DAVID,IL,81,36,-45,0.3076923076923077
SAINT DAVID,ME,119,180,61,0.6020066889632107
SAINT DAVIDS,PA,1116,1178,62,0.5135135135135135
SAINT EDWARD,NE,210,96,-114,0.3137254901960784
SAINT ELMO,IL,499,406,-93,0.4486187845303867
SAINT FRANCIS,KS,705,605,-100,0.4618320610687023
SAINT FRANCIS,ME,38,55,17,0.5913978494623656
SAINT FRANCIS,MN,3307,3071,-236,0.4814989024772656
SAINT FRANCIS,SD,39,18,-21,0.3157894736842105
SAINT FRANCIS,WI,3959,3882,-77,0.49508991200102026
SAINT FRANCISVILLE,IL,225,150,-75,0.4
SAINT FRANCISVILLE,LA,1734,2057,323,0.5426008968609866
SAINT GABRIEL,LA,848,1176,328,0.5810276679841897
SAINT GEORGE,GA,586,459,-127,0.43923444976076553
SAINT GEORGE,KS,1177,1187,10,0.5021150592216582
SAINT GEORGE,ME,237,317,80,0.572202166064982
SAINT GEORGE,SC,1814,1769,-45,0.493720346078705
SAINT GEORGE,UT,41967,44646,2679,0.5154653458487756
SAINT GEORGE,VT,56,103,47,0.6477987421383647
SAINT GEORGE ISLAND,FL,264,382,118,0.5913312693498453
SAINT GERMAIN,WI,1570,1468,-102,0.48321263989466756
SAINT HEDWIG,TX,940,3024,2084,0.7628657921291625
SAINT HELEN,MI,2229,2162,-67,0.4923707583693919
SAINT HELENA,CA,3795,3195,-600,0.4570815450643777
SAINT HELENA ISLAND,SC,3649,4335,686,0.5429609218436874
SAINT HELENS,OR,7855,7905,50,0.5015862944162437
SAINT HENRY,OH,561,415,-146,0.42520491803278687
SAINT HILAIRE,MN,13,11,-2,0.4583333333333333
SAINT IGNACE,MI,1996,1913,-83,0.48938347403427984
SAINT IGNATIUS,MT,1254,1213,-41,0.49169031211998376
SAINT INIGOES,MD,183,196,13,0.5171503957783641
SAINT JACOB,IL,677,734,57,0.520198440822112
SAINT JAMES,LA,27,13,-14,0.325
SAINT JAMES,MN,2475,2013,-462,0.4485294117647059
SAINT JAMES,MO,3925,3626,-299,0.4802012978413455
SAINT JAMES,NC,614,834,220,0.5759668508287292
SAINT JAMES,NY,4334,4599,265,0.5148326430090675
SAINT JAMES CITY,FL,6860,6643,-217,0.4919647485743909
SAINT JO,TX,278,434,156,0.6095505617977528
SAINT JOE,AR,154,167,13,0.5202492211838006
SAINT JOE,IN,346,227,-119,0.3961605584642234
SAINT JOHN,IN,3669,5382,1713,0.5946304275770633
SAINT JOHN,KS,45,25,-20,0.35714285714285715
SAINT JOHN,ND,48,35,-13,0.42168674698795183
SAINT JOHN,WA,138,190,52,0.5792682926829268
SAINT JOHNS,AZ,1683,1473,-210,0.4667300380228137
SAINT JOHNS,FL,11124,16897,5773,0.603012026694265
SAINT JOHNS,MI,6374,5795,-579,0.47621004190977073
SAINT JOHNSBURY,VT,3210,3174,-36,0.49718045112781956
SAINT JOHNSVILLE,NY,1684,1565,-119,0.4816866728224069
SAINT JOSEPH,IL,1809,1647,-162,0.4765625
SAINT JOSEPH,LA,469,344,-125,0.4231242312423124
SAINT JOSEPH,MI,9899,9440,-459,0.48813278866539117
SAINT JOSEPH,MN,2970,3058,88,0.5072992700729927
SAINT JOSEPH,MO,38178,32408,-5770,0.4591278723826254
SAINT JOSEPH,TN,135,58,-77,0.3005181347150259
SAINT LANDRY,LA,29,75,46,0.7211538461538461
SAINT LEO,FL,0,11,11,1
SAINT LEO,MN,13,0,-13,0
SAINT LEON,IN,54,54,0,0.5
SAINT LEONARD,MD,1940,2013,73,0.5092334935492031
SAINT LIBORY,IL,107,24,-83,0.183206106870229
SAINT LIBORY,NE,12,33,21,0.7333333333333333
SAINT LOUIS,MI,3502,2966,-536,0.45856524427953
SAINT LOUIS,MO,368558,329765,-38793,0.4722241713361868
SAINT LOUIS PARK,MN,6790,5843,-947,0.4625187999683369
SAINT LOUISVILLE,OH,483,537,54,0.5264705882352941
SAINT LUCIE WEST,FL,62,120,58,0.6593406593406593
SAINT MARIE,MT,11,44,33,0.8
SAINT MARIES,ID,2880,2939,59,0.505069599587558
SAINT MARTIN,MN,12,0,-12,0
SAINT MARTINVILLE,LA,3754,3604,-150,0.48980701277521066
SAINT MARY,MO,373,376,3,0.5020026702269693
SAINT MARY OF THE WOODS,IN,0,39,39,1
SAINT MARYS,GA,15262,12042,-3220,0.44103428069147377
SAINT MARYS,KS,1177,1034,-143,0.46766169154228854
SAINT MARYS,OH,5348,4859,-489,0.4760458508866464
SAINT MARYS,PA,3871,3700,-171,0.48870690793818516
SAINT MARYS,WV,1458,1415,-43,0.49251653324051514
SAINT MATTHEWS,SC,1326,1483,157,0.5279458882164472
SAINT MEINRAD,IN,28,58,30,0.6744186046511628
SAINT MICHAEL,MN,5003,5730,727,0.5338675114133979
SAINT MICHAEL,ND,13,0,-13,0
SAINT MICHAEL,PA,74,23,-51,0.23711340206185566
SAINT MICHAELS,AZ,959,100,-859,0.09442870632672333
SAINT MICHAELS,MD,1260,1349,89,0.5170563434266002
SAINT NAZIANZ,WI,71,11,-60,0.13414634146341464
SAINT ONGE,SD,15,0,-15,0
SAINT PARIS,OH,1739,1664,-75,0.4889803114898619
SAINT PAUL,IN,621,551,-70,0.47013651877133106
SAINT PAUL,KS,11,38,27,0.7755102040816326
SAINT PAUL,MN,318305,281677,-36628,0.46947575093919486
SAINT PAUL,MO,339,422,83,0.5545335085413929
SAINT PAUL,NE,1071,1051,-20,0.49528746465598494
SAINT PAUL,OR,185,115,-70,0.38333333333333336
SAINT PAUL,VA,554,515,-39,0.48175865294667913
SAINT PAUL PARK,MN,1898,1611,-287,0.4591051581647193
SAINT PAULS,NC,2568,2624,56,0.5053929121725732
SAINT PETE BEACH,FL,6937,8159,1222,0.540474297827239
SAINT PETER,MN,5168,4563,-605,0.46891378070085293
SAINT PETERS,MO,28342,29195,853,0.5074126214435928
SAINT PETERSBURG,FL,201078,197739,-3339,0.4958138695191027
SAINT PETERSBURG,PA,25,0,-25,0
SAINT REGIS,MT,619,567,-52,0.47807757166947723
SAINT REGIS FALLS,NY,482,431,-51,0.4720700985761227
SAINT ROBERT,MO,8488,7392,-1096,0.4654911838790932
SAINT ROSE,LA,1797,1726,-71,0.48992336077206927
SAINT SIMONS ISLAND,GA,6441,7524,1083,0.5387755102040817
SAINT STEPHEN,MN,37,41,4,0.5256410256410257
SAINT STEPHEN,SC,1774,1658,-116,0.4831002331002331
SAINT STEPHENS CHURCH,VA,109,203,94,0.6506410256410257
SAINT TERESA,FL,0,22,22,1
SAINT THOMAS,ND,34,0,-34,0
SAINT THOMAS,PA,1421,1281,-140,0.4740932642487047
SAINTE GENEVIEVE,MO,3499,3521,22,0.5015669515669515
SAINTE MARIE,IL,11,0,-11,0
SALADO,TX,3566,4530,964,0.5595355731225297
SALAMANCA,NY,3278,2883,-395,0.4679435156630417
SALCHA,AK,226,280,54,0.5533596837944664
SALE CITY,GA,24,0,-24,0
SALE CREEK,TN,897,1205,308,0.5732635585156993
SALEM,AL,2123,2819,696,0.5704168352893565
SALEM,AR,1853,1777,-76,0.48953168044077133
SALEM,CT,1200,1501,301,0.5557201036653091
SALEM,IA,96,38,-58,0.2835820895522388
SALEM,IL,4643,4107,-536,0.46937142857142855
SALEM,IN,6403,6170,-233,0.49073411278135687
SALEM,KY,746,636,-110,0.4602026049204052
SALEM,MA,20745,19611,-1134,0.485950044603033
SALEM,MO,6448,5938,-510,0.4794122396253835
SALEM,NH,11179,11446,267,0.5059005524861878
SALEM,NJ,3596,3471,-125,0.4911560775435121
SALEM,NY,1285,1302,17,0.5032856590645536
SALEM,OH,9956,9071,-885,0.47674357491985075
SALEM,OR,128045,101029,-27016,0.44103215554798886
SALEM,SC,2394,2994,600,0.5556792873051225
SALEM,SD,857,645,-212,0.42942743009320905
SALEM,UT,1638,2124,486,0.5645933014354066
SALEM,VA,13110,13677,567,0.5105834919923844
SALEM,WI,3062,3022,-40,0.49671268902038135
SALEM,WV,1720,1643,-77,0.48855188819506395
SALEM TWP,ME,126,114,-12,0.475
SALEMBURG,NC,611,706,95,0.5360668185269551
SALESVILLE,OH,155,91,-64,0.3699186991869919
SALIDA,CA,4030,3202,-828,0.44275442477876104
SALIDA,CO,6368,6299,-69,0.4972763874634878
SALINA,KS,28218,23033,-5185,0.44941562115861156
SALINA,OK,1398,1348,-50,0.49089584850691914
SALINA,UT,908,982,74,0.5195767195767196
SALINAS,CA,41005,35340,-5665,0.4628986836073089
SALINE,LA,305,288,-17,0.4856661045531197
SALINE,MI,6669,7044,375,0.5136731568584555
SALINEVILLE,OH,1061,986,-75,0.48168050806057644
SALISBURY,CT,867,1080,213,0.5546995377503852
SALISBURY,MA,3931,4132,201,0.5124643432965398
SALISBURY,MD,32488,27928,-4560,0.4622616525423729
SALISBURY,MO,821,801,-20,0.4938347718865598
SALISBURY,NC,25434,27250,1816,0.5172348341052312
SALISBURY,NH,148,268,120,0.6442307692307693
SALISBURY,PA,245,221,-24,0.4742489270386266
SALISBURY,VT,404,418,14,0.5085158150851582
SALISBURY CENTER,NY,62,46,-16,0.42592592592592593
SALISBURY MILLS,NY,296,490,194,0.6234096692111959
SALISBURY MLS,NY,23,40,17,0.6349206349206349
SALIX,IA,92,53,-39,0.36551724137931035
SALIX,PA,127,149,22,0.5398550724637681
SALKUM,WA,170,216,46,0.5595854922279793
SALLEY,SC,450,492,42,0.5222929936305732
SALLIS,MS,141,278,137,0.6634844868735084
SALLISAW,OK,5247,5429,182,0.508523791682278
SALMON,ID,3430,3423,-7,0.49948927477017363
SALOL,MN,13,35,22,0.7291666666666666
SALOME,AZ,3103,5281,2178,0.6298902671755725
SALT LAKE CITY,UT,211854,175702,-36152,0.45335899844151556
SALT LAKE CTY,UT,36,16,-20,0.3076923076923077
SALT LICK,KY,1042,1156,114,0.5259326660600546
SALT POINT,NY,429,615,186,0.5890804597701149
SALT ROCK,WV,254,174,-80,0.40654205607476634
SALT SPRINGS,FL,862,1057,195,0.5508077123501823
SALTER PATH,NC,36,42,6,0.5384615384615384
SALTERS,SC,119,146,27,0.5509433962264151
SALTILLO,MS,3985,3897,-88,0.4944176604922608
SALTILLO,TN,86,87,1,0.5028901734104047
SALTILLO,TX,0,71,71,1
SALTON CITY,CA,52,331,279,0.8642297650130548
SALTSBURG,PA,1596,1398,-198,0.46693386773547096
SALTVILLE,VA,1440,1393,-47,0.4917049064595835
SALUDA,NC,1224,1423,199,0.5375897242160937
SALUDA,SC,1742,1744,2,0.5002868617326449
SALUDA,VA,749,797,48,0.5155239327296248
SALUNGA,PA,250,287,37,0.5344506517690876
SALVISA,KY,592,689,97,0.5378610460577674
SALYERSVILLE,KY,2564,2581,17,0.5016520894071914
SAMBURG,TN,15,0,-15,0
SAMMAMISH,WA,18362,21258,2896,0.5365471983846543
SAMOA,CA,22,75,53,0.7731958762886598
SAMSON,AL,1581,1728,147,0.5222121486854034
SAN ACACIO,CO,13,0,-13,0
SAN ANDREAS,CA,1598,1765,167,0.5248290217068095
SAN ANGELO,TX,47848,42133,-5715,0.46824329580689256
SAN ANSELMO,CA,4731,4984,253,0.5130211013896037
SAN ANTONIO,FL,3190,4438,1248,0.5818038804404825
SAN ANTONIO,TX,773083,739110,-33973,0.48876697617301496
SAN AUGUSTINE,TX,1756,1714,-42,0.49394812680115274
SAN BENITO,TX,7284,8487,1203,0.5381396233593304
SAN BERNARDINO,CA,80195,72690,-7505,0.4754554076593518
SAN BRUNO,CA,17462,14455,-3007,0.45289344236613716
SAN CARLOS,AZ,906,131,-775,0.12632594021215043
SAN CARLOS,CA,11745,11628,-117,0.49749711205236813
SAN CLEMENTE,CA,28419,27617,-802,0.49284388607323865
SAN CRISTOBAL,NM,20,19,-1,0.48717948717948717
SAN DIEGO,CA,680433,616055,-64378,0.47517215739752316
SAN DIEGO,TX,920,1001,81,0.5210827693909422
SAN DIMAS,CA,10146,10718,572,0.5137078220858896
SAN ELIZARIO,TX,1581,1649,68,0.5105263157894737
SAN FERNANDO,CA,6158,5174,-984,0.4565831274267561
SAN FIDEL,NM,0,12,12,1
SAN FRANCISCO,CA,500753,375678,-125075,0.42864526699763017
SAN GABRIEL,CA,18984,16379,-2605,0.46316771767101206
SAN GERONIMO,CA,11,51,40,0.8225806451612904
SAN JACINTO,CA,17573,17189,-384,0.49447672746102067
SAN JOAQUIN,CA,49,41,-8,0.45555555555555555
SAN JOSE,CA,388581,337567,-51014,0.4648735519480877
SAN JOSE,IL,66,34,-32,0.34
SAN JOSE,NM,0,11,11,1
SAN JUAN,TX,5397,5472,75,0.5034501794093292
SAN JUAN BAUTISTA,CA,1436,1412,-24,0.4957865168539326
SAN JUAN CAPISTRANO,CA,9838,11037,1199,0.5287185628742515
SAN JUAN CAPO,CA,220,308,88,0.5833333333333334
SAN LEANDRO,CA,35330,30421,-4909,0.46266976928107556
SAN LEON,TX,374,405,31,0.5198973042362003
SAN LORENZO,CA,7502,6770,-732,0.4743553811659193
SAN LORENZO,NM,11,12,1,0.5217391304347826
SAN LUIS,AZ,1550,2037,487,0.567884025648174
SAN LUIS,CO,138,234,96,0.6290322580645161
SAN LUIS OBISPO,CA,28583,24607,-3976,0.46262455348749765
SAN LUIS REY,CA,143,305,162,0.6808035714285714
SAN MANUEL,AZ,1685,1536,-149,0.47687053710027943
SAN MARCOS,CA,37015,36643,-372,0.4974748160417063
SAN MARCOS,TX,38999,35813,-3186,0.47870662460567825
SAN MARINO,CA,3199,4198,999,0.5675273759632283
SAN MARTIN,CA,1819,1907,88,0.511808910359635
SAN MATEO,CA,49988,44500,-5488,0.47095927525188386
SAN MATEO,FL,757,803,46,0.5147435897435897
SAN MIGUEL,CA,1184,1280,96,0.5194805194805194
SAN PABLO,CA,18520,14168,-4352,0.4334312285854136
SAN PABLO,CO,0,12,12,1
SAN PEDRO,CA,24923,23915,-1008,0.48968016708300915
SAN PIERRE,IN,167,130,-37,0.4377104377104377
SAN QUENTIN,CA,11,0,-11,0
SAN RAFAEL,CA,25051,24199,-852,0.4913502538071066
SAN RAFAEL,NM,0,11,11,1
SAN RAMON,CA,28613,29943,1330,0.5113566500444019
SAN SABA,TX,1330,1412,82,0.5149525893508388
SAN SIMEON,CA,12,16,4,0.5714285714285714
SAN SIMON,AZ,24,143,119,0.8562874251497006
SAN TAN VALLEY,AZ,32711,40136,7425,0.5509629771987865
SAN TAN VLY,AZ,2157,2643,486,0.550625
SAN YSIDRO,CA,9154,13100,3946,0.5886582187471915
SANBORN,IA,829,711,-118,0.4616883116883117
SANBORN,MN,25,23,-2,0.4791666666666667
SANBORN,NY,1387,1478,91,0.5158813263525306
SANBORNTON,NH,1090,1124,34,0.5076784101174345
SANBORNVILLE,NH,1969,1962,-7,0.49910964131264307
SAND COULEE,MT,84,37,-47,0.30578512396694213
SAND CREEK,MI,0,11,11,1
SAND FORK,WV,0,24,24,1
SAND LAKE,MI,2035,1946,-89,0.48882190404421
SAND LAKE,NY,47,53,6,0.53
SAND POINT,AK,52,11,-41,0.1746031746031746
SAND POINT,MI,79,60,-19,0.4316546762589928
SAND ROCK,AL,66,47,-19,0.415929203539823
SAND SPRINGS,OK,10185,10731,546,0.5130522088353414
SANDBORN,IN,60,69,9,0.5348837209302325
SANDERS,AZ,377,484,107,0.562137049941928
SANDERS,KY,197,208,11,0.5135802469135803
SANDERSON,FL,1164,1117,-47,0.4896975010960105
SANDERSVILLE,GA,2909,2866,-43,0.49627705627705626
SANDERSVILLE,MS,34,0,-34,0
SANDESTIN,FL,394,561,167,0.587434554973822
SANDGATE,VT,17,24,7,0.5853658536585366
SANDIA,TX,1044,1406,362,0.5738775510204082
SANDIA PARK,NM,1671,1984,313,0.5428180574555403
SANDISFIELD,MA,111,208,97,0.6520376175548589
SANDOVAL,IL,808,757,-51,0.4837060702875399
SANDOWN,NH,1709,1879,170,0.5236900780379041
SANDPOINT,ID,10894,11179,285,0.5064558510397318
SANDSTON,VA,4199,4479,280,0.5161327494814474
SANDSTONE,MN,1793,1580,-213,0.46842573376815894
SANDUSKY,MI,2392,2360,-32,0.49663299663299665
SANDUSKY,OH,20955,17156,-3799,0.4501587468185038
SANDWICH,IL,4539,3955,-584,0.4656227925594537
SANDWICH,MA,3782,4009,227,0.5145680913874984
SANDWICH,NH,27,108,81,0.8
SANDY,OR,7673,8010,337,0.5107441178345979
SANDY,UT,40460,37887,-2573,0.48357946060474555
SANDY CREEK,NY,1184,933,-251,0.4407179971658007
SANDY HOOK,CT,2706,3024,318,0.5277486910994764
SANDY HOOK,KY,1069,1072,3,0.5007006071929005
SANDY HOOK,MS,147,250,103,0.6297229219143576
SANDY HOOK,VA,103,178,75,0.6334519572953736
SANDY LAKE,PA,988,840,-148,0.45951859956236324
SANDY RIDGE,NC,355,278,-77,0.4391785150078989
SANDY RIDGE,PA,11,13,2,0.5416666666666666
SANDY RIVER PLT,ME,21,60,39,0.7407407407407407
SANDY SPGS,GA,7855,7741,-114,0.49634521672223647
SANDY SPRING,MD,524,591,67,0.5300448430493273
SANDY SPRINGS,GA,11400,11115,-285,0.4936708860759494
SANDY SPRINGS,SC,11,64,53,0.8533333333333334
SANDY VALLEY,NV,95,89,-6,0.483695652173913
SANDYFIELD,NC,18,13,-5,0.41935483870967744
SANDYSTON,NJ,695,743,48,0.5166898470097357
SANDYVILLE,WV,611,445,-166,0.42140151515151514
SANFORD,CO,87,87,0,0.5
SANFORD,FL,51703,50312,-1391,0.4931823751409106
SANFORD,ME,7519,7225,-294,0.49002984264785676
SANFORD,MI,3469,3089,-380,0.47102775236352545
SANFORD,NC,23555,35227,11672,0.5992820931577694
SANGER,CA,9836,8416,-1420,0.4611001534078457
SANGER,TX,6316,7164,848,0.5314540059347181
SANGERVILLE,ME,569,463,-106,0.4486434108527132
SANIBEL,FL,16711,12719,-3992,0.4321780496092423
SANTA,ID,12,0,-12,0
SANTA ANA,CA,81511,70225,-11286,0.46281040754995517
SANTA ANNA,TX,332,382,50,0.5350140056022409
SANTA BARBARA,CA,54233,51429,-2804,0.48673127519827375
SANTA CLARA,CA,79273,70216,-9057,0.4697068011693168
SANTA CLARA,NM,267,182,-85,0.4053452115812918
SANTA CLARA,UT,2615,2683,68,0.5064175160437902
SANTA CLARITA,CA,21284,23579,2295,0.5255778704054566
SANTA CLAUS,IN,1158,1021,-137,0.46856356126663606
SANTA CRUZ,CA,41505,35562,-5943,0.4614426408190276
SANTA CRUZ,NM,1173,464,-709,0.2834453268173488
SANTA FE,NM,52338,56097,3759,0.5173329644487481
SANTA FE,TN,246,275,29,0.527831094049904
SANTA FE,TX,6143,6409,266,0.5105959209687699
SANTA FE SPGS,CA,775,698,-77,0.47386286490156143
SANTA FE SPRINGS,CA,4489,3983,-506,0.47013692162417375
SANTA MARGARITA,CA,907,881,-26,0.49272930648769575
SANTA MARIA,CA,32833,31225,-1608,0.4874488744575229
SANTA MARIA,TX,11,0,-11,0
SANTA MONICA,CA,60592,51039,-9553,0.45721170642563447
SANTA NELLA,CA,187,184,-3,0.49595687331536387
SANTA PAULA,CA,7292,7165,-127,0.49560766410735285
SANTA ROSA,CA,85539,81913,-3626,0.4891730167450971
SANTA ROSA,NM,878,829,-49,0.4856473345049795
SANTA ROSA,TX,323,539,216,0.6252900232018561
SANTA ROSA BEACH,FL,14922,17292,2370,0.5367852486496554
SANTA ROSA VALLEY,CA,291,331,40,0.5321543408360129
SANTA TERESA,NM,2319,2526,207,0.5213622291021672
SANTA YNEZ,CA,1941,2058,117,0.5146286571642911
SANTA YSABEL,CA,444,335,-109,0.4300385109114249
SANTAQUIN,UT,3038,4415,1377,0.5923789078223534
SANTEE,CA,22280,21991,-289,0.4967360122879537
SANTEE,SC,1505,1608,103,0.5165435271442339
SANTO,TX,313,471,158,0.6007653061224489
SAPELLO,NM,14,13,-1,0.48148148148148145
SAPPHIRE,NC,2028,2072,44,0.5053658536585366
SAPPINGTON,MO,49,47,-2,0.4895833333333333
SAPULPA,OK,12279,11136,-1143,0.47559256886611145
SARAH,MS,349,545,196,0.6096196868008948
SARAHSVILLE,OH,59,13,-46,0.18055555555555555
SARALAND,AL,5783,5775,-8,0.49965391936321163
SARANAC,MI,1760,1609,-151,0.4775897892549718
SARANAC,NY,649,605,-44,0.4824561403508772
SARANAC LAKE,NY,4093,3829,-264,0.4833375410249937
SARASOTA,FL,190885,210110,19225,0.523971620593773
SARATOGA,CA,7680,9315,1635,0.5481023830538394
SARATOGA,TX,65,48,-17,0.4247787610619469
SARATOGA,WY,1353,1111,-242,0.45089285714285715
SARATOGA SPGS,UT,1425,2047,622,0.589573732718894
SARATOGA SPRINGS,NY,22152,21483,-669,0.49233413544173255
SARATOGA SPRINGS,UT,8290,12290,4000,0.597181729834791
SARCOXIE,MO,1424,1315,-109,0.4801022270901789
SARDINIA,OH,1897,1799,-98,0.48674242424242425
SARDIS,AL,12,0,-12,0
SARDIS,GA,280,288,8,0.5070422535211268
SARDIS,MS,1561,1588,27,0.5042870752619879
SARDIS,OH,360,334,-26,0.4812680115273775
SARDIS,TN,110,257,147,0.7002724795640327
SAREPTA,LA,890,707,-183,0.4427050720100188
SARGENT,NE,197,77,-120,0.28102189781021897
SARGENT,TX,384,430,46,0.5282555282555282
SARONA,WI,786,579,-207,0.42417582417582417
SARTELL,MN,8554,8715,161,0.5046615322253749
SARVER,PA,1870,2157,287,0.5356344673454184
SASAKWA,OK,29,59,30,0.6704545454545454
SATANTA,KS,133,46,-87,0.2569832402234637
SATELLITE BEACH,FL,8798,9278,480,0.5132772737331268
SATSOP,WA,14,0,-14,0
SATSUMA,AL,2026,2032,6,0.5007392804337112
SATSUMA,FL,2874,3168,294,0.5243296921549155
SAUCIER,MS,4361,4267,-94,0.4945526193787668
SAUGATUCK,MI,1853,1918,65,0.5086184036064705
SAUGERTIES,NY,6873,6420,-453,0.48296095689460616
SAUGET,IL,24,30,6,0.5555555555555556
SAUGUS,CA,1157,1430,273,0.5527638190954773
SAUGUS,MA,8838,9381,543,0.5149020253581426
SAUK CENTRE,MN,3429,3056,-373,0.4712413261372398
SAUK CITY,WI,2124,1969,-155,0.48106523332518936
SAUK RAPIDS,MN,7810,7099,-711,0.47615534241062446
SAUK VILLAGE,IL,633,586,-47,0.4807219031993437
SAUKVILLE,WI,2044,1793,-251,0.46729215532968466
SAULSBURY,TN,391,240,-151,0.3803486529318542
SAULT SAINTE MARIE,MI,9409,7908,-1501,0.45666108448345555
SAUM,MN,18,11,-7,0.3793103448275862
SAUNDERSTOWN,RI,1743,2003,260,0.5347036839295248
SAUNEMIN,IL,23,22,-1,0.4888888888888889
SAUQUOIT,NY,1068,1058,-10,0.49764816556914393
SAUSALITO,CA,7398,6895,-503,0.4824039739732736
SAUTE NACOCHE,GA,187,194,7,0.5091863517060368
SAUTEE,GA,160,232,72,0.5918367346938775
SAUTEE NACOOCHEE,GA,775,1010,235,0.5658263305322129
SAVAGE,MD,2075,1717,-358,0.45279535864978904
SAVAGE,MN,10199,10640,441,0.5105811219348337
SAVAGE,MT,47,0,-47,0
SAVANNA,IL,1973,1631,-342,0.4525527192008879
SAVANNA,OK,348,111,-237,0.24183006535947713
SAVANNAH,GA,125353,114029,-11324,0.4763474279603312
SAVANNAH,MO,3166,2652,-514,0.45582674458576833
SAVANNAH,NY,811,786,-25,0.49217282404508456
SAVANNAH,TN,8838,7582,-1256,0.4617539585870889
SAVANNAH,TX,5290,8769,3479,0.6237285724446974
SAVERY,WY,13,0,-13,0
SAVONA,NY,889,703,-186,0.4415829145728643
SAVOY,IL,4258,4400,142,0.5082005082005082
SAVOY,MA,0,34,34,1
SAVOY,TX,594,847,253,0.5877862595419847
SAWYER,MI,1236,995,-241,0.445988346033169
SAWYER,ND,25,0,-25,0
SAWYER,OK,40,88,48,0.6875
SAWYERS BAR,CA,14,17,3,0.5483870967741935
SAWYERVILLE,AL,26,65,39,0.7142857142857143
SAXAPAHAW,NC,0,86,86,1
SAXE,VA,45,15,-30,0.25
SAXON,WI,35,0,-35,0
SAXONBURG,PA,1306,1363,57,0.5106781566129637
SAXTON,PA,958,945,-13,0.49658434051497635
SAXTONS RIVER,VT,52,112,60,0.6829268292682927
SAYBROOK,IL,22,164,142,0.8817204301075269
SAYLORSBURG,PA,3137,3148,11,0.5008750994431186
SAYNER,WI,278,284,6,0.505338078291815
SAYRE,OK,2397,1810,-587,0.43023532208224385
SAYRE,PA,4706,4303,-403,0.47763347763347763
SAYREVILLE,NJ,5929,5380,-549,0.47572729684322224
SAYVILLE,NY,4844,4565,-279,0.48517376979487725
SCAGGSVILLE,MD,261,237,-24,0.4759036144578313
SCALES MOUND,IL,37,37,0,0.5
SCALY MOUNTAIN,NC,140,321,181,0.6963123644251626
SCAMMON,KS,66,34,-32,0.34
SCANDIA,KS,16,26,10,0.6190476190476191
SCANDIA,MN,1036,1036,0,0.5
SCANDINAVIA,WI,267,113,-154,0.29736842105263156
SCAPPOOSE,OR,5508,4921,-587,0.4718573209320165
SCARBOROUGH,ME,10301,11961,1660,0.5372832629593028
SCARBOROUGH,NY,34,32,-2,0.48484848484848486
SCARBRO,WV,516,318,-198,0.381294964028777
SCARSDALE,NY,9919,10889,970,0.5233083429450212
SCENERY HILL,PA,164,144,-20,0.4675324675324675
SCHAEFFERSTOWN,PA,11,0,-11,0
SCHAGHTICOKE,NY,773,791,18,0.5057544757033248
SCHALLER,IA,234,69,-165,0.22772277227722773
SCHAUMBURG,IL,34864,31593,-3271,0.47539010187038233
SCHELL CITY,MO,13,0,-13,0
SCHELLSBURG,PA,535,507,-28,0.4865642994241843
SCHENECTADY,NY,59561,56309,-3252,0.48596703201864155
SCHENEVUS,NY,487,354,-133,0.42092746730083236
SCHERERVILLE,IN,7295,7623,328,0.5109934307547929
SCHERTZ,TX,16868,18993,2125,0.5296282869970163
SCHILLER PARK,IL,4285,3525,-760,0.4513444302176697
SCHLESWIG,IA,179,98,-81,0.35379061371841153
SCHNECKSVILLE,PA,1828,1932,104,0.5138297872340426
SCHNEIDER,IN,12,11,-1,0.4782608695652174
SCHOFIELD,WI,10224,8021,-2203,0.439627295149356
SCHOFIELD BARRACKS,HI,12,37,25,0.7551020408163265
SCHOHARIE,NY,1353,1294,-59,0.488855307895731
SCHOOLCRAFT,MI,1913,1906,-7,0.49908352971982195
SCHRIEVER,LA,1186,1381,195,0.5379820802493183
SCHROEDER,MN,11,0,-11,0
SCHROON LAKE,NY,1253,1129,-124,0.4739714525608732
SCHULENBURG,TX,1468,1615,147,0.5238404151800194
SCHURZ,NV,0,11,11,1
SCHUYKL HAVN,PA,68,70,2,0.5072463768115942
SCHUYLER,NE,2180,1876,-304,0.4625246548323471
SCHUYLER,VA,220,184,-36,0.45544554455445546
SCHUYLER FALLS,NY,93,102,9,0.5230769230769231
SCHUYLERVILLE,NY,1387,1473,86,0.515034965034965
SCHUYLKILL HAVEN,PA,3780,3851,71,0.5046520770541213
SCHWENKSVILLE,PA,3350,3513,163,0.5118752732041382
SCIENCE HILL,KY,2028,1950,-78,0.49019607843137253
SCIO,NY,607,608,1,0.5004115226337449
SCIO,OH,833,734,-99,0.46841097638800255
SCIO,OR,1645,1787,142,0.5206876456876457
SCIOTA,PA,243,225,-18,0.4807692307692308
SCIPIO,IN,228,292,64,0.5615384615384615
SCIPIO CENTER,NY,70,45,-25,0.391304347826087
SCITUATE,MA,5630,6290,660,0.5276845637583892
SCITUATE,RI,103,142,39,0.5795918367346938
SCOBEY,MS,11,12,1,0.5217391304347826
SCOBEY,MT,172,136,-36,0.44155844155844154
SCOFIELD,UT,36,26,-10,0.41935483870967744
SCOTCH PLAINS,NJ,5554,6140,586,0.5250555840602018
SCOTIA,CA,12,109,97,0.9008264462809917
SCOTIA,NE,12,12,0,0.5
SCOTIA,NY,1598,1629,31,0.5048032228075612
SCOTLAND,AR,0,15,15,1
SCOTLAND,GA,0,12,12,1
SCOTLAND,PA,24,12,-12,0.3333333333333333
SCOTLAND,SD,160,215,55,0.5733333333333334
SCOTLAND,TX,16,11,-5,0.4074074074074074
SCOTLAND NECK,NC,1115,1037,-78,0.48187732342007433
SCOTRUN,PA,311,344,33,0.5251908396946565
SCOTT,AR,670,816,146,0.5491251682368775
SCOTT,LA,3759,3594,-165,0.48878008975928194
SCOTT,OH,36,13,-23,0.2653061224489796
SCOTT AFB,IL,581,702,121,0.5471551052221356
SCOTT AIR FORCE BASE,IL,2693,3284,591,0.5494395181529195
SCOTT CITY,KS,2555,2061,-494,0.4464904679376083
SCOTT CITY,MO,2592,2498,-94,0.4907662082514735
SCOTT DEPOT,WV,2846,3025,179,0.5152444217339465
SCOTT TOWNSHIP,PA,725,770,45,0.5150501672240803
SCOTT TWP,PA,191,179,-12,0.4837837837837838
SCOTTDALE,GA,2406,1812,-594,0.4295874822190612
SCOTTDALE,PA,2538,2339,-199,0.4795981135944228
SCOTTOWN,OH,0,35,35,1
SCOTTS,MI,922,932,10,0.5026968716289104
SCOTTS HILL,TN,736,631,-105,0.4615947329919532
SCOTTS MILLS,OR,196,274,78,0.5829787234042553
SCOTTS VALLEY,CA,5453,5505,52,0.5023726957473992
SCOTTSBLUFF,NE,9024,7515,-1509,0.454380555051696
SCOTTSBORO,AL,7792,7707,-85,0.497257887605652
SCOTTSBURG,IN,7565,7092,-473,0.4838643651497578
SCOTTSBURG,OR,0,14,14,1
SCOTTSBURG,VA,212,191,-21,0.4739454094292804
SCOTTSDALE,AZ,213613,219194,5581,0.5064474465523894
SCOTTSVILLE,KY,6810,6979,169,0.5061280731017478
SCOTTSVILLE,NY,2047,1900,-147,0.4813782619711173
SCOTTSVILLE,TX,0,12,12,1
SCOTTSVILLE,VA,2191,2352,161,0.5177195685670262
SCOTTVILLE,MI,1864,1702,-162,0.47728547392035897
SCRANTON,AR,431,261,-170,0.37716763005780346
SCRANTON,IA,207,249,42,0.5460526315789473
SCRANTON,KS,189,301,112,0.6142857142857143
SCRANTON,NC,12,31,19,0.7209302325581395
SCRANTON,ND,12,0,-12,0
SCRANTON,PA,36205,31599,-4606,0.4660344522447053
SCRANTON,SC,849,923,74,0.5208803611738149
SCREVEN,GA,927,811,-116,0.4666283084004603
SCRIBNER,NE,257,273,16,0.5150943396226415
SCROGGINS,TX,391,501,110,0.5616591928251121
SCURRY,TX,1228,1511,283,0.551661190215407
SD,CA,217,260,43,0.5450733752620545
SEA BRIGHT,NJ,581,641,60,0.5245499181669394
SEA CLIFF,NY,1502,1586,84,0.5136010362694301
SEA GIRT,NJ,2005,2161,156,0.5187229956793087
SEA ISLAND,GA,120,211,91,0.6374622356495468
SEA ISLE CITY,NJ,2126,2687,561,0.5582796592561812
SEABECK,WA,2030,2001,-29,0.49640287769784175
SEABOARD,NC,65,91,26,0.5833333333333334
SEABROOK,MD,722,669,-53,0.4809489575844716
SEABROOK,NH,4562,4803,241,0.5128670581954085
SEABROOK,SC,614,797,183,0.5648476257973069
SEABROOK,TX,8524,7876,-648,0.4802439024390244
SEABROOK ISL,SC,861,1134,273,0.5684210526315789
SEABROOK ISLAND,SC,260,478,218,0.6476964769647696
SEACREST,FL,256,309,53,0.5469026548672566
SEADRIFT,TX,1248,526,-722,0.2965050732807215
SEAFORD,DE,8693,8691,-2,0.49994247583985274
SEAFORD,NY,4125,4247,122,0.5072861920688008
SEAFORD,VA,878,1069,191,0.5490498202362609
SEAGOVILLE,TX,4922,5673,751,0.5354412458706937
SEAGRAVES,TX,303,160,-143,0.34557235421166305
SEAGROVE,NC,906,1118,212,0.5523715415019763
SEAHURST,WA,43,83,40,0.6587301587301587
SEAL BEACH,CA,10133,11026,893,0.5211021314806938
SEAL COVE,ME,37,94,57,0.7175572519083969
SEAL HARBOR,ME,242,151,-91,0.3842239185750636
SEAL ROCK,OR,872,628,-244,0.4186666666666667
SEALE,AL,1123,1260,137,0.5287452790600083
SEALY,TX,4291,4410,119,0.5068382944489139
SEAMAN,OH,812,829,17,0.5051797684338818
SEARCHLIGHT,NV,97,36,-61,0.2706766917293233
SEARCY,AR,15337,14222,-1115,0.4811394160830881
SEARS,MI,427,387,-40,0.47542997542997545
SEARSBURG,VT,13,20,7,0.6060606060606061
SEARSMONT,ME,486,541,55,0.5267770204479065
SEARSPORT,ME,1599,1505,-94,0.4848582474226804
SEASIDE,CA,13969,11283,-2686,0.4468160937747505
SEASIDE,OR,4757,4844,87,0.5045307780439537
SEASIDE HEIGHTS,NJ,2735,2856,121,0.5108209622607762
SEASIDE HGTS,NJ,119,125,6,0.5122950819672131
SEASIDE PARK,NJ,1724,1864,140,0.5195094760312151
SEATAC,WA,12307,11081,-1226,0.47378997776637594
SEATON,IL,25,13,-12,0.34210526315789475
SEATTLE,WA,570563,503828,-66735,0.4689428708915097
SEAVIEW,WA,256,319,63,0.5547826086956522
SEBAGO,ME,1019,1298,279,0.5602071644367717
SEBASTIAN,FL,23591,27387,3796,0.5372317470281298
SEBASTIAN,TX,11,16,5,0.5925925925925926
SEBASTOPOL,CA,10240,10439,199,0.5048116446636685
SEBASTOPOL,MS,11,0,-11,0
SEBEC,ME,22,64,42,0.7441860465116279
SEBEKA,MN,1073,950,-123,0.46959960454770144
SEBEWAING,MI,1216,1081,-135,0.47061384414453633
SEBREE,KY,954,876,-78,0.4786885245901639
SEBRING,FL,43337,48533,5196,0.5282790900185044
SEBRING,OH,1828,1782,-46,0.4936288088642659
SECANE,PA,7864,4844,-3020,0.3811772112055398
SECAUCUS,NJ,9552,8601,-951,0.4738059824822343
SECHEDATY,NY,817,797,-20,0.49380421313506817
SECOND MESA,AZ,0,29,29,1
SECOR,IL,24,23,-1,0.48936170212765956
SECRETARY,MD,23,0,-23,0
SECTION,AL,920,1020,100,0.5257731958762887
SEDALIA,CO,1659,1638,-21,0.4968152866242038
SEDALIA,KY,114,126,12,0.525
SEDALIA,MO,19297,16405,-2892,0.4594980673351633
SEDAN,KS,709,612,-97,0.46328538985616957
SEDGEWICKVILLE,MO,172,188,16,0.5222222222222223
SEDGEWICKVLLE,MO,0,13,13,1
SEDGWICK,KS,1162,1117,-45,0.4901272487933304
SEDGWICK,ME,340,434,94,0.5607235142118863
SEDLEY,VA,0,86,86,1
SEDONA,AZ,16338,15246,-1092,0.48271276595744683
SEDRO WOOLLEY,WA,9569,9862,293,0.5075394987391282
SEEKONK,MA,3868,4409,541,0.5326809230397487
SEELEY,CA,96,115,19,0.5450236966824644
SEELEY LAKE,MT,1665,1330,-335,0.44407345575959933
SEELYVILLE,IN,15,0,-15,0
SEFFNER,FL,14259,13371,-888,0.48393051031487516
SEGUIN,TX,19927,20880,953,0.5116769181758032
SEILING,OK,237,113,-124,0.32285714285714284
SEKIU,WA,26,15,-11,0.36585365853658536
SELAH,WA,6397,6204,-193,0.49234187762875964
SELBY,SD,202,51,-151,0.2015810276679842
SELBYVILLE,DE,4134,5444,1310,0.5683858843182292
SELDEN,NY,7718,7169,-549,0.4815610935715725
SELDOVIA,AK,316,108,-208,0.25471698113207547
SELIGMAN,AZ,719,813,94,0.5306788511749347
SELIGMAN,MO,817,995,178,0.5491169977924945
SELINSGROVE,PA,4685,4459,-226,0.4876421697287839
SELKIRK,NY,2254,2412,158,0.5169309901414488
SELLERS,SC,18,47,29,0.7230769230769231
SELLERSBURG,IN,7515,7490,-25,0.4991669443518827
SELLERSVILLE,PA,3297,3674,377,0.5270405967579974
SELLS,AZ,326,430,104,0.5687830687830688
SELMA,AL,5696,5016,-680,0.4682598954443615
SELMA,CA,8588,6554,-2034,0.43283582089552236
SELMA,IN,782,738,-44,0.4855263157894737
SELMA,NC,6272,5523,-749,0.4682492581602374
SELMA,OR,851,793,-58,0.48236009732360097
SELMA,TX,4106,4749,643,0.5363071710897798
SELMA,VA,11,0,-11,0
SELMER,TN,3405,3474,69,0.5050152638464893
SELZ,ND,21,21,0,0.5
SEMINARY,MS,1347,1422,75,0.5135427952329361
SEMINOLE,AL,217,360,143,0.6239168110918544
SEMINOLE,FL,27505,28725,1220,0.5108483016183532
SEMINOLE,OK,4486,4397,-89,0.49499043116064395
SEMINOLE,TX,2929,2973,44,0.5037275499830566
SEMMES,AL,5584,6125,541,0.5231018874370142
SEMORA,NC,178,261,83,0.5945330296127562
SENATH,MO,613,579,-34,0.48573825503355705
SENATOBIA,MS,3679,3871,192,0.5127152317880794
SENECA,IL,1849,1376,-473,0.4266666666666667
SENECA,KS,1274,1155,-119,0.4755043227665706
SENECA,MO,1716,1825,109,0.5153911324484609
SENECA,OR,11,0,-11,0
SENECA,PA,1169,1099,-70,0.4845679012345679
SENECA,SC,14249,14425,176,0.5030689823533515
SENECA FALLS,NY,4845,4427,-418,0.4774590163934426
SENECAVILLE,OH,937,794,-143,0.4586943963027152
SENOIA,GA,4784,6890,2106,0.5902004454342984
SENTINEL,OK,117,62,-55,0.3463687150837989
SEPAR,NM,14,19,5,0.5757575757575758
SEPULVEDA,CA,336,288,-48,0.46153846153846156
SEQUATCHIE,TN,337,524,187,0.6085946573751452
SEQUIM,WA,15668,16209,541,0.5084857420710858
SEQUOIA NATIONAL PARK,CA,72,42,-30,0.3684210526315789
SERENA,IL,11,0,-11,0
SERGEANT BLUFF,IA,2653,2561,-92,0.4911775987725355
SESSER,IL,1090,908,-182,0.4544544544544545
SETAUKET,NY,3100,3666,566,0.5418267809636418
SETH,WV,154,59,-95,0.27699530516431925
SEVEN BAYS,WA,54,67,13,0.5537190082644629
SEVEN CORNERS,VA,124,87,-37,0.41232227488151657
SEVEN DEVILS,NC,777,373,-404,0.3243478260869565
SEVEN FIELDS,PA,403,523,120,0.5647948164146869
SEVEN HILLS,OH,2346,2913,567,0.553907586993725
SEVEN MILE,OH,109,11,-98,0.09166666666666666
SEVEN SPRINGS,NC,1031,869,-162,0.4573684210526316
SEVEN VALLEYS,PA,1624,1570,-54,0.4915466499686913
SEVERANCE,CO,4043,6227,2184,0.6063291139240506
SEVERANCE,KS,16,24,8,0.6
SEVERANCE,NY,12,11,-1,0.4782608695652174
SEVERN,MD,12171,12474,303,0.5061472915398662
SEVERNA PARK,MD,6714,7846,1132,0.5388736263736263
SEVERY,KS,13,29,16,0.6904761904761905
SEVIERVILLE,TN,21158,20832,-326,0.4961181233627054
SEVILLE,FL,111,232,121,0.6763848396501457
SEVILLE,OH,2001,2081,80,0.5097991180793728
SEWALLS POINT,FL,105,195,90,0.65
SEWANEE,TN,1062,991,-71,0.48270823185582074
SEWARD,AK,3042,1752,-1290,0.36545682102628285
SEWARD,KS,55,56,1,0.5045045045045045
SEWARD,NE,3580,2930,-650,0.4500768049155146
SEWARD,PA,527,460,-67,0.46605876393110435
SEWAREN,NJ,491,500,9,0.5045408678102926
SEWELL,NJ,9494,10596,1102,0.5274265803882529
SEWICKLEY,PA,6620,7201,581,0.5210187395991607
SEYMOUR,CT,5034,4894,-140,0.4929492344883159
SEYMOUR,IA,291,217,-74,0.4271653543307087
SEYMOUR,IL,24,15,-9,0.38461538461538464
SEYMOUR,IN,14812,12875,-1937,0.46501968432838514
SEYMOUR,MO,2362,2411,49,0.505133040016761
SEYMOUR,TN,7842,8528,686,0.5209529627367135
SEYMOUR,TX,1627,1633,6,0.500920245398773
SEYMOUR,WI,2379,2184,-195,0.47863247863247865
SF,NM,347,366,19,0.5133239831697055
SF,TX,169,198,29,0.5395095367847411
SHABBONA,IL,335,237,-98,0.4143356643356643
SHACKLEFORDS,VA,275,241,-34,0.46705426356589147
SHADE GAP,PA,72,25,-47,0.25773195876288657
SHADEHILL,SD,16,13,-3,0.4482758620689655
SHADOW HILLS,CA,756,776,20,0.5065274151436031
SHADY COVE,OR,1734,1912,178,0.5244103126714207
SHADY DALE,GA,24,14,-10,0.3684210526315789
SHADY POINT,OK,508,529,21,0.5101253616200578
SHADY SHORES,TX,508,455,-53,0.4724818276220145
SHADY SIDE,MD,1384,1525,141,0.5242351323478859
SHADY SPRING,WV,1064,941,-123,0.4693266832917706
SHADY VALLEY,TN,72,92,20,0.5609756097560976
SHADYSIDE,OH,1780,1501,-279,0.4574824748552271
SHADYSIDE,PA,128,108,-20,0.4576271186440678
SHAFER,MN,650,746,96,0.5343839541547278
SHAFTER,CA,6277,5865,-412,0.48303409652446055
SHAFTSBURY,VT,767,793,26,0.5083333333333333
SHAKER HEIGHTS,OH,12654,12801,147,0.5028874484384207
SHAKOPEE,MN,18689,19022,333,0.5044151573811355
SHALIMAR,FL,5450,5496,46,0.5021012241914855
SHALLOTTE,NC,4320,5225,905,0.5474070193818753
SHALLOWATER,TX,2217,2185,-32,0.4963652885052249
SHAMOKIN,PA,4627,4428,-199,0.4890115958034235
SHAMOKIN DAM,PA,478,449,-29,0.4843581445523193
SHAMONG,NJ,960,987,27,0.5069337442218799
SHAMROCK,TX,1152,804,-348,0.4110429447852761
SHANDAKEN,NY,87,62,-25,0.4161073825503356
SHANDON,CA,123,35,-88,0.22151898734177214
SHANKS,WV,11,33,22,0.75
SHANNOCK,RI,0,11,11,1
SHANNON,GA,183,161,-22,0.4680232558139535
SHANNON,IL,186,212,26,0.5326633165829145
SHANNON,MS,1628,1252,-376,0.43472222222222223
SHANNON,NC,1516,1014,-502,0.4007905138339921
SHAPLEIGH,ME,1093,1207,114,0.5247826086956522
SHARON,CA,136,119,-17,0.4666666666666667
SHARON,CT,1193,1570,377,0.568222946073109
SHARON,KS,11,0,-11,0
SHARON,MA,4621,5726,1105,0.5533971199381463
SHARON,ND,0,22,22,1
SHARON,NH,338,471,133,0.5822002472187886
SHARON,OK,33,16,-17,0.32653061224489793
SHARON,PA,8164,6429,-1735,0.4405536901254026
SHARON,SC,533,625,92,0.5397236614853195
SHARON,TN,862,687,-175,0.44351194318915427
SHARON,VT,254,270,16,0.5152671755725191
SHARON,WI,730,661,-69,0.47519769949676494
SHARON CENTER,OH,11,13,2,0.5416666666666666
SHARON GROVE,KY,12,11,-1,0.4782608695652174
SHARON HILL,PA,3114,2591,-523,0.45416301489921124
SHARON SPGS,NY,37,33,-4,0.4714285714285714
SHARON SPRINGS,KS,117,122,5,0.5104602510460251
SHARON SPRINGS,NY,925,781,-144,0.4577960140679953
SHARONVILLE,OH,400,334,-66,0.4550408719346049
SHARPES,FL,169,404,235,0.7050610820244329
SHARPS CHAPEL,TN,608,880,272,0.5913978494623656
SHARPSBURG,GA,5397,6691,1294,0.553524156187955
SHARPSBURG,KY,344,439,95,0.5606641123882503
SHARPSBURG,MD,1313,1086,-227,0.45268862025844103
SHARPSBURG,NC,739,652,-87,0.46872753414809487
SHARPSBURG,PA,224,218,-6,0.49321266968325794
SHARPSVILLE,IN,534,581,47,0.5210762331838565
SHARPSVILLE,PA,2822,2234,-588,0.44185126582278483
SHARPTOWN,MD,41,34,-7,0.4533333333333333
SHARTLESVILLE,PA,142,74,-68,0.3425925925925926
SHASTA,CA,175,25,-150,0.125
SHASTA LAKE,CA,3818,3949,131,0.508433114458607
SHATTUC,IL,42,43,1,0.5058823529411764
SHATTUCK,OK,796,539,-257,0.4037453183520599
SHAVANO PARK,TX,1176,1140,-36,0.49222797927461137
SHAVER LAKE,CA,196,91,-105,0.3170731707317073
SHAVERTOWN,PA,2019,2135,116,0.5139624458353395
SHAW,MS,350,230,-120,0.39655172413793105
SHAW AFB,SC,2417,1842,-575,0.4324958910542381
SHAWANO,WI,7517,6563,-954,0.4661221590909091
SHAWBORO,NC,290,535,245,0.6484848484848484
SHAWNEE,CO,11,0,-11,0
SHAWNEE,KS,24630,25887,1257,0.5124413563750817
SHAWNEE,OH,67,36,-31,0.34951456310679613
SHAWNEE,OK,17984,16409,-1575,0.47710289884569534
SHAWNEE MISSION,KS,611,566,-45,0.48088360237892946
SHAWNEE MSN,KS,280,271,-9,0.49183303085299457
SHAWNEE ON DELAWARE,PA,0,15,15,1
SHAWNEETOWN,IL,564,535,-29,0.48680618744313015
SHAWSVILLE,VA,602,646,44,0.5176282051282052
SHEBOYGAN,WI,32379,25662,-6717,0.44213573163798003
SHEBOYGAN FALLS,WI,4156,4151,-5,0.49969904899482365
SHEBOYGAN FLS,WI,123,96,-27,0.4383561643835616
SHEDD,OR,67,65,-2,0.49242424242424243
SHEEP RANCH,CA,22,25,3,0.5319148936170213
SHEEP SPRINGS,NM,0,11,11,1
SHEFFIELD,AL,4648,3920,-728,0.45751633986928103
SHEFFIELD,IA,352,223,-129,0.38782608695652177
SHEFFIELD,IL,372,253,-119,0.4048
SHEFFIELD,MA,933,1078,145,0.5360517155643958
SHEFFIELD,PA,614,464,-150,0.43042671614100186
SHEFFIELD,VT,39,11,-28,0.22
SHEFFIELD LAKE,OH,3680,3832,152,0.5101171458998935
SHEFFIELD VILLAGE,OH,612,642,30,0.5119617224880383
SHELBIANA,KY,243,169,-74,0.41019417475728154
SHELBINA,MO,1037,934,-103,0.47387113140537795
SHELBURN,IN,1114,1033,-81,0.48113646949231487
SHELBURNE,NH,90,112,22,0.5544554455445545
SHELBURNE,VT,3456,3979,523,0.5351714862138534
SHELBURNE FALLS,MA,1441,1523,82,0.5138326585695007
SHELBURNE FLS,MA,70,61,-9,0.46564885496183206
SHELBY,AL,1159,1186,27,0.5057569296375266
SHELBY,IA,302,381,79,0.5578330893118595
SHELBY,MI,2577,2183,-394,0.45861344537815124
SHELBY,MS,72,81,9,0.5294117647058824
SHELBY,MT,1637,1616,-21,0.49677221026744545
SHELBY,NC,16699,17048,349,0.5051708299997036
SHELBY,NE,140,72,-68,0.33962264150943394
SHELBY,OH,5013,4652,-361,0.48132436627004654
SHELBY TOWNSHIP,MI,20345,19627,-718,0.49101871309916945
SHELBY TWP,MI,7157,7521,364,0.512399509469955
SHELBYVILLE,IL,3176,2728,-448,0.462059620596206
SHELBYVILLE,IN,14286,13082,-1204,0.47800350774627304
SHELBYVILLE,KY,12973,12719,-254,0.4950568270278686
SHELBYVILLE,MI,2118,1816,-302,0.4616166751398068
SHELBYVILLE,MO,101,126,25,0.5550660792951542
SHELBYVILLE,TN,14859,14191,-668,0.4885025817555938
SHELBYVILLE,TX,489,575,86,0.5404135338345865
SHELDON,IA,3297,2593,-704,0.4402376910016978
SHELDON,IL,430,232,-198,0.3504531722054381
SHELDON,MO,467,526,59,0.5297079556898288
SHELDON,SC,100,200,100,0.6666666666666666
SHELDON,VT,354,271,-83,0.4336
SHELDON,WI,334,317,-17,0.4869431643625192
SHELDONVILLE,MA,0,13,13,1
SHELL,WY,11,50,39,0.819672131147541
SHELL BEACH,CA,490,516,26,0.5129224652087475
SHELL KNOB,MO,1575,1750,175,0.5263157894736842
SHELL LAKE,WI,1614,1423,-191,0.46855449456700693
SHELL ROCK,IA,662,503,-159,0.4317596566523605
SHELLEY,ID,3237,3672,435,0.531480677377334
SHELLMAN,GA,34,91,57,0.728
SHELLSBURG,IA,830,661,-169,0.443326626425218
SHELOCTA,PA,822,779,-43,0.48657089319175517
SHELTER IS,NY,236,167,-69,0.4143920595533499
SHELTER IS HT,NY,86,129,43,0.6
SHELTER ISLAND,NY,685,793,108,0.5365358592692828
SHELTER ISLAND HEIGHTS,NY,1026,907,-119,0.4692188308329022
SHELTON,CT,13447,14908,1461,0.5257626520895785
SHELTON,NE,397,293,-104,0.4246376811594203
SHELTON,WA,16612,15474,-1138,0.4822664090257433
SHENANDOAH,IA,3297,2853,-444,0.46390243902439027
SHENANDOAH,PA,4378,3251,-1127,0.4261371084021497
SHENANDOAH,TX,1581,1770,189,0.5282005371530887
SHENANDOAH,VA,1589,1524,-65,0.4895599100546097
SHENANDOAH JUNCTION,WV,296,394,98,0.5710144927536231
SHENDOAH CVRN,VA,0,11,11,1
SHENDOAH JCT,WV,12,0,-12,0
SHEPHERD,MI,2527,2153,-374,0.460042735042735
SHEPHERD,MT,1194,1320,126,0.5250596658711217
SHEPHERD,TX,2594,2694,100,0.5094553706505295
SHEPHERDSTOWN,WV,2534,2491,-43,0.4957213930348259
SHEPHERDSVILLE,KY,14301,13446,-855,0.48459292896529355
SHEPPARD AFB,TX,49365,2027,-47338,0.03944193648816936
SHEPPTON,PA,30,45,15,0.6
SHERBORN,MA,1232,1469,237,0.5438726397630507
SHERBURN,MN,405,390,-15,0.49056603773584906
SHERBURNE,NY,1734,1645,-89,0.4868304232021308
SHERIDAN,AR,4697,4769,72,0.5038030847242764
SHERIDAN,CA,278,276,-2,0.4981949458483754
SHERIDAN,IL,1204,1029,-175,0.4608150470219436
SHERIDAN,IN,2234,2538,304,0.5318524727577536
SHERIDAN,MI,1798,1689,-109,0.4843705190708345
SHERIDAN,MO,23,11,-12,0.3235294117647059
SHERIDAN,MT,826,846,20,0.5059808612440191
SHERIDAN,OR,4167,3121,-1046,0.428238199780461
SHERIDAN,TX,23,53,30,0.6973684210526315
SHERIDAN,WY,13864,13170,-694,0.48716431160760526
SHERMAN,CT,1689,1784,95,0.513676936366254
SHERMAN,IL,1458,1491,33,0.5055951169888098
SHERMAN,ME,134,54,-80,0.2872340425531915
SHERMAN,MS,62,70,8,0.5303030303030303
SHERMAN,NY,765,574,-191,0.42867811799850636
SHERMAN,SD,69,79,10,0.5337837837837838
SHERMAN,TX,21149,21451,302,0.5035446009389671
SHERMAN OAKS,CA,43924,40215,-3709,0.47795909150334565
SHERMAN VILLAGE,CA,304,269,-35,0.4694589877835951
SHERMANS DALE,PA,1652,1544,-108,0.4831038798498123
SHERRARD,IL,743,613,-130,0.45206489675516226
SHERRILL,AR,11,13,2,0.5416666666666666
SHERRILL,IA,36,39,3,0.52
SHERRILL,NY,1123,979,-144,0.46574690770694577
SHERRILLS FORD,NC,2576,3126,550,0.5482286916871273
SHERRILLS FRD,NC,58,80,22,0.5797101449275363
SHERRODSVILLE,OH,535,507,-28,0.4865642994241843
SHERWOOD,AR,12387,13236,849,0.516567146704133
SHERWOOD,MI,815,409,-406,0.3341503267973856
SHERWOOD,ND,11,0,-11,0
SHERWOOD,OH,765,507,-258,0.39858490566037735
SHERWOOD,OR,9361,9028,-333,0.4909456740442656
SHERWOOD,WI,865,859,-6,0.4982598607888631
SHERWOOD FOREST,CA,2095,1653,-442,0.4410352187833511
SHERWOOD FOREST,MD,0,36,36,1
SHEVLIN,MN,325,378,53,0.5376955903271693
SHICKLEY,NE,84,72,-12,0.46153846153846156
SHICKSHINNY,PA,1584,1495,-89,0.4855472556024683
SHIDLER,OK,53,26,-27,0.3291139240506329
SHILLINGTON,PA,2507,2361,-146,0.48500410846343467
SHILOH,GA,236,310,74,0.5677655677655677
SHILOH,IL,219,260,41,0.5427974947807933
SHILOH,NC,83,117,34,0.585
SHILOH,NJ,12,11,-1,0.4782608695652174
SHILOH,OH,678,516,-162,0.4321608040201005
SHILOH,TN,0,13,13,1
SHINER,TX,1032,1133,101,0.523325635103926
SHINGLE SPGS,CA,1544,1432,-112,0.48118279569892475
SHINGLE SPRINGS,CA,5706,6106,400,0.5169319336268202
SHINGLEHOUSE,PA,1052,861,-191,0.4500784108729744
SHINGLETON,MI,62,24,-38,0.27906976744186046
SHINGLETOWN,CA,1885,1975,90,0.5116580310880829
SHINHOPPLE,NY,17,0,-17,0
SHINNSTON,WV,1831,1735,-96,0.48653954010095346
SHIOCTON,WI,1083,994,-89,0.4785748675974964
SHIP BOTTOM,NJ,1303,2603,1300,0.66641065028161806
SHIPMAN,IL,217,178,-39,0.4506329113924051
SHIPMAN,VA,209,269,60,0.5627615062761506
SHIPPENSBURG,PA,11029,10241,-788,0.48147625763986834
SHIPPENVILLE,PA,1070,1044,-26,0.4938505203405866
SHIPROCK,NM,609,784,175,0.5628140703517588
SHIPSHEWANA,IN,1958,1741,-217,0.4706677480400108
SHIREMANSTOWN,PA,245,266,21,0.5205479452054794
SHIRLEY,AR,827,910,83,0.5238917674150835
SHIRLEY,IN,576,462,-114,0.44508670520231214
SHIRLEY,MA,1860,1889,29,0.5038676980528141
SHIRLEY,NY,8096,8030,-66,0.4979536152796726
SHIRLEY CTR,MA,93,88,-5,0.4861878453038674
SHIRLEYSBURG,PA,26,42,16,0.6176470588235294
SHIVELY,KY,12,14,2,0.5384615384615384
SHOALS,IN,1343,1243,-100,0.48066511987625676
SHOBONIER,IL,12,11,-1,0.4782608695652174
SHOEMAKERSVILLE,PA,1108,1133,25,0.5055778670236502
SHOEMAKERSVLE,PA,26,18,-8,0.4090909090909091
SHOHOLA,PA,1498,1502,4,0.5006666666666667
SHOKAN,NY,348,415,67,0.5439056356487549
SHONGALOO,LA,145,132,-13,0.47653429602888087
SHOREHAM,NY,1814,1675,-139,0.4800802522212668
SHOREHAM,VT,277,179,-98,0.3925438596491228
SHORELINE,WA,23413,23172,-241,0.4974133304711817
SHOREVIEW,MN,6242,6044,-198,0.4919420478593521
SHOREWOOD,IL,5217,5796,579,0.5262871152274584
SHOREWOOD,WI,4868,3722,-1146,0.43329452852153666
SHORT HILLS,NJ,3745,4554,809,0.5487408121460416
SHORTER,AL,133,240,107,0.6434316353887399
SHORTERVILLE,AL,0,12,12,1
SHORTSVILLE,NY,1211,1204,-7,0.4985507246376812
SHOSHONE,ID,1386,1173,-213,0.45838218053927315
SHOSHONI,WY,180,222,42,0.5522388059701493
SHOW LOW,AZ,15047,18319,3272,0.5490319486902835
SHREVE,OH,1457,1193,-264,0.450188679245283
SHREVEPORT,LA,89009,82301,-6708,0.48042145817523785
SHREWSBURY,MA,13524,13535,11,0.5002032595439595
SHREWSBURY,NJ,1427,1538,111,0.5187183811129848
SHREWSBURY,PA,1756,1973,217,0.5290962724591043
SHREWSBURY,VT,59,56,-3,0.48695652173913045
SHREWSBURY,WV,25,21,-4,0.45652173913043476
SHRUB OAK,NY,659,460,-199,0.4110813226094727
SHUBERT,NE,0,11,11,1
SHUBUTA,MS,533,543,10,0.5046468401486989
SHULLSBURG,WI,655,533,-122,0.44865319865319864
SHUMWAY,IL,11,58,47,0.8405797101449275
SHUQUALAK,MS,60,48,-12,0.4444444444444444
SHUSHAN,NY,12,52,40,0.8125
SHUTESBURY,MA,430,430,0,0.5
SIASCONSET,MA,857,804,-53,0.48404575556893437
SIBLEY,IA,1395,1266,-129,0.47576099210823
SIBLEY,IL,27,0,-27,0
SIBLEY,LA,1206,712,-494,0.37122002085505734
SIBLEY,MO,77,162,85,0.6778242677824268
SICILY ISLAND,LA,112,114,2,0.504424778761062
SICKLERVILLE,NJ,16549,15117,-1432,0.4773889976631087
SIDE LAKE,MN,259,280,21,0.5194805194805194
SIDELL,IL,69,0,-69,0
SIDMAN,PA,117,81,-36,0.4090909090909091
SIDNAW,MI,11,0,-11,0
SIDNEY,AR,41,77,36,0.652542372881356
SIDNEY,IA,921,759,-162,0.4517857142857143
SIDNEY,IL,607,334,-273,0.35494155154091395
SIDNEY,KY,0,36,36,1
SIDNEY,ME,280,236,-44,0.4573643410852713
SIDNEY,MI,125,198,73,0.6130030959752322
SIDNEY,MT,5714,4091,-1623,0.4172361040285569
SIDNEY,NE,3914,3727,-187,0.4877633817563146
SIDNEY,NY,2620,2119,-501,0.4471407469930365
SIDNEY,OH,12919,11560,-1359,0.47224151313370644
SIDNEY CENTER,NY,298,210,-88,0.41338582677165353
SIDON,MS,51,48,-3,0.48484848484848486
SIERRA BLANCA,TX,45,14,-31,0.23728813559322035
SIERRA MADRE,CA,3426,3765,339,0.5235711305798916
SIERRA VISTA,AZ,32377,29190,-3187,0.47411762795003815
SIESTA KEY,FL,496,932,436,0.6526610644257703
SIGEL,IL,22,0,-22,0
SIGEL,PA,127,123,-4,0.492
SIGNAL HILL,CA,4737,4144,-593,0.46661412003152797
SIGNAL MOUNTAIN,TN,3891,4889,998,0.5568337129840547
SIGNAL MTN,TN,473,525,52,0.5260521042084169
SIGOURNEY,IA,1202,1197,-5,0.4989578991246353
SIGURD,UT,58,49,-9,0.45794392523364486
SIKES,LA,0,17,17,1
SIKESTON,MO,11991,9736,-2255,0.44810604317209
SILAS,AL,35,40,5,0.5333333333333333
SILER CITY,NC,4247,4070,-177,0.4893591439220873
SILETZ,OR,1505,928,-577,0.3814221126181669
SILEX,MO,500,757,257,0.6022275258552108
SILOAM,NC,13,22,9,0.6285714285714286
SILOAM SPRINGS,AR,10093,9644,-449,0.4886254243299387
SILSBEE,TX,5551,5290,-261,0.4879623650954709
SILT,CO,2400,2267,-133,0.48575101778444396
SILVA,MO,13,12,-1,0.48
SILVANA,WA,23,38,15,0.6229508196721312
SILVER BAY,MN,1183,1010,-173,0.4605563155494756
SILVER BAY,NY,241,295,54,0.5503731343283582
SILVER CITY,IA,23,23,0,0.5
SILVER CITY,NM,7934,7229,-705,0.4767526215128932
SILVER CLIFF,CO,118,124,6,0.512396694214876
SILVER CLIFF,WI,0,14,14,1
SILVER CREEK,GA,2242,2114,-128,0.485307621671258
SILVER CREEK,MS,326,467,141,0.5889029003783102
SILVER CREEK,NE,14,11,-3,0.44
SILVER CREEK,NY,1779,1676,-103,0.4850940665701881
SILVER CREEK,WA,79,90,11,0.5325443786982249
SILVER GROVE,KY,196,107,-89,0.35313531353135313
SILVER LAKE,IN,961,861,-100,0.4725576289791438
SILVER LAKE,KS,798,769,-29,0.4907466496490108
SILVER LAKE,MN,453,283,-170,0.3845108695652174
SILVER LAKE,NH,125,236,111,0.6537396121883656
SILVER LAKE,NY,91,33,-58,0.2661290322580645
SILVER LAKE,OH,306,315,9,0.5072463768115942
SILVER LAKE,OR,105,181,76,0.6328671328671329
SILVER LAKE,WI,859,843,-16,0.49529964747356053
SILVER PLUME,CO,26,0,-26,0
SILVER POINT,TN,275,447,172,0.6191135734072022
SILVER RIDGE TWP,ME,12,0,-12,0
SILVER SPGS,FL,599,719,120,0.5455235204855842
SILVER SPRING,MD,123481,109254,-14227,0.46943519453455645
SILVER SPRINGS,FL,8427,9310,883,0.5248914698088741
SILVER SPRINGS,NV,3996,4203,207,0.5126234906695939
SILVER SPRINGS,NY,618,442,-176,0.4169811320754717
SILVERADO,CA,528,581,53,0.5238954012623985
SILVERDALE,PA,40,0,-40,0
SILVERDALE,WA,16825,14185,-2640,0.45743308610125766
SILVERHILL,AL,1576,1942,366,0.5520181921546333
SILVERLAKE,WA,418,530,112,0.5590717299578059
SILVERSTREET,SC,11,22,11,0.6666666666666666
SILVERTHORNE,CO,3795,3996,201,0.5128994994224104
SILVERTON,CO,818,458,-360,0.35893416927899685
SILVERTON,ID,13,11,-2,0.4583333333333333
SILVERTON,OH,183,150,-33,0.45045045045045046
SILVERTON,OR,6824,6428,-396,0.4850588590401449
SILVERTON,TX,63,37,-26,0.37
SILVERWOOD,MI,219,215,-4,0.49539170506912444
SILVIS,IL,4112,3514,-598,0.4607920272751115
SIMI VALLEY,CA,40882,41507,625,0.5037929820728495
SIMLA,CO,274,167,-107,0.3786848072562358
SIMMESPORT,LA,239,299,60,0.5557620817843866
SIMMS,MT,15,0,-15,0
SIMMS,TX,234,379,145,0.6182707993474714
SIMONTON,TX,16,36,20,0.6923076923076923
SIMPSON,IL,24,33,9,0.5789473684210527
SIMPSON,LA,0,11,11,1
SIMPSON,NC,0,25,25,1
SIMPSON,PA,502,483,-19,0.4903553299492386
SIMPSONVILLE,KY,1754,2102,348,0.5451244813278008
SIMPSONVILLE,MD,12,0,-12,0
SIMPSONVILLE,SC,33848,40285,6437,0.5434152131979011
SIMS,AR,0,13,13,1
SIMS,IL,12,0,-12,0
SIMS,IN,47,42,-5,0.47191011235955055
SIMS,NC,466,637,171,0.5775158658204895
SIMSBORO,LA,587,529,-58,0.47401433691756273
SIMSBURY,CT,4893,5478,585,0.5282036447787098
SINCLAIR,ME,146,197,51,0.5743440233236151
SINCLAIR,WY,34,0,-34,0
SINCLAIRVILLE,NY,527,591,64,0.5286225402504472
SINGER,LA,235,210,-25,0.47191011235955055
SINGERS GLEN,VA,11,23,12,0.6764705882352942
SINKING SPG,PA,396,458,62,0.5362997658079626
SINKING SPRING,PA,3027,3325,298,0.5234571788413098
SINKS GROVE,WV,15,61,46,0.8026315789473685
SINTON,TX,2871,2713,-158,0.48585243553008595
SIOUX CENTER,IA,2282,2011,-271,0.46843699044956905
SIOUX CITY,IA,41590,36281,-5309,0.46591157170191727
SIOUX FALLS,SD,121319,108725,-12594,0.4726269757089948
SIOUX RAPIDS,IA,167,178,11,0.5159420289855072
SIPSEY,AL,0,12,12,1
SIREN,WI,1519,1247,-272,0.4508315256688359
SISSETON,SD,2106,1754,-352,0.4544041450777202
SISSONVILLE,WV,259,263,4,0.5038314176245211
SISTER BAY,WI,1946,1994,48,0.5060913705583756
SISTERDALE,TX,316,489,173,0.6074534161490683
SISTERS,OR,4739,5770,1031,0.5490531925016653
SISTERSVILLE,WV,924,910,-14,0.4961832061068702
SITKA,AK,5107,4037,-1070,0.4414916885389326
SITKA,KY,11,43,32,0.7962962962962963
SIX LAKES,MI,1123,992,-131,0.4690307328605201
SIX MILE,SC,1167,1484,317,0.5597887589588835
SIX MILE RUN,PA,12,12,0,0.5
SKAGWAY,AK,1076,375,-701,0.2584424534803584
SKAMOKAWA,WA,0,39,39,1
SKANDIA,MI,601,514,-87,0.4609865470852018
SKANEATELES,NY,4135,3912,-223,0.48614390456070583
SKANEE,MI,0,23,23,1
SKEDEE,OK,27,30,3,0.5263157894736842
SKELLYTOWN,TX,36,0,-36,0
SKIATOOK,OK,5808,5587,-221,0.4903027643703379
SKIDMORE,MO,18,35,17,0.660377358490566
SKIDMORE,TX,281,234,-47,0.45436893203883494
SKILLMAN,NJ,1938,2623,685,0.575093181319886
SKIPPACK,PA,157,80,-77,0.33755274261603374
SKIPPERVILLE,AL,45,118,73,0.7239263803680982
SKIPWITH,VA,12,26,14,0.6842105263157895
SKOKIE,IL,19335,18279,-1056,0.48596267347264316
SKOWHEGAN,ME,4437,4409,-28,0.49841736378023965
SKULL VALLEY,AZ,0,16,16,1
SKY VALLEY,GA,46,19,-27,0.2923076923076923
SKYFOREST,CA,35,47,12,0.573170731707317
SKYKOMISH,WA,13,0,-13,0
SKYLAND,NC,483,318,-165,0.3970037453183521
SLANA,AK,51,12,-39,0.19047619047619047
SLANESVILLE,WV,0,35,35,1
SLATE HILL,NY,532,471,-61,0.4695912263210369
SLATEDALE,PA,50,12,-38,0.1935483870967742
SLATER,IA,567,415,-152,0.4226069246435845
SLATER,MO,1109,924,-185,0.4545007378258731
SLATER,SC,22,0,-22,0
SLATERSVILLE,RI,1032,835,-197,0.44724156400642745
SLATERVILLE SPRINGS,NY,0,11,11,1
SLATINGTON,PA,3849,3944,95,0.5060952136532786
SLATON,TX,2436,2467,31,0.5031613297980828
SLATYFORK,WV,39,0,-39,0
SLAUGHTER,LA,756,785,29,0.509409474367294
SLAUGHTERS,KY,103,179,76,0.6347517730496454
SLAYTON,MN,1382,1085,-297,0.4398054316984191
SLC,UT,11586,9291,-2295,0.44503520620778847
SLEDGE,MS,36,0,-36,0
SLEEPY EYE,MN,1706,1597,-109,0.4834998486224644
SLEEPY HOLLOW,IL,543,525,-18,0.49157303370786515
SLEEPY HOLLOW,NY,2360,2208,-152,0.48336252189141854
SLICKVILLE,PA,37,15,-22,0.28846153846153844
SLIDELL,LA,32545,33221,676,0.505139433749962
SLIGO,PA,408,374,-34,0.4782608695652174
SLINGER,WI,3091,3305,214,0.516729205753596
SLINGERLANDS,NY,3057,3471,414,0.5317095588235294
SLIPPERY ROCK,PA,4920,3691,-1229,0.42863778887469517
SLOAN,IA,521,416,-105,0.4439701173959445
SLOAN,NY,365,323,-42,0.4694767441860465
SLOANSVILLE,NY,11,47,36,0.8103448275862069
SLOATSBURG,NY,1052,1219,167,0.5367679436371643
SLOCOMB,AL,3091,2867,-224,0.48120174555219875
SLOUGHHOUSE,CA,371,416,45,0.5285895806861499
SLOVAN,PA,54,0,-54,0
SMACKOVER,AR,789,686,-103,0.46508474576271186
SMALLWOOD,NY,764,527,-237,0.40821068938807126
SMARTSVILLE,CA,571,489,-82,0.46132075471698114
SMELTERVILLE,ID,110,217,107,0.6636085626911316
SMETHPORT,PA,1465,1441,-24,0.49587061252580866
SMICKSBURG,PA,213,117,-96,0.35454545454545455
SMILEY,TX,13,42,29,0.7636363636363637
SMITH,NV,0,11,11,1
SMITH CENTER,KS,860,865,5,0.5014492753623189
SMITH POINT,NY,309,366,57,0.5422222222222223
SMITH RIVER,CA,573,683,110,0.5437898089171974
SMITHBORO,IL,0,14,14,1
SMITHDALE,MS,211,169,-42,0.44473684210526315
SMITHERS,WV,0,11,11,1
SMITHFIELD,KY,793,923,130,0.5378787878787878
SMITHFIELD,ME,280,310,30,0.5254237288135594
SMITHFIELD,NC,7370,8233,863,0.5276549381529193
SMITHFIELD,OH,12,11,-1,0.4782608695652174
SMITHFIELD,PA,1972,1655,-317,0.45629997242900466
SMITHFIELD,RI,3512,4038,526,0.5348344370860927
SMITHFIELD,UT,4579,4819,240,0.512768674185997
SMITHFIELD,VA,4804,6161,1357,0.5618787049703602
SMITHFIELD,WV,27,12,-15,0.3076923076923077
SMITHLAND,KY,719,760,41,0.5138607167004733
SMITHMILL,PA,15,0,-15,0
SMITHS,AL,79,91,12,0.5352941176470588
SMITHS GROVE,KY,2628,2753,125,0.5116149414606951
SMITHS STA,AL,105,96,-9,0.47761194029850745
SMITHS STATION,AL,4074,4444,370,0.5217187133129843
SMITHSBURG,MD,1962,2210,248,0.5297219558964525
SMITHTON,IL,1085,1216,131,0.5284658843980878
SMITHTON,MO,261,234,-27,0.4727272727272727
SMITHTON,PA,372,315,-57,0.4585152838427948
SMITHTOWN,NY,9173,9362,189,0.5050984623684921
SMITHVILLE,AR,60,126,66,0.6774193548387096
SMITHVILLE,GA,67,89,22,0.5705128205128205
SMITHVILLE,MO,4548,5024,476,0.5248641872127037
SMITHVILLE,MS,529,586,57,0.525560538116592
SMITHVILLE,OH,947,806,-141,0.4597832287507131
SMITHVILLE,OK,62,27,-35,0.30337078651685395
SMITHVILLE,TN,6560,6388,-172,0.493358047574915
SMITHVILLE,TX,4680,4264,-416,0.47674418604651164
SMITHVILLE,WV,11,0,-11,0
SMITHVILLE FLATS,NY,48,37,-11,0.43529411764705883
SMOAKS,SC,98,86,-12,0.4673913043478261
SMOCK,PA,281,172,-109,0.37969094922737306
SMOKE RISE,GA,253,263,10,0.5096899224806202
SMOOT,WY,33,22,-11,0.4
SMYRNA,DE,8671,9581,910,0.5249287749287749
SMYRNA,GA,47431,44694,-2737,0.4851451831750339
SMYRNA,NY,168,111,-57,0.3978494623655914
SMYRNA,SC,11,108,97,0.907563025210084
SMYRNA,TN,26989,27759,770,0.5070322203550814
SMYRNA MILLS,ME,33,44,11,0.5714285714285714
SN BERNRDNO,CA,800,632,-168,0.441340782122905
SN LUIS OBISP,CA,50,57,7,0.5327102803738317
SNEADS,FL,1214,1290,76,0.5151757188498403
SNEADS FERRY,NC,7837,8324,487,0.5150671369345956
SNEEDVILLE,TN,1591,1674,83,0.5127105666156202
SNELLING,CA,65,75,10,0.5357142857142857
SNELLVILLE,GA,32757,32361,-396,0.4969593660738966
SNOHOMISH,WA,19803,21749,1946,0.5234164420485176
SNOOK,TX,139,121,-18,0.4653846153846154
SNOQUALMIE,WA,5336,5541,205,0.5094235542888664
SNOVER,MI,373,248,-125,0.3993558776167472
SNOW CAMP,NC,1517,1666,149,0.5234055922086083
SNOW HILL,MD,1666,1449,-217,0.4651685393258427
SNOW HILL,NC,2230,2321,91,0.5099978026807295
SNOW SHOE,PA,28,68,40,0.7083333333333334
SNOWFLAKE,AZ,3564,3759,195,0.5133142154854567
SNOWMASS,CO,575,532,-43,0.48057813911472447
SNOWMASS VILLAGE,CO,1375,1453,78,0.5137906647807637
SNOWMASS VLG,CO,37,35,-2,0.4861111111111111
SNOWSHOE,WV,45,0,-45,0
SNYDER,OK,425,310,-115,0.4217687074829932
SNYDER,TX,5564,4588,-976,0.4519306540583136
SNYDERVILLE,UT,328,379,51,0.536067892503536
SO GRAFTON,MA,36,31,-5,0.4626865671641791
SO PLYMOUTH,NY,0,11,11,1
SOAP LAKE,WA,1647,1504,-143,0.4773087908600444
SOBIESKI,WI,743,988,245,0.5707683419988446
SOCIAL CIRCLE,GA,2877,3401,524,0.5417330359987257
SOCIETY HILL,SC,237,182,-55,0.4343675417661098
SOCORRO,NM,4113,3239,-874,0.44056039173014144
SOCORRO,TX,3123,3630,507,0.5375388716126166
SOD,WV,74,50,-24,0.4032258064516129
SODA SPRINGS,CA,38,185,147,0.8295964125560538
SODA SPRINGS,ID,2296,1769,-527,0.4351783517835178
SODDY DAISY,TN,8445,9563,1118,0.5310417592181252
SODUS,MI,216,133,-83,0.38108882521489973
SODUS,NY,2103,2068,-35,0.4958043634619995
SODUS POINT,NY,687,579,-108,0.45734597156398105
SOLANA BEACH,CA,7721,7890,169,0.5054128499135225
SOLDIER,IA,0,14,14,1
SOLDIER GROVE,WI,11,16,5,0.5925925925925926
SOLDIERS GROVE,WI,499,417,-82,0.45524017467248906
SOLDOTNA,AK,7423,7203,-220,0.49247914672501025
SOLEBURY,PA,36,0,-36,0
SOLEDAD,CA,2678,2646,-32,0.49699474079639366
SOLGOHACHIA,AR,0,17,17,1
SOLOMON,KS,328,289,-39,0.4683954619124797
SOLOMONS,MD,1699,2038,339,0.5453572384265454
SOLON,IA,2192,2268,76,0.5085201793721973
SOLON,ME,285,282,-3,0.4973544973544973
SOLON,OH,6975,7844,869,0.5293204669680815
SOLON SPRINGS,WI,1466,1332,-134,0.4760543245175125
SOLSBERRY,IN,1103,1046,-57,0.4867380176826431
SOLVANG,CA,2718,2989,271,0.5237427720343438
SOLVAY,NY,633,659,26,0.510061919504644
SOLWAY,MN,74,111,37,0.6
SOMERDALE,NJ,3188,2844,-344,0.47148541114058357
SOMERDALE,OH,147,133,-14,0.475
SOMERS,CT,2466,2788,322,0.5306433193757137
SOMERS,MT,1066,1061,-5,0.4988246356370475
SOMERS,NY,3119,3476,357,0.5270659590598938
SOMERS POINT,NJ,5208,4815,-393,0.48039509129003294
SOMERSET,CA,1225,1242,17,0.5034454803404945
SOMERSET,KY,16836,17180,344,0.5050564440263405
SOMERSET,MA,4571,4901,330,0.5174197635135135
SOMERSET,NJ,20725,19610,-1115,0.48617825709681417
SOMERSET,OH,1321,1324,3,0.5005671077504726
SOMERSET,PA,5485,5657,172,0.5077185424519834
SOMERSET,TX,1145,1360,215,0.5429141716566867
SOMERSET,WI,2958,3075,117,0.5096966683242168
SOMERSET CENTER,MI,76,85,9,0.5279503105590062
SOMERSWORTH,NH,6864,6054,-810,0.46864839758476545
SOMERTON,AZ,2022,1839,-183,0.4763014763014763
SOMERVILLE,AL,2122,2268,146,0.516628701594533
SOMERVILLE,MA,56740,41170,-15570,0.42048820345214993
SOMERVILLE,ME,112,150,38,0.5725190839694656
SOMERVILLE,NJ,5853,5923,70,0.5029721467391305
SOMERVILLE,OH,483,537,54,0.5264705882352941
SOMERVILLE,TN,2620,2971,351,0.5313897335002683
SOMERVILLE,TX,1361,1825,464,0.5728185812931575
SOMIS,CA,784,1024,240,0.5663716814159292
SOMONAUK,IL,1929,1504,-425,0.43810078648412465
SONOITA,AZ,743,806,63,0.5203357004519045
SONOMA,CA,11003,11469,466,0.5103684585261659
SONORA,CA,11203,10577,-626,0.4856290174471993
SONORA,KY,866,816,-50,0.48513674197384066
SONORA,TX,870,799,-71,0.4787297783103655
SONTAG,MS,13,23,10,0.6388888888888888
SOPCHOPPY,FL,602,852,250,0.5859697386519945
SOPER,OK,22,51,29,0.6986301369863014
SOPERTON,GA,1758,1674,-84,0.48776223776223776
SOPHIA,NC,1351,1608,257,0.5434268333896587
SOPHIA,WV,414,413,-1,0.49939540507859737
SOQUEL,CA,3937,3675,-262,0.482790331056227
SOQURL DR,CA,93,68,-25,0.422360248447205
SORENTO,IL,141,88,-53,0.38427947598253276
SORRENTO,FL,4707,5836,1129,0.553542634923646
SORRENTO,LA,919,713,-206,0.4368872549019608
SORRENTO,ME,229,294,65,0.5621414913957935
SOSO,MS,270,315,45,0.5384615384615384
SOUDAN,MN,24,0,-24,0
SOUDERTON,PA,4060,3902,-158,0.4900778698819392
SOULSBYVILLE,CA,870,938,68,0.5188053097345132
SOUND BEACH,NY,2456,2362,-94,0.49024491490244915
SOUR LAKE,TX,1546,1715,169,0.5259122968414597
SOUTH ABINGTON TOWNSHIP,PA,1745,1760,15,0.5021398002853067
SOUTH ACWORTH,NH,80,14,-66,0.14893617021276595
SOUTH AMBOY,NJ,6739,6468,-271,0.48974028924055424
SOUTH AMHERST,OH,127,124,-3,0.4940239043824701
SOUTH BARRE,MA,118,37,-81,0.23870967741935484
SOUTH BARRE,VT,24,14,-10,0.3684210526315789
SOUTH BAY,FL,955,989,34,0.5087448559670782
SOUTH BEACH,OR,1706,1192,-514,0.4113181504485852
SOUTH BELOIT,IL,4593,3669,-924,0.444081336238199
SOUTH BEND,IN,75228,58699,-16529,0.4382910092811756
SOUTH BEND,WA,1110,780,-330,0.4126984126984127
SOUTH BERWICK,ME,2244,2384,140,0.5151253241140882
SOUTH BLOOMFIELD,OH,91,100,9,0.5235602094240838
SOUTH BLOOMINGVILLE,OH,135,13,-122,0.08783783783783784
SOUTH BOARDMAN,MI,730,761,31,0.5103957075788061
SOUTH BOSTON,MA,26090,16833,-9257,0.3921673694755725
SOUTH BOSTON,VA,4580,3920,-660,0.4611764705882353
SOUTH BOUND BROOK,NJ,2092,1502,-590,0.41791875347801893
SOUTH BRANCH,MI,434,371,-63,0.4608695652173913
SOUTH BRISTOL,ME,853,706,-147,0.45285439384220655
SOUTH BURLINGTON,VT,12128,10886,-1242,0.4730164247849135
SOUTH CAIRO,NY,49,65,16,0.5701754385964912
SOUTH CARVER,MA,25,13,-12,0.34210526315789475
SOUTH CASCO,ME,154,216,62,0.5837837837837838
SOUTH CHARLESTON,OH,1275,1345,70,0.5133587786259542
SOUTH CHARLESTON,WV,5344,5094,-250,0.4880245257712205
SOUTH CHATHAM,MA,811,935,124,0.5355097365406644
SOUTH CHESTERFIELD,VA,7164,6685,-479,0.4827063325871904
SOUTH CHINA,ME,1168,1324,156,0.5313001605136437
SOUTH CLE ELUM,WA,140,164,24,0.5394736842105263
SOUTH COFFEYVILLE,OK,0,11,11,1
SOUTH COLBY,WA,114,114,0,0.5
SOUTH COLTON,NY,113,114,1,0.5022026431718062
SOUTH DARTMOUTH,MA,2747,3264,517,0.5430044917650974
SOUTH DAYTON,NY,600,402,-198,0.40119760479041916
SOUTH DAYTONA,FL,13639,12859,-780,0.4852819080685335
SOUTH DEERFIELD,MA,1317,1470,153,0.527448869752422
SOUTH DENNIS,MA,3771,3696,-75,0.49497790277219766
SOUTH DUXBURY,VT,143,157,14,0.5233333333333333
SOUTH EASTON,MA,4078,3813,-265,0.4832087187935623
SOUTH EGREMONT,MA,199,433,234,0.685126582278481
SOUTH EL MONTE,CA,3034,2654,-380,0.46659634317862164
SOUTH ELGIN,IL,7452,7479,27,0.5009041591320073
SOUTH ENGLISH,IA,44,12,-32,0.21428571428571427
SOUTH EUCLID,OH,3661,3381,-280,0.4801192842942346
SOUTH FALLSBURG,NY,557,389,-168,0.41120507399577166
SOUTH FLORAL PARK,NY,132,135,3,0.5056179775280899
SOUTH FORK,CO,1561,1991,430,0.5605292792792793
SOUTH FORK,PA,518,500,-18,0.4911591355599214
SOUTH FREEPORT,ME,38,74,36,0.6607142857142857
SOUTH FULTON,GA,23,34,11,0.5964912280701754
SOUTH FULTON,TN,1773,1558,-215,0.4677274091864305
SOUTH GARDINER,ME,36,0,-36,0
SOUTH GATE,CA,14870,12746,-2124,0.46154403244495945
SOUTH GLASTONBURY,CT,1325,1647,322,0.5541722745625841
SOUTH GLENS FALLS,NY,3069,3279,210,0.5165406427221172
SOUTH GRAFTON,MA,1625,1552,-73,0.488511174063582
SOUTH GREENFIELD,MO,0,23,23,1
SOUTH HACKENSACK,NJ,797,845,48,0.5146163215590743
SOUTH HADLEY,MA,5964,5890,-74,0.49687869073730384
SOUTH HAMILTON,MA,1672,1867,195,0.527550155411133
SOUTH HAMPTON,NH,349,345,-4,0.49711815561959655
SOUTH HARWICH,MA,24,85,61,0.7798165137614679
SOUTH HAVEN,KS,56,37,-19,0.3978494623655914
SOUTH HAVEN,MI,7292,6430,-862,0.4685905844629063
SOUTH HAVEN,MN,1415,1281,-134,0.47514836795252224
SOUTH HEART,ND,46,76,30,0.6229508196721312
SOUTH HEIGHTS,PA,13,0,-13,0
SOUTH HEMPSTEAD,NY,1576,1182,-394,0.42857142857142855
SOUTH HERO,VT,1373,1407,34,0.5061151079136691
SOUTH HILL,VA,3041,2754,-287,0.47523727351164796
SOUTH HILL,WA,584,689,105,0.5412411626080126
SOUTH HILLS,PA,288,231,-57,0.44508670520231214
SOUTH HOLLAND,IL,6349,7188,839,0.5309891408731624
SOUTH HOUSTON,TX,4167,3170,-997,0.43205669892326565
SOUTH HUTCHINSON,KS,1660,1213,-447,0.4222067525234946
SOUTH JACKSONVILLE,IL,3526,3416,-110,0.49207721117833475
SOUTH JAMESPORT,NY,56,63,7,0.5294117647058824
SOUTH JORDAN,UT,28147,31617,3470,0.5290308546951342
SOUTH KENT,CT,73,195,122,0.7276119402985075
SOUTH KINGSTOWN,RI,984,1070,86,0.5209347614410905
SOUTH KORTRIGHT,NY,22,25,3,0.5319148936170213
SOUTH LAKE,TX,1050,1394,344,0.5703764320785597
SOUTH LAKE TAHOE,CA,13203,12705,-498,0.49038906901343216
SOUTH LANCASTER,MA,70,22,-48,0.2391304347826087
SOUTH LEBANON,OH,2629,3114,485,0.5422253177781647
SOUTH LONDONDERRY,VT,230,289,59,0.5568400770712909
SOUTH LYME,CT,172,230,58,0.572139303482587
SOUTH LYON,MI,10082,11339,1257,0.5293403669296485
SOUTH MIAMI,FL,5808,5793,-15,0.49935350400827516
SOUTH MILLS,NC,1016,1252,236,0.5520282186948854
SOUTH MILWAUKEE,WI,8270,7437,-833,0.4734831603743554
SOUTH NEW BERLIN,NY,495,492,-3,0.49848024316109424
SOUTH NEWFANE,VT,24,13,-11,0.35135135135135137
SOUTH NORFOLK,VA,208,208,0,0.5
SOUTH OGDEN,UT,349,275,-74,0.4407051282051282
SOUTH ORANGE,NJ,5509,5802,293,0.512951993634515
SOUTH ORLEANS,MA,424,277,-147,0.39514978601997147
SOUTH OTSELIC,NY,39,11,-28,0.22
SOUTH OZONE PARK,NY,8356,7025,-1331,0.45673233209804304
SOUTH PADRE ISLAND,TX,2285,6697,4412,0.7456023157425963
SOUTH PARIS,ME,2143,2158,15,0.5017437805161591
SOUTH PARK,PA,3645,3710,65,0.504418762746431
SOUTH PASADENA,CA,8769,7907,-862,0.4741544734948429
SOUTH PASADENA,FL,3822,3928,106,0.5068387096774194
SOUTH PEKIN,IL,364,142,-222,0.28063241106719367
SOUTH PITTSBURG,TN,2513,2322,-191,0.48024819027921406
SOUTH PLAINFIELD,NJ,5336,5322,-14,0.49934321636329515
SOUTH PLYMOUTH,NY,40,36,-4,0.47368421052631576
SOUTH POINT,OH,4253,4020,-233,0.48591804665780247
SOUTH POMFRET,VT,26,12,-14,0.3157894736842105
SOUTH PORTLAND,ME,13079,12809,-270,0.4947852286773795
SOUTH PORTSMOUTH,KY,45,49,4,0.5212765957446809
SOUTH PRAIRIE,WA,700,310,-390,0.3069306930693069
SOUTH PRINCE GEORGE,VA,631,582,-49,0.47980214344600164
SOUTH RANGE,MI,37,36,-1,0.4931506849315068
SOUTH RANGE,WI,1136,921,-215,0.447739426349052
SOUTH READING,VT,12,0,-12,0
SOUTH RICHMOND HILL,NY,8384,5800,-2584,0.40891144952058656
SOUTH RIDING,VA,1215,1439,224,0.5422004521477016
SOUTH RIM,UT,13,30,17,0.6976744186046512
SOUTH RIVER,NJ,4619,3966,-653,0.4619685497961561
SOUTH ROCKWOOD,MI,915,755,-160,0.45209580838323354
SOUTH ROXANA,IL,1010,718,-292,0.41550925925925924
SOUTH ROYALTON,VT,1528,1295,-233,0.4587318455543748
SOUTH RYEGATE,VT,0,11,11,1
SOUTH SAINT PAUL,MN,9741,8281,-1460,0.4594939518366441
SOUTH SALEM,NY,1608,1982,374,0.5520891364902507
SOUTH SALEM,OH,162,233,71,0.589873417721519
SOUTH SALT LAKE,UT,14782,9768,-5014,0.39788187372708755
SOUTH SAN FRANCISCO,CA,19838,17456,-2382,0.46806456802702845
SOUTH SEAVILLE,NJ,77,119,42,0.6071428571428571
SOUTH SETAUKET,NY,1715,1441,-274,0.45659062103929027
SOUTH SHORE,KY,1728,1680,-48,0.49295774647887325
SOUTH SIOUX CITY,NE,6484,4882,-1602,0.42952665845504134
SOUTH SOLON,OH,100,38,-62,0.2753623188405797
SOUTH STERLING,PA,12,0,-12,0
SOUTH SUTTON,NH,0,31,31,1
SOUTH TEXARKANA,TX,288,299,11,0.5093696763202725
SOUTH THOMASTON,ME,597,662,65,0.5258141382049245
SOUTH VIENNA,OH,1088,1021,-67,0.48411569464201043
SOUTH VINEMONT,AL,120,130,10,0.52
SOUTH WALES,NY,453,407,-46,0.47325581395348837
SOUTH WALPOLE,MA,38,11,-27,0.22448979591836735
SOUTH WALTHAM,MA,1059,828,-231,0.43879173290937995
SOUTH WAYNE,WI,162,90,-72,0.35714285714285715
SOUTH WEBSTER,OH,477,391,-86,0.4504608294930876
SOUTH WELLFLEET,MA,291,266,-25,0.47755834829443444
SOUTH WEST,ME,0,36,36,1
SOUTH WEST CITY,MO,149,97,-52,0.3943089430894309
SOUTH WEYMOUTH,MA,6144,6224,80,0.5032341526520052
SOUTH WHITLEY,IN,1365,1226,-139,0.4731763797761482
SOUTH WILLIAMSON,KY,11,0,-11,0
SOUTH WILLIAMSPORT,PA,165,156,-9,0.48598130841121495
SOUTH WILMINGTON,IL,35,0,-35,0
SOUTH WINDHAM,CT,0,47,47,1
SOUTH WINDSOR,CT,8855,9213,358,0.5099070179322559
SOUTH WOODSTOCK,VT,35,36,1,0.5070422535211268
SOUTH YARMOUTH,MA,4879,4822,-57,0.4970621585403567
SOUTH ZANESVILLE,OH,24,31,7,0.5636363636363636
SOUTHAMPTON,MA,1624,1772,148,0.5217903415783275
SOUTHAMPTON,NJ,4140,4333,193,0.511389118376018
SOUTHAMPTON,NY,8163,8858,695,0.5204159567592973
SOUTHAMPTON,PA,6017,6155,138,0.5056687479461058
SOUTHAVEN,MS,22080,22349,269,0.5030273019874406
SOUTHBOROUGH,MA,2991,3410,419,0.5327292610529605
SOUTHBRIDGE,MA,10959,9119,-1840,0.4541787030580735
SOUTHBURY,CT,7016,7698,682,0.5231752072855783
SOUTHEASTERN,PA,45,186,141,0.8051948051948052
SOUTHERN PINES,NC,9462,9291,-171,0.49544072948328266
SOUTHERN PNES,NC,196,213,17,0.5207823960880196
SOUTHERN SHORES,NC,87,102,15,0.5396825396825397
SOUTHFIELD,MA,52,182,130,0.7777777777777778
SOUTHFIELD,MI,35013,32787,-2226,0.48358407079646015
SOUTHFIELDS,NY,40,14,-26,0.25925925925925924
SOUTHGATE,KY,2130,1723,-407,0.4471840124578251
SOUTHGATE,MI,14286,11222,-3064,0.43994041085149754
SOUTHINGTON,CT,9540,10334,794,0.5199758478414008
SOUTHINGTON,OH,959,980,21,0.5054151624548736
SOUTHLAKE,TX,7161,9206,2045,0.5624732693835156
SOUTHMONT,NC,11,11,0,0.5
SOUTHOLD,NY,2604,2881,277,0.5252506836827712
SOUTHPORT,CT,1611,1902,291,0.5414175918018788
SOUTHPORT,FL,868,1093,225,0.5573686894441612
SOUTHPORT,ME,734,639,-95,0.4654042243262928
SOUTHPORT,NC,9748,13036,3288,0.5721558988764045
SOUTHSIDE,AL,959,1114,155,0.5373854317414375
SOUTHSIDE,AR,2790,2460,-330,0.4685714285714286
SOUTHSIDE,TN,109,276,167,0.7168831168831169
SOUTHWEST HARBOR,ME,1823,1512,-311,0.4533733133433283
SOUTHWEST HBR,ME,371,167,-204,0.3104089219330855
SOUTHWEST RANCHES,FL,1808,2024,216,0.5281837160751566
SOUTHWICK,MA,3244,3283,39,0.5029875900107247
SOUTHWORTH,WA,0,11,11,1
SPALDING,MI,11,0,-11,0
SPALDING,NE,11,0,-11,0
SPANAWAY,WA,22097,20519,-1578,0.48148582691946684
SPANGLE,WA,189,270,81,0.5882352941176471
SPANISH FORK,UT,11903,12484,581,0.5119120843072129
SPANISH FORT,AL,5267,5645,378,0.5173203812316716
SPANISH SPGS,NV,843,1189,346,0.5851377952755905
SPANISH SPRINGS,NV,1593,1955,362,0.5510146561443067
SPANISHBURG,WV,11,0,-11,0
SPARKILL,NY,234,306,72,0.5666666666666667
SPARKMAN,AR,95,124,29,0.5662100456621004
SPARKS,GA,1654,1448,-206,0.46679561573178596
SPARKS,MD,248,288,40,0.5373134328358209
SPARKS,NV,58870,58352,-518,0.4977905171384211
SPARKS,OK,0,40,40,1
SPARKS GLENCO,MD,39,42,3,0.5185185185185185
SPARKS GLENCOE,MD,1812,1789,-23,0.4968064426548181
SPARLAND,IL,105,127,22,0.5474137931034483
SPARR,FL,28,14,-14,0.3333333333333333
SPARROW BUSH,NY,801,525,-276,0.39592760180995473
SPARROWBUSH,NY,159,102,-57,0.39080459770114945
SPARROWS POINT,MD,1892,2039,147,0.518697532434495
SPARTA,GA,1427,1800,373,0.5577936163619461
SPARTA,IL,2625,2152,-473,0.45049194054846137
SPARTA,KY,624,519,-105,0.4540682414698163
SPARTA,MI,4552,4360,-192,0.48922800718132853
SPARTA,MO,1806,1902,96,0.5129449838187702
SPARTA,NC,2323,2453,130,0.5136097152428811
SPARTA,NJ,6075,6975,900,0.5344827586206896
SPARTA,TN,9163,9799,636,0.5167703828710052
SPARTA,WI,7234,6862,-372,0.48680476730987515
SPARTANBURG,SC,49333,44949,-4384,0.4767505992660317
SPARTANSBURG,PA,693,533,-160,0.43474714518760194
SPAULDING,IL,303,257,-46,0.4589285714285714
SPAVINAW,OK,207,206,-1,0.49878934624697335
SPEARFISH,SD,9807,9106,-701,0.48146777348913444
SPEARMAN,TX,848,612,-236,0.4191780821917808
SPEARSVILLE,LA,333,169,-164,0.33665338645418325
SPEARVILLE,KS,110,141,31,0.5617529880478087
SPECULATOR,NY,398,302,-96,0.43142857142857144
SPEEDWAY,IN,916,834,-82,0.4765714285714286
SPEEDWELL,TN,1360,1214,-146,0.4716394716394716
SPEEDWELL,VA,74,145,71,0.6621004566210046
SPENCER,IA,6765,6152,-613,0.47627158008825576
SPENCER,IN,4116,3883,-233,0.4854356794599325
SPENCER,MA,4887,4899,12,0.5006131207847946
SPENCER,NC,1217,1267,50,0.5100644122383253
SPENCER,NY,1497,1359,-138,0.47584033613445376
SPENCER,OH,709,736,27,0.5093425605536333
SPENCER,OK,2259,2167,-92,0.4896068685042928
SPENCER,TN,1602,1665,63,0.509641873278237
SPENCER,VA,222,237,15,0.5163398692810458
SPENCER,WI,1198,951,-247,0.44253140995812007
SPENCER,WV,2953,2933,-20,0.4983010533469249
SPENCERPORT,NY,6234,5734,-500,0.47911096256684493
SPENCERTOWN,NY,15,150,135,0.9090909090909091
SPENCERVILLE,IN,663,512,-151,0.4357446808510638
SPENCERVILLE,MD,36,77,41,0.6814159292035398
SPENCERVILLE,OH,1535,1294,-241,0.4574054436196536
SPEONK,NY,93,176,83,0.654275092936803
SPERRY,IA,38,12,-26,0.24
SPERRY,OK,1723,1746,23,0.5033150763908908
SPERRYVILLE,VA,293,293,0,0.5
SPFLD,MA,0,16,16,1
SPICELAND,IN,400,271,-129,0.4038748137108793
SPICER,MN,2612,2344,-268,0.47296206618240516
SPICEWOOD,TX,5091,5945,854,0.5386915549111997
SPICKARD,MO,35,65,30,0.65
SPILLVILLE,IA,0,11,11,1
SPINDALE,NC,1641,1648,7,0.5010641532380663
SPIRIT LAKE,IA,6320,5429,-891,0.46208187930887734
SPIRIT LAKE,ID,2884,2770,-114,0.4899186416696144
SPIRO,OK,2332,2598,266,0.5269776876267749
SPLENDORA,TX,3880,4257,377,0.5231657859161853
SPOFFORD,NH,769,715,-54,0.48180592991913745
SPOKANE,MO,60,122,62,0.6703296703296703
SPOKANE,WA,161926,151959,-9967,0.48412316612772194
SPOKANE VALLEY,WA,27969,28084,115,0.501025814853799
SPOKANE VLY,WA,7197,6671,-526,0.48103547735794633
SPOONER,WI,3713,3513,-200,0.4861610849709383
SPOTSWOOD,NJ,2050,2062,12,0.5014591439688716
SPOTSYLVANIA,VA,11707,13894,2187,0.5427131752665911
SPOTTSVILLE,KY,12,22,10,0.6470588235294118
SPOUT SPRING,VA,402,352,-50,0.46684350132625996
SPRAGGS,PA,34,26,-8,0.43333333333333335
SPRAGUE,NE,12,0,-12,0
SPRAGUE,WA,182,115,-67,0.3872053872053872
SPRAGUE RIVER,OR,13,33,20,0.717391304347826
SPRAKERS,NY,344,240,-104,0.410958904109589
SPRAY,OR,11,15,4,0.5769230769230769
SPRECKELS,CA,25,29,4,0.5370370370370371
SPRFD,MO,170,176,6,0.5086705202312138
SPRING,TX,134158,145606,11448,0.520460102086044
SPRING ARBOR,MI,1408,1212,-196,0.46259541984732827
SPRING BRANCH,TX,6379,9197,2818,0.5904596815613765
SPRING BROOK TOWNSHIP,PA,482,425,-57,0.4685777287761852
SPRING CHURCH,PA,13,24,11,0.6486486486486487
SPRING CITY,PA,3299,3387,88,0.5065809153454981
SPRING CITY,TN,3472,3958,486,0.5327052489905787
SPRING CITY,UT,44,165,121,0.7894736842105263
SPRING CREEK,NV,6380,5725,-655,0.4729450640231309
SPRING CREEK,PA,13,0,-13,0
SPRING GREEN,WI,1494,1525,31,0.5051341503809208
SPRING GROVE,IL,3065,3080,15,0.5012205044751831
SPRING GROVE,MN,908,562,-346,0.38231292517006804
SPRING GROVE,PA,4181,3891,-290,0.4820366699702676
SPRING GROVE,VA,183,292,109,0.6147368421052631
SPRING HILL,FL,65722,71667,5945,0.5216356476864961
SPRING HILL,KS,3619,4678,1059,0.5638182475593588
SPRING HILL,TN,19541,24828,5287,0.5595798868579414
SPRING HOPE,NC,1727,1934,207,0.5282709642174269
SPRING HOUSE,PA,40,39,-1,0.4936708860759494
SPRING LAKE,MI,7606,7154,-452,0.48468834688346885
SPRING LAKE,NC,15234,13166,-2068,0.4635915492957747
SPRING LAKE,NJ,4568,4985,417,0.5218256045221397
SPRING LAKE PARK,MN,1064,883,-181,0.4535182331792501
SPRING LK PK,MN,1729,1459,-270,0.45765370138017564
SPRING MILLS,PA,888,959,71,0.5192203573362209
SPRING PARK,MN,1538,1401,-137,0.4766927526369513
SPRING RUN,PA,45,27,-18,0.375
SPRING VALLEY,CA,25146,22978,-2168,0.4774748566203973
SPRING VALLEY,IL,2204,1836,-368,0.45445544554455447
SPRING VALLEY,MN,1454,1408,-46,0.4919636617749825
SPRING VALLEY,NY,11417,8638,-2779,0.4307155322862129
SPRING VALLEY,OH,432,503,71,0.5379679144385027
SPRING VALLEY,WI,1025,962,-63,0.4841469552088576
SPRINGBORO,OH,7272,8177,905,0.5292899216777786
SPRINGBORO,PA,552,506,-46,0.4782608695652174
SPRINGBROOK,WI,265,284,19,0.517304189435337
SPRINGDALE,AR,31956,31269,-687,0.4945670225385528
SPRINGDALE,MD,785,815,30,0.509375
SPRINGDALE,OH,121,129,8,0.516
SPRINGDALE,PA,1179,1144,-35,0.49246663796814466
SPRINGDALE,UT,743,324,-419,0.3036551077788191
SPRINGDALE,WA,674,707,33,0.5119478638667632
SPRINGER,NM,45,56,11,0.5544554455445545
SPRINGER,OK,47,25,-22,0.3472222222222222
SPRINGERVILLE,AZ,1530,1253,-277,0.45023356090549765
SPRINGFIELD,AR,260,284,24,0.5220588235294118
SPRINGFIELD,CO,1354,921,-433,0.40483516483516485
SPRINGFIELD,GA,2945,3480,535,0.5416342412451361
SPRINGFIELD,IL,73114,65715,-7399,0.47335210942958605
SPRINGFIELD,KY,3316,3092,-224,0.48252184769038703
SPRINGFIELD,LA,1748,2097,349,0.5453836150845254
SPRINGFIELD,MA,66609,60196,-6413,0.4747131422262529
SPRINGFIELD,ME,136,228,92,0.6263736263736264
SPRINGFIELD,MI,3701,2909,-792,0.4400907715582451
SPRINGFIELD,MN,1318,1007,-311,0.43311827956989246
SPRINGFIELD,MO,150289,120788,-29501,0.4455855716272498
SPRINGFIELD,NE,773,960,187,0.5539526832083093
SPRINGFIELD,NH,11,91,80,0.8921568627450981
SPRINGFIELD,NJ,5926,5940,14,0.5005899207820664
SPRINGFIELD,OH,34561,32731,-1830,0.48640254413600426
SPRINGFIELD,OR,38931,34842,-4089,0.47228660892196334
SPRINGFIELD,PA,4370,4645,275,0.5152523571824736
SPRINGFIELD,SC,189,148,-41,0.4391691394658754
SPRINGFIELD,SD,174,281,107,0.6175824175824176
SPRINGFIELD,TN,10352,10755,403,0.5095465959160468
SPRINGFIELD,VA,34123,33203,-920,0.49316757270593825
SPRINGFIELD,VT,3985,3947,-38,0.49760463943519917
SPRINGFIELD,WV,295,233,-62,0.4412878787878788
SPRINGFIELD CENTER,NY,46,101,55,0.6870748299319728
SPRINGFIELD GARDENS,NY,4962,4352,-610,0.4672535967360962
SPRINGFIELD TOWNSHIP,MI,134,144,10,0.5179856115107914
SPRINGFLD TWP,MI,41,47,6,0.5340909090909091
SPRINGHILL,LA,3004,2515,-489,0.45569849610436675
SPRINGPORT,IN,194,160,-34,0.4519774011299435
SPRINGPORT,MI,1248,1154,-94,0.48043297252289757
SPRINGTOWN,TX,7759,10496,2737,0.574965762804711
SPRINGVALE,ME,1981,1973,-8,0.49898836621143144
SPRINGVILLE,AL,2854,3770,916,0.5691425120772947
SPRINGVILLE,CA,1229,1496,267,0.5489908256880734
SPRINGVILLE,IA,671,613,-58,0.47741433021806856
SPRINGVILLE,IN,1393,1449,56,0.5098522167487685
SPRINGVILLE,NY,2568,2653,85,0.5081402030262402
SPRINGVILLE,PA,267,166,-101,0.3833718244803695
SPRINGVILLE,TN,1536,1537,1,0.5001627074520013
SPRINGVILLE,UT,12819,11213,-1606,0.46658621837549935
SPRINGWATER,NY,678,707,29,0.5104693140794224
SPRNG BRK TWP,PA,66,72,6,0.5217391304347826
SPRNGFLD GDNS,NY,402,346,-56,0.4625668449197861
SPRUCE,MI,479,458,-21,0.4887940234791889
SPRUCE HEAD,ME,270,314,44,0.5376712328767124
SPRUCE PINE,AL,193,123,-70,0.38924050632911394
SPRUCE PINE,NC,3109,2882,-227,0.4810549157068937
SPUR,TX,259,371,112,0.5888888888888889
SPURGER,TX,103,213,110,0.6740506329113924
SQUAW VALLEY,CA,1030,1133,103,0.5238095238095238
SQUIRREL HILL,PA,434,339,-95,0.4385510996119017
ST ALBANS BAY,VT,11,37,26,0.7708333333333334
ST AMANT,LA,63,65,2,0.5078125
ST ANTHNY VLG,MN,310,252,-58,0.4483985765124555
ST AUG,FL,24,27,3,0.5294117647058824
ST AUGUSTINE,FL,12709,14961,2252,0.5406938923021323
ST AUGUSTINE BEACH,FL,354,402,48,0.5317460317460317
ST BONAS,NY,12,0,-12,0
ST BONIFACIUS,MN,207,177,-30,0.4609375
ST CHARLES,IL,1839,1969,130,0.5170693277310925
ST CLAIR SHORES,MI,197,193,-4,0.4948717948717949
ST CLAIR SHRS,MI,925,814,-111,0.46808510638297873
ST CLAIRSVILLE,OH,41,38,-3,0.4810126582278481
ST CLAIRSVLE,OH,215,165,-50,0.4342105263157895
ST CLOUD,FL,294,630,336,0.6818181818181818
ST CLOUD,MN,463,388,-75,0.45593419506462984
ST CLR SHORES,MI,240,269,29,0.5284872298624754
ST CROIX FALLS,WI,46,50,4,0.5208333333333334
ST CROIX FLS,WI,326,321,-5,0.49613601236476046
ST DAVID,AZ,34,31,-3,0.47692307692307695
ST FRANCIS,WI,752,712,-40,0.48633879781420764
ST FRANCISVLE,LA,37,34,-3,0.4788732394366197
ST GEORGE,UT,6814,7604,790,0.5273963101678457
ST GEORGE,VT,294,316,22,0.5180327868852459
ST GEORGE ISL,FL,72,198,126,0.7333333333333333
ST HELENA IS,SC,81,110,29,0.5759162303664922
ST IGNATIUS,MT,71,90,19,0.5590062111801242
ST JAMES CITY,FL,459,885,426,0.6584821428571429
ST JOHN,KS,503,420,-83,0.4550379198266522
ST JOHNS,FL,1450,2393,943,0.6226906062971637
ST JOHNSBURY,VT,696,637,-59,0.4778694673668417
ST JOHNSVILLE,NY,87,66,-21,0.43137254901960786
ST JOSEPH,MO,487,374,-113,0.4343786295005807
ST LOUIS,MI,56,55,-1,0.4954954954954955
ST LOUIS,MO,1465,1383,-82,0.48560393258426965
ST LOUIS PARK,MN,5269,4425,-844,0.45646791829997935
ST LOUISVILLE,OH,19,60,41,0.759493670886076
ST MARIES,ID,166,137,-29,0.4521452145214521
ST MARTINVLLE,LA,244,245,1,0.5010224948875256
ST MARYS,GA,259,227,-32,0.4670781893004115
ST MATTHEWS,SC,315,391,76,0.5538243626062322
ST MICHAELS,MD,240,252,12,0.5121951219512195
ST MOUNTAIN,GA,192,180,-12,0.4838709677419355
ST PAUL,MN,40,50,10,0.5555555555555556
ST PAUL,VA,13,15,2,0.5357142857142857
ST PAUL PARK,MN,314,290,-24,0.48013245033112584
ST PETE,FL,937,1106,169,0.5413607440039158
ST PETE BEACH,FL,2039,2678,639,0.5677337290650838
ST PETERSBURG,FL,13643,12884,-759,0.48569382138952766
ST REGIS FLS,NY,83,39,-44,0.319672131147541
ST SIMONS IS,GA,791,1032,241,0.5660998354360943
ST SIMONS ISLAND,GA,2551,3127,576,0.5507220852412822
ST STEPHENS CHURCH,VA,57,39,-18,0.40625
STAATSBURG,NY,1277,1353,76,0.5144486692015209
STACY,MN,2486,2555,69,0.5068438801825035
STACYVILLE,IA,0,25,25,1
STACYVILLE,ME,11,0,-11,0
STAFFORD,KS,757,477,-280,0.386547811993517
STAFFORD,NY,141,176,35,0.555205047318612
STAFFORD,TX,15747,14136,-1611,0.47304487501254894
STAFFORD,VA,36100,37034,934,0.506385538873848
STAFFORD SPGS,CT,383,376,-7,0.49538866930171277
STAFFORD SPRINGS,CT,4001,4135,134,0.5082350049164208
STAFFORDSVILLE,KY,426,351,-75,0.4517374517374517
STAFFORDSVLLE,KY,35,67,32,0.6568627450980392
STAHLSTOWN,PA,62,96,34,0.6075949367088608
STALEY,NC,314,355,41,0.5306427503736921
STALLINGS,NC,138,195,57,0.5855855855855856
STAMFORD,CT,61907,58055,-3852,0.48394491589003186
STAMFORD,NY,1388,1242,-146,0.47224334600760454
STAMFORD,TX,1450,1267,-183,0.46632315053367684
STAMFORD,VT,23,11,-12,0.3235294117647059
STAMPING GRD,KY,32,86,54,0.7288135593220338
STAMPING GROUND,KY,933,1082,149,0.5369727047146402
STAMPS,AR,670,536,-134,0.4444444444444444
STANARDSVILLE,VA,2139,1916,-223,0.4725030826140567
STANBERRY,MO,497,625,128,0.5570409982174688
STANCHFIELD,MN,930,991,61,0.5158771473191046
STANDARD CITY,IL,62,79,17,0.5602836879432624
STANDISH,CA,0,23,23,1
STANDISH,ME,2944,3328,384,0.5306122448979592
STANDISH,MI,2334,2160,-174,0.48064085447263016
STANFIELD,AZ,159,216,57,0.576
STANFIELD,NC,1144,1484,340,0.5646879756468798
STANFIELD,OR,870,892,22,0.5062429057888763
STANFORD,CA,7964,4625,-3339,0.36738422432282153
STANFORD,IL,184,40,-144,0.17857142857142858
STANFORD,KY,4401,4475,74,0.5041685443893645
STANFORD,MT,64,38,-26,0.37254901960784315
STANFORDVILLE,NY,694,831,137,0.5449180327868852
STANHOPE,IA,11,33,22,0.75
STANHOPE,NJ,2507,2387,-120,0.48774008990600737
STANLEY,IA,0,11,11,1
STANLEY,ID,263,231,-32,0.4676113360323887
STANLEY,NC,4419,4711,292,0.5159912376779847
STANLEY,ND,1509,1383,-126,0.4782157676348548
STANLEY,NM,29,74,45,0.7184466019417476
STANLEY,NY,572,593,21,0.5090128755364807
STANLEY,VA,2011,1959,-52,0.49345088161209066
STANLEY,WI,1965,1656,-309,0.45733222866611434
STANLEYTOWN,VA,42,13,-29,0.23636363636363636
STANTEN ISLAND,NY,26,22,-4,0.4583333333333333
STANTON,AL,0,11,11,1
STANTON,CA,8619,7769,-850,0.47406639004149376
STANTON,IA,84,73,-11,0.46496815286624205
STANTON,KY,2617,2581,-36,0.49653712966525587
STANTON,MI,2790,2691,-99,0.4909688013136289
STANTON,ND,11,0,-11,0
STANTON,NE,748,549,-199,0.42328450269853507
STANTON,TN,385,481,96,0.5554272517321016
STANTON,TX,1374,999,-375,0.42098609355246525
STANTONSBURG,NC,635,874,239,0.5791915175612988
STANTONVILLE,TN,84,217,133,0.7209302325581395
STANVILLE,KY,11,0,-11,0
STANWOOD,IA,105,58,-47,0.3558282208588957
STANWOOD,MI,3475,3204,-271,0.47971253181614015
STANWOOD,WA,9764,10447,683,0.516896739399337
STAPLEHURST,NE,15,0,-15,0
STAPLES,MN,2653,2543,-110,0.48941493456505003
STAPLETON,AL,333,558,225,0.6262626262626263
STAPLETON,GA,88,77,-11,0.4666666666666667
STAPLETON,NE,53,62,9,0.5391304347826087
STAR,ID,5707,7761,2054,0.5762548262548263
STAR,NC,728,727,-1,0.49965635738831615
STAR CITY,AR,2280,2211,-69,0.4923179692718771
STAR CITY,IN,256,292,36,0.5328467153284672
STAR CITY,WV,13,0,-13,0
STAR JUNCTION,PA,39,0,-39,0
STAR LAKE,NY,416,289,-127,0.4099290780141844
STAR LAKE,WI,46,22,-24,0.3235294117647059
STAR PRAIRIE,WI,516,632,116,0.5505226480836237
STAR TANNERY,VA,0,12,12,1
STAR VALLEY RANCH,WY,1059,1465,406,0.5804278922345484
STAR VLY RNCH,WY,226,189,-37,0.45542168674698796
STARBUCK,MN,1082,973,-109,0.4734793187347932
STARFORD,PA,0,11,11,1
STARK,NH,327,319,-8,0.4938080495356037
STARK CITY,MO,132,166,34,0.5570469798657718
STARKE,FL,5370,5961,591,0.5260788985967699
STARKS,LA,389,425,36,0.5221130221130221
STARKS,ME,156,145,-11,0.48172757475083056
STARKSBORO,VT,315,241,-74,0.43345323741007197
STARKVILLE,MS,17555,14658,-2897,0.4550336820538292
STARLIGHT,PA,0,11,11,1
STARR,SC,1153,1296,143,0.5291955900367497
STARRUCCA,PA,0,51,51,1
STARTEX,SC,146,43,-103,0.2275132275132275
STATE CENTER,IA,846,809,-37,0.48882175226586105
STATE COLLEGE,PA,31160,23405,-7755,0.4289379638962705
STATE LINE,MS,157,257,100,0.6207729468599034
STATE LINE,PA,24,0,-24,0
STATE ROAD,NC,773,913,140,0.5415183867141162
STATE UNIV,AR,38,0,-38,0
STATE UNIVERSITY,AR,947,16,-931,0.016614745586708203
STATELINE,NV,2032,1530,-502,0.4295339696799551
STATEN ISLAND,NY,112191,103489,-8702,0.4798265949554896
STATENVILLE,GA,214,11,-203,0.04888888888888889
STATESBORO,GA,22848,20833,-2015,0.4769350518532085
STATESVILLE,NC,24196,25414,1218,0.5122757508566821
STATHAM,GA,3002,3960,958,0.5688020683711578
STATON,CA,144,138,-6,0.48936170212765956
STAUNTON,IL,2694,2453,-241,0.4765883038663299
STAUNTON,IN,23,14,-9,0.3783783783783784
STAUNTON,VA,15546,15013,-533,0.4912791648941392
STAYTON,OR,4327,3997,-330,0.4801777991350312
STE GENEVIEVE,MO,332,315,-17,0.4868624420401855
STEAMBOAT ROCK,IA,39,30,-9,0.43478260869565216
STEAMBOAT SPR,CO,517,522,5,0.5024061597690087
STEAMBOAT SPRINGS,CO,12769,10770,-1999,0.45753855303963636
STEAMBURG,NY,16,0,-16,0
STEARNS,KY,803,765,-38,0.48788265306122447
STEBBINS,AK,13,11,-2,0.4583333333333333
STEDMAN,NC,1879,2046,167,0.5212738853503185
STEELE,AL,674,547,-127,0.447993447993448
STEELE,MO,2119,1455,-664,0.40710688304420817
STEELE,ND,264,106,-158,0.2864864864864865
STEELEVILLE,IL,979,841,-138,0.4620879120879121
STEELTON,PA,3432,3386,-46,0.49662657670871224
STEELVILLE,MO,2255,2179,-76,0.4914298601714028
STEENS,MS,638,764,126,0.5449358059914408
STEEP FALLS,ME,396,414,18,0.5111111111111111
STEFFENVILLE,MO,28,12,-16,0.3
STEGER,IL,3970,3439,-531,0.4641652044810366
STEILACOOM,WA,3687,3468,-219,0.4846960167714885
STEINHATCHEE,FL,883,1115,232,0.5580580580580581
STELLA,MO,308,258,-50,0.4558303886925795
STELLA,NC,533,710,177,0.5711987127916331
STEM,NC,1182,965,-217,0.44946436888681884
STEPHEN,MN,48,12,-36,0.2
STEPHENS,AR,201,155,-46,0.4353932584269663
STEPHENS,GA,14,0,-14,0
STEPHENS CITY,VA,7605,7945,340,0.5109324758842444
STEPHENSON,MI,580,636,56,0.5230263157894737
STEPHENSON,VA,1799,2518,719,0.5832754227472782
STEPHENTOWN,NY,562,614,52,0.5221088435374149
STEPHENVILLE,TX,14597,13182,-1415,0.47453112063069225
STERLING,AK,1934,1729,-205,0.472017472017472
STERLING,CO,7946,6840,-1106,0.4625997565264439
STERLING,CT,911,814,-97,0.4718840579710145
STERLING,ID,15,21,6,0.5833333333333334
STERLING,IL,10220,8175,-2045,0.44441424300081545
STERLING,KS,1078,1025,-53,0.4873989538754161
STERLING,MA,2187,2564,377,0.5396758577141655
STERLING,MI,932,839,-93,0.47374364765669114
STERLING,ND,0,28,28,1
STERLING,NE,92,62,-30,0.4025974025974026
STERLING,NY,846,807,-39,0.4882032667876588
STERLING,OH,230,100,-130,0.30303030303030304
STERLING,OK,70,63,-7,0.47368421052631576
STERLING,VA,35785,32960,-2825,0.47945305113099135
STERLING CITY,TX,98,47,-51,0.32413793103448274
STERLING HEIGHTS,MI,43446,38028,-5418,0.46675012887546946
STERLING HTS,MI,2129,1847,-282,0.4645372233400402
STERLINGTON,LA,1972,1828,-144,0.48105263157894734
STERRETT,AL,1812,1580,-232,0.4658018867924528
STETSON,ME,268,322,54,0.5457627118644067
STETSONVILLE,WI,306,165,-141,0.3503184713375796
STEUBEN,ME,511,531,20,0.5095969289827256
STEUBENVILLE,OH,10504,9677,-827,0.4795104306030425
STEVENS,PA,1324,1477,153,0.5273116744019993
STEVENS POINT,WI,18380,14008,-4372,0.4325058663702606
STEVENSON,AL,2094,1445,-649,0.4083074314778186
STEVENSON,MD,43,122,79,0.7393939393939394
STEVENSON,WA,1170,1291,121,0.5245835026412028
STEVENSON RANCH,CA,3951,4573,622,0.5364852182074143
STEVENSVILLE,MD,4534,5079,545,0.5283470300634557
STEVENSVILLE,MI,4087,3743,-344,0.47803320561941254
STEVENSVILLE,MT,5290,5495,205,0.5095039406583217
STEVENSVILLE,PA,11,0,-11,0
STEVINSON,CA,313,246,-67,0.4400715563506261
STEWARD,IL,0,23,23,1
STEWARDSON,IL,210,60,-150,0.2222222222222222
STEWART,MN,294,134,-160,0.3130841121495327
STEWART,OH,72,39,-33,0.35135135135135137
STEWART,TN,204,233,29,0.5331807780320366
STEWARTSTOWN,NH,179,220,41,0.5513784461152882
STEWARTSTOWN,PA,2456,2782,326,0.531118747613593
STEWARTSVILLE,MO,265,327,62,0.5523648648648649
STEWARTSVILLE,NJ,1595,1739,144,0.5215956808638272
STEWARTVILLE,MN,3118,2804,-314,0.4734886862546437
STICKNEY,SD,24,12,-12,0.3333333333333333
STIGLER,OK,3167,3223,56,0.5043818466353678
STILESVILLE,IN,75,62,-13,0.45255474452554745
STILLMAN VALLEY,IL,801,767,-34,0.48915816326530615
STILLMAN VLY,IL,41,45,4,0.5232558139534884
STILLWATER,ME,67,0,-67,0
STILLWATER,MN,15558,14037,-1521,0.47430309173846935
STILLWATER,NY,1703,1596,-107,0.4837829645347075
STILLWATER,OK,32479,24894,-7585,0.43389747790772665
STILLWATER,PA,164,131,-33,0.4440677966101695
STILWELL,KS,1834,2373,539,0.5640599001663894
STILWELL,OK,4487,3310,-1177,0.42452225214826217
STINNETT,KY,12,0,-12,0
STINNETT,TX,578,424,-154,0.4231536926147705
STINSON BEACH,CA,48,11,-37,0.1864406779661017
STIRLING,NJ,512,581,69,0.5315645013723697
STIRLING CITY,CA,0,11,11,1
STITES,ID,231,264,33,0.5333333333333333
STITZER,WI,13,0,-13,0
STOCKBRIDGE,GA,31477,30556,-921,0.49257653184595296
STOCKBRIDGE,MA,1387,1281,-106,0.4801349325337331
STOCKBRIDGE,MI,1761,1588,-173,0.4741713944461033
STOCKBRIDGE,VT,22,62,40,0.7380952380952381
STOCKBRIDGE,WI,28,0,-28,0
STOCKDALE,TX,1191,1430,239,0.545593285005723
STOCKERTOWN,PA,72,11,-61,0.13253012048192772
STOCKHOLM,ME,130,127,-3,0.49416342412451364
STOCKHOLM,NJ,809,784,-25,0.4921531701192718
STOCKHOLM,WI,110,68,-42,0.38202247191011235
STOCKPORT,IA,52,14,-38,0.21212121212121213
STOCKPORT,OH,803,734,-69,0.47755367599219256
STOCKTON,AL,68,168,100,0.711864406779661
STOCKTON,CA,114823,107199,-7624,0.4828305303078073
STOCKTON,IA,0,14,14,1
STOCKTON,IL,1323,1188,-135,0.4731182795698925
STOCKTON,KS,658,591,-67,0.4731785428342674
STOCKTON,MD,14,0,-14,0
STOCKTON,MO,2262,2447,185,0.5196432363559143
STOCKTON,NJ,1175,1391,216,0.5420888542478566
STOCKTON,NY,213,89,-124,0.2947019867549669
STOCKTON,UT,230,386,156,0.6266233766233766
STOCKTON SPGS,ME,133,122,-11,0.47843137254901963
STOCKTON SPRINGS,ME,969,981,12,0.5030769230769231
STOCKWELL,IN,0,11,11,1
STODDARD,NH,401,463,62,0.5358796296296297
STODDARD,WI,667,667,0,0.5
STOKES,NC,51,66,15,0.5641025641025641
STOKESDALE,NC,2185,3025,840,0.5806142034548945
STOLLINGS,WV,44,13,-31,0.22807017543859648
STONE,ID,35,18,-17,0.33962264150943394
STONE CREEK,OH,23,12,-11,0.34285714285714286
STONE HARBOR,NJ,1408,1665,257,0.5418158151643345
STONE LAKE,WI,1464,1111,-353,0.43145631067961165
STONE MOUNTAIN,GA,49266,46787,-2479,0.48709566593443204
STONE MTN,GA,2057,2110,53,0.5063594912407008
STONE PARK,IL,1266,752,-514,0.3726461843409316
STONE RIDGE,NY,978,1215,237,0.5540355677154583
STONE RIDGE,VA,415,638,223,0.6058879392212726
STONEBORO,PA,930,848,-82,0.4769403824521935
STONECREST,GA,1501,1495,-6,0.49899866488651534
STONEFORT,IL,220,110,-110,0.3333333333333333
STONEHAM,MA,7939,8134,195,0.5060660735394762
STONEHAM,ME,11,13,2,0.5416666666666666
STONEVILLE,NC,1887,2097,210,0.526355421686747
STONEWALL,LA,2017,2279,262,0.5304934823091247
STONEWALL,MS,247,363,116,0.5950819672131148
STONEWALL,OK,552,529,-23,0.48936170212765956
STONEWALL,TX,34,142,108,0.8068181818181818
STONEY BEACH,MD,593,538,-55,0.47568523430592397
STONINGTON,CT,2699,2908,209,0.518637417513822
STONINGTON,IL,203,110,-93,0.3514376996805112
STONINGTON,ME,1106,767,-339,0.40950347036839296
STONY BROOK,NY,4317,4255,-62,0.49638357442837144
STONY CREEK,NY,67,46,-21,0.40707964601769914
STONY CREEK,VA,513,542,29,0.5137440758293839
STONY POINT,NC,1298,1270,-28,0.4945482866043614
STONY POINT,NY,3481,3462,-19,0.4986317153968025
STONYFORD,CA,11,14,3,0.56
STOPOVER,KY,26,0,-26,0
STORDEN,MN,11,0,-11,0
STORM LAKE,IA,7103,5138,-1965,0.4197369495956213
STORMVILLE,NY,968,1088,120,0.5291828793774319
STORRS,CT,240,204,-36,0.4594594594594595
STORRS MANFLD,CT,279,174,-105,0.3841059602649007
STORRS MANSFIELD,CT,2703,2218,-485,0.45072139808981915
STORY,WY,267,263,-4,0.4962264150943396
STORY CITY,IA,1717,1663,-54,0.4920118343195266
STOTTS CITY,MO,36,28,-8,0.4375
STOTTVILLE,NY,23,34,11,0.5964912280701754
STOUCHSBURG,PA,30,35,5,0.5384615384615384
STOUGHTON,MA,10126,9683,-443,0.48881821394315716
STOUGHTON,WI,7496,7594,98,0.503247183565275
STOUT,OH,115,176,61,0.6048109965635738
STOUTLAND,MO,210,168,-42,0.4444444444444444
STOUTSVILLE,MO,12,23,11,0.6571428571428571
STOUTSVILLE,OH,912,780,-132,0.46099290780141844
STOVALL,MS,105,89,-16,0.4587628865979381
STOVALL,NC,0,16,16,1
STOVER,MO,1694,1776,82,0.5118155619596542
STOW,MA,1829,2122,293,0.5370792204505188
STOW,NY,12,51,39,0.8095238095238095
STOW,OH,14539,13769,-770,0.4863996043521266
STOWE,VT,3639,3815,176,0.5118057418835524
STOYSTOWN,PA,878,658,-220,0.4283854166666667
STRABANE,PA,90,0,-90,0
STRAFFORD,MO,2819,3073,254,0.5215546503733877
STRAFFORD,NH,1225,1365,140,0.527027027027027
STRAFFORD,PA,273,214,-59,0.4394250513347023
STRAFFORD,VT,51,56,5,0.5233644859813084
STRANGE CREEK,WV,26,0,-26,0
STRASBURG,CO,2214,2587,373,0.5388460737346387
STRASBURG,IL,25,11,-14,0.3055555555555556
STRASBURG,ND,27,0,-27,0
STRASBURG,OH,1426,1397,-29,0.4948636202621325
STRASBURG,PA,1565,1603,38,0.5059974747474747
STRASBURG,VA,4333,4512,179,0.5101187111362352
STRATFORD,CA,73,24,-49,0.24742268041237114
STRATFORD,CT,15829,16190,361,0.5056372778662669
STRATFORD,IA,218,148,-70,0.40437158469945356
STRATFORD,NH,11,12,1,0.5217391304347826
STRATFORD,NJ,2103,1967,-136,0.4832923832923833
STRATFORD,NY,109,75,-34,0.4076086956521739
STRATFORD,OK,1433,1272,-161,0.4702402957486137
STRATFORD,TX,520,164,-356,0.23976608187134502
STRATFORD,WI,1262,1171,-91,0.4812988080558981
STRATHAM,NH,2618,3022,404,0.5358156028368795
STRATHMERE,NJ,82,61,-21,0.42657342657342656
STRATHMORE,CA,1130,1046,-84,0.4806985294117647
STRATTANVILLE,PA,654,554,-100,0.4586092715231788
STRATTON,CO,161,174,13,0.5194029850746269
STRATTON,ME,415,217,-198,0.34335443037974683
STRATTON,NE,11,23,12,0.6764705882352942
STRATTON,VT,0,24,24,1
STRATTON MNT,VT,22,13,-9,0.37142857142857144
STRAUGHN,IN,26,0,-26,0
STRAWBERRY,AR,77,195,118,0.7169117647058824
STRAWBERRY PLAINS,TN,2616,3053,437,0.5385429529017464
STRAWBERRY POINT,IA,677,435,-242,0.39118705035971224
STRAWBERRY PT,IA,87,75,-12,0.46296296296296297
STRAWN,TX,90,45,-45,0.3333333333333333
STREAMWOOD,IL,11580,10921,-659,0.48535620639082705
STREATOR,IL,7639,6671,-968,0.46617749825296995
STREET,MD,1320,1368,48,0.5089285714285714
STREETER,ND,13,27,14,0.675
STREETMAN,TX,521,887,366,0.6299715909090909
STREETSBORO,OH,6875,6997,122,0.5043973471741637
STRINGER,MS,43,71,28,0.6228070175438597
STRINGTOWN,OK,63,11,-52,0.14864864864864866
STROMSBURG,NE,429,438,9,0.5051903114186851
STRONG,AR,476,135,-341,0.220949263502455
STRONG,ME,572,612,40,0.5168918918918919
STRONG CITY,KS,68,89,21,0.5668789808917197
STRONGHURST,IL,340,236,-104,0.4097222222222222
STRONGSVILLE,OH,14324,14492,168,0.5029150471960022
STROUD,OK,1766,1866,100,0.5137665198237885
STROUDSBURG,PA,9339,9504,165,0.5043782837127846
STRUM,WI,555,507,-48,0.4774011299435028
STRUNK,KY,90,156,66,0.6341463414634146
STRUTHERS,OH,3960,3665,-295,0.48065573770491804
STRYKER,OH,714,675,-39,0.48596112311015116
STRYKERSVILLE,NY,112,86,-26,0.43434343434343436
STUART,FL,50225,53026,2801,0.513564033278128
STUART,IA,1182,1139,-43,0.4907367514002585
STUART,NE,61,62,1,0.5040650406504065
STUART,OK,187,65,-122,0.25793650793650796
STUART,VA,2145,2316,171,0.5191661062542031
STUARTS DRAFT,VA,4292,3908,-384,0.4765853658536585
STUDIO CITY,CA,18639,16951,-1688,0.47628547344759764
STURBRIDGE,MA,2685,2806,121,0.5110180295028228
STURGEON,MO,806,743,-63,0.47966429954809553
STURGEON,PA,13,0,-13,0
STURGEON BAY,WI,9724,9197,-527,0.48607367475292
STURGEON LAKE,MN,1222,1115,-107,0.4771074026529739
STURGIS,KY,2027,1554,-473,0.4339569952527227
STURGIS,MI,7689,6963,-726,0.4752252252252252
STURGIS,MS,109,103,-6,0.4858490566037736
STURGIS,SD,4920,4577,-343,0.4819416657891966
STURTEVANT,WI,2487,2281,-206,0.4783976510067114
STUTTGART,AR,4877,3706,-1171,0.4317837585925667
STUYVESANT,NY,353,385,32,0.521680216802168
SUAMICO,WI,3233,3592,359,0.5263003663003663
SUBIACO,AR,67,36,-31,0.34951456310679613
SUBLETTE,IL,392,365,-27,0.4821664464993395
SUBLETTE,KS,968,789,-179,0.44906089926010245
SUBLIMITY,OR,1393,1701,308,0.5497737556561086
SUCCASUNNA,NJ,2050,2372,322,0.5364088647670737
SUCHES,GA,214,489,275,0.6955903271692745
SUDAN,TX,80,105,25,0.5675675675675675
SUDBURY,MA,4765,5812,1047,0.5494941854968327
SUDBURY,VT,91,40,-51,0.3053435114503817
SUDLERSVILLE,MD,132,146,14,0.5251798561151079
SUFFERN,NY,7785,7203,-582,0.48058446757405926
SUFFIELD,CT,3229,3717,488,0.5351281312985892
SUFFOLK,VA,33151,38203,5052,0.5354009586007792
SUGAR CITY,CO,11,0,-11,0
SUGAR CITY,ID,1190,926,-264,0.43761814744801514
SUGAR CREEK,MO,1270,1221,-49,0.4901645925331192
SUGAR GROVE,IL,3669,3878,209,0.5138465615476349
SUGAR GROVE,NC,525,455,-70,0.4642857142857143
SUGAR GROVE,OH,635,686,51,0.5193035579106737
SUGAR GROVE,PA,638,501,-137,0.43985952589991223
SUGAR GROVE,VA,145,335,190,0.6979166666666666
SUGAR HILL,GA,1893,2063,170,0.5214863498483316
SUGAR HILL,NH,15,99,84,0.868421052631579
SUGAR LAND,TX,46012,48386,2374,0.512574418949554
SUGAR LOAF,NY,41,0,-41,0
SUGAR MOUNTAIN,NC,635,192,-443,0.23216444981862153
SUGAR RUN,PA,12,0,-12,0
SUGAR TREE,TN,29,53,24,0.6463414634146342
SUGAR VALLEY,GA,319,203,-116,0.3888888888888889
SUGARCREEK,OH,1599,1392,-207,0.4653961885656971
SUGARLOAF,CA,995,842,-153,0.4583560152422428
SUGARLOAF,PA,720,1126,406,0.609967497291441
SUISUN CITY,CA,9829,9191,-638,0.4832281808622503
SUITLAND,MD,13434,12152,-1282,0.47494723677010864
SULA,MT,41,62,21,0.6019417475728155
SULLIGENT,AL,1364,1443,79,0.5140719629497684
SULLIVAN,IL,2963,2803,-160,0.48612556364897674
SULLIVAN,IN,3953,3947,-6,0.49962025316455694
SULLIVAN,ME,434,471,37,0.5204419889502763
SULLIVAN,MO,6818,6104,-714,0.4723726977248104
SULLIVAN,NH,57,27,-30,0.32142857142857145
SULLIVAN,OH,486,636,150,0.5668449197860963
SULLIVAN,WI,857,952,95,0.5262576008844666
SULLIVAN CITY,TX,342,476,134,0.5819070904645477
SULLIVANS IS,SC,43,27,-16,0.38571428571428573
SULLIVANS ISLAND,SC,819,864,45,0.5133689839572193
SULLY,IA,201,127,-74,0.3871951219512195
SULPHUR,KY,22,11,-11,0.3333333333333333
SULPHUR,LA,16192,14557,-1635,0.4734137695534814
SULPHUR,OK,2987,3085,98,0.5080698287220027
SULPHUR ROCK,AR,671,535,-136,0.44361525704809285
SULPHUR SPGS,AR,16,13,-3,0.4482758620689655
SULPHUR SPGS,TX,400,393,-7,0.49558638083228246
SULPHUR SPRINGS,AR,271,294,23,0.5203539823008849
SULPHUR SPRINGS,IN,41,0,-41,0
SULPHUR SPRINGS,OH,11,14,3,0.56
SULPHUR SPRINGS,TX,9881,9920,39,0.500984798747538
SULTAN,WA,2968,3652,684,0.5516616314199396
SULTANA,CA,0,11,11,1
SUMAS,WA,1181,1268,87,0.5177623519804002
SUMERCO,WV,28,24,-4,0.46153846153846156
SUMERDUCK,VA,324,311,-13,0.48976377952755906
SUMITON,AL,864,902,38,0.5107587768969423
SUMMER SHADE,KY,472,610,138,0.5637707948243993
SUMMERDALE,AL,2959,2863,-96,0.4917554105118516
SUMMERDALE,PA,250,0,-250,0
SUMMERFIELD,FL,18979,20533,1554,0.519664911925491
SUMMERFIELD,IL,47,0,-47,0
SUMMERFIELD,KS,11,0,-11,0
SUMMERFIELD,NC,3390,4192,802,0.5528884199419678
SUMMERFIELD,OH,48,38,-10,0.4418604651162791
SUMMERHILL,PA,259,159,-100,0.3803827751196172
SUMMERLAND,CA,630,386,-244,0.3799212598425197
SUMMERLAND KEY,FL,6437,7349,912,0.5330770346728565
SUMMERS,AR,116,118,2,0.5042735042735043
SUMMERSET,SD,830,733,-97,0.4689699296225208
SUMMERSVILLE,KY,46,116,70,0.7160493827160493
SUMMERSVILLE,MO,623,651,28,0.510989010989011
SUMMERSVILLE,WV,2991,2981,-10,0.4991627595445412
SUMMERTON,SC,1970,2011,41,0.5051494599346897
SUMMERTOWN,TN,1847,2225,378,0.5464145383104125
SUMMERVILLE,GA,5327,5287,-40,0.49811569625023555
SUMMERVILLE,OR,72,102,30,0.5862068965517241
SUMMERVILLE,PA,189,207,18,0.5227272727272727
SUMMERVILLE,SC,71628,81877,10249,0.5333832774176737
SUMMIT,AR,22,63,41,0.7411764705882353
SUMMIT,IL,644,511,-133,0.44242424242424244
SUMMIT,MS,3240,2895,-345,0.4718826405867971
SUMMIT,NJ,7307,7302,-5,0.4998288726127729
SUMMIT,NY,227,170,-57,0.4282115869017632
SUMMIT,SD,13,0,-13,0
SUMMIT ARGO,IL,2502,2067,-435,0.45239658568614577
SUMMIT HILL,PA,1386,1139,-247,0.4510891089108911
SUMMIT LAKE,WI,49,27,-22,0.35526315789473684
SUMMIT POINT,WV,46,108,62,0.7012987012987013
SUMMITVILLE,IN,587,596,9,0.503803888419273
SUMNER,GA,140,86,-54,0.3805309734513274
SUMNER,IA,1253,1123,-130,0.47264309764309764
SUMNER,IL,815,653,-162,0.44482288828337874
SUMNER,ME,117,127,10,0.5204918032786885
SUMNER,MI,179,249,70,0.5817757009345794
SUMNER,NE,11,11,0,0.5
SUMNER,TX,329,501,172,0.6036144578313253
SUMNER,WA,7453,7112,-341,0.48829385513216617
SUMPTER,OR,52,71,19,0.5772357723577236
SUMRALL,MS,2864,3211,347,0.528559670781893
SUMTER,SC,30567,29757,-810,0.49328625422717326
SUMTERVILLE,FL,638,924,286,0.5915492957746479
SUN CITY,AZ,39275,47558,8283,0.5476950007485634
SUN CITY,CA,6456,7395,939,0.5338964695689842
SUN CITY,FL,161,85,-76,0.34552845528455284
SUN CITY CENTER,FL,24213,28873,4660,0.5438910447198885
SUN CITY CTR,FL,452,60,-392,0.1171875
SUN CITY WEST,AZ,30196,32021,1825,0.5146664095022261
SUN LAKES,AZ,10124,9156,-968,0.47489626556016595
SUN PRAIRIE,WI,21285,20592,-693,0.491725768321513
SUN RIVER,MT,11,0,-11,0
SUN RIVER TERRACE,IL,116,100,-16,0.46296296296296297
SUN VALLEY,CA,10021,8681,-1340,0.4641749545503155
SUN VALLEY,ID,2209,2054,-155,0.4818203143326296
SUN VALLEY,NV,6460,6213,-247,0.49025487256371814
SUNAPEE,NH,2193,2019,-174,0.4793447293447293
SUNBRIGHT,TN,646,938,292,0.5921717171717171
SUNBURG,MN,0,15,15,1
SUNBURST,MT,16,14,-2,0.4666666666666667
SUNBURY,NC,278,84,-194,0.23204419889502761
SUNBURY,OH,4899,6311,1412,0.5629794826048171
SUNBURY,PA,6800,6348,-452,0.48281107392759354
SUNCOOK,NH,1286,1181,-105,0.4787190920145926
SUNDANCE,WY,860,880,20,0.5057471264367817
SUNDERLAND,MA,2376,1834,-542,0.4356294536817102
SUNDERLAND,MD,175,211,36,0.5466321243523317
SUNDERLAND,VT,101,106,5,0.5120772946859904
SUNDOWN,NY,12,13,1,0.52
SUNDOWN,TX,106,25,-81,0.19083969465648856
SUNFIELD,MI,616,540,-76,0.4671280276816609
SUNFLOWER,MS,71,81,10,0.5328947368421053
SUNLAND,CA,4803,4606,-197,0.4895312998193219
SUNLAND PARK,NM,1663,1724,61,0.5090050191910245
SUNMAN,IN,1791,1480,-311,0.4524610210944665
SUNNY HILLS,FL,241,304,63,0.5577981651376147
SUNNY ISL BCH,FL,1173,1341,168,0.5334128878281623
SUNNY ISLES BEACH,FL,10195,10072,-123,0.4969655104356836
SUNNY SIDE,GA,69,141,72,0.6714285714285714
SUNNYSIDE,NY,9903,7424,-2479,0.42846424655162463
SUNNYSIDE,UT,25,0,-25,0
SUNNYSIDE,WA,4310,4008,-302,0.4818465977398413
SUNNYVALE,CA,94876,81547,-13329,0.46222431315644785
SUNNYVALE,TX,1377,2247,870,0.6200331125827815
SUNOL,CA,57,143,86,0.715
SUNRAY,TX,532,217,-315,0.2897196261682243
SUNRISE,FL,45137,43769,-1368,0.49230648100240704
SUNRISE BEACH,MO,3224,3218,-6,0.499534306116113
SUNRISE BEACH,TX,208,268,60,0.5630252100840336
SUNRISE HWY,NY,87,97,10,0.5271739130434783
SUNRIVER,OR,885,1063,178,0.545687885010267
SUNSET,LA,2397,2108,-289,0.4679245283018868
SUNSET,ME,0,23,23,1
SUNSET,SC,628,992,364,0.6123456790123457
SUNSET,TX,762,1053,291,0.5801652892561984
SUNSET,UT,977,843,-134,0.4631868131868132
SUNSET BEACH,CA,448,523,75,0.5386199794026777
SUNSET BEACH,NC,2628,3632,1004,0.5801916932907348
SUNSHINE,LA,23,43,20,0.6515151515151515
SUPERIOR,AZ,1589,1418,-171,0.47156634519454604
SUPERIOR,CO,6669,6208,-461,0.48209986798167276
SUPERIOR,MT,1288,1248,-40,0.4921135646687697
SUPERIOR,NE,1096,922,-174,0.4568880079286422
SUPERIOR,WI,15219,13228,-1991,0.4650050971982986
SUPPLY,NC,4760,5932,1172,0.5548073325851104
SUQUAMISH,WA,1403,1286,-117,0.47824470063220526
SURF CITY,NC,2057,2607,550,0.5589622641509434
SURF CITY,NJ,786,1055,269,0.5730581205866377
SURFSIDE,CA,11,0,-11,0
SURFSIDE,FL,3450,3256,-194,0.4855353414852371
SURFSIDE BCH,SC,302,404,102,0.5722379603399433
SURFSIDE BEACH,SC,6320,8924,2604,0.5854106533718184
SURGOINSVILLE,TN,1203,1396,193,0.5371296652558677
SURING,WI,1099,1205,106,0.5230034722222222
SURPRISE,AZ,81145,101139,19994,0.5548429922538457
SURRENCY,GA,142,24,-118,0.14457831325301204
SURREY,ND,193,224,31,0.5371702637889688
SURRY,ME,1066,1028,-38,0.4909264565425024
SURRY,VA,665,633,-32,0.487673343605547
SUSANVILLE,CA,7962,7031,-931,0.4689521776829187
SUSQUEHANNA,PA,1864,1752,-112,0.48451327433628316
SUSSEX,NJ,4551,4846,295,0.5156964988826221
SUSSEX,WI,5557,6257,700,0.5296258676146944
SUTERSVILLE,PA,61,11,-50,0.1527777777777778
SUTHERLAND,IA,202,135,-67,0.40059347181008903
SUTHERLAND,NE,661,458,-203,0.4092940125111707
SUTHERLAND,VA,596,810,214,0.5761024182076814
SUTHERLAND SPRINGS,TX,12,74,62,0.8604651162790697
SUTHERLIN,OR,4845,5011,166,0.5084212662337663
SUTHERLIN,VA,76,118,42,0.6082474226804123
SUTTER,CA,1062,1088,26,0.5060465116279069
SUTTER CREEK,CA,1996,1761,-235,0.46872504657971786
SUTTON,AK,207,283,76,0.5775510204081633
SUTTON,MA,2587,2945,358,0.5323571945047
SUTTON,NE,819,587,-232,0.4174964438122333
SUTTON,VT,23,14,-9,0.3783783783783784
SUTTON,WV,1201,1147,-54,0.4885008517887564
SUTTONS BAY,MI,2498,2209,-289,0.4693010410027618
SUWANEE,GA,28686,33166,4480,0.5362154821186057
SUWANNEE,FL,11,11,0,0.5
SV,CA,540,471,-69,0.4658753709198813
SVEA,MN,0,14,14,1
SWAIN,NY,13,15,2,0.5357142857142857
SWAINSBORO,GA,5639,4132,-1507,0.42288404462184015
SWALEDALE,IA,14,0,-14,0
SWAMPSCOTT,MA,5489,5506,17,0.5007730786721237
SWAN LAKE,NY,567,570,3,0.5013192612137203
SWAN POINT,MD,87,91,4,0.5112359550561798
SWAN VALLEY,ID,102,70,-32,0.4069767441860465
SWANNANOA,NC,3932,3951,19,0.5012051249524293
SWANQUARTER,NC,37,22,-15,0.3728813559322034
SWANS ISLAND,ME,150,114,-36,0.4318181818181818
SWANSBORO,NC,4860,5518,658,0.5317016766236269
SWANSEA,IL,7621,7270,-351,0.4882143576657041
SWANSEA,MA,4435,4890,455,0.524396782841823
SWANSEA,SC,2239,2357,118,0.5128372497824195
SWANTON,MD,931,971,40,0.5105152471083071
SWANTON,OH,3788,3823,35,0.5022993036394692
SWANTON,VT,3451,3345,-106,0.4922012948793408
SWANVILLE,ME,826,727,-99,0.46812620734063104
SWANVILLE,MN,49,115,66,0.7012195121951219
SWANZEY,NH,2188,2315,127,0.5141017099711304
SWARTHMORE,PA,2496,2647,151,0.514680147773673
SWARTZ,LA,0,12,12,1
SWARTZ CREEK,MI,8061,7493,-568,0.4817410312459817
SWAYZEE,IN,457,353,-104,0.43580246913580245
SWEA CITY,IA,235,77,-158,0.2467948717948718
SWEDEBORG,MO,41,36,-5,0.4675324675324675
SWEDEN,ME,251,284,33,0.5308411214953271
SWEDESBORO,NJ,5480,5835,355,0.515687140963323
SWEENY,TX,3064,2814,-250,0.4787342633548826
SWEET,ID,0,13,13,1
SWEET BRIAR,VA,102,22,-80,0.1774193548387097
SWEET HOME,OR,6488,6619,131,0.5049973296711681
SWEET SPRINGS,MO,745,787,42,0.5137075718015666
SWEET VALLEY,PA,452,509,57,0.5296566077003122
SWEET WATER,AL,156,111,-45,0.4157303370786517
SWEETSER,IN,233,133,-100,0.3633879781420765
SWEETWATER,FL,869,681,-188,0.4393548387096774
SWEETWATER,TN,5897,6628,731,0.52918163672654694
SWEETWATER,TX,5643,5265,-378,0.48267326732673266
SWENGEL,PA,16,0,-16,0
SWIFTON,AR,185,216,31,0.5386533665835411
SWIFTWATER,PA,618,356,-262,0.3655030800821355
SWINK,CO,169,81,-88,0.324
SWISHER,IA,909,929,20,0.5054406964091404
SWISSHOME,OR,0,12,12,1
SWISSVALE,PA,225,226,1,0.5011086474501109
SWITZ CITY,IN,86,61,-25,0.41496598639455784
SWOOPE,VA,103,112,9,0.5209302325581395
SWORDS CREEK,VA,371,165,-206,0.30783582089552236
SWOYERSVILLE,PA,198,207,9,0.5111111111111111
SYCAMORE,AL,19,13,-6,0.40625
SYCAMORE,GA,183,194,11,0.5145888594164456
SYCAMORE,IL,8604,7774,-830,0.47466113078519967
SYCAMORE,OH,719,654,-65,0.4763292061179898
SYCAMORE,PA,13,0,-13,0
SYKESVILLE,MD,7032,7820,788,0.526528413681659
SYKESVILLE,PA,397,368,-29,0.48104575163398694
SYLACAUGA,AL,8333,7905,-428,0.48682103707353125
SYLMAR,CA,19652,18120,-1532,0.47972042783013874
SYLVA,NC,5988,5998,10,0.5004171533455698
SYLVAN BEACH,NY,776,454,-322,0.36910569105691055
SYLVAN GROVE,KS,12,22,10,0.6470588235294118
SYLVAN LAKE,MI,373,313,-60,0.45626822157434405
SYLVAN SPGS,AL,0,18,18,1
SYLVAN SPRINGS,AL,54,51,-3,0.4857142857142857
SYLVANIA,AL,616,638,22,0.5087719298245614
SYLVANIA,GA,3197,3179,-18,0.49858845671267255
SYLVANIA,OH,10588,11489,901,0.5204058522444173
SYLVANIA TOWNSHIP,OH,196,230,34,0.539906103286385
SYLVESTER,GA,3775,3655,-120,0.4919246298788694
SYLVIA,KS,0,11,11,1
SYMSONIA,KY,330,347,17,0.5125553914327917
SYOSSET,NY,6504,7026,522,0.519290465631929
SYRACUSE,IN,5221,4515,-706,0.46374281018898933
SYRACUSE,KS,660,98,-562,0.12928759894459102
SYRACUSE,MO,0,11,11,1
SYRACUSE,NE,782,832,50,0.5154894671623296
SYRACUSE,NY,116500,97987,-18513,0.4568435383030207
SYRACUSE,OH,34,23,-11,0.40350877192982454
SYRACUSE,UT,8086,9065,979,0.5285406098769752
T OR C,NM,581,629,48,0.5198347107438016
TABERG,NY,903,871,-32,0.49098083427282974
TABERNACLE,NJ,413,434,21,0.512396694214876
TABERNASH,CO,447,662,215,0.5969341749323716
TABIONA,UT,11,0,-11,0
TABLE GROVE,IL,63,12,-51,0.16
TABOR,IA,397,303,-94,0.4328571428571429
TABOR,SD,15,12,-3,0.4444444444444444
TABOR CITY,NC,1743,1850,107,0.5148900640133593
TABOR CITY,SC,12,12,0,0.5
TACNA,AZ,105,239,134,0.6947674418604651
TACOMA,WA,160522,141357,-19165,0.46825714938766855
TACONIC,CT,0,16,16,1
TAFT,CA,8163,6242,-1921,0.43332176327664007
TAFT,TN,596,581,-15,0.49362786745964315
TAFT,TX,1505,1425,-80,0.4863481228668942
TAFTON,PA,534,637,103,0.5439795046968403
TAFTVILLE,CT,2435,2298,-137,0.48552714979928163
TAHLEQUAH,OK,11561,11130,-431,0.4905028425366886
TAHOE CITY,CA,3282,2058,-1224,0.3853932584269663
TAHOE VISTA,CA,77,60,-17,0.43795620437956206
TAHOKA,TX,652,768,116,0.5408450704225352
TAHOMA,CA,624,451,-173,0.41953488372093023
TAHUYA,WA,820,956,136,0.5382882882882883
TAINTOR,IA,26,33,7,0.559322033898305
TAJIQUE,NM,25,17,-8,0.40476190476190477
TAKOMA PARK,MD,10164,8028,-2136,0.4412928759894459
TALALA,OK,729,766,37,0.5123745819397993
TALBOTT,TN,2516,3046,530,0.5476447321107515
TALBOTTON,GA,51,162,111,0.7605633802816901
TALCO,TX,264,262,-2,0.49809885931558934
TALCOTT,WV,24,23,-1,0.48936170212765956
TALENT,OR,5775,4516,-1259,0.4388300456709746
TALIHINA,OK,1343,1321,-22,0.4958708708708709
TALKEETNA,AK,994,706,-288,0.4152941176470588
TALKING ROCK,GA,1971,2240,269,0.5319401567323676
TALL,FL,0,17,17,1
TALL TIMBERS,MD,37,60,23,0.6185567010309279
TALLADEGA,AL,8489,7842,-647,0.48019104770069193
TALLAHASSEE,FL,123025,116043,-6982,0.4853974601368648
TALLAPOOSA,GA,2421,2639,218,0.5215415019762846
TALLASSEE,AL,4404,4723,319,0.5174756217815273
TALLASSEE,TN,0,40,40,1
TALLEVAST,FL,611,839,228,0.5786206896551724
TALLEYVILLE,DE,499,533,34,0.5164728682170543
TALLMADGE,OH,5244,5728,484,0.5220561429092235
TALLMAN,NY,91,45,-46,0.33088235294117646
TALLMANSVILLE,WV,12,0,-12,0
TALLULA,IL,262,224,-38,0.4609053497942387
TALLULAH,LA,3091,2429,-662,0.440036231884058
TALLULAH FALLS,GA,0,11,11,1
TALMAGE,CA,1024,25,-999,0.023832221163012392
TALMO,GA,204,299,95,0.5944333996023857
TAMA,IA,1631,1348,-283,0.45250083920778783
TAMAQUA,PA,4348,4533,185,0.5104154937507037
TAMARAC,FL,26062,25416,-646,0.49372547496017716
TAMARACK,MN,24,13,-11,0.35135135135135137
TAMAROA,IL,471,317,-154,0.4022842639593909
TAMASSEE,SC,50,107,57,0.6815286624203821
TAMIMENT,PA,79,13,-66,0.14130434782608695
TAMMS,IL,119,142,23,0.5440613026819924
TAMPA,FL,508082,466912,-41170,0.47888704956133066
TAMPICO,IL,412,180,-232,0.30405405405405406
TAMWORTH,NH,631,714,83,0.5308550185873606
TANEYTOWN,MD,3378,3950,572,0.539028384279476
TANEYVILLE,MO,188,223,35,0.5425790754257908
TANGENT,OR,841,862,21,0.5061655901350558
TANGERINE,FL,23,0,-23,0
TANGIER,IN,23,11,-12,0.3235294117647059
TANGIPAHOA,LA,16,0,-16,0
TANNER,AL,742,824,82,0.5261813537675607
TANNERSVILLE,NY,772,408,-364,0.34576271186440677
TANNERSVILLE,PA,1342,1154,-188,0.4623397435897436
TAOS,NM,4680,4827,147,0.5077311454717577
TAOS SKI VALLEY,NM,41,12,-29,0.22641509433962265
TAPPAHANNOCK,VA,1970,2063,93,0.5115298785023555
TAPPAN,NY,1132,1341,209,0.5422563687828549
TAPPEN,ND,11,11,0,0.5
TAR HEEL,NC,59,71,12,0.5461538461538461
TARAWA TERRACE,NC,3410,2341,-1069,0.40705964180142584
TARBORO,NC,5304,5251,-53,0.4974893415442918
TARENTUM,PA,3232,2822,-410,0.46613809051866534
TARIFFVILLE,CT,367,423,56,0.5354430379746835
TARKIO,MO,660,632,-28,0.4891640866873065
TARNOV,NE,0,11,11,1
TARPON SPGS,FL,345,530,185,0.6057142857142858
TARPON SPNGS,FL,110,101,-9,0.4786729857819905
TARPON SPRINGS,FL,20803,22869,2066,0.5236535995603591
TARRANT,AL,160,171,11,0.5166163141993958
TARRS,PA,11,22,11,0.6666666666666666
TARRYTOWN,GA,0,51,51,1
TARRYTOWN,NY,5401,5226,-175,0.491766255763621
TARZANA,CA,15556,14706,-850,0.4859559844028815
TASWELL,IN,75,39,-36,0.34210526315789475
TATAMY,PA,60,57,-3,0.48717948717948717
TATE,GA,37,46,9,0.5542168674698795
TATUM,NM,64,12,-52,0.15789473684210525
TATUM,TX,1270,1302,32,0.5062208398133748
TAUNTON,MA,18529,18020,-509,0.4930367451913869
TAVARES,FL,15846,17103,1257,0.5190749339888919
TAVERNIER,FL,4704,4982,278,0.5143506091265745
TAWAS CITY,MI,2556,2094,-462,0.4503225806451613
TAYLOR,AL,148,116,-32,0.4393939393939394
TAYLOR,AR,586,586,0,0.5
TAYLOR,AZ,972,1272,300,0.5668449197860963
TAYLOR,MI,25475,20434,-5041,0.44509791108497243
TAYLOR,MS,51,37,-14,0.42045454545454547
TAYLOR,PA,1837,1955,118,0.5155590717299579
TAYLOR,TX,6711,7220,509,0.5182686095757663
TAYLOR,WI,303,184,-119,0.37782340862423
TAYLOR MILL,KY,915,883,-32,0.4911012235817575
TAYLOR RIDGE,IL,430,509,79,0.5420660276890309
TAYLOR SPRINGS,IL,64,11,-53,0.14666666666666667
TAYLORS,SC,16508,16165,-343,0.4947510176598415
TAYLORS FALLS,MN,602,499,-103,0.45322434150772023
TAYLORSVILLE,CA,69,140,71,0.6698564593301436
TAYLORSVILLE,GA,1139,1229,90,0.5190033783783784
TAYLORSVILLE,IN,101,165,64,0.6203007518796992
TAYLORSVILLE,KY,4210,4889,679,0.5373117925046709
TAYLORSVILLE,MS,1045,1096,51,0.5119103222793088
TAYLORSVILLE,NC,5384,5547,163,0.5074558594822066
TAYLORSVILLE,UT,14394,11899,-2495,0.4525539116875214
TAYLORVILLE,IL,6285,5803,-482,0.48006287227001987
TAZEWELL,TN,3856,3312,-544,0.46205357142857145
TAZEWELL,VA,1885,1682,-203,0.4715447154471545
TCHULA,MS,290,302,12,0.5101351351351351
TEA,SD,3043,3376,333,0.5259386197226983
TEABERRY,KY,19,15,-4,0.4411764705882353
TEACHEY,NC,257,433,176,0.6275362318840579
TEAGUE,TX,1924,2036,112,0.5141414141414141
TEAL,CA,0,11,11,1
TEANECK,NJ,10629,11055,426,0.5098229109020476
TEASDALE,UT,0,38,38,1
TEATICKET,MA,1806,2063,257,0.5332127164642027
TEBBETTS,MO,26,39,13,0.6
TECATE,CA,196,545,349,0.7354925775978407
TECOPA,CA,11,0,-11,0
TECUMSEH,KS,801,853,52,0.5157194679564692
TECUMSEH,MI,5147,4986,-161,0.49205565972564885
TECUMSEH,MO,0,16,16,1
TECUMSEH,NE,1081,912,-169,0.45760160561966884
TECUMSEH,OK,3838,4135,297,0.518625360591998
TEEC NOS POS,AZ,39,154,115,0.7979274611398963
TEGA CAY,SC,3277,4052,775,0.5528721517260199
TEHACHAPI,CA,11699,12830,1131,0.5230543438379062
TEHAMA,CA,12,40,28,0.7692307692307693
TEJON RANCH,CA,93,75,-18,0.44642857142857145
TEKAMAH,NE,787,794,7,0.502213788741303
TEKOA,WA,87,125,38,0.589622641509434
TEKONSHA,MI,886,611,-275,0.4081496325985304
TELEPHONE,TX,88,133,45,0.6018099547511312
TELFERNER,TX,12,0,-12,0
TELFORD,PA,4493,3908,-585,0.46518271634329245
TELFORD,TN,1275,1532,257,0.5457784111150694
TELL CITY,IN,4994,4469,-525,0.4722603825425341
TELLICO PLAINS,TN,2792,2902,110,0.5096592904812083
TELLICO PLNS,TN,50,56,6,0.5283018867924528
TELLURIDE,CO,3494,3103,-391,0.4703653175685918
TEMECULA,CA,53095,52324,-771,0.49634316394577827
TEMESCAL VALLEY,CA,250,302,52,0.5471014492753623
TEMPE,AZ,132931,111035,-21896,0.4551248944525057
TEMPERANCE,MI,6285,6270,-15,0.4994026284348865
TEMPERANCEVILLE,VA,45,25,-20,0.35714285714285715
TEMPLE,GA,8652,7165,-1487,0.45299361446544856
TEMPLE,ME,12,24,12,0.6666666666666666
TEMPLE,NH,321,269,-52,0.4559322033898305
TEMPLE,OK,373,304,-69,0.44903988183161003
TEMPLE,PA,3408,3449,41,0.502989645617617
TEMPLE,TX,43412,47605,4193,0.5230341584539152
TEMPLE CITY,CA,9619,9241,-378,0.4899787910922587
TEMPLE HILLS,MD,15303,13690,-1613,0.4721829407098265
TEMPLE TER,FL,640,659,19,0.5073133179368745
TEMPLE TERR,FL,5993,5381,-612,0.4730965359592052
TEMPLE TERRACE,FL,13920,12170,-1750,0.46646224607129166
TEMPLETON,CA,3759,3918,159,0.5103556076592419
TEMPLETON,IA,13,0,-13,0
TEMPLETON,MA,1641,1735,94,0.5139218009478673
TEMPLETON,PA,252,180,-72,0.4166666666666667
TEN MILE,TN,1289,1626,337,0.5578044596912521
TEN SLEEP,WY,46,61,15,0.5700934579439252
TENAFLY,NJ,4295,4928,633,0.5343163829556543
TENAHA,TX,669,576,-93,0.46265060240963857
TENANTS HARBOR,ME,686,688,2,0.5007278020378457
TENINO,WA,2888,3312,424,0.5341935483870968
TENMILE,OR,29,11,-18,0.275
TENN COLONY,TX,20,11,-9,0.3548387096774194
TENNESSEE COLONY,TX,566,476,-90,0.45681381957773515
TENNESSEE RIDGE,TN,1032,720,-312,0.410958904109589
TENNILLE,GA,1252,1338,86,0.5166023166023166
TENNYSON,IN,264,150,-114,0.36231884057971014
TENSTRIKE,MN,69,33,-36,0.3235294117647059
TEQUESTA,FL,4215,5340,1125,0.5588697017268446
TERLINGUA,TX,140,289,149,0.6736596736596736
TERLTON,OK,257,395,138,0.6058282208588958
TERRA,UT,11,0,-11,0
TERRA ALTA,WV,1817,1541,-276,0.4589041095890411
TERRA BELLA,CA,826,700,-126,0.45871559633027525
TERRA CEIA,FL,59,71,12,0.5461538461538461
TERRACE PARK,OH,469,607,138,0.5641263940520446
TERRAL,OK,0,12,12,1
TERRE HAUTE,IN,45555,40935,-4620,0.4732917100242803
TERRE HILL,PA,86,103,17,0.544973544973545
TERREBONNE,OR,3607,3663,56,0.5038514442916093
TERRELL,NC,777,781,4,0.5012836970474968
TERRELL,TX,11728,12345,617,0.5128151871391186
TERRETON,ID,76,43,-33,0.36134453781512604
TERRIL,IA,58,0,-58,0
TERRY,MS,1847,2217,370,0.5455216535433071
TERRY,MT,76,116,40,0.6041666666666666
TERRYTOWN,LA,3787,2934,-853,0.4365421812230323
TERRYVILLE,CT,3025,2977,-48,0.49600133288903697
TESCOTT,KS,12,0,-12,0
TESUQUE,NM,283,481,198,0.6295811518324608
TETON,ID,41,56,15,0.5773195876288659
TETON VILLAGE,WY,443,558,115,0.5574425574425574
TETONIA,ID,665,883,218,0.5704134366925064
TEUTOPOLIS,IL,626,486,-140,0.4370503597122302
TEWKSBURY,MA,9571,9602,31,0.5008084285192719
TEXARKANA,AR,15809,13364,-2445,0.4580948136975971
TEXARKANA,TX,28454,24687,-3767,0.46455655708398413
TEXAS CITY,TX,21163,19647,-1516,0.48142612104876253
TEXHOMA,OK,112,25,-87,0.18248175182481752
TEXICO,IL,22,0,-22,0
TEXICO,NM,101,133,32,0.5683760683760684
TEXLINE,TX,11,0,-11,0
THACKERVILLE,OK,815,762,-53,0.48319594166138236
THATCHER,AZ,2908,2184,-724,0.4289080911233307
THAWVILLE,IL,11,0,-11,0
THAXTON,MS,371,333,-38,0.47301136363636365
THAXTON,VA,563,673,110,0.5444983818770227
THAYER,IL,59,11,-48,0.15714285714285714
THAYER,IN,11,0,-11,0
THAYER,KS,275,136,-139,0.3309002433090024
THAYER,MO,2145,2157,12,0.50139470013947
THAYNE,WY,1272,1539,267,0.5474919957310566
THE COLONY,TX,25460,26376,916,0.5088355582992515
THE DALLES,OR,9866,8620,-1246,0.4662988207292005
THE HILLS,TX,2833,3389,556,0.5446801671488267
THE PLAINS,OH,1780,1800,20,0.5027932960893855
THE PLAINS,VA,859,837,-22,0.49351415094339623
THE ROCK,GA,34,66,32,0.66
THE SEA RANCH,CA,0,103,103,1
THE VILLAGES,FL,72151,94573,22422,0.5672428684532521
THE WOODLANDS,TX,15097,16116,1019,0.5163233268189537
THEALKA,KY,45,33,-12,0.4230769230769231
THEBES,IL,39,71,32,0.6454545454545455
THEDFORD,NE,22,15,-7,0.40540540540540543
THEILMAN,MN,0,14,14,1
THELMA,KY,208,156,-52,0.42857142857142855
THENDARA,NY,0,11,11,1
THEODORE,AL,8323,7700,-623,0.48055919615552645
THEODOSIA,MO,262,527,265,0.6679340937896071
THERESA,NY,1493,1205,-288,0.44662713120830244
THERESA,WI,543,452,-91,0.4542713567839196
THERIOT,LA,72,38,-34,0.34545454545454546
THERMAL,CA,2294,2353,59,0.5063481816225521
THERMOPOLIS,WY,2749,2369,-380,0.4628761234857366
THETFORD CENTER,VT,97,185,88,0.6560283687943262
THIBODAUX,LA,11779,11556,-223,0.49522176987358046
THIEF RIVER FALLS,MN,5601,4881,-720,0.4656554092730395
THIEF RVR FLS,MN,213,190,-23,0.47146401985111663
THIELLS,NY,510,517,7,0.5034079844206426
THIENSVILLE,WI,2462,2472,10,0.5010133765707336
THOMAS,OK,498,296,-202,0.37279596977329976
THOMAS,WV,103,102,-1,0.4975609756097561
THOMASBORO,IL,551,404,-147,0.42303664921465967
THOMASTON,CT,2517,2552,35,0.503452357466956
THOMASTON,GA,9551,8767,-784,0.47860028387378534
THOMASTON,ME,1228,1311,83,0.5163450177235132
THOMASVILLE,AL,2258,1896,-362,0.45642753972075106
THOMASVILLE,GA,12888,12654,-234,0.49541930937279777
THOMASVILLE,NC,14999,14596,-403,0.4931914174691671
THOMASVILLE,PA,1383,1200,-183,0.4645760743321719
THOMPSON,CT,1226,1409,183,0.5347248576850094
THOMPSON,IA,191,131,-60,0.40683229813664595
THOMPSON,ND,333,325,-8,0.4939209726443769
THOMPSON,OH,407,377,-30,0.48086734693877553
THOMPSON,PA,389,502,113,0.5634118967452301
THOMPSON FALLS,MT,1572,1595,23,0.5036311967161351
THOMPSON FLS,MT,48,64,16,0.5714285714285714
THOMPSONS STATION,TN,4930,6027,1097,0.5500593228073378
THOMPSONS STN,TN,291,405,114,0.5818965517241379
THOMPSONTOWN,PA,775,659,-116,0.4595536959553696
THOMPSONVILLE,IL,718,732,14,0.5048275862068966
THOMPSONVILLE,MI,828,904,76,0.5219399538106235
THOMSON,GA,5365,5267,-98,0.4953912716328066
THOMSON,IL,465,497,32,0.5166320166320166
THONOTOSASSA,FL,6450,7249,799,0.5291627126067596
THOREAU,NM,169,261,92,0.6069767441860465
THORN HILL,TN,411,657,246,0.6151685393258427
THORNBURG,VA,238,171,-67,0.4180929095354523
THORNDALE,PA,1175,1170,-5,0.4989339019189765
THORNDALE,TX,1004,1186,182,0.5415525114155251
THORNDIKE,MA,240,155,-85,0.3924050632911392
THORNDIKE,ME,178,245,67,0.5791962174940898
THORNE BAY,AK,91,27,-64,0.2288135593220339
THORNHURST,PA,218,236,18,0.5198237885462555
THORNTON,AR,11,0,-11,0
THORNTON,CA,24,0,-24,0
THORNTON,CO,64306,59854,-4452,0.4820715206185567
THORNTON,IA,26,12,-14,0.3157894736842105
THORNTON,IL,679,746,67,0.5235087719298246
THORNTON,NH,366,522,156,0.5878378378378378
THORNTON,PA,397,431,34,0.5205314009661836
THORNTON,TX,361,344,-17,0.4879432624113475
THORNTON,WV,98,39,-59,0.2846715328467153
THORNTOWN,IN,1263,1189,-74,0.48491027732463293
THORNVILLE,OH,3026,3164,138,0.5111470113085622
THORNWOOD,NY,1012,1097,85,0.5201517306780464
THOROFARE,NJ,509,530,21,0.5101058710298364
THORP,WA,11,24,13,0.6857142857142857
THORP,WI,1708,1267,-441,0.4258823529411765
THORSBY,AL,799,878,79,0.5235539654144306
THOUSAND ISLAND PARK,NY,128,72,-56,0.36
THOUSAND OAKS,CA,25419,26015,596,0.5057938328731967
THOUSAND PALMS,CA,3585,3876,291,0.5195014073180538
THRALL,TX,344,539,195,0.6104190260475651
THREE BRIDGES,NJ,339,218,-121,0.39138240574506283
THREE FORKS,MT,1975,2351,376,0.5434581599630144
THREE LAKES,WI,1978,1856,-122,0.4840897235263432
THREE MILE BAY,NY,518,486,-32,0.48406374501992033
THREE MLE BAY,NY,0,46,46,1
THREE OAKS,MI,1329,1242,-87,0.4830805134189031
THREE RIVERS,CA,1089,873,-216,0.44495412844036697
THREE RIVERS,MA,1046,1047,1,0.5002388915432394
THREE RIVERS,MI,8271,7641,-630,0.4802036199095023
THREE RIVERS,TX,665,826,161,0.5539906103286385
THREE SPRINGS,PA,395,388,-7,0.4955300127713921
THREE WAY,TN,142,165,23,0.5374592833876222
THROCKMORTON,TX,281,160,-121,0.36281179138321995
THROOP,PA,908,830,-78,0.47756041426927504
THURMAN,IA,27,0,-27,0
THURMAN,NY,47,32,-15,0.4050632911392405
THURMAN,OH,253,244,-9,0.4909456740442656
THURMOND,NC,128,151,23,0.5412186379928315
THURMONT,MD,3125,3247,122,0.5095731324544884
THURSTON,NE,0,13,13,1
THURSTON,OH,71,50,-21,0.4132231404958678
TIBBIE,AL,0,11,11,1
TIBURON,CA,1798,1931,133,0.5178331992491284
TICKFAW,LA,2350,2197,-153,0.48317572025511324
TICONDEROGA,NY,2530,2370,-160,0.48367346938775513
TIDEWATER,OR,156,48,-108,0.23529411764705882
TIDIOUTE,PA,807,646,-161,0.44459738472126636
TIERRA VERDE,FL,1102,1166,64,0.5141093474426808
TIETON,WA,574,593,19,0.508140531276778
TIFFIN,IA,3429,4018,589,0.5395461259567611
TIFFIN,OH,10663,9507,-1156,0.4713435795736242
TIFTON,GA,12309,12065,-244,0.4949946664478543
TIGARD,OR,14722,14352,-370,0.49363692646350693
TIGER,GA,834,938,104,0.5293453724604966
TIGERTON,WI,614,639,25,0.509976057462091
TIGNALL,GA,251,388,137,0.6071987480438185
TIJERAS,NM,3056,3411,355,0.5274470388124324
TILDEN,IL,99,55,-44,0.35714285714285715
TILDEN,NE,161,63,-98,0.28125
TILDEN,TX,12,0,-12,0
TILGHMAN,MD,72,153,81,0.68
TILINE,KY,0,22,22,1
TILLAMOOK,OR,6839,6170,-669,0.47428703205473133
TILLAR,AR,72,35,-37,0.32710280373831774
TILLATOBA,MS,14,37,23,0.7254901960784313
TILLEDA,WI,13,0,-13,0
TILLSON,NY,229,303,74,0.5695488721804511
TILTON,IL,1198,876,-322,0.4223722275795564
TILTON,NH,2914,3039,125,0.5104989081135561
TILTONSVILLE,OH,436,214,-222,0.3292307692307692
TIMBER,OR,16,0,-16,0
TIMBERLAKE,NC,1575,1769,194,0.5290071770334929
TIMBERON,NM,432,408,-24,0.4857142857142857
TIMBERVILLE,VA,1596,1444,-152,0.475
TIMBO,AR,0,11,11,1
TIMMONSVILLE,SC,3086,2613,-473,0.458501491489735
TIMNATH,CO,2457,5056,2599,0.6729668574470917
TIMONIUM,MD,1175,1110,-65,0.48577680525164113
TIMPSON,TX,1092,1071,-21,0.49514563106796117
TINA,MO,11,0,-11,0
TINGLEY,IA,12,0,-12,0
TINKER AFB,OK,1556,1019,-537,0.3957281553398058
TINLEY PARK,IL,15895,15494,-401,0.493612411991462
TINMOUTH,VT,57,64,7,0.5289256198347108
TINTON FALLS,NJ,5585,5416,-169,0.4923188801018089
TIOGA,LA,157,145,-12,0.48013245033112584
TIOGA,ND,1320,1036,-284,0.4397283531409168
TIOGA,PA,1273,1127,-146,0.46958333333333335
TIOGA,TX,509,778,269,0.6045066045066045
TIOGA,WV,11,0,-11,0
TIONESTA,PA,952,956,4,0.5010482180293501
TIPLERSVILLE,MS,36,0,-36,0
TIPP,OH,150,151,1,0.5016611295681063
TIPP CITY,OH,7126,8249,1123,0.536520325203252
TIPPECANOE,IN,11,34,23,0.7555555555555555
TIPPECANOE,OH,47,50,3,0.5154639175257731
TIPTON,CA,237,251,14,0.514344262295082
TIPTON,IA,1937,1767,-170,0.47705183585313177
TIPTON,IN,3281,3305,24,0.501822046765867
TIPTON,MI,580,502,-78,0.46395563770794823
TIPTON,MO,1058,1043,-15,0.4964302712993812
TIPTON,OK,71,85,14,0.5448717948717948
TIPTONVILLE,TN,1715,1564,-151,0.47697468740469656
TIRO,OH,36,11,-25,0.23404255319148937
TISHOMINGO,MS,927,803,-124,0.4641618497109827
TISHOMINGO,OK,1916,1897,-19,0.4975085234723315
TISKILWA,IL,206,140,-66,0.4046242774566474
TITONKA,IA,132,133,1,0.5018867924528302
TITUS,AL,454,694,240,0.6045296167247387
TITUSVILLE,FL,33854,35645,1791,0.5128850774831293
TITUSVILLE,NJ,735,743,8,0.5027063599458728
TITUSVILLE,PA,4614,3987,-627,0.4635507499128008
TIVERTON,RI,5434,5914,480,0.5211491011632006
TIVOLI,NY,992,802,-190,0.44704570791527315
TIVOLI,TX,47,13,-34,0.21666666666666667
TOANO,VA,2608,3188,580,0.5500345065562456
TOAST,NC,70,54,-16,0.43548387096774194
TOBACCOVILLE,NC,876,1071,195,0.5500770416024653
TOBYHANNA,PA,7285,5935,-1350,0.4489409984871407
TOCCOA,GA,9281,8527,-754,0.478829739442947
TODD,NC,499,664,165,0.5709372312983663
TODD MISSION,TX,16,21,5,0.5675675675675675
TODDVILLE,IA,89,25,-64,0.21929824561403508
TOFTE,MN,50,22,-28,0.3055555555555556
TOGIAK,AK,17,49,32,0.7424242424242424
TOHATCHI,NM,326,115,-211,0.26077097505668934
TOIVOLA,MI,113,171,58,0.602112676056338
TOK,AK,322,344,22,0.5165165165165165
TOKELAND,WA,0,15,15,1
TOLAR,TX,1247,1412,165,0.5310267017675818
TOLEDO,IA,1394,1326,-68,0.4875
TOLEDO,IL,761,820,59,0.5186590765338394
TOLEDO,OH,142745,126121,-16624,0.46908497169593777
TOLEDO,OR,2804,2352,-452,0.4561675717610551
TOLEDO,WA,1353,1660,307,0.5509459010952539
TOLLAND,CT,3742,3991,249,0.5160998318893055
TOLLAND,MA,46,71,25,0.6068376068376068
TOLLESBORO,KY,964,875,-89,0.4758020663404024
TOLLESON,AZ,16410,16120,-290,0.4955425760836151
TOLLHOUSE,CA,808,549,-259,0.40456890198968315
TOLNA,ND,22,0,-22,0
TOLONO,IL,1272,1278,6,0.5011764705882353
TOLTEC,AZ,204,113,-91,0.35646687697160884
TOLUCA,IL,748,518,-230,0.40916271721958924
TOLUCA LAKE,CA,2831,2359,-472,0.45452793834296723
TOM BEAN,TX,53,11,-42,0.171875
TOMAH,WI,8312,7628,-684,0.4785445420326223
TOMAHAWK,KY,0,39,39,1
TOMAHAWK,WI,5304,5068,-236,0.4886232163517162
TOMALES,CA,22,0,-22,0
TOMBALL,TX,34781,40038,5257,0.5351314505673692
TOMBSTONE,AZ,1157,1256,99,0.5205138831330294
TOMKINS COVE,NY,443,480,37,0.5200433369447454
TOMPKINSVILLE,KY,2952,2610,-342,0.4692556634304207
TOMS BROOK,VA,481,350,-131,0.42117930204572807
TOMS RIVER,NJ,40532,43112,2580,0.5154225049017264
TONALEA,AZ,57,151,94,0.7259615384615384
TONASKET,WA,2306,2392,86,0.5091528309919114
TONAWANDA,NY,15328,13739,-1589,0.4726665978601163
TONEY,AL,4454,4833,379,0.5204048670184128
TONGANOXIE,KS,3152,3678,526,0.538506588579795
TONICA,IL,164,108,-56,0.39705882352941174
TONKAWA,OK,1198,1184,-14,0.49706129303106633
TONOPAH,AZ,3044,4000,956,0.5678591709256104
TONOPAH,NV,819,695,-124,0.45904887714663145
TONTITOWN,AR,2825,3126,301,0.5252898672492018
TONTO BASIN,AZ,1588,1620,32,0.5049875311720698
TONTOGANY,OH,51,0,-51,0
TONY,WI,0,13,13,1
TOOELE,UT,17381,19851,2470,0.5331703910614525
TOOL,TX,1680,1961,281,0.538588299917605
TOOMSBORO,GA,11,37,26,0.7708333333333334
TOOMSUBA,MS,706,550,-156,0.43789808917197454
TOONE,TN,184,241,57,0.5670588235294117
TOPANGA,CA,3655,3154,-501,0.4632104567484212
TOPEKA,IL,78,113,35,0.5916230366492147
TOPEKA,IN,1344,1050,-294,0.43859649122807015
TOPEKA,KS,83762,72344,-11418,0.46342869588612867
TOPINABEE,MI,144,178,34,0.5527950310559007
TOPMOST,KY,13,11,-2,0.4583333333333333
TOPOCK,AZ,1198,1317,119,0.5236580516898608
TOPPENISH,WA,3026,2081,-945,0.40747992950851775
TOPPING,VA,254,281,27,0.525233644859813
TOPSAIL BEACH,NC,273,352,79,0.5632
TOPSFIELD,MA,1715,1895,180,0.5249307479224377
TOPSHAM,ME,3604,3948,344,0.5227754237288136
TOPSHAM,VT,0,23,23,1
TOPTON,NC,147,428,281,0.7443478260869565
TOPTON,PA,1074,769,-305,0.4172544763971785
TOQUERVILLE,UT,592,647,55,0.5221953188054883
TORBERT,LA,0,24,24,1
TORNADO,WV,82,104,22,0.5591397849462365
TORNILLO,TX,0,36,36,1
TORONTO,IA,12,14,2,0.5384615384615384
TORONTO,KS,59,118,59,0.6666666666666666
TORONTO,OH,3737,3139,-598,0.45651541593949974
TORRANCE,CA,56544,53633,-2911,0.48678943881209324
TORREY,UT,35,11,-24,0.2391304347826087
TORRINGTON,CT,14705,14370,-335,0.4942390369733448
TORRINGTON,WY,4405,3994,-411,0.47553280152399097
TOSTON,MT,11,36,25,0.7659574468085106
TOTOWA,NJ,2865,3016,151,0.5128379527291277
TOUCHET,WA,88,129,41,0.5944700460829493
TOUGALOO,MS,0,12,12,1
TOUGHKENAMON,PA,13,25,12,0.6578947368421053
TOULON,IL,694,639,-55,0.47936984246061515
TOUTLE,WA,295,312,17,0.514003294892916
TOVEY,IL,161,34,-127,0.17435897435897435
TOW,TX,157,193,36,0.5514285714285714
TOWACO,NJ,1127,1397,270,0.553486529318542
TOWADA,PA,51,31,-20,0.3780487804878049
TOWANDA,IL,111,97,-14,0.46634615384615385
TOWANDA,KS,1097,1198,101,0.5220043572984749
TOWANDA,PA,4246,3974,-272,0.4834549878345499
TOWAOC,CO,0,22,22,1
TOWER,MN,1716,1487,-229,0.46425226350296595
TOWER CITY,PA,1067,955,-112,0.4723046488625124
TOWER HILL,IL,103,98,-5,0.48756218905472637
TOWN CREEK,AL,1637,1748,111,0.5163958641063515
TOWN OF TONAWANDA,NY,311,262,-49,0.4572425828970332
TOWNER,ND,53,30,-23,0.3614457831325301
TOWNLEY,AL,11,0,-11,0
TOWNSEND,DE,2982,3740,758,0.5563820291579887
TOWNSEND,GA,2441,2618,177,0.5174935758054952
TOWNSEND,MA,2417,2123,-294,0.4676211453744493
TOWNSEND,MT,2056,2403,347,0.5389100695223145
TOWNSEND,TN,1627,1726,99,0.5147628988965106
TOWNSEND,WI,793,659,-134,0.45385674931129477
TOWNSHEND,VT,349,267,-82,0.43344155844155846
TOWNSHIP OF WASHINGTON,NJ,1568,1891,323,0.5466897947383637
TOWNVILLE,PA,201,129,-72,0.39090909090909093
TOWNVILLE,SC,1683,1728,45,0.5065963060686016
TOWSON,MD,16898,16799,-99,0.49853102650087544
TOXEY,AL,35,0,-35,0
TRABUCO,CA,100,153,53,0.6047430830039525
TRABUCO CANYON,CA,4891,5619,728,0.5346336822074215
TRABUCO CYN,CA,13,0,-13,0
TRACY,CA,33841,36606,2765,0.5196246823853393
TRACY,MN,1381,1220,-161,0.46905036524413685
TRACY CITY,TN,1182,1038,-144,0.46756756756756757
TRACYS LANDING,MD,200,188,-12,0.4845360824742268
TRACYS LNDG,MD,44,0,-44,0
TRACYTON,WA,507,238,-269,0.3194630872483222
TRADE,TN,54,110,56,0.6707317073170732
TRAER,IA,815,770,-45,0.48580441640378547
TRAFALGAR,IN,1650,1741,91,0.513417870834562
TRAFFORD,AL,512,619,107,0.5473032714412025
TRAFFORD,PA,2188,2269,81,0.5090868297060803
TRAIL,OR,537,576,39,0.5175202156334232
TRAILER EST,FL,18,100,82,0.847457627118644
TRAILER ESTATES,FL,230,0,-230,0
TRAM,KY,11,0,-11,0
TRANQUILLITY,CA,11,11,0,0.5
TRANSFER,PA,661,601,-60,0.4762282091917591
TRAPHILL,NC,191,255,64,0.5717488789237668
TRAPPE,MD,904,1082,178,0.5448136958710977
TRAPPE,PA,798,844,46,0.5140073081607796
TRAPPER CREEK,AK,51,86,35,0.6277372262773723
TRASKWOOD,AR,187,300,113,0.6160164271047228
TRAVELERS REST,SC,6808,8073,1265,0.5425038639876353
TRAVERSE CITY,MI,42434,39769,-2665,0.4837901293140153
TRAVIS AFB,CA,3055,3535,480,0.5364188163884673
TREADWAY,TN,14,23,9,0.6216216216216216
TREADWELL,NY,23,11,-12,0.3235294117647059
TREASURE IS,FL,800,840,40,0.5121951219512195
TREASURE ISLAND,FL,3747,4134,387,0.5245527217358203
TREDYFFRIN,PA,49,60,11,0.5504587155963303
TREGO,MT,83,32,-51,0.2782608695652174
TREGO,WI,715,682,-33,0.4881889763779528
TREMONT,IL,1130,1183,53,0.5114569822741029
TREMONT,MS,115,96,-19,0.4549763033175355
TREMONT,PA,1129,842,-287,0.4271943176052765
TREMONT CITY,OH,11,0,-11,0
TREMONTON,UT,4014,4879,865,0.5486337568874395
TREMPEALEAU,WI,1247,1244,-3,0.4993978321959053
TRENARY,MI,35,52,17,0.5977011494252874
TRENT,SD,0,11,11,1
TRENT WOODS,NC,1097,983,-114,0.47259615384615383
TRENTON,FL,3397,3998,601,0.5406355645706559
TRENTON,GA,2974,3054,80,0.506635700066357
TRENTON,IL,1129,1074,-55,0.48751702224239674
TRENTON,KY,353,103,-250,0.22587719298245615
TRENTON,MI,6545,6075,-470,0.48137876386687795
TRENTON,MO,3845,3585,-260,0.48250336473755046
TRENTON,NC,948,1126,178,0.5429122468659595
TRENTON,ND,81,0,-81,0
TRENTON,NE,155,40,-115,0.20512820512820512
TRENTON,NJ,44250,38865,-5385,0.467605125428623
TRENTON,OH,5702,4807,-895,0.45741745170805975
TRENTON,SC,1486,1370,-116,0.4796918767507003
TRENTON,TN,3781,3448,-333,0.4769677687093651
TRENTON,TX,878,1084,206,0.5524974515800204
TRES PIEDRAS,NM,14,12,-2,0.46153846153846156
TRES PINOS,CA,17,56,39,0.7671232876712328
TRESCKOW,PA,321,0,-321,0
TRESCOTT TWP,ME,50,31,-19,0.38271604938271603
TREVETT,ME,55,133,78,0.7074468085106383
TREVOR,WI,1837,1798,-39,0.49463548830811555
TREVORTON,PA,319,269,-50,0.4574829931972789
TREXLERTOWN,PA,537,364,-173,0.4039955604883463
TREYNOR,IA,350,349,-1,0.49928469241773965
TREZEVANT,TN,439,538,99,0.5506653019447287
TRIADELPHIA,WV,1218,1133,-85,0.4819225861335602
TRIANGLE,VA,6957,5003,-1954,0.41831103678929765
TRIBES HILL,NY,0,12,12,1
TRIBUNE,KS,285,238,-47,0.45506692160611856
TRILBY,FL,136,44,-92,0.24444444444444444
TRILLA,IL,11,0,-11,0
TRIMBLE,MO,409,636,227,0.6086124401913876
TRIMBLE,TN,70,48,-22,0.4067796610169492
TRIMONT,MN,89,76,-13,0.46060606060606063
TRINIDAD,CA,1253,1221,-32,0.4935327405012126
TRINIDAD,CO,4985,5083,98,0.5048669050456893
TRINIDAD,TX,1034,1094,60,0.5140977443609023
TRINITY,AL,1999,2118,119,0.5144522710711683
TRINITY,FL,4971,5651,680,0.5320090378459801
TRINITY,NC,3633,4479,846,0.5521449704142012
TRINITY,TX,2994,3622,628,0.5474607013301088
TRINITY CENTER,CA,169,35,-134,0.1715686274509804
TRINWAY,OH,12,0,-12,0
TRION,GA,2194,2332,138,0.5152452496685815
TRIPOLI,IA,628,390,-238,0.3831041257367387
TRIPOLI,WI,11,47,36,0.8103448275862069
TRIPP,SD,164,52,-112,0.24074074074074073
TRIVOLI,IL,47,95,48,0.6690140845070423
TRONA,CA,701,585,-116,0.4548989113530327
TROPHY CLUB,TX,1747,1918,171,0.5233287858117326
TROSKY,MN,13,12,-1,0.48
TROTWOOD,OH,2737,2672,-65,0.4939914956553892
TROUP,TX,2640,2582,-58,0.49444657219456145
TROUPSBURG,NY,110,57,-53,0.3413173652694611
TROUT,LA,375,387,12,0.5078740157480315
TROUT CREEK,MI,36,34,-2,0.4857142857142857
TROUT CREEK,MT,724,942,218,0.5654261704681873
TROUT LAKE,MI,14,46,32,0.7666666666666667
TROUT LAKE,WA,248,200,-48,0.44642857142857145
TROUT RUN,PA,688,741,53,0.5185444366689993
TROUT VALLEY,IL,386,396,10,0.5063938618925832
TROUTDALE,OR,6847,6851,4,0.5001460067163089
TROUTDALE,VA,40,26,-14,0.3939393939393939
TROUTMAN,NC,3416,4939,1523,0.5911430281268701
TROUTVILLE,VA,1986,2333,347,0.5401713359573975
TROY,AL,10444,8450,-1994,0.44723192547898805
TROY,ID,443,599,156,0.5748560460652591
TROY,IL,5351,4948,-403,0.4804349936887076
TROY,IN,36,0,-36,0
TROY,KS,360,344,-16,0.48863636363636365
TROY,ME,148,204,56,0.5795454545454546
TROY,MI,31361,30368,-993,0.49195677882356753
TROY,MO,10132,10247,115,0.502821531969184
TROY,MT,1869,2006,137,0.5176774193548387
TROY,NC,1995,1927,-68,0.49133095359510454
TROY,NH,768,869,101,0.5308491142333537
TROY,NY,38208,30694,-7514,0.44547328089170124
TROY,OH,13410,13430,20,0.5003725782414307
TROY,PA,2007,1771,-236,0.46876654314452093
TROY,SC,51,59,8,0.5363636363636364
TROY,TN,1618,1504,-114,0.4817424727738629
TROY,TX,1904,2211,307,0.5373025516403402
TROY,VA,1005,1341,336,0.571611253196931
TROY,VT,12,13,1,0.52
TRUCKEE,CA,9670,10301,631,0.5157979069650994
TRUCKSVILLE,PA,46,43,-3,0.48314606741573035
TRUESDALE,MO,130,135,5,0.5094339622641509
TRUFANT,MI,401,427,26,0.5157004830917874
TRUMAN,MN,745,646,-99,0.46441409058231486
TRUMANN,AR,5283,4613,-670,0.46614793856103476
TRUMANSBURG,NY,2717,2742,25,0.502289796666056
TRUMBAUERSVILLE,PA,246,113,-133,0.3147632311977716
TRUMBULL,CT,8663,10109,1446,0.5385148092904326
TRURO,IA,198,199,1,0.5012594458438288
TRURO,MA,1742,1794,52,0.5073529411764706
TRUSSVILLE,AL,8056,9358,1302,0.5373837142529
TRUTH OR CONSEQUENCES,NM,3739,3673,-66,0.4955477603885591
TRUXTON,NY,246,194,-52,0.4409090909090909
TRYON,NC,2904,2880,-24,0.4979253112033195
TRYON,NE,17,0,-17,0
TRYON,OK,61,115,54,0.6534090909090909
TUALATIN,OR,14293,12815,-1478,0.47273867492991
TUBA CITY,AZ,912,1023,111,0.5286821705426357
TUBAC,AZ,1203,1543,340,0.5619082301529498
TUCKAHOE,NJ,11,0,-11,0
TUCKAHOE,NY,2990,2869,-121,0.48967400580303805
TUCKASEGEE,NC,227,334,107,0.5953654188948306
TUCKER,GA,15518,15029,-489,0.49199594068157265
TUCKERMAN,AR,921,770,-151,0.4553518628030751
TUCKERTON,NJ,1793,1936,143,0.5191740412979351
TUCSON,AZ,445908,441256,-4652,0.4973781623239897
TUCUMCARI,NM,2520,2594,74,0.5072350410637466
TUJUNGA,CA,7151,6678,-473,0.4828982572854147
TUKWILA,WA,15209,13467,-1742,0.4696261682242991
TULALIP,WA,3310,3443,133,0.5098474751962091
TULARE,CA,22489,21561,-928,0.48946651532349605
TULAROSA,NM,1971,1698,-273,0.4627964022894522
TULELAKE,CA,611,307,-304,0.3344226579520697
TULIA,TX,1812,1539,-273,0.459265890778872
TULLAHOMA,TN,11038,11288,250,0.5055988533548329
TULLOS,LA,13,14,1,0.5185185185185185
TULLY,NY,1963,1807,-156,0.4793103448275862
TULSA,OK,200402,181779,-18623,0.4756358898009059
TUMACACORI,AZ,349,544,195,0.6091825307950728
TUMBLING SHOALS,AR,170,118,-52,0.4097222222222222
TUMTUM,WA,0,12,12,1
TUMWATER,WA,10753,10367,-386,0.4908617424242424
TUNAS,MO,88,133,45,0.6018099547511312
TUNBRIDGE,VT,177,235,58,0.5703883495145631
TUNICA,MS,1540,1547,7,0.5011337868480725
TUNKHANNOCK,PA,4175,3668,-507,0.46767818436822645
TUNNEL HILL,GA,2946,3079,133,0.5110373443983403
TUNNEL HILL,IL,41,64,23,0.6095238095238096
TUNNELTON,WV,558,468,-90,0.45614035087719296
TUOLUMNE,CA,1304,1293,-11,0.4978821717366192
TUPELO,MS,18247,16381,-1866,0.4730564860806284
TUPELO,OK,110,51,-59,0.3167701863354037
TUPMAN,CA,12,0,-12,0
TUPPER LAKE,NY,3294,2850,-444,0.4638671875
TURBEVILLE,SC,658,466,-192,0.41459074733096085
TURBOTVILLE,PA,656,557,-99,0.45919208573784004
TURIN,NY,46,15,-31,0.2459016393442623
TURKEY,NC,362,192,-170,0.34657039711191334
TURKEY CREEK,KY,39,41,2,0.5125
TURLOCK,CA,30221,23436,-6785,0.4367743258102391
TURNER,ME,2027,2219,192,0.5226095148374941
TURNER,MI,26,65,39,0.7142857142857143
TURNER,OR,2359,2738,379,0.5371787325877967
TURNERS FALLS,MA,2435,2207,-228,0.475441619991383
TURNERS STATION,KY,91,94,3,0.5081081081081081
TURNERSVILLE,NJ,1770,1831,61,0.5084698694806998
TURNEY,MO,13,0,-13,0
TURON,KS,113,56,-57,0.33136094674556216
TURPIN,OK,156,154,-2,0.4967741935483871
TURRELL,AR,85,11,-74,0.11458333333333333
TURTLE CREEK,PA,3302,2456,-846,0.42653699201111495
TURTLE LAKE,ND,127,89,-38,0.41203703703703703
TURTLE LAKE,WI,1445,1347,-98,0.48244985673352436
TURTLEPOINT,PA,21,36,15,0.631578947368421
TURTLETOWN,TN,195,272,77,0.582441113490364
TUSCALOOSA,AL,44824,37701,-7123,0.4568433807936989
TUSCARAWAS,OH,70,38,-32,0.35185185185185186
TUSCOLA,IL,2560,2393,-167,0.48314153038562485
TUSCOLA,TX,1457,2095,638,0.5898085585585585
TUSCUMBIA,AL,6504,6743,239,0.5090209103948063
TUSCUMBIA,MO,48,64,16,0.5714285714285714
TUSKAHOMA,OK,99,79,-20,0.4438202247191011
TUSKEGEE,AL,2544,2206,-338,0.46442105263157896
TUSKEGEE INSTITUTE,AL,1175,459,-716,0.28090575275397794
TUSTIN,CA,33394,31050,-2344,0.48181366768046674
TUSTIN,MI,1119,928,-191,0.45334636052760136
TUTTLE,OK,3553,4345,792,0.5501392757660167
TUTWILER,MS,54,52,-2,0.49056603773584906
TUXEDO PARK,NY,1554,1526,-28,0.4954545454545455
TWAIN HARTE,CA,2177,1971,-206,0.475168756027001
TWELVE MILE,IN,77,67,-10,0.4652777777777778
TWENTYNINE PALMS,CA,13581,11012,-2569,0.44776969056235516
TWIN BRIDGES,CA,0,16,16,1
TWIN BRIDGES,MT,302,225,-77,0.4269449715370019
TWIN CITY,GA,992,1018,26,0.5064676616915423
TWIN FALLS,ID,29775,29397,-378,0.4968059217197323
TWIN LAKE,MI,3827,3698,-129,0.49142857142857144
TWIN LAKES,CO,27,23,-4,0.46
TWIN LAKES,WI,3229,3239,10,0.5007730364873222
TWIN MOUNTAIN,NH,201,161,-40,0.4447513812154696
TWIN PEAKS,CA,688,686,-2,0.4992721979621543
TWIN ROCKS,PA,0,11,11,1
TWIN VALLEY,MN,419,329,-90,0.43983957219251335
TWINING,MI,268,220,-48,0.45081967213114754
TWINSBURG,OH,6479,7239,760,0.5277008310249307
TWISP,WA,1148,1129,-19,0.4958278436539306
TWO HARBORS,MN,2667,2644,-23,0.49783468273394843
TWO RIVERS,AK,0,22,22,1
TWO RIVERS,WI,5916,5409,-507,0.4776158940397351
TY TY,GA,548,535,-13,0.4939981532779317
TYBEE ISLAND,GA,1875,2036,161,0.5205829711071337
TYE,TX,424,408,-16,0.49038461538461536
TYGH VALLEY,OR,529,490,-39,0.48086359175662413
TYLER,AL,13,0,-13,0
TYLER,MN,411,366,-45,0.47104247104247104
TYLER,TX,62903,60768,-2135,0.4913682269893508
TYLERTOWN,MS,2545,2723,178,0.5168944570994685
TYNDALL,SD,279,319,40,0.5334448160535117
TYNDALL AFB,FL,104,60,-44,0.36585365853658536
TYNER,KY,238,278,40,0.5387596899224806
TYNER,NC,140,298,158,0.680365296803653
TYNGSBORO,MA,3200,3722,522,0.5377058653568333
TYRINGHAM,MA,18,0,-18,0
TYRO,KS,13,0,-13,0
TYRONE,GA,2791,3449,658,0.552724358974359
TYRONE,NM,333,149,-184,0.3091286307053942
TYRONE,OK,72,60,-12,0.45454545454545453
TYRONE,PA,4387,3844,-543,0.46701494350625683
TYRONZA,AR,208,214,6,0.5071090047393365
TYSONS,VA,511,442,-69,0.46379853095487933
TYSONS CORNER,VA,211,271,60,0.5622406639004149
UBLY,MI,827,636,-191,0.43472317156527684
UCON,ID,0,24,24,1
UDALL,KS,426,576,150,0.5748502994011976
UEHLING,NE,12,0,-12,0
UHRICHSVILLE,OH,3211,3105,-106,0.49160861304623177
UKIAH,CA,11040,9460,-1580,0.46146341463414636
ULEDI,PA,11,0,-11,0
ULEN,MN,23,80,57,0.7766990291262136
ULLIN,IL,11,0,-11,0
ULM,MT,0,25,25,1
ULSTER,PA,746,626,-120,0.45626822157434405
ULSTER PARK,NY,635,807,172,0.5596393897364771
ULYSSES,KS,2179,1947,-232,0.47188560349006303
ULYSSES,NE,11,0,-11,0
ULYSSES,PA,474,406,-68,0.46136363636363636
UMATILLA,FL,4822,7164,2342,0.5976973135324545
UMATILLA,OR,3715,2337,-1378,0.3861533377395902
UMPQUA,OR,78,79,1,0.5031847133757962
UNA,SC,71,126,55,0.6395939086294417
UNADILLA,GA,513,497,-16,0.49207920792079207
UNADILLA,NY,1850,1564,-286,0.45811364967779733
UNALAKLEET,AK,24,0,-24,0
UNALASKA,AK,47,22,-25,0.3188405797101449
UNCASVILLE,CT,3616,3523,-93,0.49348648270065837
UNDERHILL,VT,764,906,142,0.5425149700598803
UNDERWOOD,IA,314,386,72,0.5514285714285714
UNDERWOOD,IN,145,162,17,0.5276872964169381
UNDERWOOD,MN,623,646,23,0.5090622537431048
UNDERWOOD,ND,241,66,-175,0.21498371335504887
UNDERWOOD,WA,246,189,-57,0.43448275862068964
UNICOI,TN,1521,1663,142,0.5222989949748744
UNION,CT,187,167,-20,0.4717514124293785
UNION,IA,133,57,-76,0.3
UNION,IL,157,230,73,0.5943152454780362
UNION,KY,6273,8259,1986,0.5683319570602807
UNION,ME,926,968,42,0.5110876451953538
UNION,MI,695,589,-106,0.45872274143302183
UNION,MO,7934,7492,-442,0.48567353818228964
UNION,MS,2182,1875,-307,0.46216416070988414
UNION,NE,34,14,-20,0.2916666666666667
UNION,NH,97,71,-26,0.4226190476190476
UNION,NJ,14912,15119,207,0.5034464386800306
UNION,OH,147,157,10,0.5164473684210527
UNION,OR,1130,983,-147,0.4652153336488405
UNION,SC,6027,5485,-542,0.4764593467685893
UNION,WA,1542,1434,-108,0.48185483870967744
UNION,WV,274,372,98,0.5758513931888545
UNION BEACH,NJ,924,805,-119,0.46558704453441296
UNION BRIDGE,MD,1361,1298,-63,0.48815344114328696
UNION CITY,CA,23422,20680,-2742,0.46891297446827807
UNION CITY,GA,12734,11597,-1137,0.4766347457975422
UNION CITY,IN,2205,1996,-209,0.47512497024517975
UNION CITY,MI,1798,1505,-293,0.4556463820768998
UNION CITY,NJ,21690,16799,-4891,0.43646236587076825
UNION CITY,OH,1265,1133,-132,0.4724770642201835
UNION CITY,OK,37,77,40,0.6754385964912281
UNION CITY,PA,3088,2646,-442,0.461457970003488
UNION CITY,TN,7192,6482,-710,0.47403832090097997
UNION DALE,PA,450,491,41,0.5217853347502657
UNION GAP,WA,958,1002,44,0.5112244897959184
UNION GROVE,AL,1290,1511,221,0.5394501963584434
UNION GROVE,NC,299,174,-125,0.3678646934460888
UNION GROVE,WI,2987,3150,163,0.5132801042854815
UNION HALL,VA,500,628,128,0.5567375886524822
UNION LAKE,MI,166,110,-56,0.39855072463768115
UNION MILLS,IN,439,462,23,0.5127635960044395
UNION MILLS,NC,509,777,268,0.604199066874028
UNION PARK,FL,338,304,-34,0.4735202492211838
UNION PIER,MI,388,333,-55,0.4618585298196949
UNION POINT,GA,567,646,79,0.5325638911788954
UNION SPRINGS,AL,1579,1462,-117,0.4807629069385071
UNION SPRINGS,NY,755,689,-66,0.47714681440443213
UNION STAR,MO,12,27,15,0.6923076923076923
UNIONDALE,IN,46,58,12,0.5576923076923077
UNIONDALE,NY,9067,6884,-2183,0.43157168829540465
UNIONTOWN,AL,272,313,41,0.535042735042735
UNIONTOWN,AR,30,49,19,0.620253164556962
UNIONTOWN,KS,0,12,12,1
UNIONTOWN,KY,447,428,-19,0.48914285714285716
UNIONTOWN,OH,7995,8185,190,0.5058714462299134
UNIONTOWN,PA,12654,11907,-747,0.48479296445584463
UNIONTOWN,WA,0,25,25,1
UNIONVILLE,CT,2247,2268,21,0.5023255813953489
UNIONVILLE,IA,12,0,-12,0
UNIONVILLE,IN,446,274,-172,0.38055555555555554
UNIONVILLE,MI,486,421,-65,0.46416758544652703
UNIONVILLE,MO,1741,1802,61,0.5086085238498448
UNIONVILLE,NY,51,0,-51,0
UNIONVILLE,PA,57,26,-31,0.3132530120481928
UNIONVILLE,TN,986,1055,69,0.5169034786869182
UNIONVILLE,VA,888,957,69,0.5186991869918699
UNIOPOLIS,OH,14,0,-14,0
UNITED STATES AIR FORCE ACAD,CO,146,111,-35,0.43190661478599224
UNITY,ME,986,904,-82,0.4783068783068783
UNITY,WI,148,27,-121,0.15428571428571428
UNITYVILLE,PA,33,36,3,0.5217391304347826
UNIVERSAL CITY,TX,12794,10757,-2037,0.456753428729141
UNIVERSITY CITY,MO,2695,2409,-286,0.47198275862068967
UNIVERSITY HEIGHTS,OH,1624,1445,-179,0.4708374063212773
UNIVERSITY HTS,OH,346,398,52,0.5349462365591398
UNIVERSITY PARK,FL,2361,2960,599,0.5562864123285097
UNIVERSITY PARK,IA,83,0,-83,0
UNIVERSITY PARK,IL,2908,2340,-568,0.4458841463414634
UNIVERSITY PARK,MD,976,902,-74,0.4802981895633653
UNIVERSITY PARK,PA,12,105,93,0.8974358974358975
UNIVERSITY PL,WA,1175,1094,-81,0.4821507271925959
UNIVERSITY PLACE,WA,15484,14791,-693,0.48855491329479767
UPATOI,GA,89,140,51,0.611353711790393
UPHAMS CORNER,MA,2402,1913,-489,0.4433371958285052
UPLAND,CA,28017,27350,-667,0.493976556432532
UPLAND,IN,1192,1141,-51,0.48906986712387485
UPLAND,PA,102,96,-6,0.48484848484848486
UPPER ARLINGTON,OH,3543,3421,-122,0.49124066628374496
UPPER ARLNGTN,OH,352,397,45,0.5300400534045394
UPPER BLACK EDDY,PA,869,912,43,0.5120718697361033
UPPER CHICHESTER,PA,994,974,-20,0.4949186991869919
UPPER DARBY,PA,14176,10729,-3447,0.43079702870909453
UPPER JAY,NY,28,0,-28,0
UPPER LAKE,CA,1070,912,-158,0.4601412714429869
UPPER MARLBORO,MD,26577,30620,4043,0.5353427627323112
UPPER MONTCLAIR,NJ,881,1094,213,0.5539240506329114
UPPER SADDLE RIVER,NJ,1629,1985,356,0.5492529053680133
UPPER SAINT CLAIR,PA,377,447,70,0.5424757281553398
UPPER SANDUSKY,OH,4347,3608,-739,0.4535512256442489
UPPER ST CLAIR,PA,396,430,34,0.5205811138014528
UPPER TRACT,WV,0,24,24,1
UPPERCO,MD,372,586,214,0.6116910229645094
UPPERVILLE,VA,39,39,0,0.5
UPPR BLCK EDY,PA,22,20,-2,0.47619047619047616
UPPR MARLBORO,MD,1599,1720,121,0.518228382042784
UPPR MORELAND,PA,112,149,37,0.5708812260536399
UPR MONTCLAIR,NJ,85,106,21,0.5549738219895288
UPTON,KY,924,856,-68,0.48089887640449436
UPTON,MA,2081,2565,484,0.5520878174773999
UPTON,ME,25,51,26,0.6710526315789473
UPTON,NY,11,0,-11,0
UPTON,WY,309,279,-30,0.4744897959183674
URANIA,LA,12,12,0,0.5
URBANA,IA,257,398,141,0.6076335877862595
URBANA,IL,28377,22019,-6358,0.4369195967933963
URBANA,IN,40,0,-40,0
URBANA,MD,984,1524,540,0.6076555023923444
URBANA,MO,759,814,55,0.5174825174825175
URBANA,OH,7213,7290,77,0.5026546231814107
URBANDALE,IA,20551,18199,-2352,0.4696516129032258
URBANNA,VA,428,643,215,0.6003734827264239
URIAH,AL,136,82,-54,0.3761467889908257
URICH,MO,297,300,3,0.5025125628140703
URSA,IL,171,103,-68,0.3759124087591241
USAF ACADEMY,CO,9210,1797,-7413,0.1632597437994004
USK,WA,605,547,-58,0.4748263888888889
UTE,IA,48,0,-48,0
UTICA,IL,624,537,-87,0.4625322997416021
UTICA,KY,1973,2271,298,0.5351083883129123
UTICA,MI,3046,2611,-435,0.46155205939543925
UTICA,MN,0,12,12,1
UTICA,MS,769,833,64,0.5199750312109863
UTICA,NE,160,128,-32,0.4444444444444444
UTICA,NY,34357,30431,-3926,0.46970117923072174
UTICA,OH,1866,1705,-161,0.477457294875385
UTICA,PA,91,39,-52,0.3
UTICA,SD,23,0,-23,0
UTOPIA,TX,63,158,95,0.7149321266968326
UVALDA,GA,626,638,12,0.504746835443038
UVALDE,TX,7641,6356,-1285,0.45409730656569264
UXBRIDGE,MA,3978,4381,403,0.5241057542768274
VA BCH,VA,8171,8051,-120,0.4963013191961534
VA BEACH,VA,10541,9864,-677,0.4834109286939476
VAB,VA,671,620,-51,0.48024786986831913
VACAVILLE,CA,39545,39089,-456,0.49710049088180686
VACHERIE,LA,931,850,-81,0.4772599663110612
VADER,WA,282,400,118,0.5865102639296188
VADITO,NM,11,0,-11,0
VADNAIS HEIGHTS,MN,931,860,-71,0.480178671133445
VADNAIS HTS,MN,567,424,-143,0.42785065590312815
VAIDEN,MS,184,257,73,0.5827664399092971
VAIL,AZ,10795,13072,2277,0.5477018477395567
VAIL,CO,6532,5222,-1310,0.4442742896035392
VAIL,IA,35,26,-9,0.4262295081967213
VAILS GATE,NY,39,22,-17,0.36065573770491804
VALATIE,NY,2075,2280,205,0.5235361653272101
VALDERS,WI,626,623,-3,0.49879903923138513
VALDESE,NC,2763,2568,-195,0.48171074845244793
VALDEZ,AK,1869,1124,-745,0.3755429335115269
VALDOSTA,GA,43778,41447,-2331,0.48632443531827513
VALE,NC,2432,2516,84,0.5084882780921585
VALE,OR,2150,1717,-433,0.4440134471166279
VALENCIA,CA,24358,23981,-377,0.496100457187778
VALENCIA,PA,2252,2725,473,0.547518585493269
VALENTINE,NE,1966,1710,-256,0.46517954298150166
VALHALLA,NY,1695,1512,-183,0.4714686623012161
VALHERMOSO SP,AL,0,11,11,1
VALHERMOSO SPG,AL,0,13,13,1
VALHERMOSO SPRINGS,AL,0,11,11,1
VALIER,IL,29,11,-18,0.275
VALIER,MT,214,187,-27,0.46633416458852867
VALLECITO,CA,11,0,-11,0
VALLEJO,CA,44122,39389,-4733,0.47166241572966433
VALLES MINES,MO,100,148,48,0.5967741935483871
VALLEY,AL,5654,5026,-628,0.4705992509363296
VALLEY,NE,1723,2021,298,0.5397970085470085
VALLEY,WA,777,848,71,0.5218461538461538
VALLEY CENTER,CA,5671,6955,1284,0.5508474576271186
VALLEY CENTER,KS,3897,3731,-166,0.4891190351337179
VALLEY CITY,ND,4198,3316,-882,0.4413095554964067
VALLEY CITY,OH,1529,1742,213,0.5325588505044329
VALLEY COTTAGE,NY,2527,2507,-20,0.4980135081446166
VALLEY FALLS,KS,770,770,0,0.5
VALLEY FALLS,NY,386,339,-47,0.4675862068965517
VALLEY FARMS,AZ,60,0,-60,0
VALLEY GLEN,CA,1234,1117,-117,0.47511697150148874
VALLEY GRANDE,AL,2924,2588,-336,0.4695210449927431
VALLEY GROVE,WV,91,149,58,0.6208333333333333
VALLEY HEAD,AL,777,742,-35,0.48847926267281105
VALLEY HEAD,WV,17,0,-17,0
VALLEY LEE,MD,127,94,-33,0.4253393665158371
VALLEY MILLS,TX,1813,1374,-439,0.4311264512080326
VALLEY PARK,MO,4112,3063,-1049,0.42689895470383277
VALLEY SPGS,CA,164,170,6,0.5089820359281437
VALLEY SPGS,SD,39,18,-21,0.3157894736842105
VALLEY SPRINGS,CA,4796,4782,-14,0.49926915848820214
VALLEY SPRINGS,SD,351,310,-41,0.4689863842662632
VALLEY STREAM,NY,14887,14038,-849,0.485324114088159
VALLEY VIEW,PA,324,334,10,0.5075987841945289
VALLEY VIEW,TX,1688,2031,343,0.5461145469212154
VALLEY VILLAGE,CA,11995,10294,-1701,0.46184216429628966
VALLEY VLG,CA,518,416,-102,0.44539614561027835
VALLEYFORD,WA,156,379,223,0.708411214953271
VALLIANT,OK,1168,973,-195,0.4544605324614666
VALLONIA,IN,323,192,-131,0.37281553398058254
VALMEYER,IL,120,42,-78,0.25925925925925924
VALPARAISO,FL,2341,2295,-46,0.49503882657463333
VALPARAISO,IN,31404,30365,-1039,0.49158963233984687
VALPARAISO,NE,51,128,77,0.7150837988826816
VALPO,IN,601,691,90,0.5348297213622291
VALRICO,FL,26321,28108,1787,0.5164158812397802
VAN,TX,1607,1869,262,0.5376869965477561
VAN ALSTYNE,TX,2889,4811,1922,0.6248051948051948
VAN BUREN,AR,15096,13951,-1145,0.48029056356938754
VAN BUREN,IN,434,221,-213,0.3374045801526718
VAN BUREN,ME,1195,948,-247,0.44237050863275784
VAN BUREN,MO,812,891,79,0.5231943628890193
VAN BUREN,OH,185,207,22,0.5280612244897959
VAN BUREN POINT,NY,0,40,40,1
VAN BUREN TWP,MI,9198,8258,-940,0.4730751604032997
VAN DYNE,WI,127,166,39,0.5665529010238908
VAN ETTEN,NY,318,304,-14,0.4887459807073955
VAN HORN,TX,396,355,-41,0.47270306258322237
VAN HORNE,IA,265,142,-123,0.3488943488943489
VAN LEAR,KY,203,254,51,0.5557986870897156
VAN METER,IA,759,869,110,0.5337837837837838
VAN NUYS,CA,43416,36296,-7120,0.4553392211963067
VAN VLECK,TX,676,606,-70,0.47269890795631825
VAN WERT,IA,27,11,-16,0.2894736842105263
VAN WERT,OH,6508,6266,-242,0.4905276342570847
VANCE,AL,1530,1486,-44,0.4927055702917772
VANCE,SC,199,300,101,0.6012024048096193
VANCEBORO,NC,2733,2297,-436,0.45666003976143144
VANCEBURG,KY,2371,2389,18,0.501890756302521
VANCLEAVE,MS,4385,5050,665,0.5352411234764176
VANCLEVE,KY,23,0,-23,0
VANCOUVER,WA,173510,172521,-989,0.4985709372859657
VANDALIA,IL,3996,3657,-339,0.4778518228145825
VANDALIA,MI,1189,822,-367,0.4087518647439085
VANDALIA,MO,1660,1471,-189,0.46981794953688916
VANDALIA,OH,6222,5456,-766,0.4672032882342867
VANDENBERG AFB,CA,990,861,-129,0.4651539708265802
VANDENBRG AFB,CA,61,49,-12,0.44545454545454544
VANDERBILT,MI,1281,1157,-124,0.4745693191140279
VANDERBILT,PA,386,412,26,0.5162907268170426
VANDERBILT,TX,11,0,-11,0
VANDERGRIFT,PA,3677,3166,-511,0.4626625748940523
VANDERWAGEN,NM,211,103,-108,0.32802547770700635
VANDIVER,AL,11,26,15,0.7027027027027027
VANDLING,PA,412,348,-64,0.45789473684210524
VANLEAR,KY,22,0,-22,0
VANLEER,TN,289,331,42,0.5338709677419354
VANLUE,OH,0,12,12,1
VANSANT,VA,694,397,-297,0.3638863428047663
VANZANT,MO,0,11,11,1
VARDAMAN,MS,395,334,-61,0.45816186556927296
VARINA,IA,35,37,2,0.5138888888888888
VARNA,IL,369,268,-101,0.4207221350078493
VARNVILLE,SC,1004,1111,107,0.5252955082742317
VARYSBURG,NY,59,105,46,0.6402439024390244
VASHON,WA,4615,4945,330,0.5172594142259415
VASS,NC,2133,2416,283,0.5311057375247307
VASSALBORO,ME,1492,1500,8,0.5013368983957219
VASSAR,KS,131,106,-25,0.4472573839662447
VASSAR,MI,3213,2681,-532,0.45486935866983375
VAUGHN,MT,499,437,-62,0.4668803418803419
VAUGHN,WA,858,782,-76,0.4768292682926829
VAUXHALL,NJ,1021,1002,-19,0.495304003954523
VEAZIE,ME,897,796,-101,0.47017129356172477
VEBLEN,SD,23,16,-7,0.41025641025641024
VEEDERSBURG,IN,1515,1412,-103,0.4824051930304066
VEGA,TX,178,77,-101,0.30196078431372547
VEGUITA,NM,312,384,72,0.5517241379310345
VELMA,OK,11,14,3,0.56
VELPEN,IN,22,25,3,0.5319148936170213
VELVA,ND,363,217,-146,0.3741379310344828
VENANGO,PA,39,12,-27,0.23529411764705882
VENEDOCIA,OH,11,0,-11,0
VENEDY,IL,0,11,11,1
VENETA,OR,3610,3718,108,0.5073689956331878
VENETIA,PA,1822,2315,493,0.5595842397872854
VENICE,CA,19394,15380,-4014,0.4422844654051878
VENICE,FL,82576,99124,16548,0.545536598789213
VENICE,IL,182,42,-140,0.1875
VENTNOR CITY,NJ,5701,5692,-9,0.4996050206267006
VENTRESS,LA,594,452,-142,0.4321223709369025
VENTURA,CA,45060,44594,-466,0.49740111986079816
VENTURA,IA,68,95,27,0.5828220858895705
VENUS,FL,190,145,-45,0.43283582089552236
VENUS,PA,76,23,-53,0.23232323232323232
VENUS,TX,3086,5153,2067,0.6254399805801675
VERADALE,WA,6234,5794,-440,0.4817093448619887
VERBANK,NY,39,107,68,0.7328767123287672
VERBENA,AL,1409,1192,-217,0.45828527489427145
VERDEN,OK,35,34,-1,0.4927536231884058
VERDI,NV,914,1682,768,0.6479198767334361
VERDIGRE,NE,102,91,-11,0.47150259067357514
VERDUGO CITY,CA,67,56,-11,0.45528455284552843
VERDUNVILLE,WV,0,29,29,1
VERGAS,MN,751,760,9,0.5029781601588352
VERGENNES,IL,26,0,-26,0
VERGENNES,VT,2572,2697,125,0.5118618333649649
VERMILION,IL,25,0,-25,0
VERMILION,OH,6116,6335,219,0.5087944743394105
VERMILLION,SD,8019,5650,-2369,0.41334406320872047
VERMONT,IL,58,95,37,0.6209150326797386
VERMONTVILLE,MI,1008,869,-139,0.46297282898241876
VERMONTVILLE,NY,111,170,59,0.604982206405694
VERNAL,UT,12333,12293,-40,0.4991878502395842
VERNDALE,MN,524,462,-62,0.4685598377281947
VERNON,AL,1687,1562,-125,0.48076331178824255
VERNON,AZ,399,538,139,0.5741728922091782
VERNON,CA,882,762,-120,0.4635036496350365
VERNON,CO,21,0,-21,0
VERNON,CT,2966,2738,-228,0.4800140252454418
VERNON,FL,1176,1322,146,0.5292233787029623
VERNON,IN,37,0,-37,0
VERNON,MI,59,76,17,0.562962962962963
VERNON,NJ,2525,2379,-146,0.4851141924959217
VERNON,NY,1332,1248,-84,0.48372093023255813
VERNON,TX,5193,4567,-626,0.46793032786885247
VERNON,VT,780,661,-119,0.4587092297015961
VERNON CENTER,MN,52,59,7,0.5315315315315315
VERNON CENTER,NY,140,135,-5,0.4909090909090909
VERNON HILL,VA,26,68,42,0.723404255319149
VERNON HILLS,IL,11218,10671,-547,0.48750513956781943
VERNON ROCKVILLE,CT,12676,11817,-859,0.48246437757726696
VERNONIA,OR,1502,1593,91,0.5147011308562197
VERO BEACH,FL,87877,96415,8538,0.5231643261780219
VERONA,IL,25,25,0,0.5
VERONA,KY,858,911,53,0.5149802148106275
VERONA,MO,799,738,-61,0.4801561483409239
VERONA,MS,106,640,534,0.8579088471849866
VERONA,NJ,3883,4179,296,0.5183577276110146
VERONA,NY,877,814,-63,0.48137196924896514
VERONA,PA,6435,5337,-1098,0.4533639143730887
VERONA,VA,1784,1692,-92,0.48676639815880324
VERONA,WI,11358,13487,2129,0.5428456429865164
VERONA BEACH,NY,121,86,-35,0.41545893719806765
VERONA ISLAND,ME,90,45,-45,0.3333333333333333
VERPLANCK,NY,165,132,-33,0.4444444444444444
VERSAILLES,IL,77,74,-3,0.4900662251655629
VERSAILLES,IN,1572,1695,123,0.5188246097337006
VERSAILLES,KY,8724,8896,172,0.5048808172531215
VERSAILLES,MO,2772,2602,-170,0.4841831038332713
VERSAILLES,OH,1160,1100,-60,0.48672566371681414
VERSHIRE,VT,57,121,64,0.6797752808988764
VESPER,WI,224,173,-51,0.4357682619647355
VESTA,MN,22,0,-22,0
VESTABURG,MI,1136,1067,-69,0.4843395369950068
VESTAL,NY,7399,7067,-332,0.48852481681183463
VESTAVIA,AL,3566,3288,-278,0.47971987160782026
VESTAVIA HILLS,AL,11501,9837,-1664,0.46100852938419723
VESUVIUS,VA,24,12,-12,0.3333333333333333
VETERAN,WY,0,11,11,1
VEVAY,IN,2134,2175,41,0.5047574843351126
VEYO,UT,50,23,-27,0.3150684931506849
VIAN,OK,1732,1551,-181,0.47243374961925066
VIBORG,SD,169,88,-81,0.3424124513618677
VIBURNUM,MO,197,85,-112,0.30141843971631205
VICCO,KY,12,28,16,0.7
VICHY,MO,45,73,28,0.6186440677966102
VICI,OK,146,275,129,0.6532066508313539
VICKERY,OH,208,141,-67,0.4040114613180516
VICKSBURG,MI,3829,3638,-191,0.48721039239319675
VICKSBURG,MS,14385,13363,-1022,0.4815842583249243
VICTOR,CA,0,34,34,1
VICTOR,CO,242,143,-99,0.37142857142857144
VICTOR,IA,265,266,1,0.5009416195856874
VICTOR,ID,3032,2879,-153,0.4870580274065302
VICTOR,MT,1801,1996,195,0.5256781669739268
VICTOR,NY,6265,6530,265,0.5103556076592419
VICTOR,WV,0,12,12,1
VICTORIA,IL,12,11,-1,0.4782608695652174
VICTORIA,KS,321,286,-35,0.471169686985173
VICTORIA,MN,2695,3401,706,0.5579068241469817
VICTORIA,TX,32280,29080,-3200,0.47392438070404175
VICTORIA,VA,1503,1348,-155,0.47281655559452823
VICTORVILLE,CA,50849,53176,2327,0.5111848113434271
VICTORY MILLS,NY,23,25,2,0.5208333333333334
VIDA,OR,770,420,-350,0.35294117647058826
VIDALIA,GA,6526,5869,-657,0.4734973779749899
VIDALIA,LA,2532,2351,-181,0.48146631169363097
VIDOR,TX,9962,8709,-1253,0.46644528948636926
VIENNA,GA,1791,1571,-220,0.4672813801308745
VIENNA,IL,1182,1238,56,0.5115702479338843
VIENNA,MD,69,38,-31,0.35514018691588783
VIENNA,ME,41,70,29,0.6306306306306306
VIENNA,MO,493,556,63,0.5300285986653956
VIENNA,OH,1383,1474,91,0.5159257962898145
VIENNA,VA,29139,27510,-1629,0.48562198803156276
VIENNA,WV,4668,4308,-360,0.4799465240641711
VIERA,FL,473,550,77,0.5376344086021505
VIEW PARK,CA,1784,1448,-336,0.44801980198019803
VIKING,MN,12,0,-12,0
VILAS,NC,1558,1380,-178,0.4697072838665759
VILLA GROVE,CO,11,31,20,0.7380952380952381
VILLA GROVE,IL,1188,1071,-117,0.47410358565737054
VILLA HILLS,KY,1530,1385,-145,0.4751286449399657
VILLA PARK,CA,1185,1579,394,0.571273516642547
VILLA PARK,IL,8740,8239,-501,0.48524648094705225
VILLA RICA,GA,20178,17907,-2271,0.4701851122489169
VILLA RIDGE,MO,2012,2102,90,0.5109382596013612
VILLAGE MILLS,TX,162,244,82,0.6009852216748769
VILLAGE OF INDIAN SPRINGS,OH,69,58,-11,0.4566929133858268
VILLAGE OF LAKEWOOD,IL,631,619,-12,0.4952
VILLAGE OF LOCH LLOYD,MO,194,249,55,0.5620767494356659
VILLAGE OF PALM SPRINGS,FL,1856,1551,-305,0.455239213384209
VILLAGE OF PALMETTO BAY,FL,199,242,43,0.5487528344671202
VILLAGE OF WELLINGTON,FL,1131,1056,-75,0.4828532235939643
VILLANOVA,PA,1646,1927,281,0.5393226980128744
VILLARD,MN,158,98,-60,0.3828125
VILLAS,NJ,3746,3411,-335,0.47659633924828837
VILLE PLATTE,LA,5451,5060,-391,0.4814004376367615
VILLISCA,IA,729,536,-193,0.42371541501976284
VILONIA,AR,3552,3651,99,0.506872136609746
VINA,AL,285,304,19,0.5161290322580645
VINA,CA,28,0,-28,0
VINALHAVEN,ME,1223,872,-351,0.4162291169451074
VINCENNES,IN,13877,12753,-1124,0.47889598197521593
VINCENT,AL,999,1092,93,0.5222381635581061
VINCENT,OH,1026,908,-118,0.46949327817993797
VINCENTOWN,NJ,984,1199,215,0.5492441594136509
VINE GROVE,KY,6270,6703,433,0.516688506898944
VINEBURG,CA,60,12,-48,0.16666666666666666
VINELAND,NJ,18813,17741,-1072,0.4853367620506648
VINEMONT,AL,2689,2971,282,0.5249116607773852
VINEYARD,UT,5338,5554,216,0.5099155343371282
VINEYARD HAVEN,MA,3478,3502,24,0.5017191977077364
VINING,MN,79,83,4,0.5123456790123457
VINITA,OK,3942,3910,-32,0.4979623025980642
VINT HILL FARMS,VA,568,630,62,0.5258764607679466
VINTON,IA,3708,3071,-637,0.4530166691252397
VINTON,LA,2212,2153,-59,0.493241695303551
VINTON,OH,884,979,95,0.5254965110037574
VINTON,TX,73,72,-1,0.496551724137931
VINTON,VA,6601,6702,101,0.5037961362098775
VINTONDALE,PA,14,46,32,0.7666666666666667
VIOLA,AR,398,350,-48,0.4679144385026738
VIOLA,DE,13,0,-13,0
VIOLA,ID,94,148,54,0.6115702479338843
VIOLA,IL,239,272,33,0.5322896281800391
VIOLA,KS,0,14,14,1
VIOLA,MN,32,23,-9,0.41818181818181815
VIOLA,WI,616,634,18,0.5072
VIOLET,LA,2631,1812,-819,0.40783254557731263
VIOLET HILL,AR,11,23,12,0.6764705882352942
VIPER,KY,309,331,22,0.5171875
VIRDEN,IL,1743,1637,-106,0.48431952662721894
VIRDEN,NM,71,76,5,0.5170068027210885
VIRGIE,KY,907,866,-41,0.4884376762549351
VIRGIL,IL,52,54,2,0.5094339622641509
VIRGILINA,VA,121,116,-5,0.48945147679324896
VIRGIN,UT,63,78,15,0.5531914893617021
VIRGINIA,IL,783,831,48,0.5148698884758365
VIRGINIA,MN,4905,4416,-489,0.47376890891535245
VIRGINIA BCH,VA,5507,5245,-262,0.48781622023809523
VIRGINIA BEACH,VA,187660,179151,-8509,0.4884013838189149
VIRGINIA CITY,MT,80,0,-80,0
VIRGINIA CITY,NV,239,351,112,0.5949152542372881
VIRGINIA GARDENS,FL,930,933,3,0.500805152979066
VIROQUA,WI,3104,3028,-76,0.4938030006523157
VISALIA,CA,52535,50783,-1752,0.49152132251882535
VISTA,CA,46749,44307,-2442,0.48659066947812335
VIVIAN,LA,1447,1341,-106,0.48098995695839314
VLY COTTAGE,NY,112,134,22,0.5447154471544715
VOLANT,PA,758,607,-151,0.44468864468864466
VOLCANO,CA,237,341,104,0.5899653979238755
VOLCANO,HI,874,1186,312,0.5757281553398058
VOLGA,SD,1111,1047,-64,0.48517145505097314
VOLIN,SD,0,12,12,1
VOLUNTOWN,CT,800,906,106,0.5310668229777257
VON ORMY,TX,2066,2700,634,0.5665127989928661
VONORE,TN,2491,2863,372,0.5347403810235338
VOORHEES,NJ,11462,11098,-364,0.49193262411347516
VOORHEESVILLE,NY,1903,2003,100,0.5128008192524321
VOORHIES,IA,19,23,4,0.5476190476190477
VOSSBURG,MS,53,100,47,0.6535947712418301
VULCAN,MI,481,465,-16,0.4915433403805497
W ALEXANDER,PA,27,0,-27,0
W ALEXANDRIA,OH,87,99,12,0.532258064516129
W ALLENHURST,NJ,54,75,21,0.5813953488372093
W BARNSTABLE,MA,128,109,-19,0.459915611814346
W BETHESDA,MD,0,12,12,1
W BLOOMFIELD,MI,968,1026,58,0.5145436308926781
W BOOTHBAY HA,ME,0,35,35,1
W BOOTHBY HBR,ME,27,0,-27,0
W BRIDGEWATER,MA,83,85,2,0.5059523809523809
W BROOKFIELD,MA,111,110,-1,0.497737556561086
W BURLINGTON,IA,42,43,1,0.5058823529411764
W CHESTERFLD,NH,25,12,-13,0.32432432432432434
W CNSHOHOCKEN,PA,498,428,-70,0.46220302375809935
W COVINA,CA,239,193,-46,0.44675925925925924
W COXSACKIE,NY,26,44,18,0.6285714285714286
W ELIZABETH,PA,0,11,11,1
W FALMOUTH,MA,41,39,-2,0.4875
W FARMINGTON,OH,58,73,15,0.5572519083969466
W FRIENDSHIP,MD,12,41,29,0.7735849056603774
W GREENWICH,RI,104,145,41,0.5823293172690763
W HARRISON,NY,259,227,-32,0.4670781893004115
W HAVERSTRAW,NY,61,68,7,0.5271317829457365
W HEMPSTEAD,NY,627,613,-14,0.49435483870967745
W HOLLYWOOD,CA,1630,1207,-423,0.425449418399718
W HYANNISPORT,MA,12,0,-12,0
W JEFFERSON,AL,16,16,0,0.5
W JEFFERSON,NC,45,77,32,0.6311475409836066
W KENNEBUNK,ME,0,11,11,1
W LAFAYETTE,IN,11,0,-11,0
W LBRTY,OH,42,20,-22,0.3225806451612903
W MELBOURNE,FL,24,16,-8,0.4
W PLM BCH,FL,115,155,40,0.5740740740740741
W PORTSMOUTH,OH,85,98,13,0.5355191256830601
W R,CO,471,420,-51,0.4713804713804714
W RUSHVILLE,OH,0,13,13,1
W SACRAMENTO,CA,2722,2694,-28,0.49741506646971934
W SAND LAKE,NY,21,16,-5,0.43243243243243246
W SOMERVILLE,MA,1644,993,-651,0.37656427758816835
W SPRINGFIELD,VA,171,206,35,0.5464190981432361
W STOCKBRIDGE,MA,11,37,26,0.7708333333333334
W TERRE HAUTE,IN,171,163,-8,0.4880239520958084
W TOWNSEND,MA,52,37,-15,0.4157303370786517
W VALLEY CITY,UT,2484,2043,-441,0.45129224652087474
W WARDSBORO,VT,0,13,13,1
W YARMOUTH,MA,378,260,-118,0.40752351097178685
W YELLOWSTONE,MT,25,114,89,0.8201438848920863
WA KEENEY,KS,16,15,-1,0.4838709677419355
WABAN,MA,1701,1842,141,0.5198983911939035
WABASH,IN,6331,6168,-163,0.49347947835826866
WABASHA,MN,2278,1966,-312,0.4632422243166824
WABASSO,FL,229,293,64,0.5613026819923371
WABASSO,MN,115,80,-35,0.41025641025641024
WABENO,WI,668,496,-172,0.4261168384879725
WACCABUC,NY,241,271,30,0.529296875
WACHAPREAGUE,VA,0,12,12,1
WACO,GA,625,908,283,0.5923026744944553
WACO,KY,931,975,44,0.5115424973767051
WACO,NC,12,11,-1,0.4782608695652174
WACO,NE,26,34,8,0.5666666666666667
WACO,TX,59114,54224,-4890,0.47842735887345816
WACONIA,MN,4661,4915,254,0.5132623224728488
WADDELL,AZ,5053,6539,1486,0.564095928226363
WADDINGTON,NY,958,752,-206,0.439766081871345
WADDY,KY,676,723,47,0.5167977126518942
WADE,ME,22,22,0,0.5
WADE,NC,633,896,263,0.5860039241334205
WADENA,MN,3587,3286,-301,0.47810272079150296
WADESBORO,NC,2991,2953,-38,0.4968034993270525
WADESVILLE,IN,944,873,-71,0.48046230049532196
WADHAMS,NY,14,14,0,0.5
WADING RIVER,NY,2364,2370,6,0.5006337135614702
WADLEY,AL,348,409,61,0.5402906208718626
WADLEY,GA,356,452,96,0.5594059405940595
WADMALAW IS,SC,15,15,0,0.5
WADMALAW ISLAND,SC,660,717,57,0.5206971677559913
WADSWORTH,IL,2484,2471,-13,0.4986881937436932
WADSWORTH,NV,48,74,26,0.6065573770491803
WADSWORTH,OH,10354,10580,226,0.5053979172637814
WAELDER,TX,159,265,106,0.625
WAGARVILLE,AL,12,0,-12,0
WAGENER,SC,1341,1459,118,0.5210714285714285
WAGGONER,IL,11,0,-11,0
WAGNER,SD,1165,1075,-90,0.4799107142857143
WAGONER,OK,5776,5796,20,0.5008641548565503
WAGRAM,NC,572,791,219,0.5803374908290535
WAHIAWA,HI,21069,16211,-4858,0.4348444206008584
WAHKON,MN,445,338,-107,0.43167305236270753
WAHOO,NE,1959,2052,93,0.5115931189229619
WAHPETON,ND,4705,3787,-918,0.4459491285916156
WAIALUA,HI,2924,2730,-194,0.48284400424478247
WAIANAE,HI,17547,14645,-2902,0.454926689860835
WAIKOLOA,HI,4401,4160,-241,0.4859245415255227
WAILUKU,HI,12009,10810,-1199,0.4737280336561637
WAIMANALO,HI,2379,2063,-316,0.4644304367402071
WAIMEA,HI,239,161,-78,0.4025
WAINSCOTT,NY,684,798,114,0.5384615384615384
WAIPAH,HI,418,325,-93,0.43741588156123823
WAIPAHU,HI,20425,17643,-2782,0.4634601239886519
WAITE PARK,MN,6125,4936,-1189,0.44625259922249344
WAITSBURG,WA,347,411,64,0.5422163588390502
WAITSFIELD,VT,1642,1648,6,0.5009118541033435
WAKARUSA,IN,862,852,-10,0.4970828471411902
WAKARUSA,KS,62,61,-1,0.4959349593495935
WAKE,VA,26,36,10,0.5806451612903226
WAKE FOREST,NC,23815,30476,6661,0.561345342690317
WAKE VILLAGE,TX,992,742,-250,0.4279123414071511
WAKEENEY,KS,1052,884,-168,0.45661157024793386
WAKEFIELD,KS,564,581,17,0.5074235807860262
WAKEFIELD,MA,8591,8671,80,0.5023172285946008
WAKEFIELD,MI,820,766,-54,0.48297604035308955
WAKEFIELD,NE,352,264,-88,0.42857142857142855
WAKEFIELD,RI,7213,8185,972,0.531562540589687
WAKEFIELD,VA,552,624,72,0.5306122448979592
WAKEMAN,OH,2084,2190,106,0.5124005615348619
WAKITA,OK,0,24,24,1
WAKONDA,SD,11,38,27,0.7755102040816326
WALBRIDGE,OH,2031,1988,-43,0.494650410549888
WALCOTT,IA,924,748,-176,0.4473684210526316
WALCOTT,ND,11,24,13,0.6857142857142857
WALDEN,CO,427,380,-47,0.4708798017348203
WALDEN,NY,4154,4182,28,0.5016794625719769
WALDO,AR,600,726,126,0.5475113122171946
WALDO,FL,809,947,138,0.5392938496583144
WALDO,ME,66,52,-14,0.4406779661016949
WALDO,OH,27,37,10,0.578125
WALDO,WI,247,274,27,0.525911708253359
WALDOBORO,ME,1911,2011,100,0.5127485976542581
WALDORF,MD,32719,32764,45,0.5003436006291709
WALDPORT,OR,3283,3527,244,0.5179148311306901
WALDRON,AR,3063,3082,19,0.5015459723352319
WALDRON,IN,424,326,-98,0.43466666666666665
WALDRON,MI,423,280,-143,0.39829302987197723
WALDRON,WA,0,11,11,1
WALDWICK,NJ,2192,2346,154,0.5169678272366681
WALES,MA,552,564,12,0.5053763440860215
WALES,ME,85,93,8,0.5224719101123596
WALES,MI,545,553,8,0.5036429872495446
WALES,WI,1351,1309,-42,0.4921052631578947
WALESKA,GA,1970,2623,653,0.571086435880688
WALFORD,IA,216,95,-121,0.3054662379421222
WALHALLA,ND,205,172,-33,0.4562334217506631
WALHALLA,SC,3614,3646,32,0.5022038567493113
WALHONDING,OH,85,72,-13,0.4585987261146497
WALKER,IA,363,302,-61,0.45413533834586467
WALKER,LA,6921,7518,597,0.5206731768127987
WALKER,MI,1295,1055,-240,0.44893617021276594
WALKER,MN,2763,2584,-179,0.4832616420422667
WALKER,MO,40,44,4,0.5238095238095238
WALKER,WV,185,319,134,0.6329365079365079
WALKER LAKE,NV,35,24,-11,0.4067796610169492
WALKERSVILLE,MD,2743,3042,299,0.5258426966292135
WALKERSVILLE,WV,47,47,0,0.5
WALKERTON,IN,2704,2443,-261,0.4746454245191374
WALKERTON,VA,11,0,-11,0
WALKERTOWN,NC,2829,3195,366,0.5303784860557769
WALKERVILLE,MI,774,530,-244,0.40644171779141103
WALL,NJ,301,308,7,0.5057471264367817
WALL,PA,512,375,-137,0.4227733934611049
WALL,SD,154,83,-71,0.350210970464135
WALL LAKE,IA,77,89,12,0.536144578313253
WALL TOWNSHIP,NJ,3591,3927,336,0.5223463687150838
WALLA WALLA,WA,16637,16232,-405,0.4938391797742554
WALLACE,CA,0,22,22,1
WALLACE,ID,1094,873,-221,0.443823080833757
WALLACE,MI,278,210,-68,0.430327868852459
WALLACE,NC,2552,2577,25,0.5024371222460519
WALLACE,NE,11,23,12,0.6764705882352942
WALLACE,SC,421,465,44,0.5248306997742663
WALLACE,WV,67,11,-56,0.14102564102564102
WALLAGRASS,ME,25,53,28,0.6794871794871795
WALLAND,TN,1244,1551,307,0.5549194991055456
WALLBACK,WV,12,0,-12,0
WALLBURG,NC,12,0,-12,0
WALLED LAKE,MI,6727,6377,-350,0.48664529914529914
WALLER,TX,3815,4274,459,0.5283718630238595
WALLING,TN,304,409,105,0.573632538569425
WALLINGFORD,CT,14013,13514,-499,0.49093617175863696
WALLINGFORD,KY,574,749,175,0.5661375661375662
WALLINGFORD,PA,2475,2645,170,0.5166015625
WALLINGFORD,VT,654,648,-6,0.4976958525345622
WALLINGTON,NJ,3705,3207,-498,0.4639756944444444
WALLINS CREEK,KY,150,246,96,0.6212121212121212
WALLIS,TX,827,948,121,0.5340845070422535
WALLISVILLE,TX,28,81,53,0.7431192660550459
WALLKILL,NY,3940,4233,293,0.5179248745870549
WALLOON LAKE,MI,379,336,-43,0.4699300699300699
WALLOWA,OR,467,438,-29,0.4839779005524862
WALLS,MS,3139,2649,-490,0.4576710435383552
WALLSBURG,UT,0,16,16,1
WALLULA,WA,0,11,11,1
WALNUT,CA,10553,15280,4727,0.5914915031161693
WALNUT,IA,347,178,-169,0.33904761904761904
WALNUT,IL,702,566,-136,0.44637223974763407
WALNUT,MS,1411,1245,-166,0.46875
WALNUT COVE,NC,2123,2467,344,0.5374727668845316
WALNUT CREEK,CA,46146,44135,-2011,0.48886255136739737
WALNUT GROVE,CA,570,630,60,0.525
WALNUT GROVE,GA,572,554,-18,0.4920071047957371
WALNUT GROVE,MN,266,166,-100,0.38425925925925924
WALNUT GROVE,MO,821,973,152,0.5423634336677815
WALNUT GROVE,MS,861,739,-122,0.461875
WALNUT HILL,FL,63,97,34,0.60625
WALNUT HILL,IL,37,15,-22,0.28846153846153844
WALNUT HILLS,OH,193,191,-2,0.4973958333333333
WALNUT PARK,CA,250,194,-56,0.4369369369369369
WALNUT RIDGE,AR,2961,2953,-8,0.4993236388231316
WALNUT SHADE,MO,214,220,6,0.5069124423963134
WALNUT SPGS,TX,44,35,-9,0.4430379746835443
WALNUT SPRINGS,TX,80,192,112,0.7058823529411765
WALNUTPORT,PA,2349,2564,215,0.5218807246081824
WALPOLE,MA,5262,6055,793,0.5350357868693116
WALPOLE,ME,50,61,11,0.5495495495495496
WALPOLE,NH,1057,1194,137,0.5304309195912927
WALSENBURG,CO,2595,2762,167,0.5155870823221953
WALSH,CO,51,29,-22,0.3625
WALSTONBURG,NC,200,255,55,0.5604395604395604
WALTERBORO,SC,7823,7177,-646,0.47846666666666665
WALTERS,MN,29,19,-10,0.3958333333333333
WALTERS,OK,1450,1211,-239,0.4550920706501315
WALTERVILLE,OR,668,481,-187,0.4186248912097476
WALTHAM,MA,29416,24416,-5000,0.45355922128102244
WALTHILL,NE,154,72,-82,0.3185840707964602
WALTHOURVILLE,GA,0,59,59,1
WALTON,IN,858,816,-42,0.4874551971326165
WALTON,KY,5489,5422,-67,0.4969297039684722
WALTON,NE,0,23,23,1
WALTON,NY,2821,2690,-131,0.4881146797314462
WALTON,WV,150,97,-53,0.39271255060728744
WALTON HILLS,OH,551,454,-97,0.45174129353233833
WALTONVILLE,IL,11,25,14,0.6944444444444444
WALWORTH,NY,1582,1584,2,0.5003158559696779
WALWORTH,WI,1517,1470,-47,0.4921325744894543
WAMEGO,KS,3401,3399,-2,0.4998529411764706
WAMIC,OR,14,14,0,0.5
WAMPSVILLE,NY,0,12,12,1
WAMPUM,PA,748,759,11,0.5036496350364964
WAMSUTTER,WY,24,0,-24,0
WANAKENA,NY,39,0,-39,0
WANAMAKER,IN,259,288,29,0.526508226691042
WANAMINGO,MN,440,341,-99,0.43661971830985913
WANAQUE,NJ,2141,2180,39,0.5045128442490164
WANATAH,IN,703,605,-98,0.4625382262996942
WANBLEE,SD,11,11,0,0.5
WANCHESE,NC,389,247,-142,0.38836477987421386
WANETTE,OK,322,416,94,0.5636856368563685
WANN,OK,12,23,11,0.6571428571428571
WANSHIP,UT,137,173,36,0.5580645161290323
WANTAGE,NJ,640,798,158,0.5549374130737135
WANTAGH,NY,6214,6568,354,0.5138475981849476
WAPAHU,HI,74,69,-5,0.4825174825174825
WAPAKONETA,OH,5623,5461,-162,0.4926921688920967
WAPANUCKA,OK,56,62,6,0.5254237288135594
WAPATO,WA,2641,2042,-599,0.4360452701259876
WAPELLA,IL,52,47,-5,0.47474747474747475
WAPELLO,IA,1626,1182,-444,0.42094017094017094
WAPENGERS FALLS,NY,275,263,-12,0.4888475836431227
WAPITI,WY,98,95,-3,0.49222797927461137
WAPPAPELLO,MO,1283,1350,67,0.5127231295100646
WAPPINGERS FALLS,NY,11368,11521,153,0.5033422167853554
WAPWALLOPEN,PA,553,684,131,0.5529506871463218
WAR,WV,406,123,-283,0.23251417769376181
WARBA,MN,55,14,-41,0.2028985507246377
WARD,AR,4006,4336,330,0.5197794293934308
WARD,CO,141,120,-21,0.45977011494252873
WARD,SC,11,12,1,0.5217391304347826
WARD,SD,32,18,-14,0.36
WARD COVE,AK,543,239,-304,0.30562659846547313
WARDELL,MO,0,12,12,1
WARDEN,WA,1052,901,-151,0.46134152585765487
WARDENSVILLE,WV,549,627,78,0.5331632653061225
WARDSBORO,VT,0,16,16,1
WARE,MA,4699,4350,-349,0.48071610122665487
WARE SHOALS,SC,1829,1628,-201,0.4709285507665606
WAREHAM,MA,4417,4531,114,0.5063701385784533
WARETOWN,NJ,3337,3627,290,0.5208213670304422
WARFIELD,KY,176,149,-27,0.4584615384615385
WARFIELD,VA,12,0,-12,0
WARFORDSBURG,PA,790,714,-76,0.4747340425531915
WARM SPRINGS,GA,436,383,-53,0.46764346764346765
WARM SPRINGS,OR,777,514,-263,0.3981409759876065
WARM SPRINGS,VA,12,49,37,0.8032786885245902
WARMINSTER,PA,7879,8428,549,0.5168332617894156
WARNE,NC,132,243,111,0.648
WARNER,NH,1208,1225,17,0.5034936292642828
WARNER,OK,744,757,13,0.5043304463690873
WARNER ROBINS,GA,38220,36709,-1511,0.4899171215417262
WARNER SPGS,CA,15,18,3,0.5454545454545454
WARNER SPRINGS,CA,544,668,124,0.5511551155115512
WARNERS,NY,531,530,-1,0.49952874646559847
WARNERVILLE,NY,116,57,-59,0.32947976878612717
WARR ACRES,OK,3605,2608,-997,0.41976500885240625
WARREN,AR,2941,2356,-585,0.44478006418727584
WARREN,CT,207,360,153,0.6349206349206349
WARREN,IL,622,426,-196,0.4064885496183206
WARREN,IN,1146,1156,10,0.5021720243266724
WARREN,MA,1036,879,-157,0.4590078328981723
WARREN,ME,1438,1563,125,0.5208263912029324
WARREN,MI,55158,47027,-8131,0.460214317169839
WARREN,MN,988,808,-180,0.44988864142538976
WARREN,NH,276,134,-142,0.32682926829268294
WARREN,NJ,3447,4689,1242,0.5763274336283186
WARREN,OH,29121,27609,-1512,0.4866737176097303
WARREN,OR,731,930,199,0.5599036724864539
WARREN,PA,7635,7143,-492,0.48335363377994317
WARREN,RI,4466,4606,140,0.5077160493827161
WARREN,TX,878,956,78,0.5212649945474372
WARREN,VT,1100,1137,37,0.5082700044702727
WARREN CENTER,PA,25,43,18,0.6323529411764706
WARREN MICHIGAN,NY,0,14,14,1
WARRENDALE,PA,55,221,166,0.8007246376811594
WARRENS,WI,1186,1186,0,0.5
WARRENSBURG,IL,331,258,-73,0.4380305602716469
WARRENSBURG,MO,15365,13201,-2164,0.4621228033326332
WARRENSBURG,NY,1906,1858,-48,0.49362380446333687
WARRENSVILLE,NC,86,54,-32,0.38571428571428573
WARRENSVILLE HEIGHTS,OH,1285,1154,-131,0.47314473144731445
WARRENTON,GA,993,891,-102,0.4729299363057325
WARRENTON,MO,6038,6440,402,0.5161083506972272
WARRENTON,NC,1677,1736,59,0.5086434222092001
WARRENTON,OR,4748,4229,-519,0.4710927926924362
WARRENTON,VA,10411,11207,796,0.5184105837727819
WARRENVILLE,IL,5858,5983,125,0.50527827041635
WARRENVILLE,SC,3020,2873,-147,0.4875275750890887
WARRINGTON,PA,5438,5343,-95,0.4955941007327706
WARRIOR,AL,3631,3776,145,0.5097880383421088
WARRIOR RUN,PA,103,93,-10,0.4744897959183674
WARRIORS MARK,PA,135,141,6,0.5108695652173914
WARROAD,MN,2095,1845,-250,0.4682741116751269
WARSAW,IL,376,348,-28,0.48066298342541436
WARSAW,IN,16389,15720,-669,0.48958236008595724
WARSAW,KY,1811,1541,-270,0.4597255369928401
WARSAW,MO,5270,5946,676,0.5301355206847361
WARSAW,NC,2483,1715,-768,0.4085278704144831
WARSAW,NY,2775,2775,0,0.5
WARSAW,OH,1211,1159,-52,0.4890295358649789
WARSAW,VA,1558,1759,201,0.5302984624660838
WARTBURG,TN,1575,1598,23,0.5036243302867949
WARTHEN,GA,16,24,8,0.6
WARTRACE,TN,1070,1203,133,0.5292564892212934
WARWICK,GA,60,99,39,0.6226415094339622
WARWICK,MA,12,36,24,0.75
WARWICK,MD,34,11,-23,0.24444444444444444
WARWICK,ND,15,0,-15,0
WARWICK,NY,5466,5950,484,0.521198318149965
WARWICK,OK,16,24,8,0.6
WARWICK,PA,3254,3208,-46,0.4964407304240173
WARWICK,RI,28242,28804,562,0.5049258493145883
WARWOOD,WV,329,272,-57,0.4525790349417637
WASCO,CA,4843,4484,-359,0.48075479789857406
WASCO,OR,24,0,-24,0
WASECA,MN,5470,4424,-1046,0.44713968061451387
WASH BORO,PA,15,0,-15,0
WASHBURN,IA,686,599,-87,0.466147859922179
WASHBURN,IL,636,490,-146,0.4351687388987567
WASHBURN,ME,403,521,118,0.5638528138528138
WASHBURN,MO,578,645,67,0.5273916598528209
WASHBURN,ND,644,547,-97,0.45927791771620485
WASHBURN,TN,426,559,133,0.5675126903553299
WASHBURN,WI,1552,1442,-110,0.4816299265197061
WASHINGTN TWP,MI,945,1036,91,0.5229681978798587
WASHINGTON,AR,23,13,-10,0.3611111111111111
WASHINGTON,CT,311,605,294,0.6604803493449781
WASHINGTON,DC,407575,337814,-69761,0.453204970827313
WASHINGTON,GA,1867,1941,74,0.5097163865546218
WASHINGTON,IA,4311,3907,-404,0.47541981017279145
WASHINGTON,IL,8663,8040,-623,0.48135065557085555
WASHINGTON,IN,9904,7964,-1940,0.4457130064920528
WASHINGTON,KS,334,224,-110,0.4014336917562724
WASHINGTON,LA,595,675,80,0.531496062992126
WASHINGTON,MA,72,158,86,0.6869565217391305
WASHINGTON,ME,365,398,33,0.5216251638269986
WASHINGTON,MI,6707,7196,489,0.5175861324893908
WASHINGTON,MO,7541,8029,488,0.5156711624919718
WASHINGTON,MS,15,27,12,0.6428571428571429
WASHINGTON,NC,7898,8444,546,0.5167054216130217
WASHINGTON,NH,492,535,43,0.5209347614410905
WASHINGTON,NJ,4260,4698,438,0.5244474212993971
WASHINGTON,OK,858,917,59,0.5166197183098592
WASHINGTON,PA,19637,17044,-2593,0.4646547258798833
WASHINGTON,TX,236,357,121,0.6020236087689713
WASHINGTON,UT,13175,16019,2844,0.5487086387613893
WASHINGTON,VA,251,176,-75,0.41217798594847777
WASHINGTON,VT,73,102,29,0.5828571428571429
WASHINGTON,WV,1318,1392,74,0.5136531365313654
WASHINGTON BORO,PA,269,406,137,0.6014814814814815
WASHINGTON CH,OH,199,202,3,0.5037406483790524
WASHINGTON COURT HOUSE,OH,9102,8904,-198,0.49450183272242587
WASHINGTON CROSSING,PA,1444,1449,5,0.5008641548565503
WASHINGTON DEPOT,CT,335,489,154,0.5934466019417476
WASHINGTON DT,CT,28,35,7,0.5555555555555556
WASHINGTON GROVE,MD,127,53,-74,0.29444444444444445
WASHINGTON ISLAND,WI,839,631,-208,0.42925170068027213
WASHINGTON PK,IL,199,133,-66,0.4006024096385542
WASHINGTON TOWNSHIP,MI,219,322,103,0.5951940850277264
WASHINGTON TWP,MI,213,190,-23,0.47146401985111663
WASHINGTON TWPS,NJ,60,80,20,0.5714285714285714
WASHINGTONVILLE,NY,2391,2561,170,0.5171647819063004
WASHINGTONVILLE,OH,178,79,-99,0.30739299610894943
WASHINGTONVLE,NY,41,41,0,0.5
WASHOE VALLEY,NV,1217,1490,273,0.5504248245289989
WASHOUGAL,WA,9209,9906,697,0.5182317551660999
WASHTA,IA,15,0,-15,0
WASILLA,AK,21445,23753,2308,0.5255321031904067
WASKOM,TX,1366,1508,142,0.5247042449547669
WASOLA,MO,12,11,-1,0.4782608695652174
WASSAIC,NY,238,224,-14,0.48484848484848486
WATAGA,IL,415,151,-264,0.2667844522968198
WATAUGA,TN,407,426,19,0.5114045618247299
WATAUGA,TX,7344,7212,-132,0.49546578730420443
WATCHUNG,NJ,1761,1999,238,0.5316489361702128
WATER MILL,NY,1835,2211,376,0.546465645081562
WATER VALLEY,KY,64,79,15,0.5524475524475524
WATER VALLEY,MS,2868,2630,-238,0.4783557657329938
WATERBORO,ME,864,901,37,0.5104815864022663
WATERBURY,CT,48113,43663,-4450,0.4757561889818689
WATERBURY,VT,2650,2499,-151,0.48533695863274423
WATERBURY CENTER,VT,816,911,95,0.527504342790967
WATERBURY CTR,VT,13,19,6,0.59375
WATERFLOW,NM,42,45,3,0.5172413793103449
WATERFORD,CA,2863,2880,17,0.5014800626850079
WATERFORD,CT,5887,6373,486,0.5198205546492659
WATERFORD,ME,701,788,87,0.529214237743452
WATERFORD,MI,28211,24480,-3731,0.46459547171243665
WATERFORD,MS,24,47,23,0.6619718309859155
WATERFORD,NY,4466,3981,-485,0.47129158281046524
WATERFORD,OH,736,640,-96,0.46511627906976744
WATERFORD,PA,3124,2997,-127,0.4896258781244895
WATERFORD,VA,542,707,165,0.566052842273819
WATERFORD,VT,150,149,-1,0.4983277591973244
WATERFORD,WI,5939,5794,-145,0.4938208471831586
WATERFORD WKS,NJ,11,22,11,0.6666666666666666
WATERFORD WORKS,NJ,766,794,28,0.5089743589743589
WATERLOO,AL,350,341,-9,0.4934876989869754
WATERLOO,IA,40570,33757,-6813,0.4541687408344209
WATERLOO,IL,4838,5052,214,0.5108190091001011
WATERLOO,IN,1905,1520,-385,0.44379562043795623
WATERLOO,NE,1112,1184,72,0.5156794425087108
WATERLOO,NY,4271,3882,-389,0.476143750766589
WATERLOO,SC,1099,1371,272,0.5550607287449393
WATERLOO,WI,1680,1634,-46,0.4930597465298733
WATERMAN,IL,636,513,-123,0.4464751958224543
WATERPORT,NY,341,340,-1,0.49926578560939794
WATERPROOF,LA,50,35,-15,0.4117647058823529
WATERS,MI,72,46,-26,0.3898305084745763
WATERSMEET,MI,709,530,-179,0.42776432606941084
WATERSOUND,FL,155,248,93,0.6153846153846154
WATERTOWN,CT,4145,4162,17,0.5010232334175996
WATERTOWN,MA,19085,17222,-1863,0.4743437904536315
WATERTOWN,MN,2018,2054,36,0.5044204322200393
WATERTOWN,NY,32064,25009,-7055,0.4381931911762129
WATERTOWN,SD,14147,11887,-2260,0.45659522163324884
WATERTOWN,TN,1846,2094,248,0.5314720812182742
WATERTOWN,WI,12531,10821,-1710,0.46338643371017474
WATERVILLE,KS,157,128,-29,0.44912280701754387
WATERVILLE,ME,11383,9894,-1489,0.4650091648258683
WATERVILLE,MN,1316,1092,-224,0.45348837209302323
WATERVILLE,NY,1122,1103,-19,0.49573033707865166
WATERVILLE,OH,2552,2928,376,0.5343065693430656
WATERVILLE,PA,13,0,-13,0
WATERVILLE,VT,50,11,-39,0.18032786885245902
WATERVILLE,WA,216,285,69,0.5688622754491018
WATERVILLE VALLEY,NH,243,368,125,0.602291325695581
WATERVLIET,MI,2690,2288,-402,0.45962233828846927
WATERVLIET,NY,10686,8244,-2442,0.4354992076069731
WATFORD CITY,ND,6743,5449,-1294,0.44693241469816275
WATHA,NC,146,179,33,0.5507692307692308
WATHENA,KS,834,827,-7,0.49789283564118003
WATKINS,CO,413,277,-136,0.40144927536231884
WATKINS,MN,815,686,-129,0.4570286475682878
WATKINS GLEN,NY,2010,1908,-102,0.4869831546707504
WATKINSVILLE,GA,5447,6388,941,0.5397549640895648
WATONGA,OK,1631,1252,-379,0.4342698577870274
WATROUS,NM,11,0,-11,0
WATSEKA,IL,3425,3114,-311,0.4762196054442575
WATSON,IL,143,94,-49,0.39662447257383965
WATSON,LA,207,193,-14,0.4825
WATSON,OK,11,24,13,0.6857142857142857
WATSONTOWN,PA,2161,2035,-126,0.4849857006673022
WATSONVILLE,CA,12301,11557,-744,0.48440774582949114
WATTS,CA,742,597,-145,0.4458551157580284
WATTS,OK,462,701,239,0.6027515047291487
WATTSBURG,PA,748,540,-208,0.4192546583850932
WATTSVILLE,AL,0,11,11,1
WAUBAY,SD,289,196,-93,0.4041237113402062
WAUBEKA,WI,29,29,0,0.5
WAUBUN,MN,1400,446,-954,0.24160346695557963
WAUCHULA,FL,5625,5151,-474,0.4780066815144766
WAUCOMA,IA,13,30,17,0.6976744186046512
WAUCONDA,IL,5570,5030,-540,0.47452830188679246
WAUCONDA,WA,0,12,12,1
WAUKEE,IA,12131,15656,3525,0.5634289415913917
WAUKEGAN,IL,40930,28618,-12312,0.4114855926841893
WAUKESHA,WI,36430,34301,-2129,0.48495002191401226
WAUKOMIS,OK,521,433,-88,0.45387840670859536
WAUKON,IA,2753,2363,-390,0.46188428459734165
WAUMANDEE,WI,16,13,-3,0.4482758620689655
WAUNA,WA,462,447,-15,0.49174917491749176
WAUNAKEE,WI,6905,7346,441,0.5154725984141464
WAUNETA,NE,135,54,-81,0.2857142857142857
WAUPACA,WI,8059,7098,-961,0.4682984759517055
WAUPUN,WI,4176,4024,-152,0.49073170731707316
WAUREGAN,CT,244,113,-131,0.3165266106442577
WAURIKA,OK,1034,961,-73,0.4817042606516291
WAUSA,NE,131,132,1,0.5019011406844106
WAUSAU,WI,26836,23522,-3314,0.4670955955359625
WAUSAUKEE,WI,1375,1287,-88,0.4834710743801653
WAUSEON,OH,5178,4403,-775,0.4595553700031312
WAUTOMA,WI,3462,3262,-200,0.4851279000594884
WAUWATOSA,WI,9813,9114,-699,0.4815343160564273
WAUZEKA,WI,316,271,-45,0.4616695059625213
WAVELAND,IN,202,148,-54,0.4228571428571429
WAVELAND,MS,2660,2515,-145,0.4859903381642512
WAVERLY,AL,12,84,72,0.875
WAVERLY,FL,62,211,149,0.7728937728937729
WAVERLY,GA,485,744,259,0.6053702196908055
WAVERLY,IA,4843,4745,-98,0.494889445139758
WAVERLY,IL,616,545,-71,0.4694229112833764
WAVERLY,KS,126,117,-9,0.48148148148148145
WAVERLY,KY,89,105,16,0.5412371134020618
WAVERLY,MN,903,1136,233,0.5571358509073076
WAVERLY,MO,99,70,-29,0.41420118343195267
WAVERLY,NE,1390,1454,64,0.5112517580872011
WAVERLY,NY,4352,3322,-1030,0.4328902788636956
WAVERLY,OH,6119,5450,-669,0.4710865243322673
WAVERLY,PA,13,38,25,0.7450980392156863
WAVERLY,TN,4297,4208,-89,0.49476778365667257
WAVERLY,VA,1133,1171,38,0.5082465277777778
WAVERLY,WV,433,236,-197,0.35276532137518685
WAVERLY HALL,GA,863,1129,266,0.5667670682730924
WAVERLY TOWNSHIP,PA,74,88,14,0.5432098765432098
WAWAKA,IN,160,137,-23,0.4612794612794613
WAXAHACHIE,TX,21616,27508,5892,0.5599706864261867
WAXHAW,NC,15260,21089,5829,0.5801810228617018
WAYCROSS,GA,15212,13426,-1786,0.4688176548641665
WAYLAND,IA,463,317,-146,0.4064102564102564
WAYLAND,KY,37,45,8,0.5487804878048781
WAYLAND,MA,4064,4473,409,0.5239545507789621
WAYLAND,MI,6262,5742,-520,0.47834055314895035
WAYLAND,MO,22,11,-11,0.3333333333333333
WAYLAND,NY,2065,1905,-160,0.47984886649874053
WAYMART,PA,1485,1505,20,0.5033444816053512
WAYNE,IL,856,762,-94,0.47095179233621753
WAYNE,ME,519,588,69,0.5311653116531165
WAYNE,MI,6758,6227,-531,0.47955333076626877
WAYNE,NE,3521,1959,-1562,0.3574817518248175
WAYNE,NJ,13635,14417,782,0.5139384001140739
WAYNE,OH,524,457,-67,0.4658511722731906
WAYNE,OK,362,493,131,0.5766081871345029
WAYNE,PA,9537,9427,-110,0.4970997679814385
WAYNE,WV,1693,1527,-166,0.47422360248447204
WAYNE CITY,IL,447,331,-116,0.4254498714652956
WAYNESBORO,GA,5018,4575,-443,0.4769102470551444
WAYNESBORO,MS,3751,3608,-143,0.49028400597907323
WAYNESBORO,PA,10313,10026,-287,0.49294458921284234
WAYNESBORO,TN,2253,2437,184,0.5196162046908316
WAYNESBORO,VA,14772,13654,-1118,0.48033490466474354
WAYNESBURG,KY,1000,1091,91,0.5217599234815877
WAYNESBURG,OH,996,843,-153,0.45840130505709625
WAYNESBURG,PA,5312,4665,-647,0.46757542347399017
WAYNESFIELD,OH,477,385,-92,0.4466357308584687
WAYNESVILLE,GA,1039,1068,29,0.5068818224964404
WAYNESVILLE,IL,12,0,-12,0
WAYNESVILLE,MO,8239,7814,-425,0.486762598891173
WAYNESVILLE,NC,12643,14012,1369,0.5256799849934346
WAYNESVILLE,OH,2955,3240,285,0.5230024213075061
WAYNETOWN,IN,480,436,-44,0.4759825327510917
WAYNOKA,OK,420,396,-24,0.4852941176470588
WAYZATA,MN,8936,8795,-141,0.49602391292087306
WEARE,NH,3180,3132,-48,0.49619771863117873
WEATHERBY,MO,0,12,12,1
WEATHERFORD,OK,8012,6164,-1848,0.4348194130925508
WEATHERFORD,TX,27777,33162,5385,0.5441835277900852
WEATHERLY,PA,1189,1230,41,0.5084745762711864
WEATOGUE,CT,2139,2538,399,0.5426555484284797
WEAUBLEAU,MO,170,184,14,0.519774011299435
WEAVER,AL,1733,1744,11,0.5015818234109864
WEAVERVILLE,CA,2053,1326,-727,0.3924237940219
WEAVERVILLE,NC,7977,9169,1192,0.5347602939461099
WEBB,AL,884,906,22,0.506145251396648
WEBB,IA,12,0,-12,0
WEBB,MS,0,13,13,1
WEBB CITY,MO,8943,7823,-1120,0.4665990695455088
WEBBERS FALLS,OK,203,123,-80,0.3773006134969325
WEBBERVILLE,MI,1823,1405,-418,0.43525402726146223
WEBBVILLE,KY,0,12,12,1
WEBER CITY,VA,330,384,54,0.5378151260504201
WEBSTER,FL,4632,4813,181,0.5095817893065114
WEBSTER,KY,101,137,36,0.5756302521008403
WEBSTER,MA,8719,8270,-449,0.4867855671316734
WEBSTER,MN,419,387,-32,0.4801488833746898
WEBSTER,NC,22,13,-9,0.37142857142857144
WEBSTER,NH,372,382,10,0.506631299734748
WEBSTER,NY,20973,21296,323,0.5038207669923584
WEBSTER,PA,12,0,-12,0
WEBSTER,SD,1156,971,-185,0.45651151857075695
WEBSTER,TX,17750,15304,-2446,0.46299993949295093
WEBSTER,WI,2313,2123,-190,0.47858431018935976
WEBSTER CITY,IA,4473,3633,-840,0.4481865284974093
WEBSTER GROVES,MO,2424,2511,87,0.5088145896656535
WEBSTER PLT,ME,38,28,-10,0.42424242424242425
WEBSTER SPGS,WV,24,24,0,0.5
WEBSTER SPRINGS,WV,1100,971,-129,0.4688556253017866
WECOTA,SD,15,23,8,0.6052631578947368
WEDDERBURN,OR,24,0,-24,0
WEDDINGTON,NC,202,257,55,0.5599128540305011
WEDGEFIELD,SC,929,1037,108,0.5274669379450662
WEDOWEE,AL,1609,1783,174,0.5256485849056604
WEED,CA,3732,3379,-353,0.4751792996765574
WEEDSPORT,NY,1916,1795,-121,0.48369711668014015
WEEDVILLE,PA,252,132,-120,0.34375
WEEHAWKEN,NJ,9694,9615,-79,0.497954321818841
WEEKI WACHEE,FL,6845,10558,3713,0.6066770097109694
WEEKSBURY,KY,0,23,23,1
WEEMS,VA,226,443,217,0.6621823617339312
WEEPING WATER,NE,224,213,-11,0.4874141876430206
WEIDMAN,MI,2250,2027,-223,0.4739303249941548
WEIMAR,CA,263,246,-17,0.48330058939096265
WEIMAR,TX,1129,1253,124,0.5260285474391267
WEINER,AR,257,152,-105,0.37163814180929094
WEINGTON,FL,549,686,137,0.5554655870445344
WEIPPE,ID,112,134,22,0.5447154471544715
WEIR,KS,424,178,-246,0.2956810631229236
WEIR,MS,218,181,-37,0.45363408521303256
WEIR,TX,25,24,-1,0.4897959183673469
WEIRSDALE,FL,1978,2181,203,0.5244049050252465
WEIRTON,WV,7242,6919,-323,0.4885954381752701
WEISER,ID,3753,3907,154,0.5100522193211489
WEKIVA SPRINGS,FL,242,253,11,0.5111111111111111
WELAKA,FL,772,963,191,0.555043227665706
WELCH,MN,281,243,-38,0.4637404580152672
WELCH,OK,457,386,-71,0.4578884934756821
WELCH,WV,1181,793,-388,0.4017223910840932
WELCHES,OR,1385,1241,-144,0.47258187357197257
WELCOME,MD,61,135,74,0.6887755102040817
WELCOME,MN,325,166,-159,0.3380855397148676
WELCOME,NC,91,195,104,0.6818181818181818
WELD,ME,168,179,11,0.515850144092219
WELDON,CA,611,750,139,0.5510653930933137
WELDON,IA,38,0,-38,0
WELDON,IL,35,45,10,0.5625
WELDON,NC,807,579,-228,0.41774891774891776
WELDON SPRING,MO,720,772,52,0.517426273458445
WELDONA,CO,92,106,14,0.5353535353535354
WELEETKA,OK,272,194,-78,0.41630901287553645
WELLBORN,FL,1002,1206,204,0.5461956521739131
WELLBORN,TX,12,24,12,0.6666666666666666
WELLESLEY,MA,4494,4196,-298,0.48285385500575373
WELLESLEY HILLS,MA,3550,4067,517,0.5339372456347643
WELLESLEY HLS,MA,468,576,108,0.5517241379310345
WELLESLEY IS,NY,36,11,-25,0.23404255319148937
WELLESLEY ISLAND,NY,991,822,-169,0.453392167677882
WELLFLEET,MA,3186,3426,240,0.5181488203266787
WELLFLEET,NE,12,0,-12,0
WELLFORD,SC,3136,3142,6,0.5004778591908251
WELLING,OK,180,171,-9,0.48717948717948717
WELLINGTON,AL,585,441,-144,0.4298245614035088
WELLINGTON,CO,5419,6301,882,0.5376279863481229
WELLINGTON,FL,29672,29604,-68,0.4994264120385991
WELLINGTON,IL,49,0,-49,0
WELLINGTON,KS,5348,4397,-951,0.4512057465366855
WELLINGTON,KY,626,718,92,0.5342261904761905
WELLINGTON,ME,31,35,4,0.5303030303030303
WELLINGTON,MO,135,111,-24,0.45121951219512196
WELLINGTON,NV,1176,1429,253,0.5485604606525911
WELLINGTON,OH,3762,3351,-411,0.4711092366090257
WELLINGTON,TX,492,575,83,0.5388940955951266
WELLINGTON,UT,543,543,0,0.5
WELLMAN,IA,816,749,-67,0.47859424920127797
WELLPINIT,WA,47,0,-47,0
WELLS,ME,6117,7642,1525,0.5554182716767206
WELLS,MI,128,49,-79,0.2768361581920904
WELLS,MN,1369,1216,-153,0.4704061895551257
WELLS,NV,298,264,-34,0.4697508896797153
WELLS,NY,153,148,-5,0.49169435215946844
WELLS,TX,0,15,15,1
WELLS,VT,487,467,-20,0.48951781970649894
WELLS RIVER,VT,138,228,90,0.6229508196721312
WELLSBORO,PA,4138,3905,-233,0.4855153549670521
WELLSBURG,IA,210,87,-123,0.29292929292929293
WELLSBURG,NY,472,329,-143,0.4107365792759051
WELLSBURG,WV,2078,1932,-146,0.48179551122194514
WELLSTON,MI,844,824,-20,0.4940047961630695
WELLSTON,OH,2773,2814,41,0.5036692321460533
WELLSTON,OK,1400,1433,33,0.5058242146134839
WELLSVILLE,KS,1234,1238,4,0.5008090614886731
WELLSVILLE,MO,724,628,-96,0.46449704142011833
WELLSVILLE,NY,4131,3841,-290,0.4818113396889112
WELLSVILLE,OH,2440,2222,-218,0.4766194766194766
WELLSVILLE,PA,669,678,9,0.5033407572383074
WELLSVILLE,UT,1287,1518,231,0.5411764705882353
WELLTON,AZ,2547,4686,2139,0.6478639568643716
WELSH,LA,1751,1439,-312,0.45109717868338556
WELTY,OK,11,0,-11,0
WENATCHEE,WA,18294,17974,-320,0.4955883974853866
WENDEL,PA,19,0,-19,0
WENDELL,ID,2415,1666,-749,0.40823327615780447
WENDELL,MA,70,62,-8,0.4696969696969697
WENDELL,NC,6494,9847,3353,0.6025947004467291
WENDEN,AZ,147,230,83,0.610079575596817
WENDOVER,UT,215,63,-152,0.22661870503597123
WENHAM,MA,1115,1277,162,0.5338628762541806
WENONA,IL,591,405,-186,0.4066265060240964
WENONAH,NJ,1801,2033,232,0.5302556077203965
WENTWORTH,MO,66,52,-14,0.4406779661016949
WENTWORTH,NH,198,174,-24,0.46774193548387094
WENTWORTH,SD,384,292,-92,0.4319526627218935
WENTZVILLE,MO,15015,17645,2630,0.540263319044703
WEOGUFKA,AL,0,14,14,1
WERNERSVILLE,PA,2499,2680,181,0.5174744159104074
WESCOSVILLE,PA,46,56,10,0.5490196078431373
WESLACO,TX,13185,16096,2911,0.5497080017758956
WESLEY,AR,105,167,62,0.6139705882352942
WESLEY,IA,40,29,-11,0.42028985507246375
WESLEY CHAPEL,FL,37608,47659,10051,0.5589383935168354
WESSINGTN SPG,SD,16,0,-16,0
WESSINGTON SPRINGS,SD,392,222,-170,0.36156351791530944
WESSON,MS,1556,1639,83,0.5129890453834116
WEST,MS,73,36,-37,0.3302752293577982
WEST,TX,1686,1898,212,0.5295758928571429
WEST ABINGTON TOWNSHIP,PA,42,67,25,0.6146788990825688
WEST ALEXANDER,PA,212,240,28,0.5309734513274337
WEST ALEXANDRIA,OH,1293,1351,58,0.5109682299546142
WEST ALLENHURST,NJ,49,61,12,0.5545454545454546
WEST ALLIS,WI,11778,10623,-1155,0.4742199008972814
WEST ALTON,MO,42,11,-31,0.20754716981132076
WEST ARLINGTON,VT,82,113,31,0.5794871794871795
WEST BABYLON,NY,11743,10861,-882,0.4804901787294284
WEST BADEN SPRINGS,IN,590,599,9,0.503784693019344
WEST BALDWIN,ME,61,98,37,0.6163522012578616
WEST BANGOR,NY,27,21,-6,0.4375
WEST BARNSTABLE,MA,969,1136,167,0.539667458432304
WEST BATH,ME,498,536,38,0.5183752417794971
WEST BEND,IA,202,86,-116,0.2986111111111111
WEST BEND,WI,19505,16926,-2579,0.46460432049628064
WEST BERLIN,NJ,1584,1901,317,0.545480631276901
WEST BLOCTON,AL,1707,1320,-387,0.4360753221010902
WEST BLOOMFIELD,MI,20954,21320,366,0.5043289019255335
WEST BOOTHBAY HARBOR,ME,257,230,-27,0.4722792607802875
WEST BOUNTIFUL,UT,1477,1716,239,0.5374256185405575
WEST BOYLSTON,MA,2449,2506,57,0.5057517658930374
WEST BRADFORD,PA,309,319,10,0.5079617834394905
WEST BRANCH,IA,1300,1476,176,0.531700288184438
WEST BRANCH,MI,5546,5220,-326,0.48485974363737694
WEST BRIDGEWATER,MA,1957,1949,-8,0.4989759344598054
WEST BROOKFIELD,MA,1332,1466,134,0.5239456754824875
WEST BROOKLYN,IL,23,16,-7,0.41025641025641024
WEST BURKE,VT,422,456,34,0.5193621867881549
WEST BURLINGTON,IA,2271,1857,-414,0.4498546511627907
WEST CALDWELL,NJ,1672,1946,274,0.5378662244333886
WEST CAPE MAY,NJ,148,386,238,0.7228464419475655
WEST CARROLLTON,OH,601,569,-32,0.4863247863247863
WEST CARROLLTON CITY,OH,400,371,-29,0.48119325551232167
WEST CHARLESTON,VT,203,228,25,0.5290023201856149
WEST CHATHAM,MA,467,423,-44,0.4752808988764045
WEST CHAZY,NY,1790,1693,-97,0.48607522250933105
WEST CHESTER,OH,20478,20991,513,0.5061853432684656
WEST CHESTER,PA,32408,31727,-681,0.4946908864114758
WEST CHESTERFIELD,NH,233,227,-6,0.4934782608695652
WEST CHICAGO,IL,8736,7982,-754,0.4774494556765163
WEST COLLEGE CORNER,IN,254,78,-176,0.23493975903614459
WEST COLLINGSWOOD,NJ,106,86,-20,0.4479166666666667
WEST COLLINGSWOOD HEIGHTS,NJ,27,36,9,0.5714285714285714
WEST COLUMBIA,SC,20601,20288,-313,0.4961725647484654
WEST COLUMBIA,TX,3107,3069,-38,0.49692357512953367
WEST COLUMBIA,WV,56,14,-42,0.2
WEST CONCORD,MN,562,413,-149,0.4235897435897436
WEST CORNWALL,CT,123,353,230,0.7415966386554622
WEST COVINA,CA,29079,26124,-2955,0.47323515026357266
WEST COXSACKIE,NY,304,309,5,0.5040783034257749
WEST CREEK,NJ,1109,1271,162,0.5340336134453781
WEST DANVILLE,VT,181,255,74,0.5848623853211009
WEST DECATUR,PA,226,191,-35,0.4580335731414868
WEST DELRAY BEACH,FL,264,447,183,0.6286919831223629
WEST DENNIS,MA,1716,1723,7,0.5010177377144519
WEST DEPTFORD,NJ,3523,3560,37,0.5026118876182408
WEST DES MOINES,IA,42704,40943,-1761,0.4894736212894664
WEST DOVER,VT,1086,923,-163,0.4594325535092086
WEST DUNDEE,IL,3663,3749,86,0.5058014031300594
WEST EDMESTON,NY,107,68,-39,0.38857142857142857
WEST ELIZABETH,PA,25,0,-25,0
WEST END,NC,2766,3759,993,0.5760919540229885
WEST ENFIELD,ME,448,346,-102,0.4357682619647355
WEST FAIRLEE,VT,0,23,23,1
WEST FALLS,NY,578,629,51,0.5211267605633803
WEST FALMOUTH,MA,805,404,-401,0.33416046319272125
WEST FARGO,ND,21336,19795,-1541,0.48126717074712505
WEST FARMINGTON,ME,25,26,1,0.5098039215686274
WEST FARMINGTON,OH,738,650,-88,0.46829971181556196
WEST FINLEY,PA,12,13,1,0.52
WEST FORK,AR,2253,2249,-4,0.4995557529986673
WEST FRANKFORT,IL,5700,4927,-773,0.4636303754587372
WEST FRIENDSHIP,MD,304,521,217,0.6315151515151515
WEST GARDINER,ME,943,1027,84,0.5213197969543147
WEST GILGO BEACH,NY,85,131,46,0.6064814814814815
WEST GLACIER,MT,638,422,-216,0.39811320754716983
WEST GLEN ROSE,TX,41,50,9,0.5494505494505495
WEST GLOVER,VT,13,36,23,0.7346938775510204
WEST GRANBY,CT,69,90,21,0.5660377358490566
WEST GREEN,GA,25,23,-2,0.4791666666666667
WEST GREENWICH,RI,1886,2071,185,0.5233762951731109
WEST GROVE,PA,2837,3159,322,0.526851234156104
WEST HALIFAX,VT,14,12,-2,0.46153846153846156
WEST HAMLIN,WV,572,362,-210,0.3875802997858672
WEST HARRISON,IN,1454,1662,208,0.5333761232349166
WEST HARRISON,NY,1915,2195,280,0.5340632603406326
WEST HARTFORD,CT,22869,22827,-42,0.49954044117647056
WEST HARTFRD,CT,209,193,-16,0.48009950248756217
WEST HARWICH,MA,1457,1327,-130,0.4766522988505747
WEST HATFIELD,MA,23,34,11,0.5964912280701754
WEST HAVEN,CT,20653,18568,-2085,0.47341985161010686
WEST HAVEN,UT,1245,1435,190,0.5354477611940298
WEST HAVEN,VT,73,66,-7,0.4748201438848921
WEST HAVERSTRAW,NY,1428,1329,-99,0.4820457018498368
WEST HAZLETON,PA,3482,3372,-110,0.49197548876568425
WEST HELENA,AR,3538,3093,-445,0.4664454833358468
WEST HEMPSTEAD,NY,5608,5349,-259,0.4881810714611664
WEST HENRIETTA,NY,4665,4797,132,0.5069752694990488
WEST HILLS,CA,10310,10681,371,0.5088371206707637
WEST HOLLYWOOD,CA,27955,22512,-5443,0.44607367190441277
WEST HURLEY,NY,594,765,171,0.5629139072847682
WEST HYANNISPORT,MA,533,354,-179,0.399098083427283
WEST HYATTSVILLE,MD,377,330,-47,0.4667609618104668
WEST ISLIP,NY,5244,5221,-23,0.4989010989010989
WEST JEFFERSON,NC,2701,2990,289,0.5253909681953962
WEST JEFFERSON,OH,2335,2252,-83,0.4909526923915413
WEST JORDAN,UT,40066,37718,-2348,0.48490692173197575
WEST KENNEBUNK,ME,93,90,-3,0.4918032786885246
WEST KILL,NY,40,0,-40,0
WEST KINGSTON,RI,1289,1399,110,0.5204613095238095
WEST LAFAYETTE,IN,30240,23430,-6810,0.43655673560648406
WEST LAFAYETTE,OH,1544,1554,10,0.5016139444803098
WEST LAKE HILLS,TX,2099,1887,-212,0.4734069242348219
WEST LAWN,PA,871,787,-84,0.4746682750301568
WEST LEBANON,IN,196,138,-58,0.41317365269461076
WEST LEBANON,NH,2684,2535,-149,0.4857252347192949
WEST LEECHBURG,PA,56,52,-4,0.48148148148148145
WEST LEISENRING,PA,23,0,-23,0
WEST LEYDEN,NY,18,15,-3,0.45454545454545453
WEST LIBERTY,IA,2180,1644,-536,0.4299163179916318
WEST LIBERTY,KY,2726,2635,-91,0.4915127774668905
WEST LIBERTY,OH,1515,1333,-182,0.46804775280898875
WEST LINE,MO,0,17,17,1
WEST LINN,OR,11232,11692,460,0.5100331530273948
WEST LOGAN,WV,156,168,12,0.5185185185185185
WEST LONG BRANCH,NJ,2323,2158,-165,0.4815889310421781
WEST MANCHESTER,OH,92,154,62,0.6260162601626016
WEST MANSFIELD,OH,721,719,-2,0.49930555555555556
WEST MARLBORO,VT,131,75,-56,0.3640776699029126
WEST MCLEAN,VA,0,18,18,1
WEST MELBOURNE,FL,981,1141,160,0.5377002827521207
WEST MEMPHIS,AR,9922,9609,-313,0.49198709743484714
WEST MIAMI,FL,4070,3768,-302,0.4807348813472825
WEST MIDDLESEX,PA,1460,1229,-231,0.4570472294533284
WEST MIFFLIN,PA,5222,4964,-258,0.48733555860985667
WEST MILFORD,NJ,3727,4165,438,0.527749619868221
WEST MILFORD,WV,62,27,-35,0.30337078651685395
WEST MILTON,OH,2367,2272,-95,0.4897607242940289
WEST MILTON,PA,285,192,-93,0.4025157232704403
WEST MONROE,LA,25360,21526,-3834,0.45911359467644924
WEST MONROE,NY,1235,1095,-140,0.4699570815450644
WEST NEW YORK,NJ,15798,12542,-3256,0.4425546930134086
WEST NEWBURY,MA,1118,1319,201,0.5412392285597045
WEST NEWFIELD,ME,454,602,148,0.5700757575757576
WEST NEWTON,MA,3071,3153,82,0.5065874035989717
WEST NEWTON,PA,1683,1738,55,0.5080385852090032
WEST NORRITON,PA,523,512,-11,0.49468599033816424
WEST NYACK,NY,1748,1868,120,0.5165929203539823
WEST OLIVE,MI,3120,3299,179,0.5139429817728618
WEST ONEONTA,NY,0,12,12,1
WEST ORANGE,NJ,13635,13941,306,0.5055483028720626
WEST ORANGE,TX,2254,2058,-196,0.4772727272727273
WEST OSSIPEE,NH,580,439,-141,0.4308145240431796
WEST OTIS,MA,0,27,27,1
WEST PADUCAH,KY,1490,1395,-95,0.48353552859618715
WEST PALM,FL,12,0,-12,0
WEST PALM BCH,FL,19859,18625,-1234,0.48396736305997295
WEST PALM BEACH,FL,140509,131879,-8630,0.4841586266649045
WEST PARIS,ME,914,551,-363,0.37610921501706485
WEST PARK,FL,3228,2897,-331,0.4729795918367347
WEST PARK,NY,11,12,1,0.5217391304347826
WEST PAWLET,VT,0,13,13,1
WEST PITTSBURG,PA,98,25,-73,0.2032520325203252
WEST PITTSTON,PA,1175,1143,-32,0.4930974978429681
WEST PLAINS,MO,13307,12260,-1047,0.4795243869049947
WEST POINT,CA,578,699,121,0.5473766640563822
WEST POINT,GA,2452,2124,-328,0.46416083916083917
WEST POINT,IA,499,484,-15,0.4923702950152594
WEST POINT,IL,12,0,-12,0
WEST POINT,KY,647,653,6,0.5023076923076923
WEST POINT,MS,4629,4332,-297,0.48342818881821226
WEST POINT,NE,1698,1518,-180,0.47201492537313433
WEST POINT,NY,8012,1704,-6308,0.1753808151502676
WEST POINT,TX,23,23,0,0.5
WEST POINT,VA,1375,1490,115,0.5200698080279232
WEST PORTSMOUTH,OH,1568,1498,-70,0.4885844748858447
WEST READING,PA,1553,1403,-150,0.4746278755074425
WEST REDDING,CT,239,314,75,0.5678119349005425
WEST RICHLAND,WA,5764,6620,856,0.5345607235142119
WEST RIVER,MD,242,458,216,0.6542857142857142
WEST ROCKPORT,ME,11,0,-11,0
WEST ROXBURY,MA,9277,8954,-323,0.4911414623443585
WEST RUSHVILLE,OH,20,11,-9,0.3548387096774194
WEST RUTLAND,VT,1470,1196,-274,0.4486121530382596
WEST SACRAMENTO,CA,17234,16825,-409,0.4939957133210018
WEST SAINT PAUL,MN,723,538,-185,0.42664551942902457
WEST SALEM,IL,335,289,-46,0.46314102564102566
WEST SALEM,OH,2044,2061,17,0.5020706455542022
WEST SALEM,WI,2731,2682,-49,0.495473859227785
WEST SAND LAKE,NY,798,752,-46,0.48516129032258065
WEST SAYVILLE,NY,919,841,-78,0.4778409090909091
WEST SENECA,NY,4663,4840,177,0.5093128485741345
WEST SHOKAN,NY,91,191,100,0.6773049645390071
WEST SIMSBURY,CT,1018,1086,68,0.5161596958174905
WEST SOMERSET,KY,158,114,-44,0.41911764705882354
WEST SPRINGFIELD,MA,12862,11024,-1838,0.46152557983756176
WEST SPRINGFIELD,PA,328,280,-48,0.4605263157894737
WEST SPRINGFIELD,VA,260,248,-12,0.4881889763779528
WEST STOCKBRIDGE,MA,983,867,-116,0.46864864864864864
WEST SUFFIELD,CT,879,957,78,0.5212418300653595
WEST SUNBURY,PA,654,560,-94,0.4612850082372323
WEST SWANZEY,NH,12,35,23,0.7446808510638298
WEST TAWAKONI,TX,130,140,10,0.5185185185185185
WEST TERRE HAUTE,IN,2819,2677,-142,0.4870815138282387
WEST TISBURY,MA,831,955,124,0.5347144456886898
WEST TOPSHAM,VT,26,23,-3,0.46938775510204084
WEST TOWNSEND,MA,277,266,-11,0.48987108655616945
WEST TOWNSHEND,VT,25,97,72,0.7950819672131147
WEST UNION,IA,1713,1329,-384,0.4368836291913215
WEST UNION,IL,0,49,49,1
WEST UNION,OH,4281,3379,-902,0.4411227154046997
WEST UNION,SC,1671,1920,249,0.5346700083542189
WEST UNION,WV,1085,1175,90,0.5199115044247787
WEST UNITY,OH,1075,941,-134,0.466765873015873
WEST UNIVERSITY PLACE,TX,363,420,57,0.5363984674329502
WEST VALLEY,NY,435,322,-113,0.42536327608982827
WEST VALLEY,UT,680,671,-9,0.4966691339748335
WEST VALLEY CITY,UT,47818,34315,-13503,0.4177979618423776
WEST VAN LEAR,KY,52,71,19,0.5772357723577236
WEST VIEW,PA,441,390,-51,0.4693140794223827
WEST WARDSBORO,VT,68,37,-31,0.3523809523809524
WEST WAREHAM,MA,1476,1579,103,0.5168576104746317
WEST WARREN,MA,303,223,-80,0.42395437262357416
WEST WARWICK,RI,14464,13608,-856,0.4847534910230835
WEST WENDOVER,NV,1334,447,-887,0.2509825940482875
WEST WHATELY,MA,42,31,-11,0.4246575342465753
WEST WINDSOR,NJ,1702,1907,205,0.5284012191742865
WEST WINDSOR,VT,55,49,-6,0.47115384615384615
WEST WINFIELD,NY,1158,1056,-102,0.47696476964769646
WEST WYOMING,PA,255,233,-22,0.4774590163934426
WEST YARMOUTH,MA,4645,4647,2,0.500107619457598
WEST YELLOWSTONE,MT,2312,1470,-842,0.3886832363828662
WEST YORK,PA,274,277,3,0.5027223230490018
WESTAMPTON,NJ,1503,1646,143,0.5227056208320101
WESTBORO,WI,114,112,-2,0.49557522123893805
WESTBOROUGH,MA,9664,9550,-114,0.4970334131362548
WESTBROOK,CT,3347,3428,81,0.5059778597785978
WESTBROOK,ME,10045,9386,-659,0.48304256085636355
WESTBROOK,MN,402,374,-28,0.48195876288659795
WESTBROOKVILLE,NY,35,45,10,0.5625
WESTBURY,NY,14636,12678,-1958,0.46415757487003
WESTBY,MT,12,16,4,0.5714285714285714
WESTBY,WI,1377,1390,13,0.5023491145645103
WESTCHASE,FL,1231,1337,106,0.5206386292834891
WESTCHESTER,CA,1270,1096,-174,0.463229078613694
WESTCHESTER,IL,4924,5221,297,0.5146377525874816
WESTCLIFFE,CO,2860,3249,389,0.5318382714028482
WESTERLO,NY,414,360,-54,0.46511627906976744
WESTERLY,RI,10521,10842,321,0.5075129897486308
WESTERN GROVE,AR,79,172,93,0.6852589641434262
WESTERN SPRGS,IL,163,167,4,0.5060606060606061
WESTERN SPRINGS,IL,2711,3299,588,0.54891846921797
WESTERNPORT,MD,1030,827,-203,0.4453419493807216
WESTERNVILLE,NY,65,13,-52,0.16666666666666666
WESTERVILLE,OH,39682,40893,1211,0.507514737821905
WESTFIELD,IA,0,12,12,1
WESTFIELD,IL,11,0,-11,0
WESTFIELD,IN,12370,17545,5175,0.5864950693631957
WESTFIELD,MA,14550,13157,-1393,0.47486194824412603
WESTFIELD,ME,11,0,-11,0
WESTFIELD,NC,388,633,245,0.6199804113614104
WESTFIELD,NJ,7164,8350,1186,0.5382235400283615
WESTFIELD,NY,2287,2237,-50,0.49447391688771
WESTFIELD,PA,1458,1251,-207,0.46179401993355484
WESTFIELD,VT,91,55,-36,0.3767123287671233
WESTFIELD,WI,1466,1344,-122,0.4782918149466192
WESTFIELD CENTER,OH,128,174,46,0.5761589403973509
WESTFIELD CTR,OH,27,0,-27,0
WESTFIR,OR,11,23,12,0.6764705882352942
WESTFORD,MA,7133,8217,1084,0.5353094462540716
WESTFORD,PA,25,19,-6,0.4318181818181818
WESTFORD,VT,510,457,-53,0.4725956566701138
WESTHAMPTON,NY,2032,1997,-35,0.49565649044427895
WESTHAMPTON BEACH,NY,3527,3203,-324,0.47592867756315005
WESTHOPE,ND,67,53,-14,0.44166666666666665
WESTLAKE,LA,4074,3859,-215,0.48644901046262445
WESTLAKE,OH,13661,13651,-10,0.4998169302870533
WESTLAKE,OR,22,49,27,0.6901408450704225
WESTLAKE,TX,318,421,103,0.5696887686062246
WESTLAKE VILLAGE,CA,12118,12777,659,0.5132355894757984
WESTLAKE VLG,CA,467,469,2,0.5010683760683761
WESTLAND,MI,36998,31355,-5643,0.458721636212017
WESTLEY,CA,48,59,11,0.5514018691588785
WESTMANLAND,ME,0,19,19,1
WESTMINSTER,CA,26933,24618,-2315,0.4775465073422436
WESTMINSTER,CO,44372,41560,-2812,0.48363822557370945
WESTMINSTER,MA,2485,2694,209,0.5201776404711335
WESTMINSTER,MD,16616,17388,772,0.5113516056934478
WESTMINSTER,SC,4781,4892,111,0.5057376201798821
WESTMINSTER,VT,87,52,-35,0.37410071942446044
WESTMINSTER WEST,VT,27,27,0,0.5
WESTMONT,IL,12323,10615,-1708,0.4627692039410585
WESTMORELAND,KS,324,419,95,0.5639300134589502
WESTMORELAND,NH,249,366,117,0.5951219512195122
WESTMORELAND,NY,260,290,30,0.5272727272727272
WESTMORELAND,TN,3346,3918,572,0.5393722466960352
WESTMORELAND CITY,PA,15,12,-3,0.4444444444444444
WESTMORLAND,CA,108,184,76,0.6301369863013698
WESTON,CO,205,245,40,0.5444444444444444
WESTON,CT,2939,3613,674,0.5514346764346765
WESTON,FL,23697,24037,340,0.5035614027737043
WESTON,ID,22,157,135,0.8770949720670391
WESTON,MA,3389,4100,711,0.5474696221124316
WESTON,ME,40,67,27,0.6261682242990654
WESTON,MO,1095,1096,1,0.5002282062984938
WESTON,NE,12,18,6,0.6
WESTON,OH,910,917,7,0.5019157088122606
WESTON,OR,270,147,-123,0.35251798561151076
WESTON,TX,11,12,1,0.5217391304347826
WESTON,VT,38,278,240,0.879746835443038
WESTON,WV,4189,3465,-724,0.4527044682518944
WESTON LAKES,TX,323,540,217,0.6257242178447276
WESTONS MILLS,NY,12,0,-12,0
WESTOVER,AL,51,48,-3,0.48484848484848486
WESTOVER,MD,277,443,166,0.6152777777777778
WESTOVER,PA,22,0,-22,0
WESTOVER,WV,522,474,-48,0.4759036144578313
WESTOVER AFB,MA,16,15,-1,0.4838709677419355
WESTPHALIA,IN,26,0,-26,0
WESTPHALIA,MI,169,62,-107,0.2683982683982684
WESTPHALIA,MO,27,11,-16,0.2894736842105263
WESTPOINT,IN,98,133,35,0.5757575757575758
WESTPOINT,TN,47,107,60,0.6948051948051948
WESTPORT,CT,9736,11413,1677,0.5396472646460826
WESTPORT,IN,1283,1029,-254,0.44506920415224915
WESTPORT,KY,0,24,24,1
WESTPORT,MA,5019,5708,689,0.5321152232683882
WESTPORT,NY,741,790,49,0.5160026126714565
WESTPORT,OR,120,145,25,0.5471698113207547
WESTPORT,WA,2519,1729,-790,0.407015065913371
WESTPORT ISLAND,ME,428,379,-49,0.46964064436183395
WESTPORT POINT,MA,25,47,22,0.6527777777777778
WESTTOWN,NY,690,899,209,0.565764631843927
WESTTOWN,PA,58,53,-5,0.4774774774774775
WESTVIEW,KY,16,12,-4,0.42857142857142855
WESTVILLE,FL,869,1006,137,0.5365333333333333
WESTVILLE,IL,1608,1529,-79,0.4874083519285942
WESTVILLE,IN,2327,2276,-51,0.4944601346947643
WESTVILLE,NJ,3500,3273,-227,0.4832422855455485
WESTVILLE,OK,1446,1536,90,0.5150905432595574
WESTWEGO,LA,8871,7648,-1223,0.4629820207034324
WESTWOOD,CA,2302,1639,-663,0.41588429332656685
WESTWOOD,KS,1182,1188,6,0.5012658227848101
WESTWOOD,MA,4416,4902,486,0.5260785576303928
WESTWOOD,NJ,4361,4610,249,0.5138780514992755
WESTWOOD HILLS,KS,621,636,15,0.5059665871121718
WESTWORTH VILLAGE,TX,704,651,-53,0.48044280442804427
WETHERSFIELD,CT,8094,8710,616,0.5183289692930255
WETMORE,CO,11,11,0,0.5
WETMORE,KS,11,0,-11,0
WETMORE,MI,362,417,55,0.5353016688061617
WETUMKA,OK,754,739,-15,0.49497655726724715
WETUMPKA,AL,11026,10881,-145,0.4966905555301958
WEVER,IA,133,147,14,0.525
WEWAHITCHKA,FL,2166,2547,381,0.5404201145767027
WEWOKA,OK,2063,2012,-51,0.49374233128834355
WEXFORD,PA,8364,8494,130,0.5038557361490094
WEYAUWEGA,WI,1552,1519,-33,0.4946271572777597
WEYBRIDGE,VT,280,254,-26,0.4756554307116105
WEYERHAEUSER,WI,167,141,-26,0.4577922077922078
WEYERS CAVE,VA,912,831,-81,0.47676419965576594
WEYMOUTH,MA,8772,8361,-411,0.48800560322185255
WHALAN,MN,0,14,14,1
WHALEYVILLE,MD,46,59,13,0.5619047619047619
WHARTON,NJ,4250,4573,323,0.5183044315992292
WHARTON,OH,50,23,-27,0.3150684931506849
WHARTON,TX,5051,4332,-719,0.4616860279228392
WHARTON,WV,12,0,-12,0
WHAT CHEER,IA,199,139,-60,0.41124260355029585
WHATELY,MA,70,23,-47,0.24731182795698925
WHATLEY,AL,0,11,11,1
WHEAT RIDGE,CO,18369,17238,-1131,0.484118291347207
WHEATCROFT,KY,11,0,-11,0
WHEATFIELD,IN,2538,2681,143,0.5136999425177237
WHEATLAND,CA,1789,1708,-81,0.4884186445524735
WHEATLAND,IA,337,198,-139,0.37009345794392523
WHEATLAND,IN,187,92,-95,0.32974910394265233
WHEATLAND,MO,931,991,60,0.5156087408949012
WHEATLAND,OK,11,11,0,0.5
WHEATLAND,PA,240,159,-81,0.39849624060150374
WHEATLAND,WY,3894,3424,-470,0.46788740092921566
WHEATLEY,AR,43,35,-8,0.44871794871794873
WHEATLEY HEIGHTS,NY,1743,1535,-208,0.4682733374008542
WHEATLEY HTS,NY,105,85,-20,0.4473684210526316
WHEATON,IL,21963,20648,-1315,0.48456971204618526
WHEATON,KS,41,31,-10,0.4305555555555556
WHEATON,MD,2945,2606,-339,0.46946496126823994
WHEATON,MN,891,666,-225,0.4277456647398844
WHEATON,MO,99,52,-47,0.3443708609271523
WHEELER,MI,197,65,-132,0.2480916030534351
WHEELER,OR,23,36,13,0.6101694915254238
WHEELER,TX,404,252,-152,0.38414634146341464
WHEELER,WI,405,266,-139,0.39642324888226527
WHEELERSBURG,OH,3651,3574,-77,0.4946712802768166
WHEELING,IL,17107,15242,-1865,0.47117376116726944
WHEELING,MO,39,11,-28,0.22
WHEELING,WV,13425,12976,-449,0.49149653422218853
WHEELWRIGHT,KY,22,11,-11,0.3333333333333333
WHIGHAM,GA,919,945,26,0.5069742489270386
WHIPPANY,NJ,1957,2249,292,0.5347123157394199
WHIPPLE,OH,58,35,-23,0.3763440860215054
WHISPER PNES,NC,164,173,9,0.5133531157270029
WHISPERING PINES,NC,2182,2616,434,0.5452271779908295
WHISTLER,AL,250,212,-38,0.4588744588744589
WHITAKERS,NC,882,1022,140,0.5367647058823529
WHITE,GA,2161,2439,278,0.5302173913043479
WHITE,SD,73,72,-1,0.496551724137931
WHITE BEAR LAKE,MN,2575,2622,47,0.5045218395228016
WHITE BEAR LAKE TOWNSHIP,MN,105,93,-12,0.4696969696969697
WHITE BEAR LK,MN,531,474,-57,0.4716417910447761
WHITE BEAR TOWNSHIP,MN,502,535,33,0.5159112825458052
WHITE BIRD,ID,119,128,9,0.5182186234817814
WHITE BLUFF,TN,2727,2714,-13,0.4988053666605403
WHITE CASTLE,LA,797,714,-83,0.47253474520185307
WHITE CITY,KS,108,145,37,0.5731225296442688
WHITE CITY,OR,4290,4871,581,0.5317105119528436
WHITE CLOUD,KS,11,11,0,0.5
WHITE CLOUD,MI,3764,3739,-25,0.49833399973343995
WHITE DEER,PA,14,0,-14,0
WHITE DEER,TX,97,58,-39,0.3741935483870968
WHITE HALL,AL,40,73,33,0.6460176991150443
WHITE HALL,AR,5338,4786,-552,0.4727380482022916
WHITE HALL,IL,1017,966,-51,0.48714069591527986
WHITE HALL,MD,1071,1194,123,0.5271523178807948
WHITE HAVEN,PA,1663,1725,62,0.5091499409681228
WHITE HEATH,IL,117,105,-12,0.47297297297297297
WHITE HORSE BEACH,MA,0,11,11,1
WHITE HOUSE,TN,6693,7737,1044,0.5361746361746361
WHITE HSE STA,NJ,167,277,110,0.6238738738738738
WHITE LAKE,MI,9544,9817,273,0.5070502556686122
WHITE LAKE,NY,379,306,-73,0.4467153284671533
WHITE LAKE,SD,34,0,-34,0
WHITE LAKE,WI,709,668,-41,0.4851125635439361
WHITE MARSH,MD,1108,1359,251,0.550871503850831
WHITE MARSH,VA,14,0,-14,0
WHITE MESA,UT,95,89,-6,0.483695652173913
WHITE MILLS,PA,11,11,0,0.5
WHITE MOUNTAIN LAKE,AZ,0,29,29,1
WHITE MTN LK,AZ,0,11,11,1
WHITE OAK,GA,53,172,119,0.7644444444444445
WHITE OAK,NC,123,220,97,0.641399416909621
WHITE OAK,PA,2486,2635,149,0.514547939855497
WHITE OAK,TX,2511,2600,89,0.5087067110154568
WHITE OAK,WV,0,11,11,1
WHITE OAKS,NM,12,0,-12,0
WHITE PIGEON,MI,2202,2084,-118,0.48623425104993
WHITE PINE,MI,26,0,-26,0
WHITE PINE,TN,2296,2670,374,0.5376560612162706
WHITE PLAINS,GA,38,214,176,0.8492063492063492
WHITE PLAINS,KY,217,361,144,0.6245674740484429
WHITE PLAINS,MD,4755,5789,1034,0.5490326251896813
WHITE PLAINS,NY,27750,25363,-2387,0.47752904185416
WHITE PLAINS,VA,11,0,-11,0
WHITE POST,VA,400,562,162,0.5841995841995842
WHITE RIV JCT,VT,74,76,2,0.5066666666666667
WHITE RIVER,SD,30,0,-30,0
WHITE RIVER JUNCTION,VT,3634,3603,-31,0.49785822854774076
WHITE ROCK,NM,1407,1591,184,0.5306871247498333
WHITE ROCK,SC,13,0,-13,0
WHITE SALMON,WA,2848,2764,-84,0.4925160370634355
WHITE SANDS,NM,26,24,-2,0.48
WHITE SANDS MISSILE RANGE,NM,596,501,-95,0.4567000911577028
WHITE SETTLEMENT,TX,1723,1751,28,0.5040299366724237
WHITE SPRINGS,FL,910,1197,287,0.5681063122923588
WHITE STONE,VA,883,1006,123,0.532556908417152
WHITE SULPHUR SPRINGS,MT,781,617,-164,0.4413447782546495
WHITE SULPHUR SPRINGS,WV,1451,1368,-83,0.48527846754168147
WHITE SWAN,WA,109,60,-49,0.35502958579881655
WHITEFACE,TX,0,11,11,1
WHITEFIELD,ME,537,642,105,0.544529262086514
WHITEFIELD,NH,1668,1720,52,0.5076741440377804
WHITEFIELD,OK,0,38,38,1
WHITEFISH,MT,10449,10880,431,0.5101036147967556
WHITEFISH BAY,WI,1164,1156,-8,0.4982758620689655
WHITEFORD,MD,616,625,9,0.5036261079774376
WHITEHALL,MI,3707,3688,-19,0.4987153482082488
WHITEHALL,MT,1677,1657,-20,0.497000599880024
WHITEHALL,NY,2338,2025,-313,0.46413018565207426
WHITEHALL,OH,2088,1930,-158,0.4803384768541563
WHITEHALL,PA,10520,9858,-662,0.48375699283541074
WHITEHALL,WI,1273,1175,-98,0.47998366013071897
WHITEHOUSE,KY,54,40,-14,0.425531914893617
WHITEHOUSE,OH,2032,2267,235,0.5273319376599209
WHITEHOUSE,TX,5011,5814,803,0.5370900692840647
WHITEHOUSE STATION,NJ,2384,2931,547,0.5514581373471308
WHITELAND,IN,4110,4506,396,0.5229805013927576
WHITELAW,WI,343,352,9,0.5064748201438849
WHITEMAN AFB,MO,349,452,103,0.5642946317103621
WHITEMAN AIR FORCE BASE,MO,1501,1710,209,0.5325443786982249
WHITEOAK,MO,0,12,12,1
WHITERIVER,AZ,294,120,-174,0.2898550724637681
WHITES CREEK,TN,1274,1397,123,0.5230250842381131
WHITESBORO,NY,3552,3455,-97,0.4930783502212074
WHITESBORO,TX,3786,4429,643,0.5391357273280585
WHITESBURG,GA,1286,1541,255,0.5451008135833039
WHITESBURG,KY,1775,1824,49,0.5068074465129202
WHITESBURG,TN,1114,1252,138,0.5291631445477599
WHITESTONE,NY,8863,8322,-541,0.484259528658714
WHITESTOWN,IN,3481,5002,1521,0.5896498880113168
WHITESVILLE,KY,741,747,6,0.5020161290322581
WHITESVILLE,NY,89,62,-27,0.4105960264900662
WHITESVILLE,WV,83,47,-36,0.36153846153846153
WHITETHORN,CA,503,348,-155,0.408930669800235
WHITEVILLE,NC,5240,5095,-145,0.4929850024189647
WHITEVILLE,TN,956,1018,62,0.5157041540020263
WHITEWATER,CA,274,348,74,0.5594855305466238
WHITEWATER,CO,715,751,36,0.5122783083219645
WHITEWATER,KS,161,86,-75,0.3481781376518219
WHITEWATER,MO,11,39,28,0.78
WHITEWATER,WI,11540,6462,-5078,0.35896011554271745
WHITEWOOD,SD,823,865,42,0.5124407582938388
WHITEWRIGHT,TX,1617,2035,418,0.5572289156626506
WHITING,IA,485,225,-260,0.31690140845070425
WHITING,IN,3540,3231,-309,0.4771821001329198
WHITING,ME,25,12,-13,0.32432432432432434
WHITING,NJ,10397,11397,1000,0.5229420941543544
WHITING,VT,11,25,14,0.6944444444444444
WHITINGHAM,VT,83,86,3,0.5088757396449705
WHITINSVILLE,MA,3749,3557,-192,0.48686011497399395
WHITLEY CITY,KY,1254,1148,-106,0.47793505412156534
WHITLEYVILLE,TN,92,312,220,0.7722772277227723
WHITMAN,MA,4641,4634,-7,0.499622641509434
WHITMAN,WV,42,0,-42,0
WHITMIRE,SC,903,748,-155,0.4530587522713507
WHITMORE,CA,23,0,-23,0
WHITMORE LAKE,MI,4852,4588,-264,0.4860169491525424
WHITNEY,TX,4748,5417,669,0.5329070339399902
WHITNEY POINT,NY,1394,1298,-96,0.4821693907875186
WHITNEYVILLE,ME,124,87,-37,0.41232227488151657
WHITSETT,NC,4325,5291,966,0.5502287853577371
WHITTAKER,MI,62,90,28,0.5921052631578947
WHITTEMORE,IA,41,12,-29,0.22641509433962265
WHITTEMORE,MI,683,678,-5,0.4981631153563556
WHITTEN,IA,18,0,-18,0
WHITTIER,AK,22,21,-1,0.4883720930232558
WHITTIER,CA,41450,38946,-2504,0.4844270859246729
WHITTIER,NC,2332,2426,94,0.5098781000420345
WHITTINGTON,IL,0,11,11,1
WHITWELL,TN,2646,2646,0,0.5
WHT SPHR SPGS,MT,13,14,1,0.5185185185185185
WHT SULPHUR SPGS,WV,386,408,22,0.5138539042821159
WIBAUX,MT,146,91,-55,0.38396624472573837
WICHITA,KS,254726,196840,-57886,0.4359052718760934
WICHITA FALLS,TX,51618,46792,-4826,0.47548013413271006
WICKENBURG,AZ,8048,10454,2406,0.5650199978380716
WICKES,AR,332,157,-175,0.3210633946830266
WICKETT,TX,34,0,-34,0
WICKLIFFE,KY,674,768,94,0.5325936199722607
WICKLIFFE,OH,6335,5939,-396,0.4838683395795991
WICONISCO,PA,80,0,-80,0
WIERGATE,TX,12,0,-12,0
WIGGINS,CO,1254,1688,434,0.5737593473827328
WIGGINS,MS,4558,3624,-934,0.442923490589098
WIKIEUP,AZ,24,12,-12,0.3333333333333333
WILBER,NE,915,779,-136,0.45985832349468714
WILBERFORCE,OH,12,0,-12,0
WILBRAHAM,MA,3931,4378,447,0.5268985437477434
WILBUR,WA,520,488,-32,0.48412698412698413
WILBURN,AR,12,0,-12,0
WILBURTON,OK,2667,2419,-248,0.47561934722768384
WILCOX,PA,160,120,-40,0.42857142857142855
WILD ROSE,WI,1438,1570,132,0.5219414893617021
WILDER,ID,1377,1642,265,0.543888704869162
WILDER,KY,1028,879,-149,0.4609334032511799
WILDER,TN,14,26,12,0.65
WILDER,VT,351,234,-117,0.4
WILDERSVILLE,TN,239,215,-24,0.473568281938326
WILDERVILLE,OR,180,294,114,0.620253164556962
WILDOMAR,CA,13053,12902,-151,0.49709111924484684
WILDORADO,TX,0,12,12,1
WILDWOOD,FL,8309,10269,1960,0.552750565184627
WILDWOOD,GA,324,554,230,0.6309794988610479
WILDWOOD,MO,5785,6430,645,0.5264019647973802
WILDWOOD,NJ,6594,5745,-849,0.4655968879163628
WILDWOOD CREST,NJ,2122,3057,935,0.5902683915813863
WILEY,CO,11,23,12,0.6764705882352942
WILEY FORD,WV,12,0,-12,0
WILIAMSBG TWP,ME,12,0,-12,0
WILKES BARRE,PA,24153,21200,-2953,0.4674442705002977
WILKESBORO,NC,3158,3448,290,0.5219497426581895
WILKESON,WA,43,110,67,0.7189542483660131
WILKESVILLE,OH,32,19,-13,0.37254901960784315
WILKINSBURG,PA,1328,1119,-209,0.4572946465059256
WILKINSON,IN,348,212,-136,0.37857142857142856
WILLACOOCHEE,GA,877,705,-172,0.44563843236409606
WILLAMINA,OR,1578,1545,-33,0.494716618635927
WILLARD,MO,3529,3575,46,0.5032376126126126
WILLARD,NC,793,961,168,0.5478905359179019
WILLARD,OH,4451,3918,-533,0.4681562910742024
WILLARD,UT,1202,1309,107,0.5213062524890482
WILLARD,WI,23,24,1,0.5106382978723404
WILLARDS,MD,584,587,3,0.5012809564474808
WILLCOX,AZ,2732,2857,125,0.5111826802648058
WILLERNIE,MN,178,110,-68,0.3819444444444444
WILLET,NY,15,0,-15,0
WILLIAMS,AZ,3419,3712,293,0.5205441032113308
WILLIAMS,CA,817,776,-41,0.48713119899560575
WILLIAMS,IA,42,22,-20,0.34375
WILLIAMS,IN,140,201,61,0.5894428152492669
WILLIAMS,MN,97,107,10,0.5245098039215687
WILLIAMS,OR,1258,1082,-176,0.4623931623931624
WILLIAMS BAY,WI,2189,1992,-197,0.4764410428127242
WILLIAMSBURG,IA,1731,1631,-100,0.4851279000594884
WILLIAMSBURG,IN,142,115,-27,0.4474708171206226
WILLIAMSBURG,KS,154,150,-4,0.4934210526315789
WILLIAMSBURG,KY,4954,4699,-255,0.48679167098311404
WILLIAMSBURG,MA,730,922,192,0.5581113801452785
WILLIAMSBURG,MI,3263,3130,-133,0.4895979978101048
WILLIAMSBURG,MO,24,41,17,0.6307692307692307
WILLIAMSBURG,NM,206,289,83,0.5838383838383838
WILLIAMSBURG,OH,2874,2964,90,0.5077081192189106
WILLIAMSBURG,PA,1014,1079,65,0.515527950310559
WILLIAMSBURG,VA,40170,43654,3484,0.5207816377171216
WILLIAMSFIELD,IL,40,11,-29,0.21568627450980393
WILLIAMSFIELD,OH,322,293,-29,0.4764227642276423
WILLIAMSON,GA,1639,2101,462,0.5617647058823529
WILLIAMSON,IA,25,0,-25,0
WILLIAMSON,NY,2457,2584,127,0.5125967070025789
WILLIAMSON,WV,1679,1531,-148,0.4769470404984424
WILLIAMSPORT,IN,1334,1262,-72,0.4861325115562404
WILLIAMSPORT,MD,3506,3407,-99,0.4928395776074063
WILLIAMSPORT,OH,709,720,11,0.5038488453463961
WILLIAMSPORT,PA,24097,22798,-1299,0.48614990937200125
WILLIAMSPORT,TN,129,87,-42,0.4027777777777778
WILLIAMSTON,MI,3845,3867,22,0.5014263485477178
WILLIAMSTON,NC,3582,3583,1,0.500069783670621
WILLIAMSTON,SC,4250,4312,62,0.5036206493809857
WILLIAMSTOWN,KY,2681,2412,-269,0.4735912036128019
WILLIAMSTOWN,MA,2844,3051,207,0.517557251908397
WILLIAMSTOWN,NJ,11583,12226,643,0.5135032970725356
WILLIAMSTOWN,NY,798,654,-144,0.45041322314049587
WILLIAMSTOWN,PA,959,960,1,0.5002605523710266
WILLIAMSTOWN,VT,1192,1291,99,0.5199355618203786
WILLIAMSTOWN,WV,1728,1731,3,0.5004336513443192
WILLIAMSVILLE,IL,422,400,-22,0.48661800486618007
WILLIAMSVILLE,MO,369,420,51,0.532319391634981
WILLIAMSVILLE,NY,8563,9254,691,0.5193915922994893
WILLIFORD,AR,404,621,217,0.6058536585365853
WILLIMANTIC,CT,9502,7809,-1693,0.4511004563572295
WILLINGBORO,NJ,9966,10470,504,0.5123311802701116
WILLINGTON,CT,2416,2055,-361,0.4596287184075151
WILLIS,MI,982,1133,151,0.5356973995271868
WILLIS,TX,12725,16001,3276,0.5570215136113625
WILLIS,VA,699,763,64,0.5218878248974008
WILLISBURG,KY,826,846,20,0.5059808612440191
WILLISTON,FL,4250,6032,1782,0.5866562925500876
WILLISTON,ND,29754,20668,-9086,0.409900440284003
WILLISTON,SC,1891,1810,-81,0.4890570116184815
WILLISTON,TN,23,70,47,0.7526881720430108
WILLISTON,VT,4941,5208,267,0.5131540053207213
WILLISTON PARK,NY,1596,1559,-37,0.49413629160063394
WILLISTON PK,NY,40,37,-3,0.4805194805194805
WILLISVILLE,IL,24,0,-24,0
WILLITS,CA,5612,4660,-952,0.45366043613707163
WILLMAR,MN,13983,12509,-1474,0.4721802808394987
WILLOUGHBY,OH,11896,11611,-285,0.4939379759220658
WILLOUGHBY HILLS,OH,2620,2560,-60,0.4942084942084942
WILLOW,AK,1623,1406,-217,0.4641795972268075
WILLOW,NY,11,51,40,0.8225806451612904
WILLOW CITY,ND,0,11,11,1
WILLOW CREEK,CA,757,479,-278,0.38754045307443363
WILLOW CREEK,MT,13,0,-13,0
WILLOW GROVE,PA,6322,6401,79,0.5031046136917394
WILLOW HILL,IL,22,0,-22,0
WILLOW LAKE,SD,51,16,-35,0.23880597014925373
WILLOW PARK,TX,2418,3338,920,0.5799166087560806
WILLOW RIVER,MN,500,469,-31,0.4840041279669763
WILLOW SPGS,IL,89,120,31,0.5741626794258373
WILLOW SPGS,MO,48,59,11,0.5514018691588785
WILLOW SPRING,NC,4381,5473,1092,0.5554089709762533
WILLOW SPRINGS,IL,1543,1592,49,0.5078149920255184
WILLOW SPRINGS,MO,2735,2565,-170,0.4839622641509434
WILLOW STREET,PA,2948,3553,605,0.5465313028764806
WILLOW WOOD,OH,0,12,12,1
WILLOWBROOK,IL,5255,5330,75,0.5035427491733585
WILLOWICK,OH,6179,5941,-238,0.49018151815181515
WILLOWS,CA,3716,3272,-444,0.4682312535775615
WILLS POINT,TX,5711,6260,549,0.5229304151699942
WILLSBORO,NY,1315,1135,-180,0.463265306122449
WILLSEYVILLE,NY,577,135,-442,0.1896067415730337
WILLSHIRE,OH,121,58,-63,0.3240223463687151
WILMAR,AR,180,255,75,0.5862068965517241
WILMER,AL,3010,2962,-48,0.4959812458137977
WILMER,TX,2387,2169,-218,0.4760755048287972
WILMERDING,PA,958,666,-292,0.4100985221674877
WILMETTE,IL,7810,8720,910,0.5275257108287962
WILMINGTON,CA,10319,9018,-1301,0.46635982830842426
WILMINGTON,DE,80184,78431,-1753,0.49447404091668506
WILMINGTON,IL,4611,4103,-508,0.470851503327978
WILMINGTON,MA,5651,5973,322,0.5138506538196834
WILMINGTON,NC,108549,107102,-1447,0.496645042220996
WILMINGTON,NY,598,584,-14,0.494077834179357
WILMINGTON,OH,8002,7614,-388,0.4875768442622951
WILMINGTON,VT,1271,1275,4,0.5007855459544384
WILMONT,MN,12,0,-12,0
WILMORE,KY,2450,2380,-70,0.4927536231884058
WILMORE,PA,13,0,-13,0
WILMOT,NH,264,375,111,0.5868544600938967
WILMOT,SD,134,117,-17,0.46613545816733065
WILSALL,MT,225,220,-5,0.4943820224719101
WILSEYVILLE,CA,0,11,11,1
WILSON,AR,131,72,-59,0.35467980295566504
WILSON,KS,95,88,-7,0.4808743169398907
WILSON,MI,195,194,-1,0.4987146529562982
WILSON,NC,19770,19078,-692,0.49109349258649093
WILSON,NY,1118,1141,23,0.5050907481186365
WILSON,OK,1217,1094,-123,0.47338814366075294
WILSON,TX,112,223,111,0.6656716417910448
WILSON,WI,177,52,-125,0.22707423580786026
WILSON,WY,2314,2095,-219,0.47516443638013156
WILSONS,VA,0,34,34,1
WILSONVILLE,AL,1507,1627,120,0.5191448627951499
WILSONVILLE,IL,74,28,-46,0.27450980392156865
WILSONVILLE,NE,0,11,11,1
WILSONVILLE,OR,16997,16667,-330,0.4950986216730038
WILTON,CA,1880,2334,454,0.5538680588514475
WILTON,CT,5963,6520,557,0.5223103420652087
WILTON,IA,2137,1630,-507,0.43270507034775685
WILTON,ME,1586,1554,-32,0.4949044585987261
WILTON,ND,298,235,-63,0.44090056285178236
WILTON,NH,1669,1554,-115,0.48215947874650944
WILTON,WI,201,129,-72,0.39090909090909093
WILTON MANORS,FL,8588,8067,-521,0.48435905133593515
WIMAUMA,FL,8487,13715,5228,0.6177371407981262
WIMBERLEY,TX,5905,6740,835,0.5330170027678924
WIMBLEDON,ND,41,13,-28,0.24074074074074073
WINAMAC,IN,2795,2679,-116,0.489404457435148
WINBURNE,PA,22,0,-22,0
WINCHENDON,MA,3722,3785,63,0.5041960836552551
WINCHESTER,CA,9162,12665,3503,0.5802446511201723
WINCHESTER,ID,22,37,15,0.6271186440677966
WINCHESTER,IL,826,811,-15,0.4954184483811851
WINCHESTER,IN,3923,3465,-458,0.4690037899296156
WINCHESTER,KS,109,36,-73,0.2482758620689655
WINCHESTER,KY,15537,15363,-174,0.49718446601941746
WINCHESTER,MA,6417,7222,805,0.5295109612141653
WINCHESTER,NH,1680,1582,-98,0.48497854077253216
WINCHESTER,OH,1535,1311,-224,0.460646521433591
WINCHESTER,OR,1406,1085,-321,0.4355680449618627
WINCHESTER,TN,6097,6325,228,0.5091772661407181
WINCHESTER,VA,32956,31016,-1940,0.4848371162383543
WINCHESTER,WI,238,234,-4,0.4957627118644068
WINCHESTER BAY,OR,763,762,-1,0.499672131147541
WIND GAP,PA,1956,2201,245,0.5294683666105364
WIND LAKE,WI,283,256,-27,0.4749536178107607
WIND RIDGE,PA,12,0,-12,0
WINDBER,PA,3420,3228,-192,0.4855595667870036
WINDCREST,TX,4363,3078,-1285,0.4136540787528558
WINDER,GA,17083,17336,253,0.5036752956216044
WINDERMERE,FL,27184,24233,-2951,0.47130326545695006
WINDFALL,IN,317,279,-38,0.46812080536912754
WINDHAM,CT,999,1125,126,0.5296610169491526
WINDHAM,ME,6101,6824,723,0.5279690522243714
WINDHAM,NH,4388,4884,496,0.5267471958584987
WINDHAM,NY,939,749,-190,0.4437203791469194
WINDHAM,OH,1234,1170,-64,0.48668885191347755
WINDHAM,VT,13,11,-2,0.4583333333333333
WINDOM,MN,2861,2266,-595,0.44197386385800663
WINDOM,TX,11,0,-11,0
WINDOW ROCK,AZ,160,339,179,0.6793587174348698
WINDSOR,CA,8138,7844,-294,0.4908021524214742
WINDSOR,CO,13056,18009,4953,0.5797199420569773
WINDSOR,CT,10294,10633,339,0.508099584269126
WINDSOR,IL,409,421,12,0.5072289156626506
WINDSOR,MA,14,15,1,0.5172413793103449
WINDSOR,ME,959,834,-125,0.4651422197434467
WINDSOR,MO,2003,1938,-65,0.49175336209083986
WINDSOR,NC,1651,1672,21,0.5031597953656335
WINDSOR,NJ,12,0,-12,0
WINDSOR,NY,2096,1851,-245,0.4689637699518622
WINDSOR,OH,183,206,23,0.5295629820051414
WINDSOR,PA,2053,1894,-159,0.47985812009120854
WINDSOR,SC,956,1134,178,0.5425837320574163
WINDSOR,VA,1686,1909,223,0.5310152990264256
WINDSOR,VT,1725,1875,150,0.5208333333333334
WINDSOR,WI,1907,2018,111,0.514140127388535
WINDSOR HEIGHTS,IA,2113,1996,-117,0.4857629593575079
WINDSOR HILLS,CA,548,541,-7,0.4967860422405877
WINDSOR HTS,IA,114,99,-15,0.4647887323943662
WINDSOR LOCKS,CT,4609,4663,54,0.5029119930974978
WINDSOR MILL,MD,15695,14418,-1277,0.4787965330588118
WINDTHORST,TX,12,13,1,0.52
WINFIELD,AL,2538,2518,-20,0.49802215189873417
WINFIELD,IA,356,423,67,0.5430038510911425
WINFIELD,IL,3095,3588,493,0.5368846326500075
WINFIELD,KS,7593,6369,-1224,0.4561667382896433
WINFIELD,MO,2651,2708,57,0.5053181563724576
WINFIELD,PA,494,670,176,0.5756013745704467
WINFIELD,TN,458,467,9,0.5048648648648648
WINFIELD,WV,1560,1706,146,0.5223515003061849
WINFRED,SD,0,13,13,1
WINGATE,IN,63,33,-30,0.34375
WINGATE,NC,1995,2022,27,0.5033607169529499
WINGAYE,NC,40,37,-3,0.4805194805194805
WINGDALE,NY,1104,1111,7,0.5015801354401805
WINGO,KY,1119,1024,-95,0.47783481101259917
WINHALL,VT,30,75,45,0.7142857142857143
WINK,TX,198,104,-94,0.3443708609271523
WINKELMAN,AZ,146,137,-9,0.4840989399293286
WINLOCK,WA,2979,2888,-91,0.49224475882052154
WINN,ME,14,0,-14,0
WINNABOW,NC,2191,3064,873,0.5830637488106565
WINNEBAGO,IL,1494,1469,-25,0.49578130273371585
WINNEBAGO,MN,817,742,-75,0.47594611930724823
WINNEBAGO,NE,272,170,-102,0.38461538461538464
WINNECONNE,WI,1833,1734,-99,0.4861227922624054
WINNEMUCCA,NV,9018,7368,-1650,0.4496521420725009
WINNER,SD,1728,1353,-375,0.439143135345667
WINNETKA,CA,12503,11397,-1106,0.4768619246861925
WINNETKA,IL,4029,4932,903,0.5503850016739203
WINNETT,MT,0,12,12,1
WINNFIELD,LA,2769,2702,-67,0.4938768049716688
WINNIE,TX,1698,1734,36,0.5052447552447552
WINNISQUAM,NH,93,11,-82,0.10576923076923077
WINNSBORO,LA,5734,4295,-1439,0.42825805165021436
WINNSBORO,SC,3310,3304,-6,0.4995464166918657
WINNSBORO,TX,4356,4479,123,0.5069609507640068
WINONA,MN,16035,13160,-2875,0.45076211680082207
WINONA,MO,849,822,-27,0.4919210053859964
WINONA,MS,1850,1695,-155,0.4781382228490832
WINONA,OH,0,24,24,1
WINONA,TX,1344,1435,91,0.5163727959697733
WINONA LAKE,IN,1939,1806,-133,0.4822429906542056
WINOOSKI,VT,6334,4862,-1472,0.43426223651304036
WINSIDE,NE,43,26,-17,0.37681159420289856
WINSLOW,AR,758,896,138,0.5417170495767836
WINSLOW,AZ,3851,3518,-333,0.4774053467227575
WINSLOW,IL,56,39,-17,0.4105263157894737
WINSLOW,IN,1235,1057,-178,0.46116928446771377
WINSLOW,ME,2116,1966,-150,0.4816266536011759
WINSLOW,NJ,14,11,-3,0.44
WINSTED,CT,5163,4740,-423,0.4786428355043926
WINSTED,MN,1093,969,-124,0.46993210475266733
WINSTON,GA,2857,3421,564,0.5449187639375598
WINSTON,MO,22,0,-22,0
WINSTON,OR,3440,3469,29,0.5020987118251556
WINSTON SALEM,NC,116400,104625,-11775,0.47336274177129284
WINTER,FL,11,0,-11,0
WINTER,WI,843,672,-171,0.44356435643564357
WINTER GARDEN,FL,36970,47744,10774,0.5635904336945488
WINTER HARBOR,ME,415,373,-42,0.4733502538071066
WINTER HAVEN,FL,62371,70448,8077,0.5304060413043314
WINTER PARK,CO,1914,1103,-811,0.3655949618826649
WINTER PARK,FL,51848,48119,-3729,0.48134884511888926
WINTER SPGS,FL,1951,1914,-37,0.49521345407503237
WINTER SPRINGS,FL,20216,20065,-151,0.4981256671880043
WINTERGREEN RESORT,VA,14,12,-2,0.46153846153846156
WINTERHAVEN,CA,908,1825,917,0.667764361507501
WINTERPORT,ME,1393,1457,64,0.5112280701754386
WINTERS,CA,2652,2965,313,0.5278618479615453
WINTERS,TX,1644,1232,-412,0.4283727399165508
WINTERSET,IA,3766,3790,24,0.5015881418740075
WINTERSVILLE,OH,904,893,-11,0.4969393433500278
WINTERVILLE,GA,2590,2527,-63,0.493844049247606
WINTERVILLE,NC,10212,10590,378,0.5090856648399192
WINTERVILLE PLT,ME,72,46,-26,0.3898305084745763
WINTHROP,AR,0,11,11,1
WINTHROP,IA,158,166,8,0.5123456790123457
WINTHROP,MA,6885,6317,-568,0.4784881078624451
WINTHROP,ME,2593,2871,278,0.5254392386530015
WINTHROP,MN,659,630,-29,0.4887509697439876
WINTHROP,NY,739,738,-1,0.4996614759647935
WINTHROP,WA,1354,1654,300,0.5498670212765957
WINTHROP HARBOR,IL,2333,2075,-258,0.4707350272232305
WINTHROP HBR,IL,68,42,-26,0.38181818181818183
WINTON,CA,5935,3071,-2864,0.3409948922940262
WINTON,MN,20,12,-8,0.375
WINTON,NC,79,12,-67,0.13186813186813187
WIRTZ,VA,1419,1516,97,0.5165247018739353
WISC DELLS,WI,89,129,40,0.591743119266055
WISCASSET,ME,1806,1806,0,0.5
WISCONSIN DELLS,WI,4964,4978,14,0.5007040836853752
WISCONSIN RAPIDS,WI,14955,13670,-1285,0.47755458515283844
WISDOM,MT,27,0,-27,0
WISE,VA,2337,2232,-105,0.4885095206828628
WISE RIVER,MT,11,12,1,0.5217391304347826
WISHEK,ND,456,178,-278,0.2807570977917981
WISHRAM,WA,63,0,-63,0
WISNER,LA,415,393,-22,0.4863861386138614
WISNER,NE,548,570,22,0.5098389982110912
WISTER,OK,1383,1245,-138,0.4737442922374429
WITHEE,WI,557,430,-127,0.43566362715298884
WITHERBEE,NY,11,49,38,0.8166666666666667
WITT,IL,441,197,-244,0.30877742946708464
WITTENBERG,WI,882,936,54,0.5148514851485149
WITTENSVILLE,KY,22,77,55,0.7777777777777778
WITTER,AR,0,55,55,1
WITTMANN,AZ,3304,4412,1108,0.5717988595127009
WIXOM,MI,7996,7104,-892,0.4704635761589404
WLBY,OH,99,133,34,0.5732758620689655
WMSTWN,NJ,258,223,-35,0.46361746361746364
WOBURN,MA,18301,16863,-1438,0.4795529518826072
WOFFORD HEIGHTS,CA,1093,1056,-37,0.49139134481154023
WOFFORD HTS,CA,51,31,-20,0.3780487804878049
WOLBACH,NE,0,11,11,1
WOLCOTT,CO,77,59,-18,0.4338235294117647
WOLCOTT,CT,3995,4487,492,0.5290025937278944
WOLCOTT,IN,450,364,-86,0.44717444717444715
WOLCOTT,NY,2614,2404,-210,0.47907532881626147
WOLCOTT,VT,570,576,6,0.5026178010471204
WOLCOTTVILLE,IN,2363,2341,-22,0.4976615646258503
WOLF CREEK,MT,252,179,-73,0.41531322505800466
WOLF CREEK,OR,623,480,-143,0.43517679057116954
WOLF POINT,MT,1423,1253,-170,0.46823617339312407
WOLFE CITY,TX,878,1140,262,0.5649157581764123
WOLFEBORO,NH,3175,3660,485,0.5354791514264814
WOLFEBORO FALLS,NH,793,493,-300,0.3833592534992224
WOLFEBORO FLS,NH,149,107,-42,0.41796875
WOLFFORTH,TX,3091,3809,718,0.5520289855072463
WOLFLAKE,IN,14,0,-14,0
WOLLASTON,MA,614,519,-95,0.4580759046778464
WOLSEY,SD,25,12,-13,0.32432432432432434
WOLVERINE,MI,1318,1249,-69,0.4865601869887028
WOLVERINE LAKE,MI,214,248,34,0.5367965367965368
WOMELSDORF,PA,1702,1715,13,0.5019022534386889
WONDER LAKE,IL,3919,3743,-176,0.4885147481075437
WONEWOC,WI,642,639,-3,0.49882903981264637
WOOD DALE,IL,5016,4623,-393,0.47961406784936195
WOOD LAKE,MN,168,34,-134,0.16831683168316833
WOOD RIDGE,NJ,3452,3657,205,0.514418342945562
WOOD RIVER,IL,5669,4481,-1188,0.44147783251231526
WOOD RIVER,NE,518,442,-76,0.46041666666666664
WOOD RIVER JUNCTION,RI,12,12,0,0.5
WOOD VILLAGE,OR,1158,1206,48,0.5101522842639594
WOODACRE,CA,164,262,98,0.6150234741784038
WOODBINE,GA,2071,2105,34,0.5040708812260536
WOODBINE,IA,1075,927,-148,0.463036963036963
WOODBINE,KY,126,320,194,0.7174887892376681
WOODBINE,MD,2029,2337,308,0.5352725606962895
WOODBINE,NJ,1937,1954,17,0.5021845283988692
WOODBOURNE,NY,843,903,60,0.5171821305841925
WOODBRIDGE,CA,1518,1664,146,0.5229415461973601
WOODBRIDGE,CT,2390,3109,719,0.5653755228223313
WOODBRIDGE,NJ,8079,7795,-284,0.4910545546176137
WOODBRIDGE,VA,83929,77982,-5947,0.4816349722995967
WOODBURN,IA,24,24,0,0.5
WOODBURN,IN,1251,1107,-144,0.46946564885496184
WOODBURN,KY,198,208,10,0.5123152709359606
WOODBURN,OR,9659,8413,-1246,0.46552678176184153
WOODBURY,CT,3655,3870,215,0.5142857142857142
WOODBURY,GA,542,701,159,0.5639581657280772
WOODBURY,MN,12884,14332,1448,0.5266019988242211
WOODBURY,NJ,8006,8149,143,0.5044258743423089
WOODBURY,NY,3708,3990,282,0.5183164458300857
WOODBURY,PA,94,52,-42,0.3561643835616438
WOODBURY,TN,3378,3308,-70,0.494765180975172
WOODBURY,VT,24,0,-24,0
WOODBURY HEIGHTS,NJ,655,708,53,0.5194424064563463
WOODBURY HTS,NJ,0,15,15,1
WOODCLIFF LAKE,NJ,1356,1675,319,0.5526228967337512
WOODFORD,VA,1355,1494,139,0.5243945243945244
WOODGATE,NY,96,151,55,0.611336032388664
WOODHAVEN,MI,5637,5423,-214,0.4903254972875226
WOODHAVEN,NY,9668,7426,-2242,0.43442143442143444
WOODHULL,IL,253,78,-175,0.23564954682779457
WOODHULL,NY,388,215,-173,0.35655058043117743
WOODINVILLE,WA,14732,15587,855,0.5141000692634982
WOODLAKE,CA,2518,2152,-366,0.460813704496788
WOODLAKE,TX,12,11,-1,0.4782608695652174
WOODLAND,AL,737,895,158,0.5484068627450981
WOODLAND,CA,20509,20321,-188,0.4976977712466324
WOODLAND,GA,0,25,25,1
WOODLAND,ME,132,98,-34,0.4260869565217391
WOODLAND,MI,217,231,14,0.515625
WOODLAND,MS,90,94,4,0.5108695652173914
WOODLAND,NC,360,347,-13,0.4908062234794908
WOODLAND,PA,401,375,-26,0.4832474226804124
WOODLAND,WA,5271,5702,431,0.5196391141893739
WOODLAND HILLS,CA,41533,40972,-561,0.4966002060481183
WOODLAND HILLS,UT,613,904,291,0.5959129861568886
WOODLAND HLS,CA,2438,2249,-189,0.47983784937059953
WOODLAND PARK,CO,8221,7782,-439,0.4862838217834156
WOODLAND PARK,NJ,3717,3590,-127,0.49130970302449706
WOODLAND WASHINGTON COUNTY,ME,48,93,45,0.6595744680851063
WOODLAWN,IL,372,423,51,0.5320754716981132
WOODLAWN,TN,1574,1742,168,0.5253317249698432
WOODLAWN,TX,12,0,-12,0
WOODLAWN,VA,1159,1231,72,0.5150627615062762
WOODLEAF,NC,656,700,44,0.5162241887905604
WOODLYN,PA,1271,1298,27,0.5052549630206306
WOODLYNNE,NJ,123,141,18,0.5340909090909091
WOODMERE,NY,3493,3605,112,0.5078895463510849
WOODRIDGE,IL,13383,11438,-1945,0.46081946738648727
WOODRIDGE,NY,1170,773,-397,0.397838394235718
WOODRUFF,SC,5316,5863,547,0.5244655156990786
WOODRUFF,WI,3698,3094,-604,0.4555359246171967
WOODS CROSS,UT,2365,2540,175,0.5178389398572885
WOODS HOLE,MA,683,817,134,0.5446666666666666
WOODSBORO,MD,499,623,124,0.5552584670231729
WOODSBORO,TX,320,335,15,0.5114503816793893
WOODSFIELD,OH,1663,1620,-43,0.4934511117879988
WOODSIDE,CA,1565,1403,-162,0.4727088948787062
WOODSIDE,NY,25719,18460,-7259,0.41784558274293215
WOODSON,IL,70,16,-54,0.18604651162790697
WOODSON,TX,0,11,11,1
WOODSTOCK,AL,1140,838,-302,0.4236602628918099
WOODSTOCK,CT,2174,2553,379,0.5400888512798815
WOODSTOCK,GA,36663,40206,3543,0.523045701127893
WOODSTOCK,IL,12748,12063,-685,0.48619563903107493
WOODSTOCK,MD,1929,2232,303,0.5364095169430425
WOODSTOCK,NY,2627,3178,551,0.5474590869939707
WOODSTOCK,OH,33,47,14,0.5875
WOODSTOCK,VA,3770,3906,136,0.5088587806149036
WOODSTOCK,VT,1768,1973,205,0.5273990911520984
WOODSTOCK VALLEY,CT,158,279,121,0.6384439359267735
WOODSTOCK VLY,CT,0,11,11,1
WOODSTOWN,NJ,1510,1618,108,0.5172634271099744
WOODSVILLE,NH,1162,1018,-144,0.4669724770642202
WOODVILLE,AL,979,1050,71,0.5174963035978315
WOODVILLE,FL,75,65,-10,0.4642857142857143
WOODVILLE,GA,109,91,-18,0.455
WOODVILLE,ME,47,106,59,0.6928104575163399
WOODVILLE,MS,566,590,24,0.5103806228373703
WOODVILLE,OH,886,850,-36,0.48963133640552997
WOODVILLE,TX,3298,3350,52,0.5039109506618532
WOODVILLE,WI,862,850,-12,0.49649532710280375
WOODWARD,IA,838,772,-66,0.4795031055900621
WOODWARD,OK,8574,6348,-2226,0.4254121431443506
WOODWAY,TX,6393,6684,291,0.5111264051387933
WOODWAY,WA,1953,2139,186,0.5227272727272727
WOODWORTH,LA,613,555,-58,0.4751712328767123
WOODY CREEK,CO,24,38,14,0.6129032258064516
WOOLFORD,MD,17,13,-4,0.43333333333333335
WOOLLUM,KY,103,105,2,0.5048076923076923
WOOLWICH,ME,1061,1177,116,0.5259159964253798
WOOLWINE,VA,11,37,26,0.7708333333333334
WOONSOCKET,RI,21545,20349,-1196,0.4857258796008975
WOONSOCKET,SD,156,178,22,0.5329341317365269
WOOSTER,OH,16369,15291,-1078,0.48297536323436513
WOOTON,KY,35,12,-23,0.2553191489361702
WORCESTER,MA,98179,82673,-15506,0.4571306924999447
WORCESTER,NY,879,686,-193,0.4383386581469649
WORCESTER,PA,48,0,-48,0
WORCESTER,VT,143,124,-19,0.46441947565543074
WORDEN,IL,886,767,-119,0.46400483968542044
WORDEN,MT,329,299,-30,0.47611464968152867
WORLAND,WY,3137,3192,55,0.5043450782114078
WORLEY,ID,856,932,76,0.5212527964205816
WORMLEYSBURG,PA,149,137,-12,0.479020979020979
WORTH,IL,3979,3598,-381,0.4748581232677841
WORTHAM,TX,418,604,186,0.5909980430528375
WORTHING,SD,103,175,72,0.6294964028776978
WORTHINGTON,IN,884,882,-2,0.49943374858437145
WORTHINGTON,KY,286,339,53,0.5424
WORTHINGTON,MA,164,210,46,0.5614973262032086
WORTHINGTON,MN,6817,4890,-1927,0.41769881267617665
WORTHINGTON,OH,8013,8100,87,0.5026996834853845
WORTHINGTON,PA,675,571,-104,0.4582664526484751
WORTHINGTON,WV,84,108,24,0.5625
WORTHINGTON SPRINGS,FL,11,50,39,0.819672131147541
WORTHVILLE,KY,643,707,64,0.5237037037037037
WORTON,MD,524,665,141,0.5592935239697224
WP AIR BASE,OH,80,78,-2,0.4936708860759494
WPAFB,OH,120,107,-13,0.4713656387665198
WPR,FL,0,21,21,1
WR,CO,2208,2112,-96,0.4888888888888889
WRANGELL,AK,828,666,-162,0.4457831325301205
WRAY,CO,1526,1179,-347,0.43585951940850276
WRAY,GA,25,14,-11,0.358974358974359
WRENS,GA,1050,1040,-10,0.49760765550239233
WRENSHALL,MN,267,334,67,0.5557404326123128
WRENTHAM,MA,3145,3965,820,0.5576652601969058
WRIGHT,MN,58,23,-35,0.2839506172839506
WRIGHT,WY,862,707,-155,0.4506054811982154
WRIGHT CITU,MO,78,92,14,0.5411764705882353
WRIGHT CITY,MO,4249,4802,553,0.5305491105955144
WRIGHT CITY,OK,109,61,-48,0.3588235294117647
WRIGHTSTOWN,NJ,1503,1433,-70,0.4880790190735695
WRIGHTSTOWN,WI,993,1018,25,0.5062158130283441
WRIGHTSVILLE,GA,1219,1287,68,0.5135674381484437
WRIGHTSVILLE,PA,2904,2818,-86,0.49248514505417684
WRIGHTSVILLE BEACH,NC,1705,1726,21,0.5030603322646459
WRIGHTWOOD,CA,1806,1759,-47,0.4934081346423562
WRITSVLLE BCH,NC,75,94,19,0.5562130177514792
WRN,MI,101,108,7,0.5167464114832536
WSHNGTN CT HS,OH,173,174,1,0.5014409221902018
WSHNGTN XING,PA,23,29,6,0.5576923076923077
WSS,MT,0,31,31,1
WURTLAND,KY,279,243,-36,0.46551724137931033
WURTSBORO,NY,2042,1988,-54,0.49330024813895784
WVC,UT,36,0,-36,0
WYACONDA,MO,36,13,-23,0.2653061224489796
WYALUSING,PA,1382,1332,-50,0.49078850405305824
WYANDANCH,NY,3431,2995,-436,0.46607531901649546
WYANDOTTE,MI,9295,7845,-1450,0.45770128354725786
WYANDOTTE,OK,1090,1158,68,0.5151245551601423
WYANET,IL,345,115,-230,0.25
WYCKOFF,NJ,3427,4451,1024,0.564991114496065
WYKAGYL,NY,170,210,40,0.5526315789473685
WYKOFF,MN,87,27,-60,0.23684210526315788
WYLIE,TX,20477,24184,3707,0.5415015337766732
WYMORE,NE,730,628,-102,0.46244477172312226
WYNANTSKILL,NY,2084,2095,11,0.5013161043311797
WYNCOTE,PA,2989,2737,-252,0.4779951100244499
WYNDMERE,ND,80,40,-40,0.3333333333333333
WYNDMOOR,PA,292,337,45,0.5357710651828299
WYNNE,AR,5119,4738,-381,0.4806736329512022
WYNNEWOOD,OK,1603,1546,-57,0.4909495077802477
WYNNEWOOD,PA,4761,4975,214,0.5109901396877568
WYNONA,OK,0,13,13,1
WYOCENA,WI,0,11,11,1
WYOMING,DE,63,83,20,0.5684931506849316
WYOMING,IA,138,138,0,0.5
WYOMING,IL,638,539,-99,0.45794392523364486
WYOMING,MI,31848,25720,-6128,0.44677598665925516
WYOMING,MN,3034,3109,75,0.5061045091974605
WYOMING,NY,146,274,128,0.6523809523809524
WYOMING,OH,1371,1265,-106,0.4798937784522003
WYOMING,PA,1665,1825,160,0.5229226361031518
WYOMING,RI,403,554,151,0.5788923719958202
WYOMISSING,PA,2968,3144,176,0.5143979057591623
WYSOX,PA,955,656,-299,0.40720049658597146
WYTHEVILLE,VA,5639,5261,-378,0.4826605504587156
XENIA,IL,316,317,1,0.5007898894154819
XENIA,OH,13323,13560,237,0.5044079901796674
YACHATS,OR,1172,1404,232,0.5450310559006211
YACOLT,WA,2669,1891,-778,0.41469298245614034
YADKINVILLE,NC,3681,3494,-187,0.48696864111498256
YAKIMA,WA,50028,44215,-5813,0.46915951317339216
YAKUTAT,AK,48,39,-9,0.4482758620689655
YALAHA,FL,634,678,44,0.5167682926829268
YALE,IA,23,0,-23,0
YALE,IL,0,12,12,1
YALE,MI,1224,1194,-30,0.49379652605459057
YALE,OK,693,786,93,0.5314401622718052
YALESVILLE,CT,902,916,14,0.5038503850385039
YAMHILL,OR,1170,1192,22,0.5046570702794242
YAMPA,CO,61,75,14,0.5514705882352942
YANCEYVILLE,NC,994,1129,135,0.5317946302402261
YANKEE HILL,CA,184,184,0,0.5
YANKEETOWN,FL,299,460,161,0.6060606060606061
YANKTON,SD,11334,9484,-1850,0.4555672975309828
YANTIS,TX,1401,1832,431,0.5666563563253944
YAPHANK,NY,2048,2646,598,0.5636983383042181
YARDLEY,PA,6207,6369,162,0.5064408396946565
YARMOUTH,ME,3989,4398,409,0.524382973649696
YARMOUTH PORT,MA,3493,3555,62,0.5043984108967083
YARNELL,AZ,326,334,8,0.5060606060606061
YARROW POINT,WA,1532,1429,-103,0.48260722728807837
YATES CENTER,KS,1103,783,-320,0.4151643690349947
YATES CITY,IL,39,46,7,0.5411764705882353
YATESBORO,PA,58,12,-46,0.17142857142857143
YATESVILLE,GA,37,191,154,0.8377192982456141
YATESVILLE,PA,128,121,-7,0.4859437751004016
YAZOO CITY,MS,4550,4393,-157,0.49122218494912223
YBOR CITY,FL,1433,1111,-322,0.4367138364779874
YEADON,PA,1483,1400,-83,0.4856052722858134
YEAGERTOWN,PA,502,289,-213,0.36536030341340076
YELLOW SPGS,OH,202,234,32,0.536697247706422
YELLOW SPRING,WV,0,27,27,1
YELLOW SPRINGS,OH,1812,1826,14,0.5019241341396372
YELLOWSTONE NATIONAL PARK,WY,1573,1353,-220,0.462406015037594
YELLVILLE,AR,2139,2594,455,0.5480667652651595
YELM,WA,12133,11658,-475,0.4900172334075911
YEMASSEE,SC,910,997,87,0.5228106974305191
YERINGTON,NV,4034,3375,-659,0.4555270616817384
YERMO,CA,654,410,-244,0.38533834586466165
YOAKUM,TX,3115,2829,-286,0.4759421265141319
YODER,CO,592,669,77,0.5305313243457573
YODER,IN,398,364,-34,0.4776902887139108
YOE,PA,998,820,-178,0.45104510451045104
YOLO,CA,12,0,-12,0
YONCALLA,OR,886,898,12,0.5033632286995515
YONGES ISLAND,SC,37,44,7,0.5432098765432098
YONKERS,NY,58354,51071,-7283,0.46672149874343155
YORBA LINDA,CA,17185,19500,2315,0.5315524056153741
YORK,AL,575,544,-31,0.48614834673815904
YORK,ME,4260,4882,622,0.5340188142638372
YORK,NE,4929,4268,-661,0.4640643688159182
YORK,PA,77485,73774,-3711,0.48773296134444893
YORK,SC,9634,11136,1502,0.5361579200770342
YORK BEACH,ME,1167,783,-384,0.4015384615384615
YORK HARBOR,ME,586,419,-167,0.41691542288557215
YORK HAVEN,PA,2086,2034,-52,0.4936893203883495
YORK NEW SALEM,PA,51,0,-51,0
YORK SPRINGS,PA,1205,1084,-121,0.47356924421144603
YORKSHIRE,NY,47,12,-35,0.2033898305084746
YORKTOWN,IN,2479,2374,-105,0.4891819493097053
YORKTOWN,TX,795,831,36,0.511070110701107
YORKTOWN,VA,17712,18119,407,0.5056794395914153
YORKTOWN HEIGHTS,NY,4892,5578,686,0.5327602674307546
YORKTOWN HTS,NY,636,666,30,0.511520737327189
YORKVILLE,IL,8836,10090,1254,0.5331290288492021
YORKVILLE,NY,835,719,-116,0.4626769626769627
YORKVILLE,OH,437,155,-282,0.26182432432432434
YOSEMITE,KY,0,23,23,1
YOSEMITE NATIONAL PARK,CA,1345,369,-976,0.21528588098016335
YOUNG,AZ,173,248,75,0.5890736342042755
YOUNG AMERICA,MN,531,536,5,0.5023430178069354
YOUNG HARRIS,GA,2169,2696,527,0.5541623843782117
YOUNGSTOWN,FL,2071,2491,420,0.5460324419114424
YOUNGSTOWN,NY,1721,1732,11,0.5015928178395598
YOUNGSTOWN,OH,56179,52294,-3885,0.48209231790399454
YOUNGSTOWN,PA,30,11,-19,0.2682926829268293
YOUNGSVILLE,LA,8905,10295,1390,0.5361979166666667
YOUNGSVILLE,NC,5846,8389,2543,0.5893220934316825
YOUNGSVILLE,NM,0,11,11,1
YOUNGSVILLE,NY,35,36,1,0.5070422535211268
YOUNGSVILLE,PA,1485,1243,-242,0.45564516129032256
YOUNGTOWN,AZ,3478,3359,-119,0.4912973526400468
YOUNGWOOD,PA,1279,1129,-150,0.4688538205980066
YOUNTVILLE,CA,1395,1330,-65,0.48807339449541287
YPSILANTI,MI,54296,42767,-11529,0.44061073735615014
YREKA,CA,5040,5110,70,0.503448275862069
YUBA CITY,CA,26580,24764,-1816,0.48231536304144595
YUCAIPA,CA,16836,17141,305,0.5044883303411131
YUCCA,AZ,941,870,-71,0.4803975704030922
YUCCA VALLEY,CA,12402,12174,-228,0.495361328125
YUKON,OK,32982,38137,5155,0.5362420731450105
YUKON,PA,75,72,-3,0.4897959183673469
YULAN,NY,28,18,-10,0.391304347826087
YULEE,FL,10034,12924,2890,0.5629410227371723
YUMA,AZ,79461,94397,14936,0.5429545951293584
YUMA,CO,1640,1395,-245,0.4596375617792422
YUMA,TN,47,25,-22,0.3472222222222222
YUTAN,NE,564,638,74,0.5307820299500832
ZACHARY,LA,8042,8780,738,0.5219355605754369
ZALMA,MO,13,27,14,0.675
ZAMORA,CA,0,11,11,1
ZANESFIELD,OH,529,486,-43,0.47881773399014776
ZANESVILLE,IN,14,11,-3,0.44
ZANESVILLE,OH,23440,22714,-726,0.4921350262165793
ZAP,ND,12,0,-12,0
ZAPATA,TX,1515,1679,164,0.5256731371321227
ZAVALLA,TX,661,818,157,0.5530764029749831
ZEARING,IA,63,54,-9,0.46153846153846156
ZEBULON,GA,1357,1546,189,0.5325525318635894
ZEBULON,NC,7404,10995,3591,0.5975868253709441
ZEELAND,MI,7134,7011,-123,0.4956521739130435
ZEIGLER,IL,630,499,-131,0.4419840566873339
ZELIENOPLE,PA,2978,3556,578,0.544230180593817
ZELLWOOD,FL,1639,1975,336,0.5464858882125069
ZEPHYR,TX,0,71,71,1
ZEPHYR COVE,NV,2177,1571,-606,0.41915688367129134
ZEPHYRHILLS,FL,48570,60077,11507,0.5529559030622107
ZIEGLERVILLE,PA,0,44,44,1
ZILLAH,WA,1679,1570,-109,0.4832256078793475
ZIMMERMAN,MN,5497,5949,452,0.5197448890442076
ZION,IL,13070,10788,-2282,0.45217537094475646
ZION CROSSROADS,VA,1289,1539,250,0.5442008486562943
ZION GROVE,PA,50,93,43,0.6503496503496503
ZIONSVILLE,IN,12065,13035,970,0.5193227091633467
ZIONSVILLE,PA,465,639,174,0.5788043478260869
ZIONVILLE,NC,503,584,81,0.5372585096596136
ZIRCONIA,NC,724,934,210,0.5633293124246079
ZOARVILLE,OH,42,36,-6,0.46153846153846156
ZOLFO SPRINGS,FL,1892,2232,340,0.5412221144519883
ZORTMAN,MT,0,11,11,1
ZUMBRO FALLS,MN,147,188,41,0.5611940298507463
ZUMBROTA,MN,1758,1861,103,0.5142304504006632
ZUNI,NM,68,129,61,0.6548223350253807
ZUNI,VA,218,357,139,0.6208695652173913
ZURICH,KS,25,17,-8,0.40476190476190477
ZWINGLE,IA,11,12,1,0.5217391304347826
ZWOLLE,LA,1214,1265,51,0.5102864058087939
