year,cbsa_title,DMA,outbound,inbound,netgain,pct_inbound
2018,"Aberdeen, SD",NA,435,228,-207,0.3438914027149321
2018,"Aberdeen, WA",NA,662,561,-101,0.45870809484873265
2018,"Abilene, TX",NA,1361,1321,-40,0.4925428784489187
2018,"Ada, OK",NA,230,228,-2,0.4978165938864629
2018,"Adrian, MI",NA,923,606,-317,0.39633747547416615
2018,"Akron, OH",NA,5543,4587,-956,0.45281342546890424
2018,"Alamogordo, NM",NA,464,440,-24,0.48672566371681414
2018,"Albany-Lebanon, OR",NA,1189,1162,-27,0.4942577626541897
2018,"Albany-Schenectady-Troy, NY",NA,8726,6526,-2200,0.4278783110411749
2018,"Albany, GA",NA,1003,1022,19,0.5046913580246913
2018,"Albemarle, NC",NA,265,301,36,0.5318021201413428
2018,"Albert Lea, MN",NA,315,229,-86,0.4209558823529412
2018,"Albertville, AL",NA,605,567,-38,0.48378839590443684
2018,"Albuquerque, NM",NA,6336,6214,-122,0.4951394422310757
2018,"Alexander City, AL",NA,240,284,44,0.5419847328244275
2018,"Alexandria, LA",NA,980,903,-77,0.4795539033457249
2018,"Alexandria, MN",NA,498,238,-260,0.3233695652173913
2018,"Alice, TX",NA,153,127,-26,0.45357142857142857
2018,"Allentown-Bethlehem-Easton, PA-NJ",NEW YORK,6552,5701,-851,0.4652738104953889
2018,"Alma, MI",NA,347,223,-124,0.3912280701754386
2018,"Alpena, MI",NA,407,195,-212,0.3239202657807309
2018,"Altoona, PA",NA,824,676,-148,0.45066666666666666
2018,"Altus, OK",NA,178,146,-32,0.4506172839506173
2018,"Amarillo, TX",NA,2001,1761,-240,0.46810207336523124
2018,"Americus, GA",NA,184,175,-9,0.48746518105849584
2018,"Ames, IA",NA,1166,758,-408,0.39397089397089397
2018,"Amsterdam, NY",NA,552,455,-97,0.45183714001986097
2018,"Anchorage, AK",NA,3073,2784,-289,0.4753286665528427
2018,"Andrews, TX",NA,156,110,-46,0.41353383458646614
2018,"Angola, IN",NA,544,267,-277,0.32922318125770655
2018,"Ann Arbor, MI",NA,3067,2235,-832,0.42153904187099206
2018,"Anniston-Oxford, AL",NA,745,725,-20,0.4931972789115646
2018,"Appleton, WI",NA,1933,1466,-467,0.431303324507208
2018,"Arcadia, FL",NA,201,907,706,0.8185920577617328
2018,"Ardmore, OK",NA,486,368,-118,0.4309133489461358
2018,"Arkadelphia, AR",NA,169,150,-19,0.4702194357366771
2018,"Asheville, NC",NA,3693,3358,-335,0.4762445043256276
2018,"Ashland, OH",NA,360,295,-65,0.45038167938931295
2018,"Ashtabula, OH",NA,829,605,-224,0.42189679218967924
2018,"Astoria, OR",NA,393,364,-29,0.4808454425363276
2018,"Atchison, KS",NA,100,77,-23,0.4350282485875706
2018,"Athens-Clarke County, GA",NA,1250,1107,-143,0.4696648281714043
2018,"Athens, OH",NA,466,390,-76,0.45560747663551404
2018,"Athens, TN",NA,375,353,-22,0.4848901098901099
2018,"Athens, TX",NA,610,618,8,0.503257328990228
2018,"Atlanta-Sandy Springs-Alpharetta, GA",NA,45949,46181,232,0.5012590904157169
2018,"Atlantic City-Hammonton, NJ",PHILADELPHIA,2304,1868,-436,0.4477468839884947
2018,"Atmore, AL",NA,180,168,-12,0.4827586206896552
2018,"Auburn-Opelika, AL",NA,895,825,-70,0.4796511627906977
2018,"Auburn, IN",NA,359,293,-66,0.4493865030674847
2018,"Auburn, NY",NA,739,499,-240,0.40306946688206785
2018,"Augusta-Richmond County, GA-SC",NA,4339,4208,-131,0.49233649233649235
2018,"Augusta-Waterville, ME",NA,1195,854,-341,0.41678867740361153
2018,"Austin-Round Rock-Georgetown, TX",NA,18088,18945,857,0.5115707612129722
2018,"Austin, MN",NA,341,232,-109,0.4048865619546248
2018,"Bainbridge, GA",NA,184,141,-43,0.4338461538461538
2018,"Bakersfield, CA",NA,5373,5126,-247,0.48823697494999524
2018,"Baltimore-Columbia-Towson, MD",NA,21204,19498,-1706,0.47904279887966195
2018,"Bangor, ME",NA,1444,1038,-406,0.41821112006446415
2018,"Baraboo, WI",NA,610,419,-191,0.4071914480077745
2018,"Bardstown, KY",NA,392,315,-77,0.44554455445544555
2018,"Barnstable Town, MA",NA,3852,1569,-2283,0.2894299944659657
2018,"Barre, VT",NA,542,442,-100,0.4491869918699187
2018,"Bartlesville, OK",NA,372,318,-54,0.4608695652173913
2018,"Batavia, NY",NA,487,293,-194,0.37564102564102564
2018,"Batesville, AR",NA,408,359,-49,0.4680573663624511
2018,"Baton Rouge, LA",NA,4619,4428,-191,0.489444014590472
2018,"Battle Creek, MI",NA,1548,1031,-517,0.39976735168670025
2018,"Bay City, MI",NA,960,673,-287,0.41212492345376606
2018,"Bay City, TX",HOUSTON,269,233,-36,0.4641434262948207
2018,"Beatrice, NE",NA,176,122,-54,0.40939597315436244
2018,"Beaumont-Port Arthur, TX",NA,2588,2313,-275,0.47194450112222
2018,"Beaver Dam, WI",NA,772,541,-231,0.412033511043412
2018,"Beckley, WV",NA,473,410,-63,0.464326160815402
2018,"Bedford, IN",NA,409,322,-87,0.44049247606019154
2018,"Beeville, TX",NA,147,154,7,0.5116279069767442
2018,"Bellefontaine, OH",NA,420,267,-153,0.388646288209607
2018,"Bellingham, WA",NA,1754,1603,-151,0.47750968126303245
2018,"Bemidji, MN",NA,417,240,-177,0.365296803652968
2018,"Bend, OR",NA,1955,1917,-38,0.49509297520661155
2018,"Bennettsville, SC",NA,123,112,-11,0.4765957446808511
2018,"Bennington, VT",NA,401,267,-134,0.3997005988023952
2018,"Berlin, NH",NA,349,227,-122,0.3940972222222222
2018,"Big Rapids, MI",NA,493,282,-211,0.3638709677419355
2018,"Big Spring, TX",NA,212,182,-30,0.4619289340101523
2018,"Big Stone Gap, VA",NA,197,150,-47,0.4322766570605187
2018,"Billings, MT",NA,1883,1413,-470,0.42870145631067963
2018,"Binghamton, NY",NA,2399,1636,-763,0.40545229244114
2018,"Birmingham-Hoover, AL",NA,6700,6455,-245,0.4906879513492968
2018,"Bismarck, ND",NA,1271,798,-473,0.38569357177380376
2018,"Blackfoot, ID",NA,285,221,-64,0.4367588932806324
2018,"Blacksburg-Christiansburg, VA",NA,1129,833,-296,0.42456676860346587
2018,"Bloomington, IL",NA,1450,1011,-439,0.4108086143843966
2018,"Bloomington, IN",NA,1733,1004,-729,0.3668249908659116
2018,"Bloomsburg-Berwick, PA",NA,686,484,-202,0.41367521367521365
2018,"Bluefield, WV-VA",NA,594,430,-164,0.419921875
2018,"Blytheville, AR",NA,284,247,-37,0.4651600753295669
2018,"Bogalusa, LA",NA,190,188,-2,0.4973544973544973
2018,"Boise City, ID",NA,5782,5666,-116,0.49493361285814114
2018,"Bonham, TX",NA,183,186,3,0.5040650406504065
2018,"Boone, NC",NA,404,209,-195,0.34094616639477976
2018,"Borger, TX",NA,143,130,-13,0.47619047619047616
2018,"Boston-Cambridge-Newton, MA-NH",NA,38602,31215,-7387,0.4470974118051477
2018,"Boulder, CO",NA,3244,2820,-424,0.4650395778364116
2018,"Bowling Green, KY",NA,1453,1288,-165,0.46990149580445095
2018,"Bozeman, MT",NA,1255,1119,-136,0.4713563605728728
2018,"Bradford, PA",NA,445,283,-162,0.38873626373626374
2018,"Brainerd, MN",NA,1389,630,-759,0.31203566121842496
2018,"Branson, MO",NA,755,562,-193,0.4267274107820805
2018,"Breckenridge, CO",NA,219,398,179,0.6450567260940032
2018,"Bremerton-Silverdale-Port Orchard, WA",NA,2583,2215,-368,0.46165068778657775
2018,"Brenham, TX",HOUSTON,216,235,19,0.5210643015521065
2018,"Brevard, NC",NA,257,142,-115,0.3558897243107769
2018,"Bridgeport-Stamford-Norwalk, CT",NEW YORK,6800,5831,-969,0.4616419919246299
2018,"Brookhaven, MS",NA,105,103,-2,0.4951923076923077
2018,"Brookings, OR",NA,228,234,6,0.5064935064935064
2018,"Brookings, SD",NA,263,192,-71,0.421978021978022
2018,"Brownsville-Harlingen, TX",NA,1221,3157,1936,0.7211055276381909
2018,"Brownsville, TN",NA,101,96,-5,0.4873096446700508
2018,"Brownwood, TX",NA,290,285,-5,0.4956521739130435
2018,"Brunswick, GA",NA,999,1149,150,0.5349162011173184
2018,"Bucyrus-Galion, OH",NA,411,285,-126,0.40948275862068967
2018,"Buffalo-Cheektowaga, NY",NA,10031,7954,-2077,0.4422574367528496
2018,"Burley, ID",NA,239,241,2,0.5020833333333333
2018,"Burlington-South Burlington, VT",NA,2154,1515,-639,0.4129190515126738
2018,"Burlington, IA-IL",NA,566,359,-207,0.3881081081081081
2018,"Burlington, NC",NA,1002,1085,83,0.5198850023957834
2018,"Butte-Silver Bow, MT",NA,279,235,-44,0.4571984435797665
2018,"Cadillac, MI",NA,637,352,-285,0.35591506572295245
2018,"Calhoun, GA",NA,313,351,38,0.5286144578313253
2018,"California-Lexington Park, MD",NA,741,694,-47,0.48362369337979094
2018,"Cambridge, MD",NA,268,206,-62,0.4345991561181435
2018,"Cambridge, OH",NA,344,259,-85,0.4295190713101161
2018,"Camden, AR",NA,203,178,-25,0.4671916010498688
2018,"Campbellsville, KY",NA,302,312,10,0.50814332247557
2018,"Ca√±on City, CO",NA,424,343,-81,0.4471968709256845
2018,"Canton-Massillon, OH",NA,3194,2489,-705,0.43797290163645963
2018,"Cape Coral-Fort Myers, FL",NA,8386,24172,15786,0.7424288961238406
2018,"Cape Girardeau, MO-IL",NA,833,693,-140,0.4541284403669725
2018,"Carbondale-Marion, IL",NA,1239,954,-285,0.43502051983584133
2018,"Carlsbad-Artesia, NM",NA,350,340,-10,0.4927536231884058
2018,"Carroll, IA",NA,167,107,-60,0.3905109489051095
2018,"Carson City, NV",NA,558,455,-103,0.4491609081934847
2018,"Casper, WY",NA,668,641,-27,0.48968678380443087
2018,"Cedar City, UT",NA,369,332,-37,0.47360912981455067
2018,"Cedar Rapids, IA",NA,2985,2021,-964,0.40371554135037957
2018,"Cedartown, GA",NA,340,301,-39,0.46957878315132606
2018,"Celina, OH",NA,254,191,-63,0.42921348314606744
2018,"Central City, KY",NA,179,168,-11,0.484149855907781
2018,"Centralia, IL",NA,400,305,-95,0.4326241134751773
2018,"Centralia, WA",NA,562,577,15,0.5065847234416154
2018,"Chambersburg-Waynesboro, PA",NA,1064,859,-205,0.4466978679147166
2018,"Champaign-Urbana, IL",NA,1831,1374,-457,0.42870514820592825
2018,"Charleston-Mattoon, IL",NA,567,415,-152,0.4226069246435845
2018,"Charleston-North Charleston, SC",NA,6458,6723,265,0.5100523480767771
2018,"Charleston, WV",NA,1481,1235,-246,0.45471281296023564
2018,"Charlotte-Concord-Gastonia, NC-SC",NA,18263,19193,930,0.5124145664246049
2018,"Charlottesville, VA",NA,1328,1227,-101,0.4802348336594912
2018,"Chattanooga, TN-GA",NA,4096,3966,-130,0.4919374844951625
2018,"Cheyenne, WY",NA,1033,814,-219,0.4407146724417975
2018,"Chicago-Naperville-Elgin, IL-IN-WI",CHICAGO,62763,53504,-9259,0.46018216690892516
2018,"Chico, CA",NA,6398,4045,-2353,0.38734080245140284
2018,"Chillicothe, OH",NA,575,469,-106,0.4492337164750958
2018,"Cincinnati, OH-KY-IN",NA,16816,14741,-2075,0.46712298380707923
2018,"Clarksburg, WV",NA,541,434,-107,0.4451282051282051
2018,"Clarksdale, MS",NA,89,50,-39,0.3597122302158273
2018,"Clarksville, TN-KY",NA,3092,2695,-397,0.465698980473475
2018,"Clearlake, CA",NA,486,438,-48,0.474025974025974
2018,"Cleveland-Elyria, OH",NA,16369,13755,-2614,0.4566126676404196
2018,"Cleveland, MS",NA,139,98,-41,0.41350210970464135
2018,"Cleveland, TN",NA,868,836,-32,0.49061032863849763
2018,"Clewiston, FL",NA,185,507,322,0.7326589595375722
2018,"Clinton, IA",NA,444,294,-150,0.3983739837398374
2018,"Clovis, NM",NA,410,396,-14,0.4913151364764268
2018,"Coeur d'Alene, ID",NA,1487,1372,-115,0.4798880727527107
2018,"Coffeyville, KS",NA,350,225,-125,0.391304347826087
2018,"Coldwater, MI",NA,492,342,-150,0.41007194244604317
2018,"College Station-Bryan, TX",NA,1781,1464,-317,0.45115562403697995
2018,"Colorado Springs, CO",NA,7425,6756,-669,0.4764121006981172
2018,"Columbia, MO",NA,1837,1417,-420,0.4354640442532268
2018,"Columbia, SC",NA,5426,5436,10,0.5004603203829866
2018,"Columbus, GA-AL",NA,2535,2495,-40,0.4960238568588469
2018,"Columbus, IN",NA,823,620,-203,0.42966042966042967
2018,"Columbus, MS",NA,410,355,-55,0.46405228758169936
2018,"Columbus, NE",NA,306,241,-65,0.4405850091407678
2018,"Columbus, OH",NA,17972,15808,-2164,0.4679692125518058
2018,"Concord, NH",NA,1353,1062,-291,0.43975155279503103
2018,"Connersville, IN",NA,275,195,-80,0.4148936170212766
2018,"Cookeville, TN",NA,845,767,-78,0.47580645161290325
2018,"Coos Bay, OR",NA,752,572,-180,0.43202416918429004
2018,"Cordele, GA",NA,145,127,-18,0.46691176470588236
2018,"Corinth, MS",NA,231,241,10,0.510593220338983
2018,"Cornelia, GA",NA,260,250,-10,0.49019607843137253
2018,"Corning, NY",NA,1090,732,-358,0.40175631174533477
2018,"Corpus Christi, TX",NA,2928,3296,368,0.5295629820051414
2018,"Corsicana, TX",NA,210,234,24,0.527027027027027
2018,"Cortland, NY",NA,425,331,-94,0.43783068783068785
2018,"Corvallis, OR",NA,761,614,-147,0.4465454545454545
2018,"Coshocton, OH",NA,272,251,-21,0.47992351816443596
2018,"Craig, CO",NA,120,90,-30,0.42857142857142855
2018,"Crawfordsville, IN",NA,401,263,-138,0.3960843373493976
2018,"Crescent City, CA",NA,197,213,16,0.5195121951219512
2018,"Crestview-Fort Walton Beach-Destin, FL",NA,2781,5006,2225,0.6428663156542956
2018,"Crossville, TN",NA,562,466,-96,0.45330739299610895
2018,"Cullman, AL",NA,464,524,60,0.5303643724696356
2018,"Cullowhee, NC",NA,425,252,-173,0.3722304283604136
2018,"Cumberland, MD-WV",NA,682,519,-163,0.4321398834304746
2018,"Dallas-Fort Worth-Arlington, TX",NA,55630,56683,1053,0.5046877921522887
2018,"Dalton, GA",NA,851,664,-187,0.4382838283828383
2018,"Danville, IL",NA,716,556,-160,0.4371069182389937
2018,"Danville, KY",NA,433,369,-64,0.4600997506234414
2018,"Danville, VA",NA,563,545,-18,0.4918772563176895
2018,"Daphne-Fairhope-Foley, AL",NA,1536,3970,2434,0.7210316018888485
2018,"Davenport-Moline-Rock Island, IA-IL",NA,3920,2623,-1297,0.4008864435274339
2018,"Dayton-Kettering, OH",NA,6730,5801,-929,0.462931928816535
2018,"Dayton, TN",NA,249,247,-2,0.49798387096774194
2018,"Decatur, AL",NA,894,805,-89,0.47380812242495585
2018,"Decatur, IL",NA,1169,776,-393,0.3989717223650386
2018,"Decatur, IN",NA,272,183,-89,0.4021978021978022
2018,"Defiance, OH",NA,372,249,-123,0.40096618357487923
2018,"Del Rio, TX",NA,262,243,-19,0.48118811881188117
2018,"Deltona-Daytona Beach-Ormond Beach, FL",NA,6146,9917,3771,0.6173815601070783
2018,"Deming, NM",NA,157,184,27,0.5395894428152492
2018,"Denver-Aurora-Lakewood, CO",NA,27368,26158,-1210,0.4886970817920263
2018,"DeRidder, LA",NA,246,251,5,0.5050301810865191
2018,"Des Moines-West Des Moines, IA",NA,6842,5538,-1304,0.44733441033925686
2018,"Detroit-Warren-Dearborn, MI",NA,37319,29029,-8290,0.43752637607765116
2018,"Dickinson, ND",NA,322,247,-75,0.43409490333919154
2018,"Dixon, IL",NA,313,223,-90,0.416044776119403
2018,"Dodge City, KS",NA,236,189,-47,0.4447058823529412
2018,"Dothan, AL",NA,1029,1168,139,0.5316340464269458
2018,"Douglas, GA",NA,297,264,-33,0.47058823529411764
2018,"Dover, DE",PHILADELPHIA,1292,1272,-20,0.4960998439937597
2018,"Dublin, GA",NA,402,417,15,0.5091575091575091
2018,"DuBois, PA",NA,440,359,-81,0.4493116395494368
2018,"Dubuque, IA",NA,818,597,-221,0.4219081272084806
2018,"Duluth, MN-WI",NA,2713,1786,-927,0.3969771060235608
2018,"Dumas, TX",NA,143,93,-50,0.3940677966101695
2018,"Duncan, OK",NA,391,312,-79,0.4438122332859175
2018,"Durango, CO",NA,548,467,-81,0.4600985221674877
2018,"Durant, OK",NA,418,300,-118,0.4178272980501393
2018,"Durham-Chapel Hill, NC",RALEIGH,3841,3907,66,0.5042591636551368
2018,"Dyersburg, TN",NA,351,307,-44,0.46656534954407297
2018,"Eagle Pass, TX",NA,112,144,32,0.5625
2018,"East Stroudsburg, PA",NA,1200,972,-228,0.44751381215469616
2018,"Easton, MD",NA,283,220,-63,0.43737574552683894
2018,"Eau Claire, WI",NA,1722,1103,-619,0.3904424778761062
2018,"Edwards, CO",NA,312,442,130,0.5862068965517241
2018,"Effingham, IL",NA,302,205,-97,0.40433925049309666
2018,"El Campo, TX",HOUSTON,216,192,-24,0.47058823529411764
2018,"El Centro, CA",NA,794,935,141,0.5407750144592249
2018,"El Dorado, AR",NA,223,223,0,0.5
2018,"El Paso, TX",NA,4778,4396,-382,0.4791802921299324
2018,"Elizabeth City, NC",NA,319,283,-36,0.4700996677740864
2018,"Elizabethtown-Fort Knox, KY",NA,1538,1298,-240,0.45768688293370946
2018,"Elk City, OK",NA,157,132,-25,0.45674740484429066
2018,"Elkhart-Goshen, IN",NA,1875,1315,-560,0.4122257053291536
2018,"Elkins, WV",NA,175,124,-51,0.41471571906354515
2018,"Elko, NV",NA,416,337,-79,0.44754316069057104
2018,"Ellensburg, WA",NA,384,312,-72,0.4482758620689655
2018,"Elmira, NY",NA,768,598,-170,0.4377745241581259
2018,"Emporia, KS",NA,494,235,-259,0.3223593964334705
2018,"Enid, OK",NA,467,353,-114,0.4304878048780488
2018,"Enterprise, AL",NA,451,353,-98,0.43905472636815923
2018,"Erie, PA",NA,2360,1622,-738,0.40733299849321947
2018,"Escanaba, MI",NA,411,200,-211,0.32733224222585927
2018,"Espa√±ola, NM",NA,67,46,-21,0.40707964601769914
2018,"Eufaula, AL-GA",NA,129,100,-29,0.4366812227074236
2018,"Eugene-Springfield, OR",NA,3955,3304,-651,0.45515911282545807
2018,"Eureka-Arcata, CA",NA,1067,896,-171,0.456444218033622
2018,"Evanston, WY",NA,140,72,-68,0.33962264150943394
2018,"Evansville, IN-KY",NA,2814,2341,-473,0.4541222114451988
2018,"Fairbanks, AK",NA,788,573,-215,0.4210139603232917
2018,"Fairfield, IA",NA,207,152,-55,0.4233983286908078
2018,"Fairmont, MN",NA,219,129,-90,0.3706896551724138
2018,"Fairmont, WV",NA,327,187,-140,0.3638132295719844
2018,"Fallon, NV",NA,224,188,-36,0.4563106796116505
2018,"Fargo, ND-MN",NA,2951,1829,-1122,0.3826359832635983
2018,"Faribault-Northfield, MN",NA,572,402,-170,0.4127310061601643
2018,"Farmington, MO",NA,566,514,-52,0.4759259259259259
2018,"Farmington, NM",NA,594,479,-115,0.44641192917054984
2018,"Fayetteville-Springdale-Rogers, AR",NA,4143,3796,-347,0.4781458621992694
2018,"Fayetteville, NC",RALEIGH,4607,4041,-566,0.4672756706753006
2018,"Fergus Falls, MN",NA,655,312,-343,0.32264736297828334
2018,"Fernley, NV",NA,519,530,11,0.5052430886558628
2018,"Findlay, OH",NA,643,475,-168,0.42486583184257604
2018,"Fitzgerald, GA",NA,117,108,-9,0.48
2018,"Flagstaff, AZ",NA,1036,762,-274,0.42380422691879865
2018,"Flint, MI",NA,4761,3499,-1262,0.42360774818401936
2018,"Florence-Muscle Shoals, AL",NA,925,912,-13,0.4964616222101252
2018,"Florence, SC",NA,962,1021,59,0.5148764498234998
2018,"Fond du Lac, WI",NA,888,655,-233,0.42449773169151006
2018,"Forest City, NC",NA,373,368,-5,0.4966261808367072
2018,"Forrest City, AR",NA,97,106,9,0.5221674876847291
2018,"Fort Collins, CO",NA,3185,2791,-394,0.46703480589022756
2018,"Fort Dodge, IA",NA,407,290,-117,0.41606886657101866
2018,"Fort Leonard Wood, MO",NA,632,527,-105,0.454702329594478
2018,"Fort Madison-Keokuk, IA-IL-MO",NA,639,421,-218,0.39716981132075474
2018,"Fort Morgan, CO",NA,220,178,-42,0.4472361809045226
2018,"Fort Payne, AL",NA,397,365,-32,0.479002624671916
2018,"Fort Polk South, LA",NA,449,359,-90,0.4443069306930693
2018,"Fort Smith, AR-OK",NA,2159,1750,-409,0.44768482987976466
2018,"Fort Wayne, IN",NA,4204,3115,-1089,0.4256045907910917
2018,"Frankfort, IN",NA,274,199,-75,0.42071881606765327
2018,"Frankfort, KY",NA,702,617,-85,0.467778620166793
2018,"Fredericksburg, TX",NA,158,214,56,0.5752688172043011
2018,"Freeport, IL",NA,433,289,-144,0.4002770083102493
2018,"Fremont, NE",NA,302,229,-73,0.4312617702448211
2018,"Fremont, OH",NA,411,319,-92,0.436986301369863
2018,"Fresno, CA",FRESNO,5673,5316,-357,0.4837564837564838
2018,"Gadsden, AL",NA,632,638,6,0.5023622047244094
2018,"Gaffney, SC",NA,288,223,-65,0.436399217221135
2018,"Gainesville, FL",NA,2652,2809,157,0.51437465665629
2018,"Gainesville, GA",NA,1223,1334,111,0.5217051231912397
2018,"Gainesville, TX",NA,331,231,-100,0.4110320284697509
2018,"Galesburg, IL",NA,476,309,-167,0.39363057324840767
2018,"Gallup, NM",NA,107,69,-38,0.39204545454545453
2018,"Garden City, KS",NA,388,277,-111,0.41654135338345866
2018,"Gardnerville Ranchos, NV",NA,442,414,-28,0.48364485981308414
2018,"Georgetown, SC",NA,322,392,70,0.5490196078431373
2018,"Gettysburg, PA",NA,654,490,-164,0.42832167832167833
2018,"Gillette, WY",NA,487,424,-63,0.4654226125137212
2018,"Glasgow, KY",NA,386,348,-38,0.47411444141689374
2018,"Glens Falls, NY",NA,1287,808,-479,0.3856801909307876
2018,"Glenwood Springs, CO",NA,809,683,-126,0.45777479892761397
2018,"Gloversville, NY",NA,551,372,-179,0.40303358613217766
2018,"Goldsboro, NC",RALEIGH,798,747,-51,0.48349514563106794
2018,"Granbury, TX",NA,409,512,103,0.5559174809989142
2018,"Grand Forks, ND-MN",NA,1080,596,-484,0.3556085918854415
2018,"Grand Island, NE",NA,728,503,-225,0.40861088545897645
2018,"Grand Junction, CO",NA,1609,1372,-237,0.46024823884602484
2018,"Grand Rapids-Kentwood, MI",NA,11209,7602,-3607,0.40412524586678006
2018,"Grand Rapids, MN",NA,374,220,-154,0.37037037037037035
2018,"Grants Pass, OR",NA,757,711,-46,0.4843324250681199
2018,"Grants, NM",NA,58,64,6,0.5245901639344263
2018,"Great Bend, KS",NA,271,213,-58,0.44008264462809915
2018,"Great Falls, MT",NA,771,565,-206,0.42290419161676646
2018,"Greeley, CO",NA,2249,2346,97,0.5105549510337323
2018,"Green Bay, WI",NA,3228,2161,-1067,0.4010020411950269
2018,"Greeneville, TN",NA,430,435,5,0.5028901734104047
2018,"Greensboro-High Point, NC",NA,5513,4728,-785,0.4616736646811835
2018,"Greensburg, IN",NA,288,178,-110,0.38197424892703863
2018,"Greenville-Anderson, SC",NA,6014,5987,-27,0.49887509374218814
2018,"Greenville, MS",NA,225,261,36,0.5370370370370371
2018,"Greenville, NC",NA,1209,1047,-162,0.4640957446808511
2018,"Greenville, OH",NA,423,363,-60,0.4618320610687023
2018,"Greenwood, MS",NA,232,203,-29,0.4666666666666667
2018,"Greenwood, SC",NA,378,370,-8,0.4946524064171123
2018,"Grenada, MS",NA,122,108,-14,0.46956521739130436
2018,"Gulfport-Biloxi, MS",NA,3316,3238,-78,0.4940494354592615
2018,"Guymon, OK",NA,151,81,-70,0.34913793103448276
2018,"Hagerstown-Martinsburg, MD-WV",NA,2123,2004,-119,0.48558274775866245
2018,"Hailey, ID",NA,147,248,101,0.6278481012658228
2018,"Hammond, LA",NA,629,638,9,0.5035516969218626
2018,"Hanford-Corcoran, CA",FRESNO,814,704,-110,0.463768115942029
2018,"Hannibal, MO",NA,377,278,-99,0.42442748091603055
2018,"Harrisburg-Carlisle, PA",NA,5014,4561,-453,0.4763446475195822
2018,"Harrison, AR",NA,328,298,-30,0.476038338658147
2018,"Harrisonburg, VA",NA,839,708,-131,0.45765998707175176
2018,"Hartford-East Hartford-Middletown, CT",NA,9773,8161,-1612,0.45505743280918926
2018,"Hastings, NE",NA,253,178,-75,0.41299303944315546
2018,"Hattiesburg, MS",NA,1080,978,-102,0.4752186588921283
2018,"Hays, KS",NA,256,189,-67,0.4247191011235955
2018,"Heber, UT",NA,461,659,198,0.5883928571428572
2018,"Helena-West Helena, AR",NA,102,83,-19,0.4486486486486487
2018,"Helena, MT",NA,781,587,-194,0.42909356725146197
2018,"Henderson, NC",RALEIGH,249,166,-83,0.4
2018,"Hereford, TX",NA,117,91,-26,0.4375
2018,"Hermiston-Pendleton, OR",NA,614,527,-87,0.4618755477651183
2018,"Hickory-Lenoir-Morganton, NC",NA,1972,1833,-139,0.4817345597897503
2018,"Hillsdale, MI",NA,459,292,-167,0.38881491344873503
2018,"Hilo, HI",NA,1307,1448,141,0.5255898366606171
2018,"Hilton Head Island-Bluffton, SC",NA,1709,2550,841,0.5987320967363231
2018,"Hinesville, GA",NA,751,712,-39,0.48667122351332875
2018,"Hobbs, NM",NA,367,390,23,0.5151915455746368
2018,"Holland, MI",NA,929,659,-270,0.4149874055415617
2018,"Homosassa Springs, FL",NA,1360,2792,1432,0.6724470134874759
2018,"Hood River, OR",NA,175,185,10,0.5138888888888888
2018,"Hope, AR",NA,155,121,-34,0.4384057971014493
2018,"Hot Springs, AR",NA,1129,966,-163,0.4610978520286396
2018,"Houghton, MI",NA,312,182,-130,0.3684210526315789
2018,"Houma-Thibodaux, LA",NA,975,893,-82,0.47805139186295503
2018,"Houston-The Woodlands-Sugar Land, TX",HOUSTON,43410,44223,813,0.5046386635171682
2018,"Hudson, NY",NA,515,343,-172,0.3997668997668998
2018,"Huntingdon, PA",NA,223,171,-52,0.434010152284264
2018,"Huntington-Ashland, WV-KY-OH",NA,2190,1763,-427,0.4459903870478118
2018,"Huntington, IN",NA,414,301,-113,0.42097902097902096
2018,"Huntsville, AL",NA,3244,3455,211,0.5157486191968951
2018,"Huntsville, TX",HOUSTON,357,326,-31,0.4773060029282577
2018,"Huron, SD",NA,161,116,-45,0.4187725631768953
2018,"Hutchinson, KS",NA,509,419,-90,0.4515086206896552
2018,"Hutchinson, MN",NA,336,218,-118,0.3935018050541516
2018,"Idaho Falls, ID",NA,1002,928,-74,0.48082901554404145
2018,"Indiana, PA",NA,551,420,-131,0.4325437693099897
2018,"Indianapolis-Carmel-Anderson, IN",NA,20663,17571,-3092,0.4595647852696553
2018,"Indianola, MS",NA,70,94,24,0.573170731707317
2018,"Iowa City, IA",NA,1485,1052,-433,0.41466298778084354
2018,"Iron Mountain, MI-WI",NA,264,163,-101,0.38173302107728335
2018,"Ithaca, NY",NA,891,590,-301,0.3983794733288319
2018,"Jackson, MI",NA,1572,1049,-523,0.40022892025944296
2018,"Jackson, MS",NA,3174,2907,-267,0.47804637395165267
2018,"Jackson, OH",NA,215,208,-7,0.491725768321513
2018,"Jackson, TN",NA,1313,1325,12,0.5022744503411676
2018,"Jackson, WY-ID",NA,234,301,67,0.5626168224299065
2018,"Jacksonville, FL",NA,14031,16013,1982,0.5329849553987485
2018,"Jacksonville, IL",NA,275,210,-65,0.4329896907216495
2018,"Jacksonville, NC",NA,2417,1849,-568,0.43342709798406
2018,"Jacksonville, TX",NA,236,198,-38,0.45622119815668205
2018,"Jamestown-Dunkirk-Fredonia, NY",NA,1362,982,-380,0.4189419795221843
2018,"Jamestown, ND",NA,181,111,-70,0.3801369863013699
2018,"Janesville-Beloit, WI",NA,1558,1165,-393,0.4278369445464561
2018,"Jasper, AL",NA,358,306,-52,0.4608433734939759
2018,"Jasper, IN",NA,372,320,-52,0.4624277456647399
2018,"Jefferson City, MO",NA,1040,949,-91,0.477124183006536
2018,"Jefferson, GA",NA,444,491,47,0.5251336898395722
2018,"Jennings, LA",NA,168,160,-8,0.4878048780487805
2018,"Jesup, GA",NA,251,175,-76,0.4107981220657277
2018,"Johnson City, TN",NA,1390,1378,-12,0.49783236994219654
2018,"Johnstown, PA",NA,813,615,-198,0.43067226890756305
2018,"Jonesboro, AR",NA,1128,880,-248,0.43824701195219123
2018,"Joplin, MO",NA,1639,1410,-229,0.4624467038373237
2018,"Juneau, AK",NA,194,207,13,0.516209476309227
2018,"Kahului-Wailuku-Lahaina, HI",NA,1527,1612,85,0.5135393437400446
2018,"Kalamazoo-Portage, MI",NA,2945,2016,-929,0.40636968353154607
2018,"Kalispell, MT",NA,1006,898,-108,0.47163865546218486
2018,"Kankakee, IL",CHICAGO,933,670,-263,0.41796631316281974
2018,"Kansas City, MO-KS",NA,17305,16134,-1171,0.4824905050988367
2018,"Kapaa, HI",NA,446,491,45,0.5240128068303095
2018,"Kearney, NE",NA,464,353,-111,0.4320685434516524
2018,"Keene, NH",NA,767,499,-268,0.3941548183254344
2018,"Kendallville, IN",NA,461,307,-154,0.3997395833333333
2018,"Kennett, MO",NA,275,231,-44,0.45652173913043476
2018,"Kennewick-Richland, WA",NA,2064,1978,-86,0.48936170212765956
2018,"Kerrville, TX",NA,404,416,12,0.5073170731707317
2018,"Ketchikan, AK",NA,142,125,-17,0.4681647940074906
2018,"Key West, FL",NA,1013,2676,1663,0.7253998373542966
2018,"Kill Devil Hills, NC",NA,334,251,-83,0.42905982905982903
2018,"Killeen-Temple, TX",NA,4865,4477,-388,0.4792335688289446
2018,"Kingsport-Bristol, TN-VA",NA,1913,1799,-114,0.48464439655172414
2018,"Kingston, NY",NEW YORK,1514,1008,-506,0.3996827914353688
2018,"Kingsville, TX",NA,263,192,-71,0.421978021978022
2018,"Kinston, NC",NA,345,297,-48,0.46261682242990654
2018,"Kirksville, MO",NA,308,181,-127,0.37014314928425357
2018,"Klamath Falls, OR",NA,561,504,-57,0.4732394366197183
2018,"Knoxville, TN",NA,6681,6188,-493,0.4808454425363276
2018,"Kokomo, IN",NA,965,631,-334,0.39536340852130325
2018,"La Crosse-Onalaska, WI-MN",NA,1281,821,-460,0.3905803996194101
2018,"La Grande, OR",NA,283,207,-76,0.42244897959183675
2018,"Laconia, NH",NA,766,462,-304,0.3762214983713355
2018,"Lafayette-West Lafayette, IN",NA,2307,1300,-1007,0.36041031327973383
2018,"Lafayette, LA",NA,2641,2478,-163,0.4840789216643876
2018,"LaGrange, GA-AL",NA,643,630,-13,0.4948939512961508
2018,"Lake Charles, LA",NA,1421,1366,-55,0.4901327592393254
2018,"Lake City, FL",NA,452,504,52,0.5271966527196653
2018,"Lake Havasu City-Kingman, AZ",NA,1769,3818,2049,0.68337211383569
2018,"Lakeland-Winter Haven, FL",NA,6640,11214,4574,0.6280945446398566
2018,"Lamesa, TX",NA,70,48,-22,0.4067796610169492
2018,"Lancaster, PA",NA,3956,3485,-471,0.46835102808762263
2018,"Lansing-East Lansing, MI",NA,5667,4011,-1656,0.4144451332920025
2018,"Laramie, WY",NA,388,237,-151,0.3792
2018,"Laredo, TX",NA,763,859,96,0.5295930949445129
2018,"Las Cruces, NM",NA,1255,1197,-58,0.48817292006525287
2018,"Las Vegas-Henderson-Paradise, NV",NA,20338,21656,1318,0.5156927180073344
2018,"Las Vegas, NM",NA,138,85,-53,0.3811659192825112
2018,"Laurel, MS",NA,373,402,29,0.5187096774193548
2018,"Laurinburg, NC",NA,177,166,-11,0.4839650145772595
2018,"Lawrence, KS",NA,865,777,-88,0.47320341047503045
2018,"Lawrenceburg, TN",NA,278,277,-1,0.4990990990990991
2018,"Lawton, OK",NA,1045,938,-107,0.4730206757438225
2018,"Lebanon, MO",NA,391,347,-44,0.470189701897019
2018,"Lebanon, NH-VT",NA,2059,1400,-659,0.4047412546978896
2018,"Lebanon, PA",NA,1125,1039,-86,0.4801293900184843
2018,"Levelland, TX",NA,110,94,-16,0.46078431372549017
2018,"Lewisburg, PA",NA,238,168,-70,0.41379310344827586
2018,"Lewisburg, TN",NA,246,215,-31,0.46637744034707157
2018,"Lewiston-Auburn, ME",NA,1107,887,-220,0.4448345035105316
2018,"Lewiston, ID-WA",NA,674,576,-98,0.4608
2018,"Lewistown, PA",NA,336,310,-26,0.47987616099071206
2018,"Lexington-Fayette, KY",NA,4639,4121,-518,0.4704337899543379
2018,"Lexington, NE",NA,230,185,-45,0.4457831325301205
2018,"Liberal, KS",NA,149,125,-24,0.4562043795620438
2018,"Lima, OH",NA,889,692,-197,0.4376976597090449
2018,"Lincoln, IL",NA,165,124,-41,0.4290657439446367
2018,"Lincoln, NE",NA,3280,2252,-1028,0.40708604483007954
2018,"Little Rock-North Little Rock-Conway, AR",NA,5804,5412,-392,0.4825249643366619
2018,"Lock Haven, PA",NA,246,205,-41,0.45454545454545453
2018,"Logan, UT-ID",NA,1206,723,-483,0.374805598755832
2018,"Logansport, IN",NA,472,320,-152,0.40404040404040403
2018,"London, KY",NA,868,750,-118,0.4635352286773795
2018,"Longview, TX",NA,1715,1754,39,0.5056212164889017
2018,"Longview, WA",NA,938,861,-77,0.4785992217898833
2018,"Los Alamos, NM",NA,157,150,-7,0.48859934853420195
2018,"Los Angeles-Long Beach-Anaheim, CA",LOS ANGELES,79218,74803,-4415,0.48566753884210595
2018,"Louisville/Jefferson County, KY-IN",NA,11142,9403,-1739,0.4576782672183013
2018,"Lubbock, TX",NA,2468,2000,-468,0.4476275738585497
2018,"Ludington, MI",NA,343,177,-166,0.3403846153846154
2018,"Lufkin, TX",NA,567,532,-35,0.4840764331210191
2018,"Lumberton, NC",NA,494,444,-50,0.47334754797441364
2018,"Lynchburg, VA",NA,1643,1448,-195,0.4684568100938208
2018,"Macomb, IL",NA,254,148,-106,0.3681592039800995
2018,"Macon-Bibb County, GA",NA,1487,1399,-88,0.48475398475398473
2018,"Madera, CA",FRESNO,649,671,22,0.5083333333333333
2018,"Madison, IN",NA,310,236,-74,0.43223443223443225
2018,"Madison, WI",NA,5586,4285,-1301,0.4340998885624557
2018,"Madisonville, KY",NA,409,366,-43,0.472258064516129
2018,"Magnolia, AR",NA,139,86,-53,0.38222222222222224
2018,"Malone, NY",NA,443,285,-158,0.3914835164835165
2018,"Malvern, AR",NA,212,190,-22,0.472636815920398
2018,"Manchester-Nashua, NH",NA,3878,3087,-791,0.44321608040201005
2018,"Manhattan, KS",NA,1959,1072,-887,0.3536786539096008
2018,"Manitowoc, WI",NA,683,490,-193,0.4177323103154305
2018,"Mankato, MN",NA,986,680,-306,0.40816326530612246
2018,"Mansfield, OH",NA,1120,860,-260,0.43434343434343436
2018,"Marietta, OH",NA,405,321,-84,0.44214876033057854
2018,"Marinette, WI-MI",NA,644,379,-265,0.3704789833822092
2018,"Marion, IN",NA,674,429,-245,0.3889392565729828
2018,"Marion, NC",NA,270,229,-41,0.4589178356713427
2018,"Marion, OH",NA,582,452,-130,0.437137330754352
2018,"Marquette, MI",NA,796,400,-396,0.33444816053511706
2018,"Marshall, MN",NA,302,174,-128,0.36554621848739494
2018,"Marshall, MO",NA,202,170,-32,0.45698924731182794
2018,"Marshalltown, IA",NA,382,266,-116,0.4104938271604938
2018,"Martin, TN",NA,270,216,-54,0.4444444444444444
2018,"Martinsville, VA",NA,390,323,-67,0.453015427769986
2018,"Maryville, MO",NA,138,95,-43,0.40772532188841204
2018,"Mason City, IA",NA,629,408,-221,0.39344262295081966
2018,"Mayfield, KY",NA,331,202,-129,0.3789868667917448
2018,"Maysville, KY",NA,143,111,-32,0.43700787401574803
2018,"McAlester, OK",NA,296,263,-33,0.47048300536672627
2018,"McAllen-Edinburg-Mission, TX",NA,2276,5337,3061,0.701037698673322
2018,"McComb, MS",NA,245,206,-39,0.4567627494456763
2018,"McMinnville, TN",NA,327,310,-17,0.48665620094191525
2018,"McPherson, KS",NA,198,177,-21,0.472
2018,"Meadville, PA",NA,794,488,-306,0.38065522620904835
2018,"Medford, OR",NA,2060,2025,-35,0.49571603427172584
2018,"Memphis, TN-MS-AR",NA,8959,8925,-34,0.4990494296577947
2018,"Menomonie, WI",NA,339,254,-85,0.42833052276559863
2018,"Merced, CA",FRESNO,1493,1363,-130,0.47724089635854344
2018,"Meridian, MS",NA,516,494,-22,0.4891089108910891
2018,"Mexico, MO",NA,160,157,-3,0.4952681388012618
2018,"Miami-Fort Lauderdale-Pompano Beach, FL",NA,51980,67295,15315,0.5642003772793963
2018,"Miami, OK",NA,248,126,-122,0.33689839572192515
2018,"Michigan City-La Porte, IN",CHICAGO,881,656,-225,0.42680546519193235
2018,"Middlesborough, KY",NA,138,119,-19,0.46303501945525294
2018,"Midland, MI",NA,889,544,-345,0.3796231681786462
2018,"Midland, TX",NA,1228,1094,-134,0.47114556416882
2018,"Milledgeville, GA",NA,267,225,-42,0.4573170731707317
2018,"Milwaukee-Waukesha, WI",NA,13132,10771,-2361,0.4506128937790235
2018,"Minden, LA",NA,315,235,-80,0.42727272727272725
2018,"Mineral Wells, TX",NA,212,182,-30,0.4619289340101523
2018,"Minneapolis-St. Paul-Bloomington, MN-WI",NA,33464,25841,-7623,0.4357305454852036
2018,"Minot, ND",NA,745,495,-250,0.39919354838709675
2018,"Missoula, MT",NA,1280,912,-368,0.41605839416058393
2018,"Mitchell, SD",NA,180,143,-37,0.44272445820433437
2018,"Moberly, MO",NA,258,197,-61,0.432967032967033
2018,"Mobile, AL",NA,2574,2562,-12,0.49883177570093457
2018,"Modesto, CA",NA,3276,2863,-413,0.4663625997719498
2018,"Monroe, LA",NA,1390,1269,-121,0.47724708537044
2018,"Monroe, MI",NA,1234,903,-331,0.42255498362189986
2018,"Montgomery, AL",NA,2666,2494,-172,0.48333333333333334
2018,"Montrose, CO",NA,410,350,-60,0.4605263157894737
2018,"Morehead City, NC",NA,521,430,-91,0.45215562565720296
2018,"Morgan City, LA",NA,250,253,3,0.5029821073558648
2018,"Morgantown, WV",NA,1006,658,-348,0.3954326923076923
2018,"Morristown, TN",NA,928,780,-148,0.4566744730679157
2018,"Moscow, ID",NA,306,184,-122,0.37551020408163266
2018,"Moses Lake, WA",NA,614,504,-110,0.45080500894454384
2018,"Moultrie, GA",NA,249,229,-20,0.4790794979079498
2018,"Mount Airy, NC",NA,318,311,-7,0.4944356120826709
2018,"Mount Gay-Shamrock, WV",NA,49,54,5,0.5242718446601942
2018,"Mount Pleasant, MI",NA,590,396,-194,0.40162271805273836
2018,"Mount Pleasant, TX",NA,234,217,-17,0.4811529933481153
2018,"Mount Sterling, KY",NA,401,362,-39,0.4744429882044561
2018,"Mount Vernon-Anacortes, WA",NA,1018,942,-76,0.4806122448979592
2018,"Mount Vernon, IL",NA,283,210,-73,0.4259634888438134
2018,"Mount Vernon, OH",NA,577,444,-133,0.4348677766895201
2018,"Mountain Home, AR",NA,340,313,-27,0.4793261868300153
2018,"Mountain Home, ID",NA,337,243,-94,0.4189655172413793
2018,"Muncie, IN",NA,1067,766,-301,0.41789416257501366
2018,"Murray, KY",NA,363,245,-118,0.4029605263157895
2018,"Muscatine, IA",NA,460,310,-150,0.4025974025974026
2018,"Muskegon, MI",NA,1826,1266,-560,0.4094437257438551
2018,"Muskogee, OK",NA,586,482,-104,0.45131086142322097
2018,"Myrtle Beach-Conway-North Myrtle Beach, SC-NC",NA,4100,6375,2275,0.6085918854415274
2018,"Nacogdoches, TX",NA,396,338,-58,0.4604904632152589
2018,"Napa, CA",SAN FRANCISCO,861,742,-119,0.462882096069869
2018,"Naples-Marco Island, FL",NA,4026,14138,10112,0.7783527857300154
2018,"Nashville-Davidson--Murfreesboro--Franklin, TN",NA,15751,15334,-417,0.49329258484799743
2018,"Natchez, MS-LA",NA,199,169,-30,0.4592391304347826
2018,"Natchitoches, LA",NA,185,191,6,0.5079787234042553
2018,"New Bern, NC",NA,1064,870,-194,0.4498448810754912
2018,"New Castle, IN",NA,480,342,-138,0.41605839416058393
2018,"New Castle, PA",NA,704,492,-212,0.411371237458194
2018,"New Haven-Milford, CT",NA,6649,5623,-1026,0.4581975228161669
2018,"New Orleans-Metairie, LA",NA,7253,7024,-229,0.49198010786579816
2018,"New Philadelphia-Dover, OH",NA,740,621,-119,0.4562821454812638
2018,"New Ulm, MN",NA,251,160,-91,0.38929440389294406
2018,"New York-Newark-Jersey City, NY-NJ-PA",NEW YORK,121119,99677,-21442,0.45144386673671627
2018,"Newberry, SC",NA,196,201,5,0.5062972292191436
2018,"Newport, OR",NA,595,532,-63,0.4720496894409938
2018,"Newport, TN",NA,209,208,-1,0.4988009592326139
2018,"Niles, MI",NA,1724,1075,-649,0.38406573776348696
2018,"Nogales, AZ",NA,224,332,108,0.5971223021582733
2018,"Norfolk, NE",NA,417,276,-141,0.39826839826839827
2018,"North Platte, NE",NA,308,200,-108,0.3937007874015748
2018,"North Port-Sarasota-Bradenton, FL",NA,8374,22893,14519,0.7321776953337384
2018,"North Vernon, IN",NA,255,229,-26,0.4731404958677686
2018,"North Wilkesboro, NC",NA,307,305,-2,0.49836601307189543
2018,"Norwalk, OH",NA,541,389,-152,0.4182795698924731
2018,"Norwich-New London, CT",NA,2699,2061,-638,0.43298319327731094
2018,"Oak Harbor, WA",NA,895,728,-167,0.4485520640788663
2018,"Ocala, FL",NA,3080,4690,1610,0.6036036036036037
2018,"Ocean City, NJ",PHILADELPHIA,1358,702,-656,0.3407766990291262
2018,"Odessa, TX",NA,1024,964,-60,0.48490945674044267
2018,"Ogden-Clearfield, UT",NA,4356,3869,-487,0.4703951367781155
2018,"Ogdensburg-Massena, NY",NA,1125,675,-450,0.375
2018,"Oil City, PA",NA,396,260,-136,0.39634146341463417
2018,"Okeechobee, FL",NA,281,940,659,0.7698607698607699
2018,"Oklahoma City, OK",NA,9841,9056,-785,0.4792295073292057
2018,"Olean, NY",NA,708,474,-234,0.4010152284263959
2018,"Olympia-Lacey-Tumwater, WA",NA,2581,2507,-74,0.49272798742138363
2018,"Omaha-Council Bluffs, NE-IA",NA,8067,6748,-1319,0.45548430644616944
2018,"Oneonta, NY",NA,501,276,-225,0.3552123552123552
2018,"Ontario, OR-ID",NA,534,397,-137,0.4264232008592911
2018,"Opelousas, LA",NA,368,365,-3,0.4979536152796726
2018,"Orangeburg, SC",NA,477,421,-56,0.4688195991091314
2018,"Orlando-Kissimmee-Sanford, FL",NA,26327,30276,3949,0.5348833100719043
2018,"Oshkosh-Neenah, WI",NA,1672,1233,-439,0.4244406196213425
2018,"Oskaloosa, IA",NA,181,118,-63,0.39464882943143814
2018,"Othello, WA",NA,79,83,4,0.5123456790123457
2018,"Ottawa, IL",CHICAGO,1161,823,-338,0.41481854838709675
2018,"Ottawa, KS",NA,233,176,-57,0.43031784841075793
2018,"Ottumwa, IA",NA,432,315,-117,0.42168674698795183
2018,"Owatonna, MN",NA,352,224,-128,0.3888888888888889
2018,"Owensboro, KY",NA,984,826,-158,0.456353591160221
2018,"Oxford, MS",NA,277,211,-66,0.4323770491803279
2018,"Oxnard-Thousand Oaks-Ventura, CA",LOS ANGELES,4825,4961,136,0.5069487022276722
2018,"Ozark, AL",NA,400,350,-50,0.4666666666666667
2018,"Paducah, KY-IL",NA,866,744,-122,0.462111801242236
2018,"Pahrump, NV",NA,420,498,78,0.5424836601307189
2018,"Palatka, FL",NA,525,770,245,0.5945945945945946
2018,"Palestine, TX",NA,266,251,-15,0.48549323017408125
2018,"Palm Bay-Melbourne-Titusville, FL",NA,5771,8965,3194,0.6083740499457112
2018,"Pampa, TX",NA,94,87,-7,0.48066298342541436
2018,"Panama City, FL",NA,4139,3720,-419,0.4733426644611274
2018,"Paragould, AR",NA,340,318,-22,0.48328267477203646
2018,"Paris, TN",NA,259,245,-14,0.4861111111111111
2018,"Paris, TX",NA,399,361,-38,0.475
2018,"Parkersburg-Vienna, WV",NA,576,477,-99,0.452991452991453
2018,"Parsons, KS",NA,189,147,-42,0.4375
2018,"Payson, AZ",NA,419,435,16,0.509367681498829
2018,"Pearsall, TX",NA,45,64,19,0.5871559633027523
2018,"Pecos, TX",NA,25,40,15,0.6153846153846154
2018,"Pella, IA",NA,300,236,-64,0.44029850746268656
2018,"Pensacola-Ferry Pass-Brent, FL",NA,3955,4656,701,0.5407037510161421
2018,"Peoria, IL",NA,3977,2597,-1380,0.39504107088530577
2018,"Peru, IN",NA,358,206,-152,0.36524822695035464
2018,"Philadelphia-Camden-Wilmington, PA-NJ-DE-MD",PHILADELPHIA,39200,35077,-4123,0.47224578267835265
2018,"Phoenix-Mesa-Chandler, AZ",NA,41270,60119,18849,0.5929538707354841
2018,"Picayune, MS",NA,356,336,-20,0.48554913294797686
2018,"Pierre, SD",NA,203,141,-62,0.40988372093023256
2018,"Pine Bluff, AR",NA,491,421,-70,0.4616228070175439
2018,"Pinehurst-Southern Pines, NC",RALEIGH,624,696,72,0.5272727272727272
2018,"Pittsburg, KS",NA,335,235,-100,0.41228070175438597
2018,"Pittsburgh, PA",NA,16318,13161,-3157,0.44645340751043117
2018,"Pittsfield, MA",NA,1340,876,-464,0.3953068592057762
2018,"Plainview, TX",NA,160,139,-21,0.46488294314381273
2018,"Platteville, WI",NA,389,228,-161,0.3695299837925446
2018,"Plattsburgh, NY",NA,876,548,-328,0.3848314606741573
2018,"Plymouth, IN",NA,441,314,-127,0.41589403973509936
2018,"Pocatello, ID",NA,816,645,-171,0.44147843942505133
2018,"Point Pleasant, WV-OH",NA,347,251,-96,0.4197324414715719
2018,"Ponca City, OK",NA,412,317,-95,0.4348422496570645
2018,"Pontiac, IL",NA,271,168,-103,0.3826879271070615
2018,"Poplar Bluff, MO",NA,554,501,-53,0.47488151658767774
2018,"Port Angeles, WA",NA,650,553,-97,0.4596841230257689
2018,"Port Lavaca, TX",HOUSTON,70,66,-4,0.4852941176470588
2018,"Port St. Lucie, FL",NA,3990,8900,4910,0.6904577191621412
2018,"Portales, NM",NA,132,115,-17,0.46558704453441296
2018,"Portland-South Portland, ME",NA,5796,4240,-1556,0.42247907532881623
2018,"Portland-Vancouver-Hillsboro, OR-WA",NA,21808,20793,-1015,0.48808713410483323
2018,"Portsmouth, OH",NA,504,463,-41,0.4788004136504654
2018,"Pottsville, PA",NA,1112,981,-131,0.4687052078356426
2018,"Poughkeepsie-Newburgh-Middletown, NY",NEW YORK,4775,3996,-779,0.455592292783035
2018,"Prescott Valley-Prescott, AZ",NA,2255,2462,207,0.5219419122323511
2018,"Price, UT",NA,105,108,3,0.5070422535211268
2018,"Prineville, OR",NA,261,219,-42,0.45625
2018,"Providence-Warwick, RI-MA",NA,13740,11304,-2436,0.45136559655007186
2018,"Provo-Orem, UT",NA,3457,3349,-108,0.49206582427270057
2018,"Pueblo, CO",NA,1278,1226,-52,0.48961661341853036
2018,"Pullman, WA",NA,388,209,-179,0.3500837520938023
2018,"Punta Gorda, FL",NA,1945,6572,4627,0.7716332041798756
2018,"Quincy, IL-MO",NA,599,476,-123,0.4427906976744186
2018,"Racine, WI",NA,1569,1319,-250,0.4567174515235457
2018,"Raleigh-Cary, NC",RALEIGH,9851,10485,634,0.5155881195908734
2018,"Rapid City, SD",NA,1458,1167,-291,0.44457142857142856
2018,"Raymondville, TX",NA,30,53,23,0.6385542168674698
2018,"Reading, PA",PHILADELPHIA,3168,2774,-394,0.4668461797374621
2018,"Red Bluff, CA",NA,618,726,108,0.5401785714285714
2018,"Red Wing, MN",NA,399,260,-139,0.3945371775417299
2018,"Redding, CA",NA,1860,1755,-105,0.4854771784232365
2018,"Reno, NV",NA,4071,4030,-41,0.4974694482162696
2018,"Rexburg, ID",NA,631,330,-301,0.3433922996878252
2018,"Richmond-Berea, KY",NA,878,756,-122,0.46266829865361075
2018,"Richmond, IN",NA,564,441,-123,0.4388059701492537
2018,"Richmond, VA",NA,8893,8677,-216,0.49385315879339786
2018,"Rio Grande City-Roma, TX",NA,104,90,-14,0.4639175257731959
2018,"Riverside-San Bernardino-Ontario, CA",LOS ANGELES,27066,31142,4076,0.5350123694337549
2018,"Riverton, WY",NA,277,216,-61,0.4381338742393509
2018,"Roanoke Rapids, NC",RALEIGH,289,278,-11,0.49029982363315694
2018,"Roanoke, VA",NA,2300,2071,-229,0.47380462136810797
2018,"Rochelle, IL",NA,382,304,-78,0.44314868804664725
2018,"Rochester, MN",NA,1955,1427,-528,0.42193968066233
2018,"Rochester, NY",NA,10467,8089,-2378,0.43592369045052815
2018,"Rock Springs, WY",NA,367,292,-75,0.44309559939301973
2018,"Rockford, IL",NA,3104,2456,-648,0.441726618705036
2018,"Rockingham, NC",NA,291,237,-54,0.44886363636363635
2018,"Rockport, TX",NA,154,474,320,0.7547770700636943
2018,"Rocky Mount, NC",RALEIGH,825,801,-24,0.492619926199262
2018,"Rolla, MO",NA,414,318,-96,0.4344262295081967
2018,"Rome, GA",NA,711,611,-100,0.462178517397882
2018,"Roseburg, OR",NA,889,868,-21,0.4940239043824701
2018,"Roswell, NM",NA,482,332,-150,0.40786240786240785
2018,"Ruidoso, NM",NA,180,120,-60,0.4
2018,"Russellville, AR",NA,656,572,-84,0.46579804560260585
2018,"Ruston, LA",NA,289,231,-58,0.4442307692307692
2018,"Rutland, VT",NA,497,361,-136,0.42074592074592077
2018,"Sacramento-Roseville-Folsom, CA",NA,16760,16774,14,0.500208743364943
2018,"Safford, AZ",NA,325,203,-122,0.38446969696969696
2018,"Saginaw, MI",NA,1890,1423,-467,0.42952007244189555
2018,"Salem, OH",NA,803,654,-149,0.4488675360329444
2018,"Salem, OR",NA,3679,3242,-437,0.46842941771420316
2018,"Salina, KS",NA,591,407,-184,0.40781563126252507
2018,"Salinas, CA",NA,2442,2158,-284,0.4691304347826087
2018,"Salisbury, MD-DE",NA,3735,3072,-663,0.4513001322168356
2018,"Salt Lake City, UT",NA,9301,8298,-1003,0.471504062730837
2018,"San Angelo, TX",NA,897,733,-164,0.44969325153374234
2018,"San Antonio-New Braunfels, TX",NA,18227,18017,-210,0.49710296876724425
2018,"San Diego-Chula Vista-Carlsbad, CA",NA,26428,25806,-622,0.4940460236627484
2018,"San Francisco-Oakland-Berkeley, CA",SAN FRANCISCO,31790,29597,-2193,0.4821379119357519
2018,"San Jose-Sunnyvale-Santa Clara, CA",SAN FRANCISCO,14460,13286,-1174,0.4788437973041159
2018,"San Luis Obispo-Paso Robles, CA",NA,1975,1951,-24,0.49694345389709627
2018,"Sandpoint, ID",NA,372,353,-19,0.4868965517241379
2018,"Sandusky, OH",NA,836,555,-281,0.3989935298346513
2018,"Sanford, NC",RALEIGH,452,532,80,0.540650406504065
2018,"Santa Cruz-Watsonville, CA",NA,1674,1509,-165,0.4740810556079171
2018,"Santa Fe, NM",NA,959,1131,172,0.5411483253588517
2018,"Santa Maria-Santa Barbara, CA",NA,2488,2470,-18,0.4981847519160952
2018,"Santa Rosa-Petaluma, CA",SAN FRANCISCO,3192,3053,-139,0.488871096877502
2018,"Sault Ste. Marie, MI",NA,406,168,-238,0.2926829268292683
2018,"Savannah, GA",NA,3261,3132,-129,0.4899108399812295
2018,"Sayre, PA",NA,588,397,-191,0.4030456852791878
2018,"Scottsbluff, NE",NA,312,248,-64,0.44285714285714284
2018,"Scottsboro, AL",NA,326,301,-25,0.4800637958532695
2018,"Scottsburg, IN",NA,248,213,-35,0.46203904555314534
2018,"Scranton--Wilkes-Barre, PA",NA,4406,3646,-760,0.45280675608544463
2018,"Searcy, AR",NA,561,549,-12,0.4945945945945946
2018,"Seattle-Tacoma-Bellevue, WA",NA,35947,34206,-1741,0.48759140735250095
2018,"Sebastian-Vero Beach, FL",NA,1543,3658,2115,0.7033262834070371
2018,"Sebring-Avon Park, FL",NA,1065,3274,2209,0.7545517400322655
2018,"Sedalia, MO",NA,332,295,-37,0.4704944178628389
2018,"Selinsgrove, PA",NA,216,195,-21,0.4744525547445255
2018,"Selma, AL",NA,179,162,-17,0.4750733137829912
2018,"Seneca Falls, NY",NA,334,226,-108,0.4035714285714286
2018,"Seneca, SC",NA,522,489,-33,0.4836795252225519
2018,"Sevierville, TN",NA,850,776,-74,0.47724477244772445
2018,"Seymour, IN",NA,450,380,-70,0.4578313253012048
2018,"Shawano, WI",NA,345,220,-125,0.3893805309734513
2018,"Shawnee, OK",NA,444,376,-68,0.4585365853658537
2018,"Sheboygan, WI",NA,1045,702,-343,0.4018317115054379
2018,"Shelby, NC",NA,495,487,-8,0.4959266802443992
2018,"Shelbyville, TN",NA,362,306,-56,0.45808383233532934
2018,"Shelton, WA",NA,555,428,-127,0.43540183112919634
2018,"Sheridan, WY",NA,253,175,-78,0.4088785046728972
2018,"Sherman-Denison, TX",NA,1131,1067,-64,0.4854413102820746
2018,"Show Low, AZ",NA,694,581,-113,0.4556862745098039
2018,"Shreveport-Bossier City, LA",NA,2711,2545,-166,0.4842085235920852
2018,"Sidney, OH",NA,377,267,-110,0.41459627329192544
2018,"Sierra Vista-Douglas, AZ",NA,1180,1294,114,0.52303961196443
2018,"Sikeston, MO",NA,395,338,-57,0.461118690313779
2018,"Silver City, NM",NA,199,168,-31,0.45776566757493187
2018,"Sioux City, IA-NE-SD",NA,1337,993,-344,0.42618025751072963
2018,"Sioux Falls, SD",NA,2621,2112,-509,0.4462286076484259
2018,"Snyder, TX",NA,124,89,-35,0.41784037558685444
2018,"Somerset, KY",NA,526,453,-73,0.4627170582226762
2018,"Somerset, PA",NA,466,328,-138,0.41309823677581864
2018,"Sonora, CA",NA,360,352,-8,0.4943820224719101
2018,"South Bend-Mishawaka, IN-MI",NA,3212,2165,-1047,0.4026408778129068
2018,"Spartanburg, SC",NA,1929,2006,77,0.5097839898348158
2018,"Spearfish, SD",NA,278,189,-89,0.40471092077087795
2018,"Spencer, IA",NA,143,109,-34,0.43253968253968256
2018,"Spirit Lake, IA",NA,298,111,-187,0.2713936430317848
2018,"Spokane-Spokane Valley, WA",NA,5000,4562,-438,0.47709684166492367
2018,"Springfield, IL",NA,2092,1632,-460,0.43823845327604727
2018,"Springfield, MA",NA,5851,4728,-1123,0.44692314963607144
2018,"Springfield, MO",NA,4471,3675,-796,0.45114166462067273
2018,"Springfield, OH",NA,920,785,-135,0.4604105571847507
2018,"St. Cloud, MN",NA,1787,1314,-473,0.4237342792647533
2018,"St. George, UT",NA,1254,1582,328,0.5578279266572638
2018,"St. Joseph, MO-KS",NA,899,654,-245,0.4211204121056021
2018,"St. Louis, MO-IL",NA,21403,18885,-2518,0.46875
2018,"St. Marys, GA",NA,527,517,-10,0.4952107279693487
2018,"St. Marys, PA",NA,193,132,-61,0.40615384615384614
2018,"Starkville, MS",NA,348,199,-149,0.36380255941499084
2018,"State College, PA",NA,929,604,-325,0.39399869536855836
2018,"Statesboro, GA",NA,489,425,-64,0.4649890590809628
2018,"Staunton, VA",NA,817,731,-86,0.4722222222222222
2018,"Steamboat Springs, CO",NA,165,234,69,0.5864661654135338
2018,"Stephenville, TX",NA,336,285,-51,0.45893719806763283
2018,"Sterling, CO",NA,131,132,1,0.5019011406844106
2018,"Sterling, IL",NA,610,394,-216,0.39243027888446214
2018,"Stevens Point, WI",NA,561,346,-215,0.3814773980154355
2018,"Stillwater, OK",NA,655,445,-210,0.40454545454545454
2018,"Stockton, CA",NA,4167,4410,243,0.5141657922350472
2018,"Storm Lake, IA",NA,234,150,-84,0.390625
2018,"Sturgis, MI",NA,636,396,-240,0.38372093023255816
2018,"Sulphur Springs, TX",NA,205,216,11,0.5130641330166271
2018,"Summerville, GA",NA,145,133,-12,0.4784172661870504
2018,"Sumter, SC",NA,865,877,12,0.5034443168771527
2018,"Sunbury, PA",NA,690,598,-92,0.4642857142857143
2018,"Susanville, CA",NA,184,179,-5,0.4931129476584022
2018,"Sweetwater, TX",NA,111,106,-5,0.48847926267281105
2018,"Syracuse, NY",NA,6949,4880,-2069,0.4125454391749091
2018,"Tahlequah, OK",NA,328,283,-45,0.46317512274959083
2018,"Talladega-Sylacauga, AL",NA,469,402,-67,0.46153846153846156
2018,"Tallahassee, FL",NA,2489,2491,2,0.5002008032128514
2018,"Tampa-St. Petersburg-Clearwater, FL",NA,32895,45948,13053,0.582778433088543
2018,"Taos, NM",NA,140,190,50,0.5757575757575758
2018,"Taylorville, IL",NA,357,273,-84,0.43333333333333335
2018,"Terre Haute, IN",NA,1619,1268,-351,0.4392102528576377
2018,"Texarkana, TX-AR",NA,1092,929,-163,0.45967342899554675
2018,"The Dalles, OR",NA,228,204,-24,0.4722222222222222
2018,"The Villages, FL",NA,1166,4280,3114,0.7858979067205288
2018,"Thomaston, GA",NA,167,157,-10,0.4845679012345679
2018,"Thomasville, GA",NA,281,289,8,0.5070175438596491
2018,"Tiffin, OH",NA,472,377,-95,0.44405182567726736
2018,"Tifton, GA",NA,208,191,-17,0.47869674185463656
2018,"Toccoa, GA",NA,204,140,-64,0.4069767441860465
2018,"Toledo, OH",NA,5774,4417,-1357,0.4334216465508782
2018,"Topeka, KS",NA,1957,1648,-309,0.45714285714285713
2018,"Torrington, CT",NA,1426,1106,-320,0.4368088467614534
2018,"Traverse City, MI",NA,2092,1183,-909,0.3612213740458015
2018,"Trenton-Princeton, NJ",PHILADELPHIA,2327,2145,-182,0.4796511627906977
2018,"Troy, AL",NA,206,168,-38,0.44919786096256686
2018,"Truckee-Grass Valley, CA",NA,749,804,55,0.5177076625885383
2018,"Tucson, AZ",NA,8897,12201,3304,0.5783012607830126
2018,"Tullahoma-Manchester, TN",NA,726,671,-55,0.48031496062992124
2018,"Tulsa, OK",NA,7239,6896,-343,0.48786699681641316
2018,"Tupelo, MS",NA,1103,927,-176,0.45665024630541873
2018,"Tuscaloosa, AL",NA,1381,1251,-130,0.47530395136778114
2018,"Twin Falls, ID",NA,985,850,-135,0.46321525885558584
2018,"Tyler, TX",NA,1425,1373,-52,0.49070764832022873
2018,"Ukiah, CA",SAN FRANCISCO,521,466,-55,0.47213779128672745
2018,"Union City, TN",NA,308,224,-84,0.42105263157894735
2018,"Union, SC",NA,117,121,4,0.5084033613445378
2018,"Urban Honolulu, HI",NA,8261,6861,-1400,0.4537098267424944
2018,"Urbana, OH",NA,346,286,-60,0.4525316455696203
2018,"Utica-Rome, NY",NA,2677,1908,-769,0.41613958560523445
2018,"Uvalde, TX",NA,164,108,-56,0.39705882352941174
2018,"Valdosta, GA",NA,1084,987,-97,0.4765813616610333
2018,"Vallejo, CA",SAN FRANCISCO,2927,2852,-75,0.49351098806021804
2018,"Van Wert, OH",NA,215,137,-78,0.38920454545454547
2018,"Vermillion, SD",NA,105,50,-55,0.3225806451612903
2018,"Vernal, UT",NA,199,177,-22,0.47074468085106386
2018,"Vernon, TX",NA,99,100,1,0.5025125628140703
2018,"Vicksburg, MS",NA,311,297,-14,0.48848684210526316
2018,"Victoria, TX",NA,567,499,-68,0.46810506566604126
2018,"Vidalia, GA",NA,207,213,6,0.5071428571428571
2018,"Vincennes, IN",NA,344,286,-58,0.45396825396825397
2018,"Vineland-Bridgeton, NJ",PHILADELPHIA,1123,891,-232,0.44240317775571003
2018,"Vineyard Haven, MA",NA,255,63,-192,0.19811320754716982
2018,"Virginia Beach-Norfolk-Newport News, VA-NC",NA,14773,14071,-702,0.487831091388157
2018,"Visalia, CA",FRESNO,2296,2213,-83,0.49079618540696385
2018,"Wabash, IN",NA,235,197,-38,0.45601851851851855
2018,"Waco, TX",NA,1845,1737,-108,0.4849246231155779
2018,"Wahpeton, ND-MN",NA,159,105,-54,0.3977272727272727
2018,"Walla Walla, WA",NA,448,387,-61,0.46347305389221555
2018,"Wapakoneta, OH",NA,320,239,-81,0.4275491949910555
2018,"Warner Robins, GA",NA,1363,1420,57,0.5102407473948976
2018,"Warren, PA",NA,320,196,-124,0.3798449612403101
2018,"Warrensburg, MO",NA,479,349,-130,0.4214975845410628
2018,"Warsaw, IN",NA,846,529,-317,0.38472727272727275
2018,"Washington Court House, OH",NA,260,222,-38,0.4605809128630705
2018,"Washington-Arlington-Alexandria, DC-VA-MD-WV",NA,48712,45843,-2869,0.4848289355401618
2018,"Washington, IN",NA,308,210,-98,0.40540540540540543
2018,"Washington, NC",NA,237,251,14,0.514344262295082
2018,"Waterloo-Cedar Falls, IA",NA,1645,1153,-492,0.41208005718370266
2018,"Watertown-Fort Atkinson, WI",NA,683,506,-177,0.4255677039529016
2018,"Watertown-Fort Drum, NY",NA,1785,901,-884,0.33544303797468356
2018,"Watertown, SD",NA,321,181,-140,0.3605577689243028
2018,"Wauchula, FL",NA,147,351,204,0.7048192771084337
2018,"Wausau-Weston, WI",NA,1394,922,-472,0.39810017271157166
2018,"Waycross, GA",NA,444,370,-74,0.45454545454545453
2018,"Weatherford, OK",NA,267,171,-96,0.3904109589041096
2018,"Weirton-Steubenville, WV-OH",NA,794,595,-199,0.42836573074154066
2018,"Wenatchee, WA",NA,901,776,-125,0.4627310673822302
2018,"West Plains, MO",NA,414,350,-64,0.4581151832460733
2018,"West Point, MS",NA,82,92,10,0.5287356321839081
2018,"Wheeling, WV-OH",NA,948,717,-231,0.4306306306306306
2018,"Whitewater, WI",NA,984,653,-331,0.3989004276114844
2018,"Wichita Falls, TX",NA,2383,1106,-1277,0.3169962740040126
2018,"Wichita, KS",NA,6614,4880,-1734,0.42456934052549156
2018,"Williamsport, PA",NA,1048,838,-210,0.4443266171792153
2018,"Williston, ND",NA,511,391,-120,0.4334811529933481
2018,"Willmar, MN",NA,443,280,-163,0.3872752420470263
2018,"Wilmington, NC",NA,2695,2279,-416,0.4581825492561319
2018,"Wilmington, OH",NA,343,258,-85,0.4292845257903494
2018,"Wilson, NC",RALEIGH,417,413,-4,0.4975903614457831
2018,"Winchester, VA-WV",NA,905,823,-82,0.47627314814814814
2018,"Winfield, KS",NA,342,244,-98,0.41638225255972694
2018,"Winnemucca, NV",NA,192,145,-47,0.43026706231454004
2018,"Winona, MN",NA,390,264,-126,0.4036697247706422
2018,"Winston-Salem, NC",NA,3857,3765,-92,0.4939648386250328
2018,"Wisconsin Rapids-Marshfield, WI",NA,660,426,-234,0.39226519337016574
2018,"Woodward, OK",NA,194,152,-42,0.4393063583815029
2018,"Wooster, OH",NA,820,546,-274,0.39970717423133234
2018,"Worcester, MA-CT",NA,8406,7081,-1325,0.4572221863498418
2018,"Worthington, MN",NA,190,115,-75,0.3770491803278688
2018,"Yakima, WA",NA,1591,1345,-246,0.45810626702997276
2018,"Yankton, SD",NA,231,179,-52,0.43658536585365854
2018,"York-Hanover, PA",NA,3413,3087,-326,0.47492307692307695
2018,"Youngstown-Warren-Boardman, OH-PA",NA,4334,3398,-936,0.43947232281427834
2018,"Yuba City, CA",NA,1120,1245,125,0.5264270613107822
2018,"Yuma, AZ",NA,1139,2816,1677,0.7120101137800253
2018,"Zanesville, OH",NA,761,659,-102,0.4640845070422535
2018,"Zapata, TX",NA,22,48,26,0.6857142857142857
2018,NA,NA,129465,97057,-32408,0.42846610925208145
2019,"Aberdeen, SD",NA,4665,3555,-1110,0.4324817518248175
2019,"Aberdeen, WA",NA,8859,7783,-1076,0.46767215478908786
2019,"Abilene, TX",NA,18868,17009,-1859,0.4740920366808819
2019,"Ada, OK",NA,3594,3441,-153,0.4891257995735608
2019,"Adrian, MI",NA,9467,8242,-1225,0.46541306680219097
2019,"Akron, OH",NA,64229,61720,-2509,0.49003961921095046
2019,"Alamogordo, NM",NA,6648,6444,-204,0.4922089825847846
2019,"Albany-Lebanon, OR",NA,14588,14637,49,0.5008383233532934
2019,"Albany-Schenectady-Troy, NY",NA,91106,85009,-6097,0.48269028759617294
2019,"Albany, GA",NA,13016,12367,-649,0.48721585313004767
2019,"Albemarle, NC",NA,3729,4191,462,0.5291666666666667
2019,"Albert Lea, MN",NA,2937,2730,-207,0.48173636844891476
2019,"Albertville, AL",NA,7825,7276,-549,0.48182239586782333
2019,"Albuquerque, NM",NA,84239,82682,-1557,0.49533611708532777
2019,"Alexander City, AL",NA,3460,2882,-578,0.4544307789340902
2019,"Alexandria, LA",NA,12051,11290,-761,0.4836982134441541
2019,"Alexandria, MN",NA,4753,4278,-475,0.47370169416454433
2019,"Alice, TX",NA,2555,2111,-444,0.4524217745392199
2019,"Allentown-Bethlehem-Easton, PA-NJ",NEW YORK,78244,75167,-3077,0.48997138405981316
2019,"Alma, MI",NA,4149,3335,-814,0.4456173169428113
2019,"Alpena, MI",NA,3479,2902,-577,0.4547876508384266
2019,"Altoona, PA",NA,11235,10126,-1109,0.47404147745892045
2019,"Altus, OK",NA,2450,2151,-299,0.4675070636818083
2019,"Amarillo, TX",NA,26032,23878,-2154,0.4784211580845522
2019,"Americus, GA",NA,2414,2047,-367,0.45886572517372787
2019,"Ames, IA",NA,17390,12890,-4500,0.4256935270805812
2019,"Amsterdam, NY",NA,5896,5351,-545,0.4757713167955899
2019,"Anchorage, AK",NA,42877,40032,-2845,0.48284263469587135
2019,"Andrews, TX",NA,1549,1204,-345,0.43734108245550307
2019,"Angola, IN",NA,4570,3747,-823,0.45052302512925335
2019,"Ann Arbor, MI",NA,41454,33771,-7683,0.4489332003988036
2019,"Anniston-Oxford, AL",NA,10225,9466,-759,0.48072723579300186
2019,"Appleton, WI",NA,23425,20964,-2461,0.47227916826240735
2019,"Arcadia, FL",NA,3626,4888,1262,0.5741132252760159
2019,"Ardmore, OK",NA,5829,5091,-738,0.4662087912087912
2019,"Arkadelphia, AR",NA,2359,1856,-503,0.44033214709371293
2019,"Asheville, NC",NA,48162,49481,1319,0.5067541964093688
2019,"Ashland, OH",NA,4248,3903,-345,0.47883695252116304
2019,"Ashtabula, OH",NA,9483,8677,-806,0.47780837004405285
2019,"Astoria, OR",NA,5499,5192,-307,0.4856421288934618
2019,"Atchison, KS",NA,1589,1362,-227,0.46153846153846156
2019,"Athens-Clarke County, GA",NA,18632,16503,-2129,0.4697025757791376
2019,"Athens, OH",NA,6215,4934,-1281,0.4425509014261369
2019,"Athens, TN",NA,4705,4938,233,0.5120813024992222
2019,"Athens, TX",NA,8663,8858,195,0.5055647508703841
2019,"Atlanta-Sandy Springs-Alpharetta, GA",NA,600363,600167,-196,0.49991836938685413
2019,"Atlantic City-Hammonton, NJ",PHILADELPHIA,25297,25185,-112,0.4988906937126104
2019,"Atmore, AL",NA,2598,2335,-263,0.47334279343198865
2019,"Auburn-Opelika, AL",NA,14210,13056,-1154,0.47883811340130567
2019,"Auburn, IN",NA,4575,4005,-570,0.46678321678321677
2019,"Auburn, NY",NA,8013,7134,-879,0.4709843533372945
2019,"Augusta-Richmond County, GA-SC",NA,55355,54204,-1151,0.4947471225549704
2019,"Augusta-Waterville, ME",NA,13870,13240,-630,0.4883806713389893
2019,"Austin-Round Rock-Georgetown, TX",NA,258461,269343,10882,0.510308750975741
2019,"Austin, MN",NA,3812,3456,-356,0.4755090809025867
2019,"Bainbridge, GA",NA,2258,2045,-213,0.4752498257029979
2019,"Bakersfield, CA",NA,70235,66499,-3736,0.4863384381353577
2019,"Baltimore-Columbia-Towson, MD",NA,271934,260138,-11796,0.4889150340555414
2019,"Bangor, ME",NA,18132,16231,-1901,0.47233943485725927
2019,"Baraboo, WI",NA,6890,6282,-608,0.47692074096568476
2019,"Bardstown, KY",NA,4433,4009,-424,0.4748874674247809
2019,"Barnstable Town, MA",NA,31806,32299,493,0.5038452538803525
2019,"Barre, VT",NA,6744,6269,-475,0.48174902021055865
2019,"Bartlesville, OK",NA,4747,4571,-176,0.4905559132861129
2019,"Batavia, NY",NA,5165,4592,-573,0.47063646612688326
2019,"Batesville, AR",NA,5448,5189,-259,0.48782551471279495
2019,"Baton Rouge, LA",NA,60234,57470,-2764,0.488258682797526
2019,"Battle Creek, MI",NA,16902,14195,-2707,0.45647490111586325
2019,"Bay City, MI",NA,10124,9143,-981,0.4745419629418176
2019,"Bay City, TX",HOUSTON,3331,2701,-630,0.4477785145888594
2019,"Beatrice, NE",NA,2378,1851,-527,0.437692125798061
2019,"Beaumont-Port Arthur, TX",NA,33379,30316,-3063,0.47595572650914514
2019,"Beaver Dam, WI",NA,8305,7489,-816,0.4741674053438014
2019,"Beckley, WV",NA,5914,5324,-590,0.47374977754048764
2019,"Bedford, IN",NA,4969,4285,-684,0.46304300842878754
2019,"Beeville, TX",NA,1846,1734,-112,0.48435754189944136
2019,"Bellefontaine, OH",NA,4446,4080,-366,0.47853624208304013
2019,"Bellingham, WA",NA,25646,25081,-565,0.49443097364322747
2019,"Bemidji, MN",NA,4703,4130,-573,0.46756481376655723
2019,"Bend, OR",NA,26808,28142,1334,0.5121383075523203
2019,"Bennettsville, SC",NA,1687,1462,-225,0.4642743728167672
2019,"Bennington, VT",NA,3887,3272,-615,0.45704707361363317
2019,"Berlin, NH",NA,4183,3621,-562,0.4639928241927217
2019,"Big Rapids, MI",NA,5203,4569,-634,0.46756037658616456
2019,"Big Spring, TX",NA,2681,2377,-304,0.46994859628311586
2019,"Big Stone Gap, VA",NA,2959,2398,-561,0.44763860369609854
2019,"Billings, MT",NA,24078,20666,-3412,0.4618719828356875
2019,"Binghamton, NY",NA,27043,24097,-2946,0.47119671490027376
2019,"Birmingham-Hoover, AL",NA,90361,87112,-3249,0.4908464949597967
2019,"Bismarck, ND",NA,15599,12290,-3309,0.44067553515723046
2019,"Blackfoot, ID",NA,3832,3405,-427,0.47049882548017136
2019,"Blacksburg-Christiansburg, VA",NA,17752,13801,-3951,0.43739105631794123
2019,"Bloomington, IL",NA,17099,15532,-1567,0.4759890901290184
2019,"Bloomington, IN",NA,29149,16184,-12965,0.35700262501930163
2019,"Bloomsburg-Berwick, PA",NA,7653,6954,-699,0.4760731156294927
2019,"Bluefield, WV-VA",NA,7419,6455,-964,0.46525875738791983
2019,"Blytheville, AR",NA,4026,3315,-711,0.45157335512872904
2019,"Bogalusa, LA",NA,3388,2877,-511,0.4592178770949721
2019,"Boise City, ID",NA,83118,83631,513,0.501538240109386
2019,"Bonham, TX",NA,2582,2511,-71,0.49302964853720793
2019,"Boone, NC",NA,5167,4369,-798,0.4581585570469799
2019,"Borger, TX",NA,1860,1552,-308,0.4548651817116061
2019,"Boston-Cambridge-Newton, MA-NH",NA,467281,436163,-31118,0.48277812459875763
2019,"Boulder, CO",NA,46263,41815,-4448,0.47474965371602446
2019,"Bowling Green, KY",NA,17804,17471,-333,0.49527994330262226
2019,"Bozeman, MT",NA,18340,16453,-1887,0.4728824763601874
2019,"Bradford, PA",NA,4261,3699,-562,0.46469849246231154
2019,"Brainerd, MN",NA,13409,12370,-1039,0.4798479382443074
2019,"Branson, MO",NA,8738,7543,-1195,0.46330078005036546
2019,"Breckenridge, CO",NA,4236,3925,-311,0.48094596250459504
2019,"Bremerton-Silverdale-Port Orchard, WA",NA,31908,28675,-3233,0.4733175973457901
2019,"Brenham, TX",HOUSTON,2613,2586,-27,0.49740334679746107
2019,"Brevard, NC",NA,2874,3223,349,0.528620633098245
2019,"Bridgeport-Stamford-Norwalk, CT",NEW YORK,77430,76006,-1424,0.4953596287703016
2019,"Brookhaven, MS",NA,1841,1698,-143,0.4797965526985024
2019,"Brookings, OR",NA,2808,2993,185,0.515945526633339
2019,"Brookings, SD",NA,3978,2981,-997,0.42836614456100014
2019,"Brownsville-Harlingen, TX",NA,18106,21479,3373,0.5426045219148667
2019,"Brownsville, TN",NA,1305,1269,-36,0.493006993006993
2019,"Brownwood, TX",NA,3632,3727,95,0.5064546813425738
2019,"Brunswick, GA",NA,12239,11494,-745,0.4843045548392534
2019,"Bucyrus-Galion, OH",NA,4483,3956,-527,0.4687759213176917
2019,"Buffalo-Cheektowaga, NY",NA,107456,101727,-5729,0.4863062485957272
2019,"Burley, ID",NA,3447,3297,-150,0.4888790035587189
2019,"Burlington-South Burlington, VT",NA,29826,25355,-4471,0.4594878672006669
2019,"Burlington, IA-IL",NA,6193,4172,-2021,0.40250844187168355
2019,"Burlington, NC",NA,12950,14235,1285,0.5236343571822696
2019,"Butte-Silver Bow, MT",NA,3790,3332,-458,0.4678461106430778
2019,"Cadillac, MI",NA,5938,5299,-639,0.4715671442555842
2019,"Calhoun, GA",NA,4580,4669,89,0.5048113309546978
2019,"California-Lexington Park, MD",NA,8833,8938,105,0.5029542513083113
2019,"Cambridge, MD",NA,2975,2763,-212,0.48152666434297664
2019,"Cambridge, OH",NA,3823,3198,-625,0.45549067084460904
2019,"Camden, AR",NA,1923,1715,-208,0.471412864211105
2019,"Campbellsville, KY",NA,3819,3196,-623,0.4555951532430506
2019,"Ca√±on City, CO",NA,5155,4578,-577,0.4703585739237645
2019,"Canton-Massillon, OH",NA,36211,33406,-2805,0.4798540586351035
2019,"Cape Coral-Fort Myers, FL",NA,148497,150422,1925,0.5032199358354604
2019,"Cape Girardeau, MO-IL",NA,10232,8769,-1463,0.4615020262091469
2019,"Carbondale-Marion, IL",NA,16184,12587,-3597,0.43748913836849607
2019,"Carlsbad-Artesia, NM",NA,4800,4154,-646,0.4639267366540094
2019,"Carroll, IA",NA,1949,1662,-287,0.4602603157020216
2019,"Carson City, NV",NA,6871,6650,-221,0.49182752754973746
2019,"Casper, WY",NA,9153,8934,-219,0.49394592801459614
2019,"Cedar City, UT",NA,4998,4948,-50,0.4974864267042027
2019,"Cedar Rapids, IA",NA,34228,28501,-5727,0.4543512569943726
2019,"Cedartown, GA",NA,4208,3673,-535,0.46605760690267733
2019,"Celina, OH",NA,2916,2528,-388,0.46436443791329907
2019,"Central City, KY",NA,2484,2286,-198,0.47924528301886793
2019,"Centralia, IL",NA,4184,3515,-669,0.4565527990648136
2019,"Centralia, WA",NA,7761,7718,-43,0.4986110213838103
2019,"Chambersburg-Waynesboro, PA",NA,12637,11667,-970,0.4800444371296906
2019,"Champaign-Urbana, IL",NA,26106,22021,-4085,0.4575602052901698
2019,"Charleston-Mattoon, IL",NA,6753,5807,-946,0.4623407643312102
2019,"Charleston-North Charleston, SC",NA,88248,86935,-1313,0.4962524902530497
2019,"Charleston, WV",NA,17974,15581,-2393,0.46434212486961707
2019,"Charlotte-Concord-Gastonia, NC-SC",NA,250683,261687,11004,0.5107383336260906
2019,"Charlottesville, VA",NA,22118,20574,-1544,0.48191698678909395
2019,"Chattanooga, TN-GA",NA,53340,52204,-1136,0.49461835822026834
2019,"Cheyenne, WY",NA,12200,11622,-578,0.487868356980942
2019,"Chicago-Naperville-Elgin, IL-IN-WI",CHICAGO,838128,779623,-58505,0.4819177982272921
2019,"Chico, CA",NA,44590,24118,-20472,0.3510217150841241
2019,"Chillicothe, OH",NA,6689,5981,-708,0.4720599842146804
2019,"Cincinnati, OH-KY-IN",NA,199124,194412,-4712,0.4940132541876728
2019,"Clarksburg, WV",NA,6451,5639,-812,0.4664185277088503
2019,"Clarksdale, MS",NA,1696,1363,-333,0.44557044785877736
2019,"Clarksville, TN-KY",NA,40112,36630,-3482,0.47731359620546765
2019,"Clearlake, CA",NA,5939,5259,-680,0.46963743525629575
2019,"Cleveland-Elyria, OH",NA,187405,180902,-6503,0.4911717670313081
2019,"Cleveland, MS",NA,1645,1279,-366,0.4374145006839945
2019,"Cleveland, TN",NA,11530,11385,-145,0.4968361335369845
2019,"Clewiston, FL",NA,3462,3899,437,0.5296834669202554
2019,"Clinton, IA",NA,5257,3928,-1329,0.4276537833424061
2019,"Clovis, NM",NA,5618,5175,-443,0.47947743908088575
2019,"Coeur d'Alene, ID",NA,21303,22631,1328,0.5151135794600993
2019,"Coffeyville, KS",NA,4331,3195,-1136,0.42452830188679247
2019,"Coldwater, MI",NA,5102,4387,-715,0.46232479713352304
2019,"College Station-Bryan, TX",NA,28108,23669,-4439,0.45713347625393513
2019,"Colorado Springs, CO",NA,103678,97590,-6088,0.48487588687719857
2019,"Columbia, MO",NA,25173,21279,-3894,0.4580857659519504
2019,"Columbia, SC",NA,72792,71406,-1386,0.4951941081013606
2019,"Columbus, GA-AL",NA,32643,30336,-2307,0.48168437098080313
2019,"Columbus, IN",NA,9409,8140,-1269,0.4638440936805516
2019,"Columbus, MS",NA,5196,4840,-356,0.4822638501394978
2019,"Columbus, NE",NA,3632,2942,-690,0.44752053544265286
2019,"Columbus, OH",NA,220928,211742,-9186,0.4893845193796658
2019,"Concord, NH",NA,15222,14360,-862,0.48543032925427626
2019,"Connersville, IN",NA,3276,2428,-848,0.42566619915848525
2019,"Cookeville, TN",NA,10746,10869,123,0.5028452463566967
2019,"Coos Bay, OR",NA,8711,7832,-879,0.473432871909569
2019,"Cordele, GA",NA,1827,1724,-103,0.4854970430864545
2019,"Corinth, MS",NA,2700,2711,11,0.5010164479763445
2019,"Cornelia, GA",NA,3298,3237,-61,0.4953328232593726
2019,"Corning, NY",NA,11099,9605,-1494,0.4639200154559505
2019,"Corpus Christi, TX",NA,38148,37526,-622,0.4958902661416074
2019,"Corsicana, TX",NA,3364,3615,251,0.517982518985528
2019,"Cortland, NY",NA,5119,4756,-363,0.481620253164557
2019,"Corvallis, OR",NA,11400,8896,-2504,0.4383129680725266
2019,"Coshocton, OH",NA,3242,3187,-55,0.49572250738839635
2019,"Craig, CO",NA,1579,1297,-282,0.45097357440890123
2019,"Crawfordsville, IN",NA,4379,3890,-489,0.47043173297859475
2019,"Crescent City, CA",NA,2317,2393,76,0.508067940552017
2019,"Crestview-Fort Walton Beach-Destin, FL",NA,38404,43266,4862,0.5297661319946124
2019,"Crossville, TN",NA,6085,6248,163,0.5066082867104517
2019,"Cullman, AL",NA,6113,6620,507,0.5199088981386947
2019,"Cullowhee, NC",NA,5306,5193,-113,0.49461853509858084
2019,"Cumberland, MD-WV",NA,7470,6362,-1108,0.4599479467900521
2019,"Dallas-Fort Worth-Arlington, TX",NA,746165,753444,7279,0.5024269659624608
2019,"Dalton, GA",NA,10333,8960,-1373,0.4644171461151713
2019,"Danville, IL",NA,8910,7474,-1436,0.4561767578125
2019,"Danville, KY",NA,5325,5163,-162,0.49227688787185353
2019,"Danville, VA",NA,7739,7031,-708,0.4760324983073798
2019,"Daphne-Fairhope-Foley, AL",NA,24268,27665,3397,0.5327056014480196
2019,"Davenport-Moline-Rock Island, IA-IL",NA,43940,36123,-7817,0.4511821940222075
2019,"Dayton-Kettering, OH",NA,80340,76804,-3536,0.4887491727332892
2019,"Dayton, TN",NA,2942,2983,41,0.5034599156118144
2019,"Decatur, AL",NA,11955,11161,-794,0.48282574839937703
2019,"Decatur, IL",NA,13921,10188,-3733,0.4225807789622133
2019,"Decatur, IN",NA,2815,2478,-337,0.4681655016058946
2019,"Defiance, OH",NA,3806,3213,-593,0.457757515315572
2019,"Del Rio, TX",NA,3482,3072,-410,0.46872139151663106
2019,"Deltona-Daytona Beach-Ormond Beach, FL",NA,89772,93158,3386,0.5092549062482917
2019,"Deming, NM",NA,2163,2101,-62,0.4927298311444653
2019,"Denver-Aurora-Lakewood, CO",NA,376829,366248,-10581,0.49288028024013664
2019,"DeRidder, LA",NA,3011,2866,-145,0.4876637740343713
2019,"Des Moines-West Des Moines, IA",NA,81020,76011,-5009,0.4840509198820615
2019,"Detroit-Warren-Dearborn, MI",NA,395004,367801,-27203,0.48216909957328546
2019,"Dickinson, ND",NA,3983,3637,-346,0.4772965879265092
2019,"Dixon, IL",NA,3345,2722,-623,0.44865666721608705
2019,"Dodge City, KS",NA,3906,2530,-1376,0.3931013051584835
2019,"Dothan, AL",NA,14504,14128,-376,0.49343392008941045
2019,"Douglas, GA",NA,4033,3383,-650,0.45617583603020495
2019,"Dover, DE",PHILADELPHIA,15140,15717,577,0.5093495803221311
2019,"Dublin, GA",NA,4759,4536,-223,0.48800430338891876
2019,"DuBois, PA",NA,5138,4568,-570,0.4706367195549145
2019,"Dubuque, IA",NA,9308,8289,-1019,0.47104620105699835
2019,"Duluth, MN-WI",NA,32006,28380,-3626,0.4699764846156394
2019,"Dumas, TX",NA,1954,1265,-689,0.3929791860826344
2019,"Duncan, OK",NA,4907,3956,-951,0.4463499943585693
2019,"Durango, CO",NA,7490,7316,-174,0.49412400378225046
2019,"Durant, OK",NA,5168,4556,-612,0.46853146853146854
2019,"Durham-Chapel Hill, NC",RALEIGH,59288,58340,-948,0.4959703471962458
2019,"Dyersburg, TN",NA,4094,3536,-558,0.46343381389252947
2019,"Eagle Pass, TX",NA,1984,1978,-6,0.49924280666330134
2019,"East Stroudsburg, PA",NA,14723,13352,-1371,0.4755832591273375
2019,"Easton, MD",NA,2874,3050,176,0.5148548278190412
2019,"Eau Claire, WI",NA,20778,16994,-3784,0.4499099862331886
2019,"Edwards, CO",NA,5763,4212,-1551,0.4222556390977444
2019,"Effingham, IL",NA,3084,2773,-311,0.4734505719651699
2019,"El Campo, TX",HOUSTON,2996,2565,-431,0.4612479769825571
2019,"El Centro, CA",NA,10998,11367,369,0.5082494969818914
2019,"El Dorado, AR",NA,3110,2628,-482,0.45799930289299406
2019,"El Paso, TX",NA,61163,56954,-4209,0.48218292032476273
2019,"Elizabeth City, NC",NA,4139,4209,70,0.5041926209870627
2019,"Elizabethtown-Fort Knox, KY",NA,18436,16759,-1677,0.4761755931240233
2019,"Elk City, OK",NA,2297,1743,-554,0.43143564356435643
2019,"Elkhart-Goshen, IN",NA,21783,18163,-3620,0.45468882992039256
2019,"Elkins, WV",NA,2115,1709,-406,0.4469142259414226
2019,"Elko, NV",NA,5840,4649,-1191,0.44322623701020114
2019,"Ellensburg, WA",NA,6258,5307,-951,0.45888456549935147
2019,"Elmira, NY",NA,9353,8632,-721,0.4799555184876286
2019,"Emporia, KS",NA,5583,3334,-2249,0.37389256476393407
2019,"Enid, OK",NA,6337,5063,-1274,0.44412280701754386
2019,"Enterprise, AL",NA,5301,4867,-434,0.47865853658536583
2019,"Erie, PA",NA,26710,23563,-3147,0.46870089312354546
2019,"Escanaba, MI",NA,3708,3363,-345,0.4756045820958846
2019,"Espa√±ola, NM",NA,872,765,-107,0.46731826511912034
2019,"Eufaula, AL-GA",NA,1611,1544,-67,0.48938193343898573
2019,"Eugene-Springfield, OR",NA,49937,45231,-4706,0.4752753026227303
2019,"Eureka-Arcata, CA",NA,14045,11809,-2236,0.4567571749052371
2019,"Evanston, WY",NA,2251,1725,-526,0.43385311871227367
2019,"Evansville, IN-KY",NA,34802,31262,-3540,0.47320779849842576
2019,"Fairbanks, AK",NA,11423,9095,-2328,0.4432693244955649
2019,"Fairfield, IA",NA,1977,1741,-236,0.4682625067240452
2019,"Fairmont, MN",NA,2018,1620,-398,0.44529961517317207
2019,"Fairmont, WV",NA,4124,3610,-514,0.46677010602534263
2019,"Fallon, NV",NA,2846,2768,-78,0.49305308158175987
2019,"Fargo, ND-MN",NA,37466,29189,-8277,0.4379116345360438
2019,"Faribault-Northfield, MN",NA,6152,5656,-496,0.47899728997289975
2019,"Farmington, MO",NA,6882,6752,-130,0.4952325069678744
2019,"Farmington, NM",NA,8490,7307,-1183,0.4625561815534595
2019,"Fayetteville-Springdale-Rogers, AR",NA,57540,54916,-2624,0.48833321476844277
2019,"Fayetteville, NC",RALEIGH,60094,53075,-7019,0.46898885737260204
2019,"Fergus Falls, MN",NA,6436,6064,-372,0.48512
2019,"Fernley, NV",NA,6843,6559,-284,0.48940456648261454
2019,"Findlay, OH",NA,7055,6145,-910,0.465530303030303
2019,"Fitzgerald, GA",NA,1629,1620,-9,0.4986149584487535
2019,"Flagstaff, AZ",NA,15295,13206,-2089,0.4633521630819971
2019,"Flint, MI",NA,49015,43776,-5239,0.4717698914765441
2019,"Florence-Muscle Shoals, AL",NA,12497,12271,-226,0.495437661498708
2019,"Florence, SC",NA,14317,14115,-202,0.49644766460326395
2019,"Fond du Lac, WI",NA,9603,8493,-1110,0.46933023872679047
2019,"Forest City, NC",NA,5021,5295,274,0.5132803412175262
2019,"Forrest City, AR",NA,1351,1189,-162,0.46811023622047243
2019,"Fort Collins, CO",NA,46818,44131,-2687,0.4852279849146225
2019,"Fort Dodge, IA",NA,4181,3290,-891,0.44036942845669924
2019,"Fort Leonard Wood, MO",NA,7317,6354,-963,0.4647794601711652
2019,"Fort Madison-Keokuk, IA-IL-MO",NA,6158,4862,-1296,0.4411978221415608
2019,"Fort Morgan, CO",NA,2528,2434,-94,0.490528012898025
2019,"Fort Payne, AL",NA,5012,4211,-801,0.4565759514257834
2019,"Fort Polk South, LA",NA,5383,4528,-855,0.4568661083644435
2019,"Fort Smith, AR-OK",NA,28547,23658,-4889,0.45317498323915334
2019,"Fort Wayne, IN",NA,46953,41274,-5679,0.46781597470162195
2019,"Frankfort, IN",NA,3078,2721,-357,0.4692188308329022
2019,"Frankfort, KY",NA,8011,8057,46,0.5014314164799601
2019,"Fredericksburg, TX",NA,2595,2770,175,0.516309412861137
2019,"Freeport, IL",NA,4518,3768,-750,0.4547429398986242
2019,"Fremont, NE",NA,4526,3613,-913,0.4439120285047303
2019,"Fremont, OH",NA,4108,3867,-241,0.48489028213166147
2019,"Fresno, CA",FRESNO,73278,68146,-5132,0.48185597918316553
2019,"Gadsden, AL",NA,8166,8010,-156,0.4951780415430267
2019,"Gaffney, SC",NA,3842,3190,-652,0.4536405005688282
2019,"Gainesville, FL",NA,35653,33730,-1923,0.48614213856420163
2019,"Gainesville, GA",NA,15037,15638,601,0.5097962510187449
2019,"Gainesville, TX",NA,4291,3340,-951,0.4376883763595859
2019,"Galesburg, IL",NA,5542,4465,-1077,0.44618766863195763
2019,"Gallup, NM",NA,2121,1449,-672,0.40588235294117647
2019,"Garden City, KS",NA,4527,3317,-1210,0.4228709841917389
2019,"Gardnerville Ranchos, NV",NA,5255,5333,78,0.5036834151870041
2019,"Georgetown, SC",NA,4211,4213,2,0.5001187084520418
2019,"Gettysburg, PA",NA,7577,6901,-676,0.4766542340102224
2019,"Gillette, WY",NA,6318,6059,-259,0.4895370445180577
2019,"Glasgow, KY",NA,5099,5091,-8,0.4996074582924436
2019,"Glens Falls, NY",NA,14236,13383,-853,0.48455773199608965
2019,"Glenwood Springs, CO",NA,10930,9799,-1131,0.4727193786482705
2019,"Gloversville, NY",NA,6348,5489,-859,0.4637154684463969
2019,"Goldsboro, NC",RALEIGH,10350,9810,-540,0.48660714285714285
2019,"Granbury, TX",NA,5713,6799,1086,0.5433983375959079
2019,"Grand Forks, ND-MN",NA,14199,10055,-4144,0.4145707924466068
2019,"Grand Island, NE",NA,9020,6823,-2197,0.4306633844600139
2019,"Grand Junction, CO",NA,21596,19482,-2114,0.4742684648717075
2019,"Grand Rapids-Kentwood, MI",NA,118962,102272,-16690,0.46227975808420046
2019,"Grand Rapids, MN",NA,4209,4130,-79,0.4952632210097134
2019,"Grants Pass, OR",NA,8799,9394,595,0.5163524432474028
2019,"Grants, NM",NA,899,754,-145,0.45614035087719296
2019,"Great Bend, KS",NA,2919,2373,-546,0.44841269841269843
2019,"Great Falls, MT",NA,10345,9026,-1319,0.46595426152496
2019,"Greeley, CO",NA,32184,33887,1703,0.5128876511631427
2019,"Green Bay, WI",NA,37081,31489,-5592,0.4592241505031355
2019,"Greeneville, TN",NA,4939,5308,369,0.5180052698350737
2019,"Greensboro-High Point, NC",NA,71924,65664,-6260,0.47725092304561445
2019,"Greensburg, IN",NA,3363,2772,-591,0.45183374083129585
2019,"Greenville-Anderson, SC",NA,83213,82918,-295,0.4991121464386538
2019,"Greenville, MS",NA,3273,3081,-192,0.48489140698772426
2019,"Greenville, NC",NA,15787,14872,-915,0.4850777911869272
2019,"Greenville, OH",NA,4721,4264,-457,0.47456872565386754
2019,"Greenwood, MS",NA,2284,2001,-283,0.46697782963827306
2019,"Greenwood, SC",NA,4993,4713,-280,0.48557593241294045
2019,"Grenada, MS",NA,1812,1430,-382,0.44108574953732266
2019,"Gulfport-Biloxi, MS",NA,42861,39387,-3474,0.4788809454333236
2019,"Guymon, OK",NA,1646,1073,-573,0.3946303788157411
2019,"Hagerstown-Martinsburg, MD-WV",NA,27075,26711,-364,0.4966162198341576
2019,"Hailey, ID",NA,2569,2536,-33,0.49676787463271305
2019,"Hammond, LA",NA,8345,8985,640,0.518465089440277
2019,"Hanford-Corcoran, CA",FRESNO,11153,9846,-1307,0.46887947045097383
2019,"Hannibal, MO",NA,4376,3548,-828,0.447753659767794
2019,"Harrisburg-Carlisle, PA",NA,59167,57400,-1767,0.4924206679420419
2019,"Harrison, AR",NA,3854,3803,-51,0.4966697139872013
2019,"Harrisonburg, VA",NA,11138,10133,-1005,0.4763762869634714
2019,"Hartford-East Hartford-Middletown, CT",NA,115144,110453,-4691,0.48960314188575205
2019,"Hastings, NE",NA,3657,2687,-970,0.4235498108448928
2019,"Hattiesburg, MS",NA,15286,13492,-1794,0.46883035652234345
2019,"Hays, KS",NA,3465,2876,-589,0.4535562214161804
2019,"Heber, UT",NA,7985,8410,425,0.5129612686794754
2019,"Helena-West Helena, AR",NA,1488,1216,-272,0.44970414201183434
2019,"Helena, MT",NA,9545,9138,-407,0.4891077450088316
2019,"Henderson, NC",RALEIGH,3810,2870,-940,0.4296407185628742
2019,"Hereford, TX",NA,1285,949,-336,0.42479856759176365
2019,"Hermiston-Pendleton, OR",NA,8512,7354,-1158,0.46350687003655616
2019,"Hickory-Lenoir-Morganton, NC",NA,25144,25190,46,0.5004569475900982
2019,"Hillsdale, MI",NA,4507,4137,-370,0.4785978713558538
2019,"Hilo, HI",NA,16761,16285,-476,0.4927979180536222
2019,"Hilton Head Island-Bluffton, SC",NA,23418,24921,1503,0.5155464531744554
2019,"Hinesville, GA",NA,10837,9475,-1362,0.46647302087436
2019,"Hobbs, NM",NA,4889,4385,-504,0.4728272590036662
2019,"Holland, MI",NA,10108,9778,-330,0.4917027054208991
2019,"Homosassa Springs, FL",NA,22272,24034,1762,0.5190256122316762
2019,"Hood River, OR",NA,2411,2169,-242,0.47358078602620085
2019,"Hope, AR",NA,1924,1521,-403,0.44150943396226416
2019,"Hot Springs, AR",NA,12912,12016,-896,0.4820282413350449
2019,"Houghton, MI",NA,4151,3375,-776,0.44844538931703426
2019,"Houma-Thibodaux, LA",NA,13200,12133,-1067,0.47894051237516283
2019,"Houston-The Woodlands-Sugar Land, TX",HOUSTON,565272,570572,5300,0.5023330668648159
2019,"Hudson, NY",NA,4685,4390,-295,0.4837465564738292
2019,"Huntingdon, PA",NA,2710,2530,-180,0.48282442748091603
2019,"Huntington-Ashland, WV-KY-OH",NA,26508,23908,-2600,0.4742145350682323
2019,"Huntington, IN",NA,4419,3820,-599,0.4636485010316786
2019,"Huntsville, AL",NA,43441,46112,2671,0.5149129565732025
2019,"Huntsville, TX",HOUSTON,5168,4751,-417,0.4789797358604698
2019,"Huron, SD",NA,2217,1868,-349,0.4572827417380661
2019,"Hutchinson, KS",NA,8048,6543,-1505,0.4484271126036598
2019,"Hutchinson, MN",NA,3738,3290,-448,0.4681274900398406
2019,"Idaho Falls, ID",NA,14224,14247,23,0.5004039197780198
2019,"Indiana, PA",NA,6020,5413,-607,0.4734540365608327
2019,"Indianapolis-Carmel-Anderson, IN",NA,243724,231479,-12245,0.4871160325166297
2019,"Indianola, MS",NA,1148,1039,-109,0.4750800182898948
2019,"Iowa City, IA",NA,22500,18620,-3880,0.45282101167315175
2019,"Iron Mountain, MI-WI",NA,3153,2789,-364,0.4693705822955234
2019,"Ithaca, NY",NA,12518,10048,-2470,0.4452716476114509
2019,"Jackson, MI",NA,17208,15140,-2068,0.468035118090763
2019,"Jackson, MS",NA,44294,41533,-2761,0.4839153180234658
2019,"Jackson, OH",NA,2675,2556,-119,0.4886255018160964
2019,"Jackson, TN",NA,17173,16821,-352,0.4948226157557216
2019,"Jackson, WY-ID",NA,3976,3713,-263,0.48289764598777474
2019,"Jacksonville, FL",NA,181879,191003,9124,0.5122344334132514
2019,"Jacksonville, IL",NA,3582,3296,-286,0.47920907240476884
2019,"Jacksonville, NC",NA,27626,23618,-4008,0.4608929825930841
2019,"Jacksonville, TX",NA,2943,2747,-196,0.4827768014059754
2019,"Jamestown-Dunkirk-Fredonia, NY",NA,15842,14489,-1353,0.4776960865121493
2019,"Jamestown, ND",NA,2069,1755,-314,0.45894351464435146
2019,"Janesville-Beloit, WI",NA,18396,16048,-2348,0.4659156892346998
2019,"Jasper, AL",NA,4361,4195,-166,0.4902992052360916
2019,"Jasper, IN",NA,4645,4197,-448,0.4746663650757747
2019,"Jefferson City, MO",NA,13175,12259,-916,0.48199260831957225
2019,"Jefferson, GA",NA,5787,6987,1200,0.5469704086425552
2019,"Jennings, LA",NA,2077,1856,-221,0.47190439867785405
2019,"Jesup, GA",NA,2906,2393,-513,0.4515946404982072
2019,"Johnson City, TN",NA,18804,18614,-190,0.49746111497140416
2019,"Johnstown, PA",NA,9796,8692,-1104,0.4701427953266984
2019,"Jonesboro, AR",NA,15603,13220,-2383,0.4586614856191236
2019,"Joplin, MO",NA,20187,18162,-2025,0.47359774700774465
2019,"Juneau, AK",NA,2959,2716,-243,0.47859030837004407
2019,"Kahului-Wailuku-Lahaina, HI",NA,18021,16175,-1846,0.47300853901041057
2019,"Kalamazoo-Portage, MI",NA,32060,26599,-5461,0.453451303295317
2019,"Kalispell, MT",NA,13435,14105,670,0.5121641249092229
2019,"Kankakee, IL",CHICAGO,12444,9664,-2780,0.4371268319160485
2019,"Kansas City, MO-KS",NA,220780,216230,-4550,0.4947941694698062
2019,"Kapaa, HI",NA,6230,4927,-1303,0.4416061665322219
2019,"Kearney, NE",NA,6489,5182,-1307,0.44400651186702084
2019,"Keene, NH",NA,8228,7806,-422,0.4868404640139703
2019,"Kendallville, IN",NA,4648,4035,-613,0.46470114015893127
2019,"Kennett, MO",NA,3494,2939,-555,0.4568630498989585
2019,"Kennewick-Richland, WA",NA,28406,27787,-619,0.4944921965369352
2019,"Kerrville, TX",NA,5323,5146,-177,0.491546470532047
2019,"Ketchikan, AK",NA,1662,1595,-67,0.4897144611605772
2019,"Key West, FL",NA,16909,16498,-411,0.4938485946059209
2019,"Kill Devil Hills, NC",NA,3885,3864,-21,0.4986449864498645
2019,"Killeen-Temple, TX",NA,64749,57102,-7647,0.4686215131595145
2019,"Kingsport-Bristol, TN-VA",NA,25682,25850,168,0.5016300551113871
2019,"Kingston, NY",NEW YORK,15064,13954,-1110,0.48087394031290925
2019,"Kingsville, TX",NA,2920,2300,-620,0.44061302681992337
2019,"Kinston, NC",NA,4458,3758,-700,0.4574001947419669
2019,"Kirksville, MO",NA,3992,2838,-1154,0.41551976573938504
2019,"Klamath Falls, OR",NA,6781,6895,114,0.5041678853465926
2019,"Knoxville, TN",NA,82362,81965,-397,0.49879204269535743
2019,"Kokomo, IN",NA,11839,8981,-2858,0.4313640730067243
2019,"La Crosse-Onalaska, WI-MN",NA,15644,13402,-2242,0.4614060455828686
2019,"La Grande, OR",NA,3426,2594,-832,0.43089700996677743
2019,"Laconia, NH",NA,8082,8112,30,0.5009262689885142
2019,"Lafayette-West Lafayette, IN",NA,30252,21221,-9031,0.4122743962854312
2019,"Lafayette, LA",NA,36046,34134,-1912,0.4863778854374466
2019,"LaGrange, GA-AL",NA,8437,8003,-434,0.48680048661800485
2019,"Lake Charles, LA",NA,19234,17296,-1938,0.47347385710375034
2019,"Lake City, FL",NA,6053,6381,328,0.5131896413060962
2019,"Lake Havasu City-Kingman, AZ",NA,28435,33012,4577,0.5372434781193549
2019,"Lakeland-Winter Haven, FL",NA,96532,103553,7021,0.5175450433565735
2019,"Lamesa, TX",NA,787,632,-155,0.44538407329105
2019,"Lancaster, PA",NA,48130,45056,-3074,0.48350610606743505
2019,"Lansing-East Lansing, MI",NA,62570,52986,-9584,0.4585309287271972
2019,"Laramie, WY",NA,5466,4332,-1134,0.4421310471524801
2019,"Laredo, TX",NA,10652,10922,270,0.5062575322147029
2019,"Las Cruces, NM",NA,15548,16201,653,0.5102837884657785
2019,"Las Vegas-Henderson-Paradise, NV",NA,265535,274754,9219,0.5085315451545377
2019,"Las Vegas, NM",NA,2025,1426,-599,0.4132135612865836
2019,"Laurel, MS",NA,4986,4466,-520,0.47249259415996614
2019,"Laurinburg, NC",NA,2077,1861,-216,0.47257491112239713
2019,"Lawrence, KS",NA,15266,13171,-2095,0.46316418750219784
2019,"Lawrenceburg, TN",NA,4285,4023,-262,0.48423206547905634
2019,"Lawton, OK",NA,14692,13013,-1679,0.46969861035914096
2019,"Lebanon, MO",NA,4259,3777,-482,0.47000995520159283
2019,"Lebanon, NH-VT",NA,24734,22268,-2466,0.4737670737415429
2019,"Lebanon, PA",NA,12762,12559,-203,0.49599146953121914
2019,"Levelland, TX",NA,2206,1291,-915,0.369173577352016
2019,"Lewisburg, PA",NA,2973,2646,-327,0.47090229578216763
2019,"Lewisburg, TN",NA,2891,3032,141,0.511902751983792
2019,"Lewiston-Auburn, ME",NA,12300,11703,-597,0.48756405449318835
2019,"Lewiston, ID-WA",NA,7910,6484,-1426,0.4504654717243296
2019,"Lewistown, PA",NA,4316,4091,-225,0.4866182942785774
2019,"Lexington-Fayette, KY",NA,59078,55007,-4071,0.4821580400578516
2019,"Lexington, NE",NA,2991,2377,-614,0.44280923994038746
2019,"Liberal, KS",NA,1769,1480,-289,0.4555247768544167
2019,"Lima, OH",NA,9724,9059,-665,0.48229782249906833
2019,"Lincoln, IL",NA,2499,2082,-417,0.4544859201047806
2019,"Lincoln, NE",NA,42828,34672,-8156,0.44738064516129034
2019,"Little Rock-North Little Rock-Conway, AR",NA,76249,72444,-3805,0.4872051811450438
2019,"Lock Haven, PA",NA,3385,2829,-556,0.45526231091084646
2019,"Logan, UT-ID",NA,16638,12147,-4491,0.42199062011464306
2019,"Logansport, IN",NA,4669,3602,-1067,0.43549752146052473
2019,"London, KY",NA,9507,9054,-453,0.48779699369646035
2019,"Longview, TX",NA,24093,22898,-1195,0.4872847992168713
2019,"Longview, WA",NA,11586,11289,-297,0.49350819672131147
2019,"Los Alamos, NM",NA,1770,1803,33,0.5046179680940386
2019,"Los Angeles-Long Beach-Anaheim, CA",LOS ANGELES,1028815,960996,-67819,0.4829584317304508
2019,"Louisville/Jefferson County, KY-IN",NA,134906,125931,-8975,0.48279576900516413
2019,"Lubbock, TX",NA,32322,29971,-2351,0.481129500907004
2019,"Ludington, MI",NA,3587,3421,-166,0.4881563926940639
2019,"Lufkin, TX",NA,6816,6477,-339,0.48724892800722186
2019,"Lumberton, NC",NA,7774,6940,-834,0.4716596438765801
2019,"Lynchburg, VA",NA,22107,20551,-1556,0.48176192039007926
2019,"Macomb, IL",NA,3315,2537,-778,0.433526999316473
2019,"Macon-Bibb County, GA",NA,19046,18323,-723,0.49032620621370654
2019,"Madera, CA",FRESNO,9076,9218,142,0.5038810538974527
2019,"Madison, IN",NA,3523,2979,-544,0.4581667179329437
2019,"Madison, WI",NA,83363,74469,-8894,0.4718244715900451
2019,"Madisonville, KY",NA,4674,4210,-464,0.4738856371004052
2019,"Magnolia, AR",NA,1767,1356,-411,0.43419788664745435
2019,"Malone, NY",NA,5321,4841,-480,0.4763826018500295
2019,"Malvern, AR",NA,2778,2592,-186,0.48268156424581005
2019,"Manchester-Nashua, NH",NA,45247,42171,-3076,0.4824063693976069
2019,"Manhattan, KS",NA,23304,16080,-7224,0.4082876294942108
2019,"Manitowoc, WI",NA,7355,6345,-1010,0.46313868613138687
2019,"Mankato, MN",NA,14226,10513,-3713,0.42495654634382957
2019,"Mansfield, OH",NA,11994,11012,-982,0.4786577414587499
2019,"Marietta, OH",NA,5203,4523,-680,0.4650421550483241
2019,"Marinette, WI-MI",NA,6126,5484,-642,0.4723514211886305
2019,"Marion, IN",NA,7967,6355,-1612,0.44372294372294374
2019,"Marion, NC",NA,3146,3071,-75,0.4939681518417243
2019,"Marion, OH",NA,6079,5921,-158,0.49341666666666667
2019,"Marquette, MI",NA,8728,7032,-1696,0.44619289340101526
2019,"Marshall, MN",NA,2994,2211,-783,0.42478386167146975
2019,"Marshall, MO",NA,2217,2063,-154,0.48200934579439253
2019,"Marshalltown, IA",NA,4502,3637,-865,0.4468607937093009
2019,"Martin, TN",NA,3410,2648,-762,0.43710795642126116
2019,"Martinsville, VA",NA,5430,4947,-483,0.47672737785487135
2019,"Maryville, MO",NA,1952,1596,-356,0.44983089064261556
2019,"Mason City, IA",NA,6171,4952,-1219,0.4452036321136384
2019,"Mayfield, KY",NA,3714,2901,-813,0.4385487528344671
2019,"Maysville, KY",NA,1566,1525,-41,0.4933678421222905
2019,"McAlester, OK",NA,3304,3065,-239,0.481237242895274
2019,"McAllen-Edinburg-Mission, TX",NA,35323,40175,4852,0.5321333015444117
2019,"McComb, MS",NA,3619,2733,-886,0.4302581863979849
2019,"McMinnville, TN",NA,3888,3856,-32,0.49793388429752067
2019,"McPherson, KS",NA,3114,2809,-305,0.4742529123754854
2019,"Meadville, PA",NA,8365,7104,-1261,0.4592410627707027
2019,"Medford, OR",NA,25967,25367,-600,0.4941559200529863
2019,"Memphis, TN-MS-AR",NA,117330,115058,-2272,0.4951116236638725
2019,"Menomonie, WI",NA,4332,3790,-542,0.4666338340310268
2019,"Merced, CA",FRESNO,19816,17994,-1822,0.4759058450145464
2019,"Meridian, MS",NA,6226,5849,-377,0.4843892339544513
2019,"Mexico, MO",NA,2330,2217,-113,0.48757422476358037
2019,"Miami-Fort Lauderdale-Pompano Beach, FL",NA,709462,678193,-31269,0.4887331505309317
2019,"Miami, OK",NA,3151,2422,-729,0.43459537053651537
2019,"Michigan City-La Porte, IN",CHICAGO,10772,9431,-1341,0.4668118596248082
2019,"Middlesborough, KY",NA,1700,1572,-128,0.480440097799511
2019,"Midland, MI",NA,8956,8012,-944,0.4721829325789722
2019,"Midland, TX",NA,18100,14950,-3150,0.4523449319213313
2019,"Milledgeville, GA",NA,3445,3215,-230,0.4827327327327327
2019,"Milwaukee-Waukesha, WI",NA,172750,159164,-13586,0.47953385515525104
2019,"Minden, LA",NA,3809,2965,-844,0.4377029819899616
2019,"Mineral Wells, TX",NA,2426,2412,-14,0.49855312112443156
2019,"Minneapolis-St. Paul-Bloomington, MN-WI",NA,405625,377360,-28265,0.4819504843643237
2019,"Minot, ND",NA,10031,7340,-2691,0.4225433193253123
2019,"Missoula, MT",NA,16972,15047,-1925,0.469939723289297
2019,"Mitchell, SD",NA,2810,2329,-481,0.4532010118700136
2019,"Moberly, MO",NA,2822,2361,-461,0.4555276866679529
2019,"Mobile, AL",NA,34888,32455,-2433,0.48193576169757807
2019,"Modesto, CA",NA,42231,37484,-4747,0.47022517719375273
2019,"Monroe, LA",NA,18402,16351,-2051,0.4704917561073864
2019,"Monroe, MI",NA,12572,12445,-127,0.4974617260263021
2019,"Montgomery, AL",NA,36459,32479,-3980,0.47113348225942153
2019,"Montrose, CO",NA,5726,5217,-509,0.4767431234579183
2019,"Morehead City, NC",NA,6033,6213,180,0.5073493385595297
2019,"Morgan City, LA",NA,3487,3025,-462,0.46452702702702703
2019,"Morgantown, WV",NA,13542,10076,-3466,0.4266237615378101
2019,"Morristown, TN",NA,11625,11583,-42,0.49909513960703206
2019,"Moscow, ID",NA,4849,4102,-747,0.45827281867947717
2019,"Moses Lake, WA",NA,7636,7302,-334,0.48882045789262285
2019,"Moultrie, GA",NA,3143,3021,-122,0.4901038286826736
2019,"Mount Airy, NC",NA,4524,4267,-257,0.4853827778409737
2019,"Mount Gay-Shamrock, WV",NA,705,746,41,0.5141281874569262
2019,"Mount Pleasant, MI",NA,7156,6063,-1093,0.45865799228383386
2019,"Mount Pleasant, TX",NA,3018,2872,-146,0.48760611205432935
2019,"Mount Sterling, KY",NA,4390,4284,-106,0.4938897855660595
2019,"Mount Vernon-Anacortes, WA",NA,14375,12768,-1607,0.47039752422355674
2019,"Mount Vernon, IL",NA,3274,2652,-622,0.4475194060074249
2019,"Mount Vernon, OH",NA,7261,5331,-1930,0.42336404066073696
2019,"Mountain Home, AR",NA,4475,4396,-79,0.4955472889189494
2019,"Mountain Home, ID",NA,3932,3329,-603,0.45847679383005097
2019,"Muncie, IN",NA,13315,10868,-2447,0.44940660794773185
2019,"Murray, KY",NA,4618,3422,-1196,0.4256218905472637
2019,"Muscatine, IA",NA,5424,4278,-1146,0.4409400123685838
2019,"Muskegon, MI",NA,17496,16208,-1288,0.48089247567054355
2019,"Muskogee, OK",NA,7183,5686,-1497,0.44183697256974125
2019,"Myrtle Beach-Conway-North Myrtle Beach, SC-NC",NA,53470,63151,9681,0.5415062467308632
2019,"Nacogdoches, TX",NA,5042,4407,-635,0.46639856069425334
2019,"Napa, CA",SAN FRANCISCO,11327,10618,-709,0.4838459785828207
2019,"Naples-Marco Island, FL",NA,80649,77200,-3449,0.48907500205892973
2019,"Nashville-Davidson--Murfreesboro--Franklin, TN",NA,209239,208583,-656,0.49921497671257137
2019,"Natchez, MS-LA",NA,3057,2732,-325,0.47192952150630507
2019,"Natchitoches, LA",NA,2855,2470,-385,0.463849765258216
2019,"New Bern, NC",NA,13541,11144,-2397,0.45144824792384036
2019,"New Castle, IN",NA,4853,4295,-558,0.4695015303891561
2019,"New Castle, PA",NA,7032,6657,-375,0.4863028709182555
2019,"New Haven-Milford, CT",NA,81721,78210,-3511,0.4890233913375143
2019,"New Orleans-Metairie, LA",NA,94249,90249,-4000,0.489159774089692
2019,"New Philadelphia-Dover, OH",NA,8087,7245,-842,0.4725410905296113
2019,"New Ulm, MN",NA,2534,2113,-421,0.4547019582526361
2019,"New York-Newark-Jersey City, NY-NJ-PA",NEW YORK,1407215,1295085,-112130,0.4792528586759427
2019,"Newberry, SC",NA,2406,2343,-63,0.4933670246367656
2019,"Newport, OR",NA,7511,6919,-592,0.4794871794871795
2019,"Newport, TN",NA,3218,3291,73,0.5056076202181595
2019,"Niles, MI",NA,17118,15235,-1883,0.4708991438197385
2019,"Nogales, AZ",NA,3246,3365,119,0.5090001512630464
2019,"Norfolk, NE",NA,4940,3702,-1238,0.428373061791252
2019,"North Platte, NE",NA,4173,3188,-985,0.43309332971063713
2019,"North Port-Sarasota-Bradenton, FL",NA,151285,155117,3832,0.50625322289019
2019,"North Vernon, IN",NA,2546,2213,-333,0.46501365833158226
2019,"North Wilkesboro, NC",NA,3504,3508,4,0.5002852253280091
2019,"Norwalk, OH",NA,5465,5032,-433,0.4793750595408212
2019,"Norwich-New London, CT",NA,29960,28315,-1645,0.4858858858858859
2019,"Oak Harbor, WA",NA,11073,9878,-1195,0.4714810748890268
2019,"Ocala, FL",NA,45555,47954,2399,0.5128276422590339
2019,"Ocean City, NJ",PHILADELPHIA,12252,12564,312,0.5062862669245648
2019,"Odessa, TX",NA,14661,12734,-1927,0.46482934842124474
2019,"Ogden-Clearfield, UT",NA,59117,55321,-3796,0.48341460004543946
2019,"Ogdensburg-Massena, NY",NA,12128,9963,-2165,0.4509981440405595
2019,"Oil City, PA",NA,4093,3878,-215,0.4865136118429306
2019,"Okeechobee, FL",NA,5021,5759,738,0.5342300556586271
2019,"Oklahoma City, OK",NA,138200,127831,-10369,0.4805116696926298
2019,"Olean, NY",NA,7862,6932,-930,0.4685683385156144
2019,"Olympia-Lacey-Tumwater, WA",NA,32279,33395,1116,0.5084965130797576
2019,"Omaha-Council Bluffs, NE-IA",NA,106822,96918,-9904,0.47569451261411605
2019,"Oneonta, NY",NA,5380,4536,-844,0.4574425171440097
2019,"Ontario, OR-ID",NA,6257,5521,-736,0.4687553065036509
2019,"Opelousas, LA",NA,5354,4948,-406,0.4802950883323627
2019,"Orangeburg, SC",NA,5429,5094,-335,0.4840824859830847
2019,"Orlando-Kissimmee-Sanford, FL",NA,361184,348340,-12844,0.49094886149023853
2019,"Oshkosh-Neenah, WI",NA,19039,16648,-2391,0.46650040631042117
2019,"Oskaloosa, IA",NA,2153,1809,-344,0.4565875820292781
2019,"Othello, WA",NA,1168,1064,-104,0.4767025089605735
2019,"Ottawa, IL",CHICAGO,13514,11223,-2291,0.4536928487690504
2019,"Ottawa, KS",NA,2517,2340,-177,0.4817788758492897
2019,"Ottumwa, IA",NA,4841,3772,-1069,0.43794264483919654
2019,"Owatonna, MN",NA,4006,3580,-426,0.4719219615080411
2019,"Owensboro, KY",NA,11726,10561,-1165,0.47386368735137074
2019,"Oxford, MS",NA,5068,3868,-1200,0.43285586392121755
2019,"Oxnard-Thousand Oaks-Ventura, CA",LOS ANGELES,62273,62532,259,0.5010376186851488
2019,"Ozark, AL",NA,6226,4891,-1335,0.43995682288387156
2019,"Paducah, KY-IL",NA,10428,9297,-1131,0.47133079847908743
2019,"Pahrump, NV",NA,6121,6850,729,0.5281011487163673
2019,"Palatka, FL",NA,7930,7714,-216,0.49309639478394274
2019,"Palestine, TX",NA,3387,3369,-18,0.49866785079928955
2019,"Palm Bay-Melbourne-Titusville, FL",NA,81706,83141,1435,0.5043525208223383
2019,"Pampa, TX",NA,1731,1572,-159,0.47593097184377836
2019,"Panama City, FL",NA,24959,24200,-759,0.49228015215931975
2019,"Paragould, AR",NA,5082,4570,-512,0.4734769995855781
2019,"Paris, TN",NA,3537,3239,-298,0.4780106257378985
2019,"Paris, TX",NA,4927,4526,-401,0.47878980217920236
2019,"Parkersburg-Vienna, WV",NA,7121,6623,-498,0.48188300349243307
2019,"Parsons, KS",NA,2439,1865,-574,0.433317843866171
2019,"Payson, AZ",NA,6141,5423,-718,0.46895537876167415
2019,"Pearsall, TX",NA,876,899,23,0.5064788732394366
2019,"Pecos, TX",NA,632,619,-13,0.49480415667466027
2019,"Pella, IA",NA,3190,2994,-196,0.48415265200517466
2019,"Pensacola-Ferry Pass-Brent, FL",NA,51633,55159,3526,0.5165087272454866
2019,"Peoria, IL",NA,43275,35652,-7623,0.4517085408035273
2019,"Peru, IN",NA,3831,2983,-848,0.437775168770179
2019,"Philadelphia-Camden-Wilmington, PA-NJ-DE-MD",PHILADELPHIA,487855,468428,-19427,0.48984244203860156
2019,"Phoenix-Mesa-Chandler, AZ",NA,599713,628037,28324,0.5115349216045612
2019,"Picayune, MS",NA,4718,4498,-220,0.4880642361111111
2019,"Pierre, SD",NA,1975,1829,-146,0.48080967402733965
2019,"Pine Bluff, AR",NA,6373,5501,-872,0.4632811184099714
2019,"Pinehurst-Southern Pines, NC",RALEIGH,8559,9225,666,0.5187246963562753
2019,"Pittsburg, KS",NA,5429,4098,-1331,0.43014590112312373
2019,"Pittsburgh, PA",NA,194105,179947,-14158,0.48107482382128686
2019,"Pittsfield, MA",NA,13786,13133,-653,0.48787102046881387
2019,"Plainview, TX",NA,2282,1863,-419,0.4494571773220748
2019,"Platteville, WI",NA,5001,4259,-742,0.4599352051835853
2019,"Plattsburgh, NY",NA,9917,8458,-1459,0.4602993197278912
2019,"Plymouth, IN",NA,4380,3861,-519,0.46851110302147797
2019,"Pocatello, ID",NA,10329,8599,-1730,0.45430050718512255
2019,"Point Pleasant, WV-OH",NA,3638,3321,-317,0.47722373904296594
2019,"Ponca City, OK",NA,5431,4280,-1151,0.4407373082071877
2019,"Pontiac, IL",NA,3252,2611,-641,0.44533515265222584
2019,"Poplar Bluff, MO",NA,6581,6224,-357,0.48606013276064036
2019,"Port Angeles, WA",NA,8212,8523,311,0.5092919031968928
2019,"Port Lavaca, TX",HOUSTON,1473,1029,-444,0.41127098321342925
2019,"Port St. Lucie, FL",NA,67154,68187,1033,0.503816286269497
2019,"Portales, NM",NA,1833,1624,-209,0.46977147816025455
2019,"Portland-South Portland, ME",NA,65075,65219,144,0.500552596435753
2019,"Portland-Vancouver-Hillsboro, OR-WA",NA,291345,282502,-8843,0.49229498455163134
2019,"Portsmouth, OH",NA,6219,5821,-398,0.4834717607973422
2019,"Pottsville, PA",NA,12589,11595,-994,0.47944922262652995
2019,"Poughkeepsie-Newburgh-Middletown, NY",NEW YORK,50824,50199,-625,0.4969066450214308
2019,"Prescott Valley-Prescott, AZ",NA,30118,32002,1884,0.5151641983258209
2019,"Price, UT",NA,1729,1697,-32,0.4953298307063631
2019,"Prineville, OR",NA,3526,3209,-317,0.4764662212323682
2019,"Providence-Warwick, RI-MA",NA,151529,150540,-989,0.4983629568078816
2019,"Provo-Orem, UT",NA,48935,47913,-1022,0.4947236907318685
2019,"Pueblo, CO",NA,16872,16711,-161,0.4976029538754727
2019,"Pullman, WA",NA,6104,4144,-1960,0.40437158469945356
2019,"Punta Gorda, FL",NA,38527,40473,1946,0.5123164556962025
2019,"Quincy, IL-MO",NA,6936,5984,-952,0.4631578947368421
2019,"Racine, WI",NA,18861,17749,-1112,0.4848128926522808
2019,"Raleigh-Cary, NC",RALEIGH,136099,143958,7859,0.5140310722460071
2019,"Rapid City, SD",NA,18015,17419,-596,0.4915899983067111
2019,"Raymondville, TX",NA,551,685,134,0.5542071197411004
2019,"Reading, PA",PHILADELPHIA,37936,36050,-1886,0.48725434541670043
2019,"Red Bluff, CA",NA,7493,6607,-886,0.46858156028368797
2019,"Red Wing, MN",NA,4540,4156,-384,0.4779208831646734
2019,"Redding, CA",NA,20024,17375,-2649,0.46458461456188666
2019,"Reno, NV",NA,56336,55031,-1305,0.4941409932924475
2019,"Rexburg, ID",NA,6980,4907,-2073,0.4128039034239085
2019,"Richmond-Berea, KY",NA,11395,10865,-530,0.4880952380952381
2019,"Richmond, IN",NA,7962,6652,-1310,0.45517996441768166
2019,"Richmond, VA",NA,125157,124498,-659,0.4986801786465322
2019,"Rio Grande City-Roma, TX",NA,1473,1078,-395,0.4225793806350451
2019,"Riverside-San Bernardino-Ontario, CA",LOS ANGELES,369580,372972,3392,0.5022840151262133
2019,"Riverton, WY",NA,3358,3035,-323,0.4747379946816831
2019,"Roanoke Rapids, NC",RALEIGH,4168,4001,-167,0.4897784306524666
2019,"Roanoke, VA",NA,29627,28626,-1001,0.4914081678196831
2019,"Rochelle, IL",NA,4353,4059,-294,0.4825249643366619
2019,"Rochester, MN",NA,24368,22405,-1963,0.4790156714343745
2019,"Rochester, NY",NA,117122,109957,-7165,0.48422355215585766
2019,"Rock Springs, WY",NA,4739,4176,-563,0.46842400448682
2019,"Rockford, IL",NA,36433,32460,-3973,0.47116543045011827
2019,"Rockingham, NC",NA,2815,2646,-169,0.4845266434718916
2019,"Rockport, TX",NA,2594,3468,874,0.5720884196634775
2019,"Rocky Mount, NC",RALEIGH,9916,9825,-91,0.49769515222126537
2019,"Rolla, MO",NA,5219,4726,-493,0.4752136752136752
2019,"Rome, GA",NA,9490,7720,-1770,0.44857640906449736
2019,"Roseburg, OR",NA,11903,11280,-623,0.486563430099642
2019,"Roswell, NM",NA,5677,4743,-934,0.4551823416506718
2019,"Ruidoso, NM",NA,2423,2281,-142,0.484906462585034
2019,"Russellville, AR",NA,8178,7057,-1121,0.4632097144732524
2019,"Ruston, LA",NA,4128,3407,-721,0.45215660252156603
2019,"Rutland, VT",NA,6237,5711,-526,0.477987947773686
2019,"Sacramento-Roseville-Folsom, CA",NA,224287,217186,-7101,0.491957605561382
2019,"Safford, AZ",NA,3635,2494,-1141,0.40691793114700603
2019,"Saginaw, MI",NA,19820,17475,-2345,0.46856146936586673
2019,"Salem, OH",NA,8832,8217,-615,0.48196375153967974
2019,"Salem, OR",NA,50693,43037,-7656,0.45915928731462713
2019,"Salina, KS",NA,7765,6079,-1686,0.4391071944524704
2019,"Salinas, CA",NA,29092,26183,-2909,0.4736861148801447
2019,"Salisbury, MD-DE",NA,40634,42367,1733,0.5104396332574306
2019,"Salt Lake City, UT",NA,130686,116356,-14330,0.47099683454635244
2019,"San Angelo, TX",NA,11768,10290,-1478,0.46649741590352706
2019,"San Antonio-New Braunfels, TX",NA,236758,237237,479,0.5005052795915569
2019,"San Diego-Chula Vista-Carlsbad, CA",NA,352451,333932,-18519,0.48650971833509865
2019,"San Francisco-Oakland-Berkeley, CA",SAN FRANCISCO,414562,375592,-38970,0.475340250128456
2019,"San Jose-Sunnyvale-Santa Clara, CA",SAN FRANCISCO,185324,169024,-16300,0.477000011288338
2019,"San Luis Obispo-Paso Robles, CA",NA,26191,25345,-846,0.4917921452964918
2019,"Sandpoint, ID",NA,5575,5870,295,0.5128877238968982
2019,"Sandusky, OH",NA,9170,7983,-1187,0.4653996385471929
2019,"Sanford, NC",RALEIGH,5837,7748,1911,0.570334928229665
2019,"Santa Cruz-Watsonville, CA",NA,22279,19962,-2317,0.47257403944035414
2019,"Santa Fe, NM",NA,13631,14860,1229,0.5215682145238847
2019,"Santa Maria-Santa Barbara, CA",NA,33622,32015,-1607,0.4877584289348995
2019,"Santa Rosa-Petaluma, CA",SAN FRANCISCO,44134,42546,-1588,0.49083987078910934
2019,"Sault Ste. Marie, MI",NA,3785,3319,-466,0.46720157657657657
2019,"Savannah, GA",NA,45191,42162,-3029,0.4826623012375076
2019,"Sayre, PA",NA,6257,5611,-646,0.4727839568587799
2019,"Scottsbluff, NE",NA,4274,3421,-853,0.4445743989603639
2019,"Scottsboro, AL",NA,4015,3787,-228,0.4853883619584722
2019,"Scottsburg, IN",NA,3447,2886,-561,0.45570819516816674
2019,"Scranton--Wilkes-Barre, PA",NA,52031,47270,-4761,0.47602743174791795
2019,"Searcy, AR",NA,7617,7177,-440,0.48512910639448426
2019,"Seattle-Tacoma-Bellevue, WA",NA,479994,467413,-12581,0.49336029816119154
2019,"Sebastian-Vero Beach, FL",NA,25723,26110,387,0.5037331429784114
2019,"Sebring-Avon Park, FL",NA,20695,19522,-1173,0.48541661486436083
2019,"Sedalia, MO",NA,5291,4257,-1034,0.44585253456221197
2019,"Selinsgrove, PA",NA,2506,2242,-264,0.4721988205560236
2019,"Selma, AL",NA,2094,1782,-312,0.45975232198142413
2019,"Seneca Falls, NY",NA,3302,2988,-314,0.4750397456279809
2019,"Seneca, SC",NA,6656,6616,-40,0.4984930681133213
2019,"Sevierville, TN",NA,9724,9539,-185,0.4951980480714323
2019,"Seymour, IN",NA,4860,4505,-355,0.4810464495461826
2019,"Shawano, WI",NA,3460,2997,-463,0.46414743689019666
2019,"Shawnee, OK",NA,6170,5941,-229,0.49054578482371397
2019,"Sheboygan, WI",NA,11890,9918,-1972,0.45478723404255317
2019,"Shelby, NC",NA,6630,6804,174,0.5064761054041983
2019,"Shelbyville, TN",NA,4282,4012,-270,0.4837231733783458
2019,"Shelton, WA",NA,6632,6741,109,0.5040753757571226
2019,"Sheridan, WY",NA,3615,3395,-220,0.4843081312410842
2019,"Sherman-Denison, TX",NA,13006,13732,726,0.5135761837085796
2019,"Show Low, AZ",NA,10644,11487,843,0.5190456825267724
2019,"Shreveport-Bossier City, LA",NA,37923,35210,-2713,0.4814516018760341
2019,"Sidney, OH",NA,4053,3419,-634,0.4575749464668094
2019,"Sierra Vista-Douglas, AZ",NA,15633,14727,-906,0.4850790513833992
2019,"Sikeston, MO",NA,4904,3975,-929,0.44768555017456924
2019,"Silver City, NM",NA,2225,1866,-359,0.45612319726228306
2019,"Sioux City, IA-NE-SD",NA,15450,13164,-2286,0.4600545187670371
2019,"Sioux Falls, SD",NA,33034,30465,-2569,0.47977133498165325
2019,"Snyder, TX",NA,1274,1082,-192,0.4592529711375212
2019,"Somerset, KY",NA,6463,6238,-225,0.49114242972994254
2019,"Somerset, PA",NA,5122,4629,-493,0.4747205414829248
2019,"Sonora, CA",NA,5008,4622,-386,0.47995846313603324
2019,"South Bend-Mishawaka, IN-MI",NA,37385,29848,-7537,0.4439486561658709
2019,"Spartanburg, SC",NA,26355,26748,393,0.5037003559120954
2019,"Spearfish, SD",NA,3395,2928,-467,0.46307132690178715
2019,"Spencer, IA",NA,1759,1542,-217,0.46713117237200846
2019,"Spirit Lake, IA",NA,2685,2420,-265,0.4740450538687561
2019,"Spokane-Spokane Valley, WA",NA,68849,66777,-2072,0.4923613466444487
2019,"Springfield, IL",NA,24397,21540,-2857,0.46890306289048045
2019,"Springfield, MA",NA,68857,63740,-5117,0.48070469165969065
2019,"Springfield, MO",NA,59642,51757,-7885,0.46460919756909846
2019,"Springfield, OH",NA,10816,10273,-543,0.48712598985252975
2019,"St. Cloud, MN",NA,20890,19024,-1866,0.47662474319787546
2019,"St. George, UT",NA,19190,20694,1504,0.5188546785678467
2019,"St. Joseph, MO-KS",NA,11494,9478,-2016,0.45193591455273696
2019,"St. Louis, MO-IL",NA,258425,243504,-14921,0.48513634398490624
2019,"St. Marys, GA",NA,7574,6371,-1203,0.45686626030835426
2019,"St. Marys, PA",NA,2355,2174,-181,0.4800176639434754
2019,"Starkville, MS",NA,6206,4363,-1843,0.41281105118743494
2019,"State College, PA",NA,13010,10858,-2152,0.45491871962460195
2019,"Statesboro, GA",NA,6112,5578,-534,0.4771599657827203
2019,"Staunton, VA",NA,11108,10473,-635,0.4852879848014457
2019,"Steamboat Springs, CO",NA,3230,2861,-369,0.4697094073222788
2019,"Stephenville, TX",NA,4147,3859,-288,0.4820134898825881
2019,"Sterling, CO",NA,1942,1704,-238,0.4673614920460779
2019,"Sterling, IL",NA,6427,5155,-1272,0.44508720428250736
2019,"Stevens Point, WI",NA,7720,6063,-1657,0.4398897192193282
2019,"Stillwater, OK",NA,9975,7746,-2229,0.4371085153208058
2019,"Stockton, CA",NA,55544,55497,-47,0.4997883664592358
2019,"Storm Lake, IA",NA,2213,1672,-541,0.4303732303732304
2019,"Sturgis, MI",NA,6300,5745,-555,0.47696139476961397
2019,"Sulphur Springs, TX",NA,2880,2940,60,0.5051546391752577
2019,"Summerville, GA",NA,2106,2015,-91,0.4889589905362776
2019,"Sumter, SC",NA,10983,10694,-289,0.4933339484245975
2019,"Sunbury, PA",NA,8333,7648,-685,0.47856829985607907
2019,"Susanville, CA",NA,2205,1995,-210,0.475
2019,"Sweetwater, TX",NA,1443,1343,-100,0.48205312275664036
2019,"Syracuse, NY",NA,73177,65911,-7266,0.47387984585298515
2019,"Tahlequah, OK",NA,3565,3534,-31,0.4978165938864629
2019,"Talladega-Sylacauga, AL",NA,5647,5343,-304,0.4861692447679709
2019,"Tallahassee, FL",NA,35025,33636,-1389,0.48988508760431687
2019,"Tampa-St. Petersburg-Clearwater, FL",NA,462318,461700,-618,0.4996655909300468
2019,"Taos, NM",NA,2059,2143,84,0.5099952403617325
2019,"Taylorville, IL",NA,3766,2757,-1009,0.42265828606469413
2019,"Terre Haute, IN",NA,19237,17286,-1951,0.4732908030556088
2019,"Texarkana, TX-AR",NA,15124,13174,-1950,0.4655452682168351
2019,"The Dalles, OR",NA,2942,2542,-400,0.46353026987600293
2019,"The Villages, FL",NA,23482,27077,3595,0.5355525227951502
2019,"Thomaston, GA",NA,2332,2069,-263,0.4701204271756419
2019,"Thomasville, GA",NA,3967,3807,-160,0.4897092873681502
2019,"Tiffin, OH",NA,5468,4903,-565,0.47276058239321184
2019,"Tifton, GA",NA,3193,2889,-304,0.47500822097994083
2019,"Toccoa, GA",NA,3100,2702,-398,0.46570148224750085
2019,"Toledo, OH",NA,67042,61259,-5783,0.4774631530541461
2019,"Topeka, KS",NA,24974,21764,-3210,0.46565963455860326
2019,"Torrington, CT",NA,15748,15264,-484,0.4921965690700374
2019,"Traverse City, MI",NA,20818,19582,-1236,0.4847029702970297
2019,"Trenton-Princeton, NJ",PHILADELPHIA,29232,28253,-979,0.49148473514829955
2019,"Troy, AL",NA,2989,2441,-548,0.44953959484346223
2019,"Truckee-Grass Valley, CA",NA,9455,9583,128,0.503361697657317
2019,"Tucson, AZ",NA,129611,128082,-1529,0.49703329155235104
2019,"Tullahoma-Manchester, TN",NA,8888,9258,370,0.5101950843161027
2019,"Tulsa, OK",NA,92734,88736,-3998,0.48898440513583513
2019,"Tupelo, MS",NA,13323,11726,-1597,0.46812247993931894
2019,"Tuscaloosa, AL",NA,19024,17067,-1957,0.47288797761214707
2019,"Twin Falls, ID",NA,12072,11335,-737,0.48425684624257703
2019,"Tyler, TX",NA,19933,19661,-272,0.49656513613173714
2019,"Ukiah, CA",SAN FRANCISCO,7560,5981,-1579,0.4416955911675652
2019,"Union City, TN",NA,3213,2762,-451,0.4622594142259414
2019,"Union, SC",NA,2088,1860,-228,0.47112462006079026
2019,"Urban Honolulu, HI",NA,99794,80492,-19302,0.4464683891150727
2019,"Urbana, OH",NA,2952,2865,-87,0.4925219185146983
2019,"Utica-Rome, NY",NA,29338,26810,-2528,0.4774880672508371
2019,"Uvalde, TX",NA,1993,1651,-342,0.4530735455543359
2019,"Valdosta, GA",NA,14461,13460,-1001,0.48207442426847175
2019,"Vallejo, CA",SAN FRANCISCO,37940,36408,-1532,0.4896971001237424
2019,"Van Wert, OH",NA,2030,1801,-229,0.47011224223440357
2019,"Vermillion, SD",NA,1988,1316,-672,0.3983050847457627
2019,"Vernal, UT",NA,2951,2848,-103,0.4911191584755992
2019,"Vernon, TX",NA,1318,1086,-232,0.45174708818635606
2019,"Vicksburg, MS",NA,3577,3434,-143,0.48980174012266436
2019,"Victoria, TX",NA,7967,7017,-950,0.4682995194874533
2019,"Vidalia, GA",NA,3060,2581,-479,0.4575429888317674
2019,"Vincennes, IN",NA,4637,3900,-737,0.4568349537308188
2019,"Vineland-Bridgeton, NJ",PHILADELPHIA,11595,10390,-1205,0.4725949511030248
2019,"Vineyard Haven, MA",NA,2883,2656,-227,0.47950893663116084
2019,"Virginia Beach-Norfolk-Newport News, VA-NC",NA,190369,183746,-6623,0.4911484436603718
2019,"Visalia, CA",FRESNO,28906,27728,-1178,0.48959988699367873
2019,"Wabash, IN",NA,2659,2444,-215,0.4789339604154419
2019,"Waco, TX",NA,25150,23847,-1303,0.48670326754699267
2019,"Wahpeton, ND-MN",NA,1888,1493,-395,0.44158532978408754
2019,"Walla Walla, WA",NA,6136,5390,-746,0.467638382786743
2019,"Wapakoneta, OH",NA,3509,3212,-297,0.4779050736497545
2019,"Warner Robins, GA",NA,17782,17772,-10,0.4998593688473871
2019,"Warren, PA",NA,3490,3056,-434,0.46684998472349526
2019,"Warrensburg, MO",NA,6437,5529,-908,0.46205916764165134
2019,"Warsaw, IN",NA,8740,7854,-886,0.4733036037121851
2019,"Washington Court House, OH",NA,2749,2576,-173,0.48375586854460095
2019,"Washington-Arlington-Alexandria, DC-VA-MD-WV",NA,642798,618172,-24626,0.4902352950506356
2019,"Washington, IN",NA,2909,2234,-675,0.4343768228660315
2019,"Washington, NC",NA,3402,3493,91,0.5065989847715736
2019,"Waterloo-Cedar Falls, IA",NA,19482,16795,-2687,0.4629655153402983
2019,"Watertown-Fort Atkinson, WI",NA,7886,7002,-884,0.47031166039763567
2019,"Watertown-Fort Drum, NY",NA,20911,15431,-5480,0.4246051400583347
2019,"Watertown, SD",NA,3826,3082,-744,0.4461493920092646
2019,"Wauchula, FL",NA,2399,2261,-138,0.4851931330472103
2019,"Wausau-Weston, WI",NA,16386,14362,-2024,0.46708729023025886
2019,"Waycross, GA",NA,5240,4572,-668,0.4659600489196902
2019,"Weatherford, OK",NA,3428,2456,-972,0.4174031271244052
2019,"Weirton-Steubenville, WV-OH",NA,9066,8148,-918,0.47333565702335306
2019,"Wenatchee, WA",NA,10821,10811,-10,0.49976886094674555
2019,"West Plains, MO",NA,4727,4297,-430,0.4761746453900709
2019,"West Point, MS",NA,1077,1019,-58,0.48616412213740456
2019,"Wheeling, WV-OH",NA,11049,9484,-1565,0.4618906151073881
2019,"Whitewater, WI",NA,11560,10117,-1443,0.46671587396779995
2019,"Wichita Falls, TX",NA,30446,14916,-15530,0.328821480534368
2019,"Wichita, KS",NA,87875,68167,-19708,0.4368503351661732
2019,"Williamsport, PA",NA,11202,10514,-688,0.4841591453306318
2019,"Williston, ND",NA,6994,5599,-1395,0.44461208607956804
2019,"Willmar, MN",NA,5027,4619,-408,0.4788513373419034
2019,"Wilmington, NC",NA,31889,30865,-1024,0.4918411575357746
2019,"Wilmington, OH",NA,3817,3629,-188,0.4873757722266989
2019,"Wilson, NC",RALEIGH,5893,5578,-315,0.48626972365094584
2019,"Winchester, VA-WV",NA,12401,12268,-133,0.49730430905184647
2019,"Winfield, KS",NA,4012,3294,-718,0.45086230495483165
2019,"Winnemucca, NV",NA,2279,1828,-451,0.4450937423910397
2019,"Winona, MN",NA,4763,3966,-797,0.45434757704204376
2019,"Winston-Salem, NC",NA,54352,53120,-1232,0.49426827452731875
2019,"Wisconsin Rapids-Marshfield, WI",NA,7813,6621,-1192,0.4587086046833864
2019,"Woodward, OK",NA,2417,1717,-700,0.41533623609095305
2019,"Wooster, OH",NA,9527,8511,-1016,0.47183723250914733
2019,"Worcester, MA-CT",NA,93490,88638,-4852,0.4866796977949574
2019,"Worthington, MN",NA,1807,1303,-504,0.4189710610932476
2019,"Yakima, WA",NA,20000,17398,-2602,0.46521204342478206
2019,"Yankton, SD",NA,2809,2240,-569,0.4436522083580907
2019,"York-Hanover, PA",NA,40471,39189,-1282,0.4919533015315089
2019,"Youngstown-Warren-Boardman, OH-PA",NA,50862,45618,-5244,0.4728233830845771
2019,"Yuba City, CA",NA,14875,14431,-444,0.49242475943492803
2019,"Yuma, AZ",NA,20595,23997,3402,0.5381458557588805
2019,"Zanesville, OH",NA,8877,8017,-860,0.47454717651237127
2019,"Zapata, TX",NA,389,430,41,0.525030525030525
2019,NA,NA,1540758,1397681,-143077,0.4756542504370518
2020,"Aberdeen, SD",NA,5042,4152,-890,0.45159886882749617
2020,"Aberdeen, WA",NA,8455,8551,96,0.5028225332235682
2020,"Abilene, TX",NA,21638,19479,-2159,0.4737456526497556
2020,"Ada, OK",NA,3959,3759,-200,0.48704327545996373
2020,"Adrian, MI",NA,9243,8585,-658,0.4815458828808616
2020,"Akron, OH",NA,69919,67873,-2046,0.4925757663725035
2020,"Alamogordo, NM",NA,6637,7015,378,0.5138441254028714
2020,"Albany-Lebanon, OR",NA,15848,15891,43,0.5006774000441098
2020,"Albany-Schenectady-Troy, NY",NA,97239,93586,-3653,0.49042840298703
2020,"Albany, GA",NA,14943,14434,-509,0.4913367600503796
2020,"Albemarle, NC",NA,4554,5302,748,0.5379464285714286
2020,"Albert Lea, MN",NA,2744,2504,-240,0.4771341463414634
2020,"Albertville, AL",NA,8734,8719,-15,0.4995702744513837
2020,"Albuquerque, NM",NA,94083,93434,-649,0.4982694902328855
2020,"Alexander City, AL",NA,3524,3575,51,0.5035920552190449
2020,"Alexandria, LA",NA,13974,13338,-636,0.4883567662565905
2020,"Alexandria, MN",NA,4896,4597,-299,0.4842515537764669
2020,"Alice, TX",NA,2871,2716,-155,0.48612851261857887
2020,"Allentown-Bethlehem-Easton, PA-NJ",NEW YORK,80213,79766,-447,0.49860294163608976
2020,"Alma, MI",NA,3864,3466,-398,0.4728512960436562
2020,"Alpena, MI",NA,3309,2978,-331,0.4736758390329251
2020,"Altoona, PA",NA,11121,10445,-676,0.48432718167485855
2020,"Altus, OK",NA,2529,2362,-167,0.482927826620323
2020,"Amarillo, TX",NA,27655,26660,-995,0.49084046764245604
2020,"Americus, GA",NA,2624,2270,-354,0.4638332652227217
2020,"Ames, IA",NA,16818,13907,-2911,0.4526281529698942
2020,"Amsterdam, NY",NA,5418,5061,-357,0.48296593186372744
2020,"Anchorage, AK",NA,45648,43529,-2119,0.48811913385738476
2020,"Andrews, TX",NA,1870,1264,-606,0.40331844288449265
2020,"Angola, IN",NA,4864,4280,-584,0.4680664916885389
2020,"Ann Arbor, MI",NA,44434,37587,-6847,0.45826068933565794
2020,"Anniston-Oxford, AL",NA,11017,10768,-249,0.49428505852650906
2020,"Appleton, WI",NA,23946,22120,-1826,0.4801806104285156
2020,"Arcadia, FL",NA,3574,5278,1704,0.596249435155897
2020,"Ardmore, OK",NA,6179,5879,-300,0.4875601260573893
2020,"Arkadelphia, AR",NA,3063,2417,-646,0.44105839416058396
2020,"Asheville, NC",NA,55006,58942,3936,0.5172710359111173
2020,"Ashland, OH",NA,4375,4125,-250,0.4852941176470588
2020,"Ashtabula, OH",NA,9742,9228,-514,0.4864522930943595
2020,"Astoria, OR",NA,5613,5845,232,0.5101239308779891
2020,"Atchison, KS",NA,1568,1394,-174,0.4706279540850776
2020,"Athens-Clarke County, GA",NA,20788,19013,-1775,0.47770156528730434
2020,"Athens, OH",NA,6208,5367,-841,0.4636717062634989
2020,"Athens, TN",NA,4904,5352,448,0.5218408736349454
2020,"Athens, TX",NA,9465,10353,888,0.5224038752649107
2020,"Atlanta-Sandy Springs-Alpharetta, GA",NA,684465,693337,8872,0.5032196208163437
2020,"Atlantic City-Hammonton, NJ",PHILADELPHIA,26379,27542,1163,0.5107842955434803
2020,"Atmore, AL",NA,2898,2683,-215,0.4807382189571761
2020,"Auburn-Opelika, AL",NA,15662,15048,-614,0.49000325626831653
2020,"Auburn, IN",NA,4595,4187,-408,0.4767706672739695
2020,"Auburn, NY",NA,7756,7194,-562,0.4812040133779264
2020,"Augusta-Richmond County, GA-SC",NA,60056,62143,2087,0.5085393497491796
2020,"Augusta-Waterville, ME",NA,13714,14109,395,0.5070984437336017
2020,"Austin-Round Rock-Georgetown, TX",NA,303627,316850,13223,0.5106555118078511
2020,"Austin, MN",NA,3866,3614,-252,0.48315508021390374
2020,"Bainbridge, GA",NA,2519,2371,-148,0.48486707566462167
2020,"Bakersfield, CA",NA,74138,72338,-1800,0.4938556487069554
2020,"Baltimore-Columbia-Towson, MD",NA,290268,283610,-6658,0.4941991154914459
2020,"Bangor, ME",NA,17234,16711,-523,0.4922963617616733
2020,"Baraboo, WI",NA,7338,6935,-403,0.48588243536747705
2020,"Bardstown, KY",NA,4614,4476,-138,0.4924092409240924
2020,"Barnstable Town, MA",NA,35239,41028,5789,0.5379521942648852
2020,"Barre, VT",NA,6986,7374,388,0.5135097493036211
2020,"Bartlesville, OK",NA,5334,4991,-343,0.48338983050847456
2020,"Batavia, NY",NA,5306,4756,-550,0.4726694494136355
2020,"Batesville, AR",NA,5843,5844,1,0.5000427825789339
2020,"Baton Rouge, LA",NA,69617,69040,-577,0.497919326106868
2020,"Battle Creek, MI",NA,16292,14273,-2019,0.4669720268280713
2020,"Bay City, MI",NA,10332,9473,-859,0.47831355718252966
2020,"Bay City, TX",HOUSTON,3902,3145,-757,0.4462892010784731
2020,"Beatrice, NE",NA,2130,1846,-284,0.4642857142857143
2020,"Beaumont-Port Arthur, TX",NA,35526,33155,-2371,0.4827390399091452
2020,"Beaver Dam, WI",NA,8565,7883,-682,0.47926799610894943
2020,"Beckley, WV",NA,6475,6059,-416,0.48340513802457313
2020,"Bedford, IN",NA,4679,4374,-305,0.48315475532972496
2020,"Beeville, TX",NA,1924,1729,-195,0.47330960854092524
2020,"Bellefontaine, OH",NA,4455,4379,-76,0.4956984378537469
2020,"Bellingham, WA",NA,28814,27959,-855,0.4924700121536646
2020,"Bemidji, MN",NA,5019,4410,-609,0.46770601336302897
2020,"Bend, OR",NA,30172,33590,3418,0.5268027979047082
2020,"Bennettsville, SC",NA,1850,1804,-46,0.49370552818828684
2020,"Bennington, VT",NA,4293,4852,559,0.5305631492618917
2020,"Berlin, NH",NA,3820,3806,-14,0.4990820875950695
2020,"Big Rapids, MI",NA,5119,4856,-263,0.4868170426065163
2020,"Big Spring, TX",NA,3060,2553,-507,0.4548369855692143
2020,"Big Stone Gap, VA",NA,3130,2657,-473,0.4591325384482461
2020,"Billings, MT",NA,25195,23079,-2116,0.4780834403612711
2020,"Binghamton, NY",NA,26126,23912,-2214,0.4778768136216475
2020,"Birmingham-Hoover, AL",NA,101846,99782,-2064,0.49488166326105504
2020,"Bismarck, ND",NA,17457,13973,-3484,0.44457524657970093
2020,"Blackfoot, ID",NA,3912,3723,-189,0.48762278978388995
2020,"Blacksburg-Christiansburg, VA",NA,17802,14968,-2834,0.45675923100396704
2020,"Bloomington, IL",NA,17989,16510,-1479,0.47856459607524854
2020,"Bloomington, IN",NA,32675,17971,-14704,0.35483552501678317
2020,"Bloomsburg-Berwick, PA",NA,7727,7568,-159,0.49480222294867604
2020,"Bluefield, WV-VA",NA,8341,7564,-777,0.47557371895630307
2020,"Blytheville, AR",NA,4511,3896,-615,0.46342333769477817
2020,"Bogalusa, LA",NA,3726,3296,-430,0.46938194246653375
2020,"Boise City, ID",NA,91486,98365,6879,0.5181168389947907
2020,"Bonham, TX",NA,2747,3094,347,0.529703817839411
2020,"Boone, NC",NA,5907,5339,-568,0.47474657656055486
2020,"Borger, TX",NA,2127,1941,-186,0.4771386430678466
2020,"Boston-Cambridge-Newton, MA-NH",NA,545574,486354,-59220,0.4713061376375096
2020,"Boulder, CO",NA,54100,48901,-5199,0.4747623809477578
2020,"Bowling Green, KY",NA,19492,19733,241,0.5030720203951562
2020,"Bozeman, MT",NA,20277,19571,-706,0.49114133708090746
2020,"Bradford, PA",NA,4040,3817,-223,0.4858088328878707
2020,"Brainerd, MN",NA,14618,14872,254,0.5043065445913869
2020,"Branson, MO",NA,9213,8801,-412,0.4885644498723215
2020,"Breckenridge, CO",NA,4726,4787,61,0.5032061389677284
2020,"Bremerton-Silverdale-Port Orchard, WA",NA,34644,32174,-2470,0.48151695650872517
2020,"Brenham, TX",HOUSTON,2651,2844,193,0.5175614194722475
2020,"Brevard, NC",NA,3141,3757,616,0.5446506233690925
2020,"Bridgeport-Stamford-Norwalk, CT",NEW YORK,90585,96778,6193,0.5165267422063055
2020,"Brookhaven, MS",NA,2036,1992,-44,0.4945382323733863
2020,"Brookings, OR",NA,2912,3327,415,0.5332585350216381
2020,"Brookings, SD",NA,4212,3265,-947,0.4366724622174669
2020,"Brownsville-Harlingen, TX",NA,21653,25331,3678,0.539140984164822
2020,"Brownsville, TN",NA,1415,1482,67,0.5115636865723162
2020,"Brownwood, TX",NA,3858,3943,85,0.5054480194846814
2020,"Brunswick, GA",NA,13522,14037,515,0.5093435901157517
2020,"Bucyrus-Galion, OH",NA,4650,4329,-321,0.48212495823588375
2020,"Buffalo-Cheektowaga, NY",NA,111456,105713,-5743,0.4867775787520318
2020,"Burley, ID",NA,3679,3764,85,0.5057100631465807
2020,"Burlington-South Burlington, VT",NA,31504,28280,-3224,0.47303626388331327
2020,"Burlington, IA-IL",NA,5626,4633,-993,0.45160347012379376
2020,"Burlington, NC",NA,14559,16234,1675,0.5271977397460462
2020,"Butte-Silver Bow, MT",NA,4209,4094,-115,0.4930747922437673
2020,"Cadillac, MI",NA,6009,5511,-498,0.4783854166666667
2020,"Calhoun, GA",NA,5178,5389,211,0.5099839121794265
2020,"California-Lexington Park, MD",NA,9848,10013,165,0.5041538693922764
2020,"Cambridge, MD",NA,3038,2877,-161,0.4863905325443787
2020,"Cambridge, OH",NA,4006,3661,-345,0.4775009782183383
2020,"Camden, AR",NA,2078,1923,-155,0.48062984253936514
2020,"Campbellsville, KY",NA,3930,3580,-350,0.4766977363515313
2020,"Ca√±on City, CO",NA,5206,5340,134,0.5063531196662242
2020,"Canton-Massillon, OH",NA,38826,36443,-2383,0.4841701098725903
2020,"Cape Coral-Fort Myers, FL",NA,155193,184151,28958,0.5426676175208638
2020,"Cape Girardeau, MO-IL",NA,10191,9741,-450,0.48871161950632147
2020,"Carbondale-Marion, IL",NA,16045,13501,-2544,0.4569484871048535
2020,"Carlsbad-Artesia, NM",NA,5605,4833,-772,0.46301973558152903
2020,"Carroll, IA",NA,1718,1557,-161,0.47541984732824427
2020,"Carson City, NV",NA,7245,7162,-83,0.49711945582008743
2020,"Casper, WY",NA,10173,9584,-589,0.4850938907728906
2020,"Cedar City, UT",NA,5698,6247,549,0.522980326496442
2020,"Cedar Rapids, IA",NA,35663,30899,-4764,0.4642138156906343
2020,"Cedartown, GA",NA,4653,4141,-512,0.47088924266545373
2020,"Celina, OH",NA,2907,2645,-262,0.4764048991354467
2020,"Central City, KY",NA,2599,2318,-281,0.4714256660565385
2020,"Centralia, IL",NA,4159,3753,-406,0.4743427704752275
2020,"Centralia, WA",NA,8103,8476,373,0.5112491706375535
2020,"Chambersburg-Waynesboro, PA",NA,12606,12440,-166,0.49668609758045196
2020,"Champaign-Urbana, IL",NA,26945,23855,-3090,0.46958661417322833
2020,"Charleston-Mattoon, IL",NA,6601,6070,-531,0.4790466419382843
2020,"Charleston-North Charleston, SC",NA,102768,104502,1734,0.5041829497756549
2020,"Charleston, WV",NA,19398,18243,-1155,0.4846576870965171
2020,"Charlotte-Concord-Gastonia, NC-SC",NA,292478,307372,14894,0.5124147703592565
2020,"Charlottesville, VA",NA,23502,22994,-508,0.4945371644872677
2020,"Chattanooga, TN-GA",NA,60697,60788,91,0.500374531835206
2020,"Cheyenne, WY",NA,13616,13131,-485,0.49093356264253935
2020,"Chicago-Naperville-Elgin, IL-IN-WI",CHICAGO,928399,848543,-79856,0.4775299362612848
2020,"Chico, CA",NA,26148,23431,-2717,0.47259928598801915
2020,"Chillicothe, OH",NA,6940,6475,-465,0.48266865449124113
2020,"Cincinnati, OH-KY-IN",NA,218127,214344,-3783,0.49562629632969607
2020,"Clarksburg, WV",NA,6911,6196,-715,0.47272449835965513
2020,"Clarksdale, MS",NA,1650,1453,-197,0.46825652594263617
2020,"Clarksville, TN-KY",NA,42656,41324,-1332,0.492069540366754
2020,"Clearlake, CA",NA,6191,6299,108,0.5043234587670136
2020,"Cleveland-Elyria, OH",NA,204855,198680,-6175,0.49234886688886964
2020,"Cleveland, MS",NA,1933,1750,-183,0.4751561227260386
2020,"Cleveland, TN",NA,12445,12790,345,0.5068357440063403
2020,"Clewiston, FL",NA,3558,4308,750,0.547673531655225
2020,"Clinton, IA",NA,4777,4096,-681,0.461625154964499
2020,"Clovis, NM",NA,5948,5631,-317,0.4863114258571552
2020,"Coeur d'Alene, ID",NA,22830,26515,3685,0.5373391427702908
2020,"Coffeyville, KS",NA,4221,3365,-856,0.44358027946216716
2020,"Coldwater, MI",NA,4990,4517,-473,0.47512359314189545
2020,"College Station-Bryan, TX",NA,30254,27064,-3190,0.4721727903974319
2020,"Colorado Springs, CO",NA,116826,110928,-5898,0.4870518190679417
2020,"Columbia, MO",NA,27537,24264,-3273,0.4684079457925523
2020,"Columbia, SC",NA,80727,81324,597,0.5018420126997056
2020,"Columbus, GA-AL",NA,36120,33985,-2135,0.48477284073889165
2020,"Columbus, IN",NA,9700,8788,-912,0.47533535266118565
2020,"Columbus, MS",NA,5829,5403,-426,0.4810363247863248
2020,"Columbus, NE",NA,3648,3212,-436,0.46822157434402334
2020,"Columbus, OH",NA,241676,235049,-6627,0.49304945199014105
2020,"Concord, NH",NA,15488,16009,521,0.5082706289487888
2020,"Connersville, IN",NA,3273,2884,-389,0.46840993990579827
2020,"Cookeville, TN",NA,12162,12715,553,0.5111146842464928
2020,"Coos Bay, OR",NA,8633,8438,-195,0.49428855954542794
2020,"Cordele, GA",NA,1926,1902,-24,0.49686520376175547
2020,"Corinth, MS",NA,3017,2905,-112,0.4905437352245863
2020,"Cornelia, GA",NA,3554,3878,324,0.5217976318622174
2020,"Corning, NY",NA,10423,9447,-976,0.4754403623553095
2020,"Corpus Christi, TX",NA,44960,44269,-691,0.49612794046778513
2020,"Corsicana, TX",NA,3695,4066,371,0.5239015590774385
2020,"Cortland, NY",NA,5148,4707,-441,0.4776255707762557
2020,"Corvallis, OR",NA,12673,10759,-1914,0.4591584158415842
2020,"Coshocton, OH",NA,3043,3020,-23,0.49810324921655946
2020,"Craig, CO",NA,1602,1310,-292,0.4498626373626374
2020,"Crawfordsville, IN",NA,3990,3540,-450,0.4701195219123506
2020,"Crescent City, CA",NA,2689,2661,-28,0.4973831775700935
2020,"Crestview-Fort Walton Beach-Destin, FL",NA,42423,48942,6519,0.5356755869315384
2020,"Crossville, TN",NA,6383,7042,659,0.5245437616387337
2020,"Cullman, AL",NA,6952,7816,864,0.5292524377031419
2020,"Cullowhee, NC",NA,5856,6127,271,0.5113076858883419
2020,"Cumberland, MD-WV",NA,7107,6550,-557,0.4796075272753899
2020,"Dallas-Fort Worth-Arlington, TX",NA,858650,873102,14452,0.5041726528971816
2020,"Dalton, GA",NA,11254,10295,-959,0.4777483873961669
2020,"Danville, IL",NA,8934,7852,-1082,0.467770761348743
2020,"Danville, KY",NA,5512,5401,-111,0.4949143223678182
2020,"Danville, VA",NA,7810,7672,-138,0.49554321147138614
2020,"Daphne-Fairhope-Foley, AL",NA,27651,32854,5203,0.5429964465746633
2020,"Davenport-Moline-Rock Island, IA-IL",NA,44277,38271,-6006,0.46362116586713187
2020,"Dayton-Kettering, OH",NA,86336,84280,-2056,0.4939747737609603
2020,"Dayton, TN",NA,3180,3473,293,0.5220201412896438
2020,"Decatur, AL",NA,12988,12737,-251,0.4951214771622935
2020,"Decatur, IL",NA,13275,10727,-2548,0.44692108990917423
2020,"Decatur, IN",NA,2682,2349,-333,0.4669051878354204
2020,"Defiance, OH",NA,3779,3413,-366,0.47455506117908786
2020,"Del Rio, TX",NA,3706,3406,-300,0.47890888638920137
2020,"Deltona-Daytona Beach-Ormond Beach, FL",NA,97524,109882,12358,0.5297918093015631
2020,"Deming, NM",NA,2417,2419,2,0.500206782464847
2020,"Denver-Aurora-Lakewood, CO",NA,440442,425103,-15339,0.4911391088851533
2020,"DeRidder, LA",NA,3356,3034,-322,0.47480438184663537
2020,"Des Moines-West Des Moines, IA",NA,88574,85016,-3558,0.4897517138083991
2020,"Detroit-Warren-Dearborn, MI",NA,420944,394235,-26709,0.4836177085032858
2020,"Dickinson, ND",NA,4733,3873,-860,0.4500348594004183
2020,"Dixon, IL",NA,3081,2818,-263,0.4777080861162909
2020,"Dodge City, KS",NA,3790,2964,-826,0.4388510512289014
2020,"Dothan, AL",NA,16243,16320,77,0.5011823234959923
2020,"Douglas, GA",NA,4523,4010,-513,0.4699402320403141
2020,"Dover, DE",PHILADELPHIA,16090,17149,1059,0.5159300821324347
2020,"Dublin, GA",NA,4913,4783,-130,0.49329620462046203
2020,"DuBois, PA",NA,4831,4649,-182,0.49040084388185656
2020,"Dubuque, IA",NA,10438,9167,-1271,0.4675847997959704
2020,"Duluth, MN-WI",NA,33685,30847,-2838,0.4780109093163082
2020,"Dumas, TX",NA,2198,1526,-672,0.40977443609022557
2020,"Duncan, OK",NA,5035,4695,-340,0.48252826310380265
2020,"Durango, CO",NA,8021,8778,757,0.5225311030418477
2020,"Durant, OK",NA,5835,5358,-477,0.47869203966764945
2020,"Durham-Chapel Hill, NC",RALEIGH,68157,66701,-1456,0.4946017292262973
2020,"Dyersburg, TN",NA,4326,3975,-351,0.4788579689194073
2020,"Eagle Pass, TX",NA,2331,2472,141,0.5146783260462211
2020,"East Stroudsburg, PA",NA,15276,15277,1,0.5000163650050732
2020,"Easton, MD",NA,3267,3940,673,0.546690717358124
2020,"Eau Claire, WI",NA,20867,18686,-2181,0.47242939852855664
2020,"Edwards, CO",NA,5717,5148,-569,0.4738150023009664
2020,"Effingham, IL",NA,2964,2635,-329,0.4706197535274156
2020,"El Campo, TX",HOUSTON,3258,2880,-378,0.46920821114369504
2020,"El Centro, CA",NA,11475,11934,459,0.5098039215686274
2020,"El Dorado, AR",NA,3272,2943,-329,0.4735317779565567
2020,"El Paso, TX",NA,67292,64755,-2537,0.49039357198573236
2020,"Elizabeth City, NC",NA,4750,5091,341,0.5173254750533482
2020,"Elizabethtown-Fort Knox, KY",NA,18847,18249,-598,0.4919398317877938
2020,"Elk City, OK",NA,2315,1960,-355,0.4584795321637427
2020,"Elkhart-Goshen, IN",NA,21343,18411,-2932,0.4631232077275243
2020,"Elkins, WV",NA,2030,1825,-205,0.47341115434500647
2020,"Elko, NV",NA,6174,5407,-767,0.4668854157672049
2020,"Ellensburg, WA",NA,6400,5897,-503,0.47954785720094334
2020,"Elmira, NY",NA,9294,8430,-864,0.47562626946513203
2020,"Emporia, KS",NA,4536,3614,-922,0.4434355828220859
2020,"Enid, OK",NA,6926,5835,-1091,0.4572525664132905
2020,"Enterprise, AL",NA,5778,5734,-44,0.49808895066018066
2020,"Erie, PA",NA,27954,25394,-2560,0.476006598185499
2020,"Escanaba, MI",NA,3873,3753,-120,0.49213217938631
2020,"Espa√±ola, NM",NA,931,901,-30,0.49181222707423583
2020,"Eufaula, AL-GA",NA,1865,1784,-81,0.4889010687859688
2020,"Eugene-Springfield, OR",NA,52982,49793,-3189,0.48448552663585503
2020,"Eureka-Arcata, CA",NA,14952,13445,-1507,0.47346550691974504
2020,"Evanston, WY",NA,2317,1780,-537,0.43446424212838664
2020,"Evansville, IN-KY",NA,37396,34952,-2444,0.48310941560236637
2020,"Fairbanks, AK",NA,11466,9996,-1470,0.4657534246575342
2020,"Fairfield, IA",NA,2101,1831,-270,0.4656663275686673
2020,"Fairmont, MN",NA,1981,1760,-221,0.47046244319700614
2020,"Fairmont, WV",NA,4299,3841,-458,0.4718673218673219
2020,"Fallon, NV",NA,2710,2861,151,0.513552324537785
2020,"Fargo, ND-MN",NA,40896,33175,-7721,0.4478810870651132
2020,"Faribault-Northfield, MN",NA,6077,5838,-239,0.4899706252622744
2020,"Farmington, MO",NA,7365,7363,-2,0.4999321021184139
2020,"Farmington, NM",NA,8847,7805,-1042,0.46871246697093444
2020,"Fayetteville-Springdale-Rogers, AR",NA,64417,64581,164,0.5006356687700585
2020,"Fayetteville, NC",RALEIGH,66037,60212,-5825,0.47693051034067596
2020,"Fergus Falls, MN",NA,6526,6317,-209,0.4918632718212256
2020,"Fernley, NV",NA,6792,7172,380,0.5136064164995703
2020,"Findlay, OH",NA,7165,6389,-776,0.4713737642024495
2020,"Fitzgerald, GA",NA,1876,1820,-56,0.49242424242424243
2020,"Flagstaff, AZ",NA,18171,15904,-2267,0.4667351430667645
2020,"Flint, MI",NA,49717,45323,-4394,0.4768834175084175
2020,"Florence-Muscle Shoals, AL",NA,13732,13890,158,0.5028600390992687
2020,"Florence, SC",NA,15997,16251,254,0.5039382287273629
2020,"Fond du Lac, WI",NA,10460,9369,-1091,0.47248978768470423
2020,"Forest City, NC",NA,5655,5889,234,0.5101351351351351
2020,"Forrest City, AR",NA,1542,1462,-80,0.4866844207723036
2020,"Fort Collins, CO",NA,53480,51115,-2365,0.4886944882642574
2020,"Fort Dodge, IA",NA,4124,3548,-576,0.4624608967674661
2020,"Fort Leonard Wood, MO",NA,7236,6576,-660,0.476107732406603
2020,"Fort Madison-Keokuk, IA-IL-MO",NA,6043,4974,-1069,0.45148407007352276
2020,"Fort Morgan, CO",NA,2589,2543,-46,0.4955183164458301
2020,"Fort Payne, AL",NA,5250,5139,-111,0.49465781114640484
2020,"Fort Polk South, LA",NA,5202,4749,-453,0.47723846849562856
2020,"Fort Smith, AR-OK",NA,31098,27743,-3355,0.47149096718274675
2020,"Fort Wayne, IN",NA,49214,45189,-4025,0.4786818215522812
2020,"Frankfort, IN",NA,3199,2954,-245,0.4800910125142207
2020,"Frankfort, KY",NA,8422,8629,207,0.5060700252184622
2020,"Fredericksburg, TX",NA,2635,3055,420,0.5369068541300527
2020,"Freeport, IL",NA,4734,3813,-921,0.4461214461214461
2020,"Fremont, NE",NA,4099,3661,-438,0.4717783505154639
2020,"Fremont, OH",NA,4331,4009,-322,0.48069544364508393
2020,"Fresno, CA",FRESNO,78918,75315,-3603,0.48831962031471865
2020,"Gadsden, AL",NA,9245,9088,-157,0.4957181039655266
2020,"Gaffney, SC",NA,4113,3749,-364,0.47685067412872045
2020,"Gainesville, FL",NA,39902,38360,-1542,0.49014847563312974
2020,"Gainesville, GA",NA,17558,19121,1563,0.5213064696420295
2020,"Gainesville, TX",NA,4480,4031,-449,0.4736223710492304
2020,"Galesburg, IL",NA,5240,4174,-1066,0.44338219672827706
2020,"Gallup, NM",NA,2063,1612,-451,0.43863945578231295
2020,"Garden City, KS",NA,4742,3583,-1159,0.4303903903903904
2020,"Gardnerville Ranchos, NV",NA,5616,6255,639,0.5269143290371494
2020,"Georgetown, SC",NA,4837,5622,785,0.5375274882875992
2020,"Gettysburg, PA",NA,7422,7460,38,0.5012767101196076
2020,"Gillette, WY",NA,7479,6764,-715,0.47489995085305065
2020,"Glasgow, KY",NA,5343,5411,68,0.5031616142830575
2020,"Glens Falls, NY",NA,14762,14352,-410,0.49295871402074604
2020,"Glenwood Springs, CO",NA,11998,11655,-343,0.4927493341225215
2020,"Gloversville, NY",NA,5763,5452,-311,0.48613464110566207
2020,"Goldsboro, NC",RALEIGH,10745,10347,-398,0.4905651431822492
2020,"Granbury, TX",NA,6555,7928,1373,0.547400400469516
2020,"Grand Forks, ND-MN",NA,14345,11205,-3140,0.4385518590998043
2020,"Grand Island, NE",NA,9286,7180,-2106,0.4360500425118426
2020,"Grand Junction, CO",NA,22097,21392,-705,0.4918945020579917
2020,"Grand Rapids-Kentwood, MI",NA,124717,110097,-14620,0.46886897714787024
2020,"Grand Rapids, MN",NA,4591,4682,91,0.5049067184298501
2020,"Grants Pass, OR",NA,9301,10246,945,0.5241725072901212
2020,"Grants, NM",NA,883,954,71,0.5193249863908547
2020,"Great Bend, KS",NA,3084,2672,-412,0.4642112578179291
2020,"Great Falls, MT",NA,10436,9889,-547,0.4865436654366544
2020,"Greeley, CO",NA,36692,38774,2082,0.5137942914690059
2020,"Green Bay, WI",NA,38355,33887,-4468,0.46907616068215163
2020,"Greeneville, TN",NA,5420,6076,656,0.5285316631871956
2020,"Greensboro-High Point, NC",NA,79096,75541,-3555,0.4885053383084255
2020,"Greensburg, IN",NA,3323,2804,-519,0.4576464827811327
2020,"Greenville-Anderson, SC",NA,94412,98087,3675,0.509545504132489
2020,"Greenville, MS",NA,3720,3345,-375,0.4734607218683652
2020,"Greenville, NC",NA,18201,17152,-1049,0.48516391819647553
2020,"Greenville, OH",NA,4621,4283,-338,0.4810197663971249
2020,"Greenwood, MS",NA,2310,2079,-231,0.47368421052631576
2020,"Greenwood, SC",NA,5787,5544,-243,0.4892772041302621
2020,"Grenada, MS",NA,1878,1601,-277,0.4601897096866916
2020,"Gulfport-Biloxi, MS",NA,45626,45297,-329,0.4981907768111479
2020,"Guymon, OK",NA,1667,1206,-461,0.4197702749738949
2020,"Hagerstown-Martinsburg, MD-WV",NA,27810,29308,1498,0.5131132042438461
2020,"Hailey, ID",NA,2852,3326,474,0.538361929426999
2020,"Hammond, LA",NA,10101,10789,688,0.5164672091910005
2020,"Hanford-Corcoran, CA",FRESNO,11814,10524,-1290,0.4711254364759602
2020,"Hannibal, MO",NA,4458,3818,-640,0.4613339777670372
2020,"Harrisburg-Carlisle, PA",NA,62939,62655,-284,0.498869372740736
2020,"Harrison, AR",NA,4285,4376,91,0.5052534349382288
2020,"Harrisonburg, VA",NA,11441,10588,-853,0.4806391574742385
2020,"Hartford-East Hartford-Middletown, CT",NA,123495,122393,-1102,0.4977591423737637
2020,"Hastings, NE",NA,3809,2996,-813,0.4402645113886848
2020,"Hattiesburg, MS",NA,16429,15325,-1104,0.4826163632928135
2020,"Hays, KS",NA,3821,3114,-707,0.44902667627974047
2020,"Heber, UT",NA,9293,11090,1797,0.544080851690134
2020,"Helena-West Helena, AR",NA,1631,1378,-253,0.45795945496842805
2020,"Helena, MT",NA,10077,10540,463,0.5112285977591308
2020,"Henderson, NC",RALEIGH,3944,3422,-522,0.4645669291338583
2020,"Hereford, TX",NA,1379,1163,-216,0.45751376868607396
2020,"Hermiston-Pendleton, OR",NA,8960,7973,-987,0.4708557255064076
2020,"Hickory-Lenoir-Morganton, NC",NA,27835,28704,869,0.5076849608235023
2020,"Hillsdale, MI",NA,4710,4392,-318,0.48253131179960446
2020,"Hilo, HI",NA,17681,19642,1961,0.5262706642016987
2020,"Hilton Head Island-Bluffton, SC",NA,26079,32122,6043,0.5519149155512791
2020,"Hinesville, GA",NA,12290,11735,-555,0.48844953173777317
2020,"Hobbs, NM",NA,6286,4999,-1287,0.44297740363314136
2020,"Holland, MI",NA,10128,10093,-35,0.4991345630779882
2020,"Homosassa Springs, FL",NA,23024,27309,4285,0.5425665070629607
2020,"Hood River, OR",NA,2520,2731,211,0.5200914111597791
2020,"Hope, AR",NA,2103,1839,-264,0.4665144596651446
2020,"Hot Springs, AR",NA,14464,14393,-71,0.49876979589007864
2020,"Houghton, MI",NA,4233,3616,-617,0.4606956300165626
2020,"Houma-Thibodaux, LA",NA,14472,13742,-730,0.48706316013326717
2020,"Houston-The Woodlands-Sugar Land, TX",HOUSTON,661661,676459,14798,0.5055293994559531
2020,"Hudson, NY",NA,5375,8404,3029,0.6099136366935192
2020,"Huntingdon, PA",NA,2613,2493,-120,0.4882491186839013
2020,"Huntington-Ashland, WV-KY-OH",NA,29314,27274,-2040,0.4819749770269315
2020,"Huntington, IN",NA,4379,3905,-474,0.4713906325446644
2020,"Huntsville, AL",NA,49402,52728,3326,0.5162831685107216
2020,"Huntsville, TX",HOUSTON,6008,5705,-303,0.48706565354734055
2020,"Huron, SD",NA,2204,1897,-307,0.462570104852475
2020,"Hutchinson, KS",NA,8288,6892,-1396,0.4540184453227932
2020,"Hutchinson, MN",NA,3516,3233,-283,0.4790339309527337
2020,"Idaho Falls, ID",NA,15501,16396,895,0.5140295325579208
2020,"Indiana, PA",NA,5786,5537,-249,0.4890046807383202
2020,"Indianapolis-Carmel-Anderson, IN",NA,263703,256853,-6850,0.49342049654600084
2020,"Indianola, MS",NA,1367,1180,-187,0.46329014526894385
2020,"Iowa City, IA",NA,23713,20601,-3112,0.4648869431782281
2020,"Iron Mountain, MI-WI",NA,2977,2768,-209,0.48181026979982594
2020,"Ithaca, NY",NA,12944,11233,-1711,0.46461513008230965
2020,"Jackson, MI",NA,16591,15285,-1306,0.47951436817668464
2020,"Jackson, MS",NA,50464,48515,-1949,0.49015447721233796
2020,"Jackson, OH",NA,2656,2638,-18,0.4982999622213827
2020,"Jackson, TN",NA,17918,17899,-19,0.4997347628221236
2020,"Jackson, WY-ID",NA,4591,4752,161,0.5086160762067858
2020,"Jacksonville, FL",NA,207253,222699,15446,0.5179624702292349
2020,"Jacksonville, IL",NA,3507,3425,-82,0.4940854010386613
2020,"Jacksonville, NC",NA,30148,28060,-2088,0.482064321055525
2020,"Jacksonville, TX",NA,3083,3024,-59,0.4951694776486
2020,"Jamestown-Dunkirk-Fredonia, NY",NA,14459,13691,-768,0.48635879218472466
2020,"Jamestown, ND",NA,2266,2005,-261,0.4694450948255678
2020,"Janesville-Beloit, WI",NA,17863,16921,-942,0.48645929162833484
2020,"Jasper, AL",NA,5163,4950,-213,0.48946900029664786
2020,"Jasper, IN",NA,4696,4521,-175,0.49050667245307583
2020,"Jefferson City, MO",NA,13438,12826,-612,0.48834907097167224
2020,"Jefferson, GA",NA,6658,8195,1537,0.5517403891469737
2020,"Jennings, LA",NA,2299,2390,91,0.509703561526978
2020,"Jesup, GA",NA,3042,2740,-302,0.47388446904185405
2020,"Johnson City, TN",NA,21180,21220,40,0.5004716981132076
2020,"Johnstown, PA",NA,9138,8986,-152,0.49580666519532113
2020,"Jonesboro, AR",NA,17354,15722,-1632,0.4753295440802999
2020,"Joplin, MO",NA,21955,20627,-1328,0.48440655676107275
2020,"Juneau, AK",NA,3166,2837,-329,0.47259703481592535
2020,"Kahului-Wailuku-Lahaina, HI",NA,19563,19394,-169,0.49783094180763404
2020,"Kalamazoo-Portage, MI",NA,34081,28364,-5717,0.45422371687084634
2020,"Kalispell, MT",NA,14262,16503,2241,0.5364212579229644
2020,"Kankakee, IL",CHICAGO,12257,9961,-2296,0.4483301827347196
2020,"Kansas City, MO-KS",NA,243955,240408,-3547,0.49633848993420226
2020,"Kapaa, HI",NA,6609,6371,-238,0.49083204930662555
2020,"Kearney, NE",NA,6396,5420,-976,0.45870006770480704
2020,"Keene, NH",NA,8371,8356,-15,0.4995516231242901
2020,"Kendallville, IN",NA,4563,4122,-441,0.47461139896373056
2020,"Kennett, MO",NA,3665,3311,-354,0.47462729357798167
2020,"Kennewick-Richland, WA",NA,29394,29249,-145,0.4987637058131405
2020,"Kerrville, TX",NA,5771,5791,20,0.500864902266044
2020,"Ketchikan, AK",NA,1766,1602,-164,0.47565320665083133
2020,"Key West, FL",NA,18415,20143,1728,0.5224078012345038
2020,"Kill Devil Hills, NC",NA,4118,4927,809,0.5447208402432283
2020,"Killeen-Temple, TX",NA,64347,63452,-895,0.49649840765577197
2020,"Kingsport-Bristol, TN-VA",NA,27299,28772,1473,0.513135132243049
2020,"Kingston, NY",NEW YORK,16452,19949,3497,0.5480343946594873
2020,"Kingsville, TX",NA,3142,2687,-455,0.4609710070337965
2020,"Kinston, NC",NA,5040,4534,-506,0.4735742636306664
2020,"Kirksville, MO",NA,3830,2902,-928,0.43107546048722517
2020,"Klamath Falls, OR",NA,7070,7598,528,0.5179983637851104
2020,"Knoxville, TN",NA,90348,93326,2978,0.5081067543582651
2020,"Kokomo, IN",NA,12986,9737,-3249,0.42850855960920653
2020,"La Crosse-Onalaska, WI-MN",NA,16931,14746,-2185,0.4655112542223064
2020,"La Grande, OR",NA,3586,3006,-580,0.45600728155339804
2020,"Laconia, NH",NA,8781,9176,395,0.510998496408086
2020,"Lafayette-West Lafayette, IN",NA,29088,22832,-6256,0.4397534668721109
2020,"Lafayette, LA",NA,40026,39907,-119,0.49925562658726685
2020,"LaGrange, GA-AL",NA,9570,9724,154,0.5039908779931584
2020,"Lake Charles, LA",NA,30208,22881,-7327,0.4309932377705363
2020,"Lake City, FL",NA,7066,7331,265,0.5092033062443565
2020,"Lake Havasu City-Kingman, AZ",NA,30998,36837,5839,0.5430382545883393
2020,"Lakeland-Winter Haven, FL",NA,104501,118731,14230,0.5318726705848624
2020,"Lamesa, TX",NA,828,675,-153,0.4491017964071856
2020,"Lancaster, PA",NA,48590,46600,-1990,0.48954722134678014
2020,"Lansing-East Lansing, MI",NA,64342,56036,-8306,0.4655003405937962
2020,"Laramie, WY",NA,5973,4713,-1260,0.44104435710275125
2020,"Laredo, TX",NA,12329,12551,222,0.5044614147909968
2020,"Las Cruces, NM",NA,17939,18702,763,0.5104118337381621
2020,"Las Vegas-Henderson-Paradise, NV",NA,306738,317451,10713,0.5085815354003355
2020,"Las Vegas, NM",NA,1924,1738,-186,0.474604041507373
2020,"Laurel, MS",NA,5567,4989,-578,0.47262220538082605
2020,"Laurinburg, NC",NA,2246,2308,62,0.5068072024593764
2020,"Lawrence, KS",NA,16483,15021,-1462,0.47679659725749113
2020,"Lawrenceburg, TN",NA,4418,4551,133,0.507414427472405
2020,"Lawton, OK",NA,16106,15371,-735,0.48832480859039934
2020,"Lebanon, MO",NA,4159,4209,50,0.5029875717017208
2020,"Lebanon, NH-VT",NA,25703,26714,1011,0.5096438178453555
2020,"Lebanon, PA",NA,12897,12731,-166,0.49676135476822225
2020,"Levelland, TX",NA,1485,1361,-124,0.4782150386507379
2020,"Lewisburg, PA",NA,3211,2893,-318,0.47395150720838797
2020,"Lewisburg, TN",NA,3183,3470,287,0.521569216894634
2020,"Lewiston-Auburn, ME",NA,12956,12154,-802,0.4840302668259657
2020,"Lewiston, ID-WA",NA,7390,6876,-514,0.48198513949249966
2020,"Lewistown, PA",NA,4362,4202,-160,0.49065857076132646
2020,"Lexington-Fayette, KY",NA,64860,61839,-3021,0.4880780432363318
2020,"Lexington, NE",NA,2747,2359,-388,0.4620054837446142
2020,"Liberal, KS",NA,1700,1497,-203,0.4682514857679074
2020,"Lima, OH",NA,10395,9689,-706,0.48242381995618405
2020,"Lincoln, IL",NA,2427,2083,-344,0.46186252771618624
2020,"Lincoln, NE",NA,45694,38571,-7123,0.45773452797721476
2020,"Little Rock-North Little Rock-Conway, AR",NA,87256,84825,-2431,0.49293646596660873
2020,"Lock Haven, PA",NA,3200,3161,-39,0.4969344442697689
2020,"Logan, UT-ID",NA,17969,14176,-3793,0.44100171099704466
2020,"Logansport, IN",NA,4320,3473,-847,0.4456563582702425
2020,"London, KY",NA,10938,10783,-155,0.4964320243082731
2020,"Longview, TX",NA,26972,26958,-14,0.4998702021138513
2020,"Longview, WA",NA,12356,12002,-354,0.49273339354626816
2020,"Los Alamos, NM",NA,2067,1970,-97,0.4879861283131038
2020,"Los Angeles-Long Beach-Anaheim, CA",LOS ANGELES,1215530,1094419,-121111,0.4737849190609836
2020,"Louisville/Jefferson County, KY-IN",NA,144722,137572,-7150,0.4873358980353816
2020,"Lubbock, TX",NA,36193,34159,-2034,0.48554412099158517
2020,"Ludington, MI",NA,3471,3513,42,0.5030068728522337
2020,"Lufkin, TX",NA,7360,7312,-48,0.4983642311886587
2020,"Lumberton, NC",NA,9038,8456,-582,0.4833657253915628
2020,"Lynchburg, VA",NA,24272,23695,-577,0.49398544832905955
2020,"Macomb, IL",NA,3237,2811,-426,0.46478174603174605
2020,"Macon-Bibb County, GA",NA,21595,21278,-317,0.4963030345438854
2020,"Madera, CA",FRESNO,9630,10468,838,0.5208478455567718
2020,"Madison, IN",NA,3424,3222,-202,0.48480288895576285
2020,"Madison, WI",NA,88992,80420,-8572,0.47470072958232
2020,"Madisonville, KY",NA,4441,4350,-91,0.4948242520759868
2020,"Magnolia, AR",NA,1683,1627,-56,0.49154078549848945
2020,"Malone, NY",NA,5244,5061,-183,0.4911208151382824
2020,"Malvern, AR",NA,2930,2794,-136,0.4881201956673655
2020,"Manchester-Nashua, NH",NA,46749,45711,-1038,0.4943867618429591
2020,"Manhattan, KS",NA,23825,17521,-6304,0.4237652977313404
2020,"Manitowoc, WI",NA,7522,7012,-510,0.4824549332599422
2020,"Mankato, MN",NA,15206,11182,-4024,0.42375322116113384
2020,"Mansfield, OH",NA,12670,11835,-835,0.48296266068149357
2020,"Marietta, OH",NA,5283,4823,-460,0.4772412428260439
2020,"Marinette, WI-MI",NA,6455,5903,-552,0.47766628904353453
2020,"Marion, IN",NA,7836,6942,-894,0.4697523345513601
2020,"Marion, NC",NA,3214,3572,358,0.5263778367226644
2020,"Marion, OH",NA,6272,6037,-235,0.4904541392477049
2020,"Marquette, MI",NA,8463,7210,-1253,0.4600267976775346
2020,"Marshall, MN",NA,2939,2571,-368,0.4666061705989111
2020,"Marshall, MO",NA,2306,2143,-163,0.4816812766913913
2020,"Marshalltown, IA",NA,4230,3700,-530,0.4665825977301387
2020,"Martin, TN",NA,3501,3032,-469,0.46410531149548445
2020,"Martinsville, VA",NA,5399,5179,-220,0.4896010588012857
2020,"Maryville, MO",NA,1944,1607,-337,0.45254857786539004
2020,"Mason City, IA",NA,6319,5389,-930,0.46028356679193716
2020,"Mayfield, KY",NA,3747,3208,-539,0.4612508986340762
2020,"Maysville, KY",NA,1777,1683,-94,0.4864161849710983
2020,"McAlester, OK",NA,3564,3495,-69,0.4951126221844454
2020,"McAllen-Edinburg-Mission, TX",NA,41936,46059,4123,0.5234274674697426
2020,"McComb, MS",NA,3600,3233,-367,0.4731450314649495
2020,"McMinnville, TN",NA,4225,4284,59,0.503466917381596
2020,"McPherson, KS",NA,3231,3041,-190,0.4848533163265306
2020,"Meadville, PA",NA,8195,7439,-756,0.4758219265702955
2020,"Medford, OR",NA,31390,31391,1,0.5000079641929883
2020,"Memphis, TN-MS-AR",NA,133221,130546,-2675,0.4949292367885293
2020,"Menomonie, WI",NA,4847,4165,-682,0.4621615623612961
2020,"Merced, CA",FRESNO,19997,19940,-57,0.49928637604226656
2020,"Meridian, MS",NA,7420,7077,-343,0.48816996619990344
2020,"Mexico, MO",NA,2455,2377,-78,0.4919288079470199
2020,"Miami-Fort Lauderdale-Pompano Beach, FL",NA,796111,783703,-12408,0.49607295542386637
2020,"Miami, OK",NA,3167,3009,-158,0.48720854922279794
2020,"Michigan City-La Porte, IN",CHICAGO,10740,9820,-920,0.4776264591439689
2020,"Middlesborough, KY",NA,1872,1793,-79,0.4892223738062756
2020,"Midland, MI",NA,9328,8660,-668,0.48143206582165887
2020,"Midland, TX",NA,21608,16862,-4746,0.4383155705744736
2020,"Milledgeville, GA",NA,3814,3674,-140,0.4906517094017094
2020,"Milwaukee-Waukesha, WI",NA,186298,171877,-14421,0.479868779228031
2020,"Minden, LA",NA,4115,3374,-741,0.4505274402456937
2020,"Mineral Wells, TX",NA,2875,2889,14,0.5012144344205413
2020,"Minneapolis-St. Paul-Bloomington, MN-WI",NA,450923,414962,-35961,0.47923454038353824
2020,"Minot, ND",NA,10220,8019,-2201,0.4396622621854268
2020,"Missoula, MT",NA,18047,17086,-961,0.4863233996527481
2020,"Mitchell, SD",NA,3016,2304,-712,0.4330827067669173
2020,"Moberly, MO",NA,2695,2630,-65,0.49389671361502346
2020,"Mobile, AL",NA,40181,38670,-1511,0.4904186376837326
2020,"Modesto, CA",NA,43718,40098,-3620,0.4784050777894435
2020,"Monroe, LA",NA,21038,19928,-1110,0.4864521798564663
2020,"Monroe, MI",NA,13023,12930,-93,0.4982082996185412
2020,"Montgomery, AL",NA,39240,37503,-1737,0.48868300691919786
2020,"Montrose, CO",NA,6318,6195,-123,0.4950851114840566
2020,"Morehead City, NC",NA,6716,7746,1030,0.5356105656202461
2020,"Morgan City, LA",NA,3659,3243,-416,0.4698638075920023
2020,"Morgantown, WV",NA,13642,11321,-2321,0.453511196570925
2020,"Morristown, TN",NA,12896,13795,899,0.5168408826945412
2020,"Moscow, ID",NA,5347,4715,-632,0.4685947127807593
2020,"Moses Lake, WA",NA,8608,8441,-167,0.4951023520441082
2020,"Moultrie, GA",NA,3394,3299,-95,0.49290303301957267
2020,"Mount Airy, NC",NA,4985,5033,48,0.5023956877620284
2020,"Mount Gay-Shamrock, WV",NA,817,913,96,0.5277456647398844
2020,"Mount Pleasant, MI",NA,7159,6348,-811,0.46997852965129194
2020,"Mount Pleasant, TX",NA,3158,3179,21,0.5016569354584188
2020,"Mount Sterling, KY",NA,4744,4704,-40,0.497883149872989
2020,"Mount Vernon-Anacortes, WA",NA,14533,14112,-421,0.4926514225868389
2020,"Mount Vernon, IL",NA,3548,3082,-466,0.46485671191553546
2020,"Mount Vernon, OH",NA,7132,5530,-1602,0.43673985152424577
2020,"Mountain Home, AR",NA,4815,4932,117,0.5060018467220684
2020,"Mountain Home, ID",NA,3982,3658,-324,0.4787958115183246
2020,"Muncie, IN",NA,13136,11363,-1773,0.46381484958569735
2020,"Murray, KY",NA,4629,4070,-559,0.4678698701000115
2020,"Muscatine, IA",NA,5279,4361,-918,0.4523858921161826
2020,"Muskegon, MI",NA,18154,17292,-862,0.48784065903063817
2020,"Muskogee, OK",NA,7839,6611,-1228,0.45750865051903117
2020,"Myrtle Beach-Conway-North Myrtle Beach, SC-NC",NA,61782,78094,16312,0.5583087877834654
2020,"Nacogdoches, TX",NA,5507,4921,-586,0.47190257000383584
2020,"Napa, CA",SAN FRANCISCO,13033,12701,-332,0.49354938991217845
2020,"Naples-Marco Island, FL",NA,83439,100054,16615,0.5452742066454851
2020,"Nashville-Davidson--Murfreesboro--Franklin, TN",NA,244781,242800,-1981,0.497968542662655
2020,"Natchez, MS-LA",NA,3452,3292,-160,0.48813760379596677
2020,"Natchitoches, LA",NA,3169,2822,-347,0.47103989317309297
2020,"New Bern, NC",NA,13955,13243,-712,0.48691080226487243
2020,"New Castle, IN",NA,4584,4255,-329,0.48138929743183617
2020,"New Castle, PA",NA,6981,6999,18,0.5006437768240344
2020,"New Haven-Milford, CT",NA,85882,84355,-1527,0.49551507604104866
2020,"New Orleans-Metairie, LA",NA,109376,105047,-4329,0.48990546723066086
2020,"New Philadelphia-Dover, OH",NA,8101,7579,-522,0.4833545918367347
2020,"New Ulm, MN",NA,2427,2204,-223,0.4759231267544807
2020,"New York-Newark-Jersey City, NY-NJ-PA",NEW YORK,1829655,1497482,-332173,0.4500812560468655
2020,"Newberry, SC",NA,2605,2865,260,0.5237659963436929
2020,"Newport, OR",NA,8029,8075,46,0.501428216592151
2020,"Newport, TN",NA,3257,3509,252,0.518622524386639
2020,"Niles, MI",NA,17139,16232,-907,0.48641035629738394
2020,"Nogales, AZ",NA,3412,3880,468,0.5320899616017554
2020,"Norfolk, NE",NA,5238,4243,-995,0.447526632211792
2020,"North Platte, NE",NA,4435,3683,-752,0.45368317319536833
2020,"North Port-Sarasota-Bradenton, FL",NA,157811,187710,29899,0.543266545304048
2020,"North Vernon, IN",NA,2437,2375,-62,0.4935577722360765
2020,"North Wilkesboro, NC",NA,3733,3936,203,0.5132351023601512
2020,"Norwalk, OH",NA,5637,5229,-408,0.481225842076201
2020,"Norwich-New London, CT",NA,31009,31367,358,0.5028696934718482
2020,"Oak Harbor, WA",NA,11310,11089,-221,0.4950667440510737
2020,"Ocala, FL",NA,47408,53734,6326,0.5312728638943268
2020,"Ocean City, NJ",PHILADELPHIA,13149,15196,2047,0.5361086611395308
2020,"Odessa, TX",NA,19426,14816,-4610,0.43268500671689736
2020,"Ogden-Clearfield, UT",NA,64494,63662,-832,0.49675395611598366
2020,"Ogdensburg-Massena, NY",NA,11648,9992,-1656,0.4617375231053604
2020,"Oil City, PA",NA,4061,3966,-95,0.4940824716581537
2020,"Okeechobee, FL",NA,5390,6573,1183,0.5494441193680515
2020,"Oklahoma City, OK",NA,157853,151570,-6283,0.4898472317830284
2020,"Olean, NY",NA,7252,6680,-572,0.4794717197817973
2020,"Olympia-Lacey-Tumwater, WA",NA,34388,34830,442,0.5031928111184952
2020,"Omaha-Council Bluffs, NE-IA",NA,113161,105034,-8127,0.4813767501546782
2020,"Oneonta, NY",NA,5312,5167,-145,0.4930814008970322
2020,"Ontario, OR-ID",NA,5878,5629,-249,0.4891804988268011
2020,"Opelousas, LA",NA,5842,5671,-171,0.49257361243811343
2020,"Orangeburg, SC",NA,6307,6113,-194,0.49219001610305957
2020,"Orlando-Kissimmee-Sanford, FL",NA,409707,401952,-7755,0.49522274748385714
2020,"Oshkosh-Neenah, WI",NA,19561,17926,-1635,0.47819244004588257
2020,"Oskaloosa, IA",NA,2133,1901,-232,0.4712444224095191
2020,"Othello, WA",NA,1209,1186,-23,0.4951983298538622
2020,"Ottawa, IL",CHICAGO,12773,11328,-1445,0.47002199078876394
2020,"Ottawa, KS",NA,2694,2494,-200,0.4807247494217425
2020,"Ottumwa, IA",NA,5125,4017,-1108,0.4394005688033253
2020,"Owatonna, MN",NA,4068,3652,-416,0.4730569948186529
2020,"Owensboro, KY",NA,12589,11716,-873,0.48204073235959677
2020,"Oxford, MS",NA,5598,4602,-996,0.4511764705882353
2020,"Oxnard-Thousand Oaks-Ventura, CA",LOS ANGELES,68638,70208,1570,0.5056537458767267
2020,"Ozark, AL",NA,5829,5380,-449,0.47997145151217774
2020,"Paducah, KY-IL",NA,11061,10280,-781,0.4817018883838621
2020,"Pahrump, NV",NA,6192,7262,1070,0.5397651256132006
2020,"Palatka, FL",NA,8131,8626,495,0.5147699468878677
2020,"Palestine, TX",NA,3761,3771,10,0.5006638343069569
2020,"Palm Bay-Melbourne-Titusville, FL",NA,87478,96425,8947,0.5243253236760683
2020,"Pampa, TX",NA,1788,1654,-134,0.48053457292271934
2020,"Panama City, FL",NA,24741,27957,3216,0.5305134919731299
2020,"Paragould, AR",NA,5581,5320,-261,0.4880286212274103
2020,"Paris, TN",NA,3408,3307,-101,0.4924795234549516
2020,"Paris, TX",NA,5099,4942,-157,0.4921820535803207
2020,"Parkersburg-Vienna, WV",NA,7652,7487,-165,0.49455049871193607
2020,"Parsons, KS",NA,2392,1946,-446,0.44859382203780546
2020,"Payson, AZ",NA,6360,6316,-44,0.49826443673082993
2020,"Pearsall, TX",NA,1033,947,-86,0.4782828282828283
2020,"Pecos, TX",NA,756,667,-89,0.46872803935347856
2020,"Pella, IA",NA,3350,2977,-373,0.47052315473368106
2020,"Pensacola-Ferry Pass-Brent, FL",NA,59113,62460,3347,0.5137653919867076
2020,"Peoria, IL",NA,43667,38619,-5048,0.4693264953941132
2020,"Peru, IN",NA,3864,3310,-554,0.46138834680791746
2020,"Philadelphia-Camden-Wilmington, PA-NJ-DE-MD",PHILADELPHIA,539257,515349,-23908,0.48866496113240393
2020,"Phoenix-Mesa-Chandler, AZ",NA,671126,723271,52145,0.5186980465391133
2020,"Picayune, MS",NA,4838,4696,-142,0.49255296832389345
2020,"Pierre, SD",NA,2273,2208,-65,0.49274715465297925
2020,"Pine Bluff, AR",NA,7054,6336,-718,0.47318894697535474
2020,"Pinehurst-Southern Pines, NC",RALEIGH,9211,11085,1874,0.5461667323610564
2020,"Pittsburg, KS",NA,5236,4335,-901,0.45293072824156305
2020,"Pittsburgh, PA",NA,211277,196703,-14574,0.48213883033482036
2020,"Pittsfield, MA",NA,14028,16152,2124,0.5351888667992047
2020,"Plainview, TX",NA,2511,2264,-247,0.47413612565445024
2020,"Platteville, WI",NA,4989,4432,-557,0.4704383823373315
2020,"Plattsburgh, NY",NA,9231,8190,-1041,0.4701222662304116
2020,"Plymouth, IN",NA,4418,4176,-242,0.4859204095880847
2020,"Pocatello, ID",NA,11660,10074,-1586,0.46351338915984175
2020,"Point Pleasant, WV-OH",NA,3895,3653,-242,0.4839692633810281
2020,"Ponca City, OK",NA,5368,4820,-548,0.4731056144483706
2020,"Pontiac, IL",NA,2978,2704,-274,0.4758887715593101
2020,"Poplar Bluff, MO",NA,7840,7493,-347,0.4886845366203613
2020,"Port Angeles, WA",NA,8825,9317,492,0.5135596957336567
2020,"Port Lavaca, TX",HOUSTON,1322,1311,-11,0.49791112799088494
2020,"Port St. Lucie, FL",NA,70878,81849,10971,0.535917028423265
2020,"Portales, NM",NA,2125,1815,-310,0.4606598984771574
2020,"Portland-South Portland, ME",NA,69522,74421,4899,0.5170171526229133
2020,"Portland-Vancouver-Hillsboro, OR-WA",NA,336105,323212,-12893,0.49022245748251597
2020,"Portsmouth, OH",NA,6697,6358,-339,0.48701646878590577
2020,"Pottsville, PA",NA,12383,12221,-162,0.49670785238172654
2020,"Poughkeepsie-Newburgh-Middletown, NY",NEW YORK,55055,58819,3764,0.516527038656761
2020,"Prescott Valley-Prescott, AZ",NA,32606,37501,4895,0.5349109218765601
2020,"Price, UT",NA,1912,1819,-93,0.48753685339051195
2020,"Prineville, OR",NA,3594,3697,103,0.5070635029488411
2020,"Providence-Warwick, RI-MA",NA,158489,161328,2839,0.5044384757533215
2020,"Provo-Orem, UT",NA,56817,57779,962,0.5041973541833921
2020,"Pueblo, CO",NA,19092,18934,-158,0.4979224740966707
2020,"Pullman, WA",NA,6326,4667,-1659,0.4245428909305922
2020,"Punta Gorda, FL",NA,39658,48417,8759,0.549724666477434
2020,"Quincy, IL-MO",NA,7051,6065,-986,0.4624123208295212
2020,"Racine, WI",NA,20296,19537,-759,0.49047272362111816
2020,"Raleigh-Cary, NC",RALEIGH,157623,170607,12984,0.5197788136367791
2020,"Rapid City, SD",NA,19728,19770,42,0.5005316724897463
2020,"Raymondville, TX",NA,614,733,119,0.5441722345953972
2020,"Reading, PA",PHILADELPHIA,37551,36447,-1104,0.49254033892807914
2020,"Red Bluff, CA",NA,7208,6870,-338,0.48799545389970167
2020,"Red Wing, MN",NA,4437,4406,-31,0.49824720117607146
2020,"Redding, CA",NA,20684,18924,-1760,0.4777822662088467
2020,"Reno, NV",NA,62689,64159,1470,0.5057943365287588
2020,"Rexburg, ID",NA,8334,6224,-2110,0.4275312542931721
2020,"Richmond-Berea, KY",NA,12277,12495,218,0.5044001291781043
2020,"Richmond, IN",NA,8110,6854,-1256,0.45803261160117614
2020,"Richmond, VA",NA,136795,138080,1285,0.502337426102774
2020,"Rio Grande City-Roma, TX",NA,1349,1334,-15,0.4972046216921357
2020,"Riverside-San Bernardino-Ontario, CA",LOS ANGELES,393281,415442,22161,0.5137012302110858
2020,"Riverton, WY",NA,3551,3502,-49,0.4965263008648802
2020,"Roanoke Rapids, NC",RALEIGH,4668,4591,-77,0.49584188357274006
2020,"Roanoke, VA",NA,32442,32232,-210,0.49837647277112906
2020,"Rochelle, IL",NA,4389,4162,-227,0.48672669863173895
2020,"Rochester, MN",NA,24869,23915,-954,0.4902222040013119
2020,"Rochester, NY",NA,118651,112207,-6444,0.48604336865085895
2020,"Rock Springs, WY",NA,5108,4525,-583,0.4697394373507734
2020,"Rockford, IL",NA,36869,33915,-2954,0.47913370253164556
2020,"Rockingham, NC",NA,3198,3056,-142,0.48864726574992007
2020,"Rockport, TX",NA,2694,3966,1272,0.5954954954954955
2020,"Rocky Mount, NC",RALEIGH,11664,11886,222,0.5047133757961784
2020,"Rolla, MO",NA,5573,5260,-313,0.4855534016431275
2020,"Rome, GA",NA,9954,8710,-1244,0.46667381054436347
2020,"Roseburg, OR",NA,12495,12756,261,0.5051681121539741
2020,"Roswell, NM",NA,5766,5260,-506,0.4770542354434972
2020,"Ruidoso, NM",NA,2696,2534,-162,0.4845124282982792
2020,"Russellville, AR",NA,9011,8275,-736,0.47871109568436887
2020,"Ruston, LA",NA,4533,3859,-674,0.4598427073403241
2020,"Rutland, VT",NA,6617,6581,-36,0.49863615699348385
2020,"Sacramento-Roseville-Folsom, CA",NA,244664,245173,509,0.5005195605885223
2020,"Safford, AZ",NA,3832,2863,-969,0.4276325616131441
2020,"Saginaw, MI",NA,19944,18217,-1727,0.47737218626346267
2020,"Salem, OH",NA,9306,8990,-316,0.49136423261915174
2020,"Salem, OR",NA,52794,46724,-6070,0.4695030044816013
2020,"Salina, KS",NA,7873,6896,-977,0.4669239623535784
2020,"Salinas, CA",NA,30728,29144,-1584,0.48677177979690006
2020,"Salisbury, MD-DE",NA,43955,50712,6757,0.5356882546188217
2020,"Salt Lake City, UT",NA,147062,135411,-11651,0.47937678999408795
2020,"San Angelo, TX",NA,13414,11604,-1810,0.4638260452474219
2020,"San Antonio-New Braunfels, TX",NA,271584,277892,6308,0.5057400141225459
2020,"San Diego-Chula Vista-Carlsbad, CA",NA,395847,378992,-16855,0.4891235469562064
2020,"San Francisco-Oakland-Berkeley, CA",SAN FRANCISCO,556385,457018,-99367,0.45097360082810095
2020,"San Jose-Sunnyvale-Santa Clara, CA",SAN FRANCISCO,228940,198342,-30598,0.4641946068404473
2020,"San Luis Obispo-Paso Robles, CA",NA,29381,30118,737,0.506193381401368
2020,"Sandpoint, ID",NA,6081,7087,1006,0.5381986634264885
2020,"Sandusky, OH",NA,9030,8228,-802,0.47676439911924906
2020,"Sanford, NC",RALEIGH,6225,8911,2686,0.5887288583509513
2020,"Santa Cruz-Watsonville, CA",NA,27561,24557,-3004,0.47118078207145325
2020,"Santa Fe, NM",NA,15349,17105,1756,0.5270536759721451
2020,"Santa Maria-Santa Barbara, CA",NA,38439,36863,-1576,0.48953547050543145
2020,"Santa Rosa-Petaluma, CA",SAN FRANCISCO,48977,49675,698,0.5035376880347079
2020,"Sault Ste. Marie, MI",NA,3734,3360,-374,0.4736396955173386
2020,"Savannah, GA",NA,52489,51319,-1170,0.49436459617755857
2020,"Sayre, PA",NA,5884,5603,-281,0.48776878210150604
2020,"Scottsbluff, NE",NA,4051,3710,-341,0.4780311815487695
2020,"Scottsboro, AL",NA,4335,4195,-140,0.4917936694021102
2020,"Scottsburg, IN",NA,3428,3255,-173,0.4870567110579081
2020,"Scranton--Wilkes-Barre, PA",NA,52494,50478,-2016,0.4902109311269083
2020,"Searcy, AR",NA,8365,8057,-308,0.4906223358908781
2020,"Seattle-Tacoma-Bellevue, WA",NA,551497,512208,-39289,0.4815320037040345
2020,"Sebastian-Vero Beach, FL",NA,27489,31815,4326,0.5364730878186968
2020,"Sebring-Avon Park, FL",NA,20377,21672,1295,0.5153987015148993
2020,"Sedalia, MO",NA,5301,4679,-622,0.4688376753507014
2020,"Selinsgrove, PA",NA,2406,2357,-49,0.4948561830778921
2020,"Selma, AL",NA,2324,2148,-176,0.4803220035778175
2020,"Seneca Falls, NY",NA,3263,2953,-310,0.47506435006435005
2020,"Seneca, SC",NA,7149,7862,713,0.523749250549597
2020,"Sevierville, TN",NA,10739,11386,647,0.5146214689265537
2020,"Seymour, IN",NA,5438,4925,-513,0.475248480169835
2020,"Shawano, WI",NA,3393,3273,-120,0.490999099909991
2020,"Shawnee, OK",NA,6671,6600,-71,0.49732499434857963
2020,"Sheboygan, WI",NA,12781,11018,-1763,0.46296062859784026
2020,"Shelby, NC",NA,7875,8232,357,0.5110821382007823
2020,"Shelbyville, TN",NA,4788,4674,-114,0.4939759036144578
2020,"Shelton, WA",NA,7459,7493,34,0.5011369716425896
2020,"Sheridan, WY",NA,3794,3931,137,0.5088673139158576
2020,"Sherman-Denison, TX",NA,14154,16086,1932,0.5319444444444444
2020,"Show Low, AZ",NA,11115,12956,1841,0.5382410369324083
2020,"Shreveport-Bossier City, LA",NA,42772,40665,-2107,0.4873737071083572
2020,"Sidney, OH",NA,4289,3790,-499,0.4691174650328011
2020,"Sierra Vista-Douglas, AZ",NA,16360,16409,49,0.5007476578473558
2020,"Sikeston, MO",NA,4832,4242,-590,0.46748953052677983
2020,"Silver City, NM",NA,2378,2216,-162,0.4823683064867218
2020,"Sioux City, IA-NE-SD",NA,16235,14263,-1972,0.467670011148272
2020,"Sioux Falls, SD",NA,36173,34427,-1746,0.4876345609065156
2020,"Snyder, TX",NA,1342,1142,-200,0.45974235104669886
2020,"Somerset, KY",NA,7034,7322,288,0.5100306492059069
2020,"Somerset, PA",NA,4858,4625,-233,0.48771485816724663
2020,"Sonora, CA",NA,5493,5608,115,0.5051797135393208
2020,"South Bend-Mishawaka, IN-MI",NA,38041,32461,-5580,0.46042665456299114
2020,"Spartanburg, SC",NA,29969,30883,914,0.5075100243213041
2020,"Spearfish, SD",NA,3771,3421,-350,0.47566740823136816
2020,"Spencer, IA",NA,1922,1772,-150,0.47969680563075257
2020,"Spirit Lake, IA",NA,2915,2584,-331,0.46990361883978904
2020,"Spokane-Spokane Valley, WA",NA,73160,73282,122,0.5004165471654307
2020,"Springfield, IL",NA,25016,23248,-1768,0.481684070943146
2020,"Springfield, MA",NA,70233,66283,-3950,0.48553283131647573
2020,"Springfield, MO",NA,64269,59315,-4954,0.4799569523562921
2020,"Springfield, OH",NA,11607,11391,-216,0.49530393947299767
2020,"St. Cloud, MN",NA,22146,20237,-1909,0.4774791779723002
2020,"St. George, UT",NA,21243,25286,4043,0.543446022910443
2020,"St. Joseph, MO-KS",NA,11373,10312,-1061,0.4755360848512797
2020,"St. Louis, MO-IL",NA,280226,269940,-10286,0.49065191233191435
2020,"St. Marys, GA",NA,8057,6894,-1163,0.46110628051635344
2020,"St. Marys, PA",NA,2370,2143,-227,0.47485043208508754
2020,"Starkville, MS",NA,6655,5045,-1610,0.4311965811965812
2020,"State College, PA",NA,13593,11590,-2003,0.4602311082873367
2020,"Statesboro, GA",NA,7087,6565,-522,0.4808819220627014
2020,"Staunton, VA",NA,11495,11358,-137,0.4970025817179364
2020,"Steamboat Springs, CO",NA,3330,3503,173,0.5126591541050783
2020,"Stephenville, TX",NA,4477,4434,-43,0.497587251711368
2020,"Sterling, CO",NA,2151,1987,-164,0.48018366360560655
2020,"Sterling, IL",NA,6349,5311,-1038,0.4554888507718696
2020,"Stevens Point, WI",NA,7461,6296,-1165,0.4576579196045649
2020,"Stillwater, OK",NA,10541,8817,-1724,0.4554706064676103
2020,"Stockton, CA",NA,57794,60738,2944,0.5124185873856849
2020,"Storm Lake, IA",NA,2276,1739,-537,0.43312577833125776
2020,"Sturgis, MI",NA,6543,6132,-411,0.48378698224852074
2020,"Sulphur Springs, TX",NA,2974,3224,250,0.5201677960632463
2020,"Summerville, GA",NA,2318,2495,177,0.518387699979223
2020,"Sumter, SC",NA,12187,12175,-12,0.4997537148017404
2020,"Sunbury, PA",NA,7971,7657,-314,0.48995392884566163
2020,"Susanville, CA",NA,2307,2229,-78,0.4914021164021164
2020,"Sweetwater, TX",NA,1467,1471,4,0.5006807351940096
2020,"Syracuse, NY",NA,74849,69046,-5803,0.4798359915215956
2020,"Tahlequah, OK",NA,4002,4094,92,0.5056818181818182
2020,"Talladega-Sylacauga, AL",NA,6169,6178,9,0.5003644610026727
2020,"Tallahassee, FL",NA,39547,38461,-1086,0.49303917546918263
2020,"Tampa-St. Petersburg-Clearwater, FL",NA,496523,519097,22574,0.5111134085583191
2020,"Taos, NM",NA,2211,2530,319,0.5336426914153132
2020,"Taylorville, IL",NA,3433,2701,-732,0.44033257254646235
2020,"Terre Haute, IN",NA,19330,18301,-1029,0.48632776168584413
2020,"Texarkana, TX-AR",NA,15807,14825,-982,0.4839710107077566
2020,"The Dalles, OR",NA,2964,2800,-164,0.4857737682165163
2020,"The Villages, FL",NA,23494,31111,7617,0.5697463602234227
2020,"Thomaston, GA",NA,2505,2322,-183,0.4810441267868241
2020,"Thomasville, GA",NA,4217,4139,-78,0.4953326950694112
2020,"Tiffin, OH",NA,5389,5023,-366,0.4824241260084518
2020,"Tifton, GA",NA,3572,3419,-153,0.48905735946216566
2020,"Toccoa, GA",NA,3191,2920,-271,0.4778268695794469
2020,"Toledo, OH",NA,71052,65448,-5604,0.4794725274725275
2020,"Topeka, KS",NA,26633,24451,-2182,0.47864301934069375
2020,"Torrington, CT",NA,17388,20872,3484,0.54553058024046
2020,"Traverse City, MI",NA,21913,21690,-223,0.49744283650207555
2020,"Trenton-Princeton, NJ",PHILADELPHIA,31643,30842,-801,0.4935904617108106
2020,"Troy, AL",NA,3266,2838,-428,0.4649410222804718
2020,"Truckee-Grass Valley, CA",NA,10474,12326,1852,0.5406140350877193
2020,"Tucson, AZ",NA,138898,143911,5013,0.5088628721151024
2020,"Tullahoma-Manchester, TN",NA,10297,10788,491,0.5116433483519089
2020,"Tulsa, OK",NA,106883,105282,-1601,0.4962269931421299
2020,"Tupelo, MS",NA,14312,13488,-824,0.4851798561151079
2020,"Tuscaloosa, AL",NA,22077,20251,-1826,0.47843035343035345
2020,"Twin Falls, ID",NA,12620,12759,139,0.5027384845738603
2020,"Tyler, TX",NA,23064,23218,154,0.5016637137548074
2020,"Ukiah, CA",SAN FRANCISCO,7496,6938,-558,0.48067063876957183
2020,"Union City, TN",NA,3181,2903,-278,0.47715318869165024
2020,"Union, SC",NA,1958,1840,-118,0.48446550816219064
2020,"Urban Honolulu, HI",NA,107255,92542,-14713,0.4631801278297472
2020,"Urbana, OH",NA,3016,3005,-11,0.499086530476665
2020,"Utica-Rome, NY",NA,28780,26800,-1980,0.4821878373515653
2020,"Uvalde, TX",NA,1988,1764,-224,0.4701492537313433
2020,"Valdosta, GA",NA,15943,15546,-397,0.49369621137540093
2020,"Vallejo, CA",SAN FRANCISCO,41106,39575,-1531,0.49051201645988524
2020,"Van Wert, OH",NA,2153,2063,-90,0.48932637571157495
2020,"Vermillion, SD",NA,1948,1466,-482,0.4294083186877563
2020,"Vernal, UT",NA,3375,3458,83,0.5060734669983902
2020,"Vernon, TX",NA,1419,1214,-205,0.46107102164830993
2020,"Vicksburg, MS",NA,4023,3598,-425,0.4721165201417137
2020,"Victoria, TX",NA,9389,8569,-820,0.4771689497716895
2020,"Vidalia, GA",NA,3169,2874,-295,0.475591593579348
2020,"Vincennes, IN",NA,4419,3912,-507,0.469571480014404
2020,"Vineland-Bridgeton, NJ",PHILADELPHIA,11327,10750,-577,0.4869321012818771
2020,"Vineyard Haven, MA",NA,2928,3775,847,0.5631806653737133
2020,"Virginia Beach-Norfolk-Newport News, VA-NC",NA,207238,203199,-4039,0.4950796346333298
2020,"Visalia, CA",FRESNO,31100,30730,-370,0.4970079249555232
2020,"Wabash, IN",NA,2640,2595,-45,0.49570200573065903
2020,"Waco, TX",NA,28491,26854,-1637,0.4852109494985997
2020,"Wahpeton, ND-MN",NA,1879,1548,-331,0.45170703238984533
2020,"Walla Walla, WA",NA,6050,5847,-203,0.4914684374211986
2020,"Wapakoneta, OH",NA,3582,3269,-313,0.47715661947161
2020,"Warner Robins, GA",NA,19295,20434,1139,0.5143346170303809
2020,"Warren, PA",NA,3389,3062,-327,0.47465509223376223
2020,"Warrensburg, MO",NA,6544,5930,-614,0.47538880872214206
2020,"Warsaw, IN",NA,8707,8292,-415,0.48779339961174184
2020,"Washington Court House, OH",NA,2635,2722,87,0.5081202165391077
2020,"Washington-Arlington-Alexandria, DC-VA-MD-WV",NA,744173,693867,-50306,0.48250883146504964
2020,"Washington, IN",NA,3238,2639,-599,0.4490386251488855
2020,"Washington, NC",NA,3531,3721,190,0.5130998345284059
2020,"Waterloo-Cedar Falls, IA",NA,20607,17639,-2968,0.461198556711813
2020,"Watertown-Fort Atkinson, WI",NA,7864,7478,-386,0.48742015382609827
2020,"Watertown-Fort Drum, NY",NA,20444,16992,-3452,0.4538946468639812
2020,"Watertown, SD",NA,3791,3185,-606,0.45656536697247707
2020,"Wauchula, FL",NA,2527,2614,87,0.508461388834857
2020,"Wausau-Weston, WI",NA,16780,15590,-1190,0.4816187828236021
2020,"Waycross, GA",NA,5407,5121,-286,0.4864171732522796
2020,"Weatherford, OK",NA,3778,2872,-906,0.4318796992481203
2020,"Weirton-Steubenville, WV-OH",NA,9568,8849,-719,0.48047999131237445
2020,"Wenatchee, WA",NA,11102,11600,498,0.5109681966346578
2020,"West Plains, MO",NA,5335,5170,-165,0.49214659685863876
2020,"West Point, MS",NA,1293,1222,-71,0.48588469184890654
2020,"Wheeling, WV-OH",NA,11788,10792,-996,0.47794508414526127
2020,"Whitewater, WI",NA,12160,11525,-635,0.4865948912814017
2020,"Wichita Falls, TX",NA,30397,16068,-14329,0.34580867319487785
2020,"Wichita, KS",NA,90628,76936,-13692,0.4591439688715953
2020,"Williamsport, PA",NA,11563,11144,-419,0.4907737702030211
2020,"Williston, ND",NA,9487,5947,-3540,0.38531812880653105
2020,"Willmar, MN",NA,4937,4695,-242,0.48743770764119604
2020,"Wilmington, NC",NA,37110,38452,1342,0.5088801249305206
2020,"Wilmington, OH",NA,4067,3875,-192,0.4879123646436666
2020,"Wilson, NC",RALEIGH,6621,6390,-231,0.49112289601106757
2020,"Winchester, VA-WV",NA,13420,14039,619,0.5112713500127463
2020,"Winfield, KS",NA,4126,3711,-415,0.4735230317723619
2020,"Winnemucca, NV",NA,2072,1945,-127,0.4841921832213094
2020,"Winona, MN",NA,4815,4344,-471,0.4742875859810023
2020,"Winston-Salem, NC",NA,60902,62121,1219,0.5049543581281549
2020,"Wisconsin Rapids-Marshfield, WI",NA,7983,7269,-714,0.47659323367427225
2020,"Woodward, OK",NA,2458,1901,-557,0.43610919935765086
2020,"Wooster, OH",NA,9757,9296,-461,0.4879021676376424
2020,"Worcester, MA-CT",NA,96144,93393,-2751,0.49274284176704286
2020,"Worthington, MN",NA,1790,1357,-433,0.4312043215761042
2020,"Yakima, WA",NA,20326,18084,-2242,0.47081489195521997
2020,"Yankton, SD",NA,2900,2439,-461,0.45682712118374225
2020,"York-Hanover, PA",NA,43025,42094,-931,0.4945311857517123
2020,"Youngstown-Warren-Boardman, OH-PA",NA,51406,48886,-2520,0.48743668488014996
2020,"Yuba City, CA",NA,15261,15272,11,0.5001801329708839
2020,"Yuma, AZ",NA,21001,25495,4494,0.5483267377838954
2020,"Zanesville, OH",NA,8818,8781,-37,0.498948803909313
2020,"Zapata, TX",NA,390,460,70,0.5411764705882353
2020,NA,NA,1580119,1559779,-20340,0.49676104128223275
2021,"Aberdeen, SD",NA,4992,3963,-1029,0.44254606365159127
2021,"Aberdeen, WA",NA,8799,8074,-725,0.4785159722633794
2021,"Abilene, TX",NA,20337,18671,-1666,0.4786454060705496
2021,"Ada, OK",NA,3643,3509,-134,0.49063199105145416
2021,"Adrian, MI",NA,8418,7584,-834,0.4739407574053243
2021,"Akron, OH",NA,64777,61705,-3072,0.4878559795069654
2021,"Alamogordo, NM",NA,6658,6317,-341,0.486859344894027
2021,"Albany-Lebanon, OR",NA,15193,15027,-166,0.4972534745201853
2021,"Albany-Schenectady-Troy, NY",NA,92970,85728,-7242,0.4797367625826814
2021,"Albany, GA",NA,13377,13016,-361,0.4931610654340166
2021,"Albemarle, NC",NA,4603,5369,766,0.5384075411151223
2021,"Albert Lea, MN",NA,2612,2390,-222,0.4778088764494202
2021,"Albertville, AL",NA,7959,8122,163,0.5050680927802997
2021,"Albuquerque, NM",NA,89246,85991,-3255,0.4907125778231766
2021,"Alexander City, AL",NA,3222,3248,26,0.5020092735703245
2021,"Alexandria, LA",NA,13488,12406,-1082,0.4791071290646482
2021,"Alexandria, MN",NA,4528,4360,-168,0.49054905490549056
2021,"Alice, TX",NA,2628,2359,-269,0.47302987768197313
2021,"Allentown-Bethlehem-Easton, PA-NJ",NEW YORK,75672,73301,-2371,0.49204218214038786
2021,"Alma, MI",NA,3779,3282,-497,0.46480668460557995
2021,"Alpena, MI",NA,3193,2681,-512,0.4564181137214845
2021,"Altoona, PA",NA,10428,9663,-765,0.48096162460803343
2021,"Altus, OK",NA,2531,2408,-123,0.48754808665721805
2021,"Amarillo, TX",NA,25647,24173,-1474,0.48520674427940585
2021,"Americus, GA",NA,2359,2222,-137,0.4850469329840646
2021,"Ames, IA",NA,16101,13043,-3058,0.44753637112270106
2021,"Amsterdam, NY",NA,5329,4905,-424,0.4792847371506742
2021,"Anchorage, AK",NA,44377,41656,-2721,0.4841863006055816
2021,"Andrews, TX",NA,1602,1246,-356,0.4375
2021,"Angola, IN",NA,4630,4036,-594,0.46572813293330256
2021,"Ann Arbor, MI",NA,42352,35208,-7144,0.45394533264569364
2021,"Anniston-Oxford, AL",NA,10321,9940,-381,0.4905977000148068
2021,"Appleton, WI",NA,23866,21720,-2146,0.4764620716886763
2021,"Arcadia, FL",NA,3780,5590,1810,0.5965848452508005
2021,"Ardmore, OK",NA,5886,5565,-321,0.48598375687712864
2021,"Arkadelphia, AR",NA,2505,2163,-342,0.4633676092544987
2021,"Asheville, NC",NA,52931,55665,2734,0.5125879406239641
2021,"Ashland, OH",NA,3907,3615,-292,0.48059026854559955
2021,"Ashtabula, OH",NA,8940,8341,-599,0.4826688270354725
2021,"Astoria, OR",NA,5741,5013,-728,0.4661521294402083
2021,"Atchison, KS",NA,1400,1186,-214,0.4586233565351895
2021,"Athens-Clarke County, GA",NA,19047,17939,-1108,0.4850213594332991
2021,"Athens, OH",NA,5808,4988,-820,0.46202297147091514
2021,"Athens, TN",NA,4616,5163,547,0.5279680948972287
2021,"Athens, TX",NA,9272,9797,525,0.5137657978918664
2021,"Atlanta-Sandy Springs-Alpharetta, GA",NA,649471,656396,6925,0.5026514951369473
2021,"Atlantic City-Hammonton, NJ",PHILADELPHIA,23492,24309,817,0.5085458463212067
2021,"Atmore, AL",NA,2695,2460,-235,0.4772065955383123
2021,"Auburn-Opelika, AL",NA,15831,14990,-841,0.4863567048440998
2021,"Auburn, IN",NA,4170,3711,-459,0.47087933003425964
2021,"Auburn, NY",NA,7144,6181,-963,0.46386491557223264
2021,"Augusta-Richmond County, GA-SC",NA,57642,59169,1527,0.5065361995017592
2021,"Augusta-Waterville, ME",NA,13254,13365,111,0.5020849768962019
2021,"Austin-Round Rock-Georgetown, TX",NA,304624,312508,7884,0.5063876123746621
2021,"Austin, MN",NA,3724,3432,-292,0.4795975405254332
2021,"Bainbridge, GA",NA,2358,2297,-61,0.4934479054779807
2021,"Bakersfield, CA",NA,71723,67778,-3945,0.4858603164135024
2021,"Baltimore-Columbia-Towson, MD",NA,278007,265117,-12890,0.488133464917772
2021,"Bangor, ME",NA,16161,15159,-1002,0.48400383141762454
2021,"Baraboo, WI",NA,6764,6401,-363,0.48621344473984046
2021,"Bardstown, KY",NA,4176,4230,54,0.5032119914346895
2021,"Barnstable Town, MA",NA,34076,35326,1250,0.5090055041641451
2021,"Barre, VT",NA,5921,6018,97,0.5040623167769495
2021,"Bartlesville, OK",NA,5317,5153,-164,0.49216809933142314
2021,"Batavia, NY",NA,4822,4253,-569,0.46865013774104686
2021,"Batesville, AR",NA,5522,5595,73,0.5032832598722677
2021,"Baton Rouge, LA",NA,68355,65387,-2968,0.4889040092117659
2021,"Battle Creek, MI",NA,15226,13273,-1953,0.46573563984701216
2021,"Bay City, MI",NA,9598,8875,-723,0.48043089915011095
2021,"Bay City, TX",HOUSTON,2916,2689,-227,0.479750223015165
2021,"Beatrice, NE",NA,2057,1640,-417,0.4436029212875304
2021,"Beaumont-Port Arthur, TX",NA,34490,31943,-2547,0.48083031023738204
2021,"Beaver Dam, WI",NA,8327,7447,-880,0.4721059972105997
2021,"Beckley, WV",NA,6574,5858,-716,0.4712033462033462
2021,"Bedford, IN",NA,4571,4220,-351,0.48003640086452054
2021,"Beeville, TX",NA,1681,1512,-169,0.4735358596930786
2021,"Bellefontaine, OH",NA,4057,3796,-261,0.4833821469502101
2021,"Bellingham, WA",NA,28140,26564,-1576,0.4855952032758116
2021,"Bemidji, MN",NA,4752,4170,-582,0.4673839946200404
2021,"Bend, OR",NA,30187,29793,-394,0.49671557185728576
2021,"Bennettsville, SC",NA,1526,1467,-59,0.49014366855997327
2021,"Bennington, VT",NA,3972,3800,-172,0.4889346371590324
2021,"Berlin, NH",NA,3544,3448,-96,0.4931350114416476
2021,"Big Rapids, MI",NA,4894,4613,-281,0.48522141579888506
2021,"Big Spring, TX",NA,2784,2360,-424,0.45878693623639194
2021,"Big Stone Gap, VA",NA,2926,2511,-415,0.4618355710869965
2021,"Billings, MT",NA,23603,22065,-1538,0.4831610755890339
2021,"Binghamton, NY",NA,24515,21543,-2972,0.46773633245038865
2021,"Birmingham-Hoover, AL",NA,98332,95588,-2744,0.49292491749174916
2021,"Bismarck, ND",NA,17125,13864,-3261,0.44738455581012615
2021,"Blackfoot, ID",NA,3627,3599,-28,0.49806255189593135
2021,"Blacksburg-Christiansburg, VA",NA,16444,13932,-2512,0.4586515670265999
2021,"Bloomington, IL",NA,17212,15614,-1598,0.475659538170962
2021,"Bloomington, IN",NA,31021,16715,-14306,0.35015501927266635
2021,"Bloomsburg-Berwick, PA",NA,7388,7081,-307,0.4893911120326215
2021,"Bluefield, WV-VA",NA,7844,7248,-596,0.4802544394381129
2021,"Blytheville, AR",NA,3955,3397,-558,0.4620511425462459
2021,"Bogalusa, LA",NA,3402,3243,-159,0.48803611738148983
2021,"Boise City, ID",NA,90653,89720,-933,0.4974136927367178
2021,"Bonham, TX",NA,2396,2824,428,0.5409961685823754
2021,"Boone, NC",NA,5403,4771,-632,0.46894043640652644
2021,"Borger, TX",NA,1697,1483,-214,0.46635220125786164
2021,"Boston-Cambridge-Newton, MA-NH",NA,519451,470602,-48849,0.4753301085901462
2021,"Boulder, CO",NA,56388,45612,-10776,0.4471764705882353
2021,"Bowling Green, KY",NA,19307,19314,7,0.5000906242717692
2021,"Bozeman, MT",NA,19245,17707,-1538,0.47918921844555096
2021,"Bradford, PA",NA,3597,3221,-376,0.47242593135816957
2021,"Brainerd, MN",NA,14113,13322,-791,0.4855841078913796
2021,"Branson, MO",NA,9761,8229,-1532,0.4574207893274041
2021,"Breckenridge, CO",NA,5082,4198,-884,0.4523706896551724
2021,"Bremerton-Silverdale-Port Orchard, WA",NA,33897,30344,-3553,0.47234632088541584
2021,"Brenham, TX",HOUSTON,2687,2844,157,0.514192731874887
2021,"Brevard, NC",NA,3034,3634,600,0.5449910017996401
2021,"Bridgeport-Stamford-Norwalk, CT",NEW YORK,86984,85964,-1020,0.49705113675786944
2021,"Brookhaven, MS",NA,2001,1869,-132,0.48294573643410854
2021,"Brookings, OR",NA,2860,2897,37,0.5032134792426611
2021,"Brookings, SD",NA,4002,3165,-837,0.4416073670992047
2021,"Brownsville-Harlingen, TX",NA,20137,23805,3668,0.5417368349187566
2021,"Brownsville, TN",NA,1303,1323,20,0.5038080731150039
2021,"Brownwood, TX",NA,3545,3901,356,0.5239054525919957
2021,"Brunswick, GA",NA,12545,13390,845,0.5162907268170426
2021,"Bucyrus-Galion, OH",NA,4191,4011,-180,0.4890270665691295
2021,"Buffalo-Cheektowaga, NY",NA,103395,95239,-8156,0.47946977858775436
2021,"Burley, ID",NA,3344,3361,17,0.5012677106636838
2021,"Burlington-South Burlington, VT",NA,29758,24731,-5027,0.4538714235900824
2021,"Burlington, IA-IL",NA,5409,4322,-1087,0.4441475696228548
2021,"Burlington, NC",NA,13993,14879,886,0.5153435854807425
2021,"Butte-Silver Bow, MT",NA,3730,3694,-36,0.49757543103448276
2021,"Cadillac, MI",NA,5174,4844,-330,0.4835296466360551
2021,"Calhoun, GA",NA,4943,5116,173,0.5085992643403917
2021,"California-Lexington Park, MD",NA,9554,9190,-364,0.49029022620571916
2021,"Cambridge, MD",NA,2866,2645,-221,0.47994919252404283
2021,"Cambridge, OH",NA,3612,3189,-423,0.46890163211292457
2021,"Camden, AR",NA,1966,1714,-252,0.4657608695652174
2021,"Campbellsville, KY",NA,3382,3149,-233,0.48216199663145
2021,"Ca√±on City, CO",NA,5133,4981,-152,0.49248566343682026
2021,"Canton-Massillon, OH",NA,35500,34060,-1440,0.4896492236917769
2021,"Cape Coral-Fort Myers, FL",NA,160187,189134,28947,0.5414332376238474
2021,"Cape Girardeau, MO-IL",NA,9378,8282,-1096,0.46896942242355605
2021,"Carbondale-Marion, IL",NA,14933,12736,-2197,0.4602985290397195
2021,"Carlsbad-Artesia, NM",NA,4798,4319,-479,0.47373039376988046
2021,"Carroll, IA",NA,1690,1507,-183,0.4713794182045668
2021,"Carson City, NV",NA,7539,6920,-619,0.47859464693270626
2021,"Casper, WY",NA,9231,9212,-19,0.4994848994198341
2021,"Cedar City, UT",NA,5338,5672,334,0.5151680290644868
2021,"Cedar Rapids, IA",NA,33280,28319,-4961,0.4597314891475511
2021,"Cedartown, GA",NA,4629,3984,-645,0.462556600487635
2021,"Celina, OH",NA,2675,2395,-280,0.4723865877712032
2021,"Central City, KY",NA,2242,2009,-233,0.4725946836038579
2021,"Centralia, IL",NA,3871,3501,-370,0.47490504612045575
2021,"Centralia, WA",NA,7917,7996,79,0.5024822472192547
2021,"Chambersburg-Waynesboro, PA",NA,11371,11164,-207,0.49540714444197914
2021,"Champaign-Urbana, IL",NA,26120,22108,-4012,0.45840590528323794
2021,"Charleston-Mattoon, IL",NA,5986,5360,-626,0.472413185263529
2021,"Charleston-North Charleston, SC",NA,97779,101411,3632,0.5091169235403383
2021,"Charleston, WV",NA,19321,17086,-2235,0.4693053533661109
2021,"Charlotte-Concord-Gastonia, NC-SC",NA,282019,295801,13782,0.5119258592641307
2021,"Charlottesville, VA",NA,23236,22466,-770,0.49157586101264716
2021,"Chattanooga, TN-GA",NA,57076,57996,920,0.5039974972191323
2021,"Cheyenne, WY",NA,12977,12402,-575,0.4886717364750384
2021,"Chicago-Naperville-Elgin, IL-IN-WI",CHICAGO,912433,832076,-80357,0.47696859116232704
2021,"Chico, CA",NA,24804,21240,-3564,0.4612978889757623
2021,"Chillicothe, OH",NA,6456,5862,-594,0.47588894301022894
2021,"Cincinnati, OH-KY-IN",NA,205936,198770,-7166,0.49114665955038966
2021,"Clarksburg, WV",NA,6537,6101,-436,0.4827504351954423
2021,"Clarksdale, MS",NA,1533,1385,-148,0.4746401644962303
2021,"Clarksville, TN-KY",NA,42612,41145,-1467,0.4912425230130019
2021,"Clearlake, CA",NA,6258,5743,-515,0.4785434547121073
2021,"Cleveland-Elyria, OH",NA,190131,180804,-9327,0.48742771644627764
2021,"Cleveland, MS",NA,1820,1598,-222,0.4675248683440609
2021,"Cleveland, TN",NA,11307,11467,160,0.5035127777289892
2021,"Clewiston, FL",NA,3399,4584,1185,0.5742202179631717
2021,"Clinton, IA",NA,4645,3944,-701,0.45919198975433695
2021,"Clovis, NM",NA,5673,5177,-496,0.47714285714285715
2021,"Coeur d'Alene, ID",NA,22653,24212,1559,0.5166328816814254
2021,"Coffeyville, KS",NA,4175,3397,-778,0.4486265187533016
2021,"Coldwater, MI",NA,4808,4061,-747,0.4578870222121998
2021,"College Station-Bryan, TX",NA,28943,26091,-2852,0.4740887451393684
2021,"Colorado Springs, CO",NA,112674,105441,-7233,0.4834192971597552
2021,"Columbia, MO",NA,26050,23189,-2861,0.4709478259103556
2021,"Columbia, SC",NA,76923,78516,1593,0.5051241966301894
2021,"Columbus, GA-AL",NA,34578,31446,-3132,0.4762813522355507
2021,"Columbus, IN",NA,10284,8814,-1470,0.4615142946905435
2021,"Columbus, MS",NA,5086,4727,-359,0.48170793844899623
2021,"Columbus, NE",NA,3424,2838,-586,0.45320983711274354
2021,"Columbus, OH",NA,231894,222206,-9688,0.48933274609116933
2021,"Concord, NH",NA,14591,14017,-574,0.48996784116331094
2021,"Connersville, IN",NA,3156,2511,-645,0.44309158284806777
2021,"Cookeville, TN",NA,11495,12018,523,0.5111215072513078
2021,"Coos Bay, OR",NA,8588,7944,-644,0.4805226227921607
2021,"Cordele, GA",NA,1739,1717,-22,0.49681712962962965
2021,"Corinth, MS",NA,2720,2608,-112,0.4894894894894895
2021,"Cornelia, GA",NA,3620,3827,207,0.5138982140459245
2021,"Corning, NY",NA,10026,9263,-763,0.4802218881227643
2021,"Corpus Christi, TX",NA,41446,40387,-1059,0.49352950521183386
2021,"Corsicana, TX",NA,3693,4044,351,0.5226832105467235
2021,"Cortland, NY",NA,4783,4448,-335,0.48185462030115916
2021,"Corvallis, OR",NA,12777,10663,-2114,0.4549061433447099
2021,"Coshocton, OH",NA,2787,2767,-20,0.4981994958588405
2021,"Craig, CO",NA,1593,1287,-306,0.446875
2021,"Crawfordsville, IN",NA,4069,3443,-626,0.4583333333333333
2021,"Crescent City, CA",NA,2238,2287,49,0.505414364640884
2021,"Crestview-Fort Walton Beach-Destin, FL",NA,41462,48178,6716,0.5374609549308345
2021,"Crossville, TN",NA,6782,7058,276,0.5099710982658959
2021,"Cullman, AL",NA,6810,7269,459,0.5163008736415938
2021,"Cullowhee, NC",NA,5956,5883,-73,0.49691696933862656
2021,"Cumberland, MD-WV",NA,7001,6337,-664,0.4751087119508172
2021,"Dallas-Fort Worth-Arlington, TX",NA,816619,845723,29104,0.508753914657754
2021,"Dalton, GA",NA,10454,9754,-700,0.482680126682502
2021,"Danville, IL",NA,7956,6839,-1117,0.46225076039202434
2021,"Danville, KY",NA,5150,4924,-226,0.48878300575739525
2021,"Danville, VA",NA,6990,6927,-63,0.4977365811597327
2021,"Daphne-Fairhope-Foley, AL",NA,27616,32422,4806,0.5400246510543323
2021,"Davenport-Moline-Rock Island, IA-IL",NA,43322,37557,-5765,0.46436034075594407
2021,"Dayton-Kettering, OH",NA,81761,77581,-4180,0.48688355863488597
2021,"Dayton, TN",NA,2821,3179,358,0.5298333333333334
2021,"Decatur, AL",NA,12328,12046,-282,0.49421514728809385
2021,"Decatur, IL",NA,12468,10152,-2316,0.4488063660477454
2021,"Decatur, IN",NA,2615,2294,-321,0.4673049500916684
2021,"Defiance, OH",NA,3484,3035,-449,0.46556220279183924
2021,"Del Rio, TX",NA,3436,3131,-305,0.4767778285366225
2021,"Deltona-Daytona Beach-Ormond Beach, FL",NA,96879,109472,12593,0.5305135424592079
2021,"Deming, NM",NA,2679,2367,-312,0.4690844233055886
2021,"Denver-Aurora-Lakewood, CO",NA,428477,404913,-23564,0.4858625613458285
2021,"DeRidder, LA",NA,3132,2979,-153,0.48748159057437407
2021,"Des Moines-West Des Moines, IA",NA,87740,83281,-4459,0.4869635892668152
2021,"Detroit-Warren-Dearborn, MI",NA,395461,361934,-33527,0.47786689904211144
2021,"Dickinson, ND",NA,4284,3627,-657,0.45847554038680316
2021,"Dixon, IL",NA,3101,2661,-440,0.4618188129121833
2021,"Dodge City, KS",NA,2858,2221,-637,0.4372908052766293
2021,"Dothan, AL",NA,15700,15505,-195,0.4968755007210383
2021,"Douglas, GA",NA,4010,3695,-315,0.47955872809863725
2021,"Dover, DE",PHILADELPHIA,15703,16576,873,0.5135227237522848
2021,"Dublin, GA",NA,4292,4238,-54,0.49683470105509964
2021,"DuBois, PA",NA,4548,4192,-356,0.4796338672768879
2021,"Dubuque, IA",NA,10469,8965,-1504,0.46130492950499125
2021,"Duluth, MN-WI",NA,31545,28672,-2873,0.4761446103259877
2021,"Dumas, TX",NA,1597,1127,-470,0.41372980910425844
2021,"Duncan, OK",NA,4817,4369,-448,0.4756150664053995
2021,"Durango, CO",NA,7721,8077,356,0.5112672490188631
2021,"Durant, OK",NA,5512,5141,-371,0.48258706467661694
2021,"Durham-Chapel Hill, NC",RALEIGH,64013,63351,-662,0.49740114946138625
2021,"Dyersburg, TN",NA,3765,3494,-271,0.48133351701336274
2021,"Eagle Pass, TX",NA,2070,2088,18,0.5021645021645021
2021,"East Stroudsburg, PA",NA,15357,13306,-2051,0.4642221679517148
2021,"Easton, MD",NA,3173,3300,127,0.5098099799165765
2021,"Eau Claire, WI",NA,19689,17380,-2309,0.46885537780895087
2021,"Edwards, CO",NA,5056,4602,-454,0.4764961689790847
2021,"Effingham, IL",NA,3029,2656,-373,0.4671943711521548
2021,"El Campo, TX",HOUSTON,3000,2678,-322,0.47164494540331103
2021,"El Centro, CA",NA,10672,10985,313,0.507226300965046
2021,"El Dorado, AR",NA,3287,2847,-440,0.4641343332246495
2021,"El Paso, TX",NA,63834,60324,-3510,0.4858647851930605
2021,"Elizabeth City, NC",NA,4458,4909,451,0.5240738763745062
2021,"Elizabethtown-Fort Knox, KY",NA,18757,16940,-1817,0.4745496820461103
2021,"Elk City, OK",NA,2402,2021,-381,0.45692968573366494
2021,"Elkhart-Goshen, IN",NA,19857,16811,-3046,0.4584651467219374
2021,"Elkins, WV",NA,1948,1591,-357,0.4495620231703871
2021,"Elko, NV",NA,5743,4989,-754,0.46487141259783826
2021,"Ellensburg, WA",NA,6840,5510,-1330,0.4461538461538462
2021,"Elmira, NY",NA,8496,7530,-966,0.46986147510295767
2021,"Emporia, KS",NA,3941,3256,-685,0.4524107266916771
2021,"Enid, OK",NA,6661,5914,-747,0.4702982107355865
2021,"Enterprise, AL",NA,5758,5470,-288,0.487174919843249
2021,"Erie, PA",NA,26055,23652,-2403,0.47582835415535035
2021,"Escanaba, MI",NA,3647,3385,-262,0.48137087599544937
2021,"Espa√±ola, NM",NA,849,699,-150,0.45155038759689925
2021,"Eufaula, AL-GA",NA,1820,1706,-114,0.4838343732274532
2021,"Eugene-Springfield, OR",NA,50057,44677,-5380,0.47160470369666646
2021,"Eureka-Arcata, CA",NA,13040,11455,-1585,0.4676464584609104
2021,"Evanston, WY",NA,2376,1762,-614,0.42580956984050267
2021,"Evansville, IN-KY",NA,35811,32752,-3059,0.4776920496477692
2021,"Fairbanks, AK",NA,11005,8961,-2044,0.4488129820695182
2021,"Fairfield, IA",NA,2210,1768,-442,0.4444444444444444
2021,"Fairmont, MN",NA,1899,1619,-280,0.46020466173962477
2021,"Fairmont, WV",NA,4445,3812,-633,0.4616688870049655
2021,"Fallon, NV",NA,3089,2862,-227,0.48092757519744583
2021,"Fargo, ND-MN",NA,40831,32725,-8106,0.44489912447658925
2021,"Faribault-Northfield, MN",NA,5870,5792,-78,0.49665580517921454
2021,"Farmington, MO",NA,7589,6948,-641,0.47795281007085366
2021,"Farmington, NM",NA,8790,7923,-867,0.4740621073415904
2021,"Fayetteville-Springdale-Rogers, AR",NA,62710,62240,-470,0.4981192476990796
2021,"Fayetteville, NC",RALEIGH,63085,58021,-5064,0.479092695655046
2021,"Fergus Falls, MN",NA,6359,6164,-195,0.4922143256408209
2021,"Fernley, NV",NA,7234,6941,-293,0.48966490299823634
2021,"Findlay, OH",NA,7074,6436,-638,0.4763878608438194
2021,"Fitzgerald, GA",NA,1546,1576,30,0.5048046124279308
2021,"Flagstaff, AZ",NA,15836,14228,-1608,0.4732570516232038
2021,"Flint, MI",NA,46854,41466,-5388,0.46949728260869567
2021,"Florence-Muscle Shoals, AL",NA,13053,12970,-83,0.4984052568881374
2021,"Florence, SC",NA,15462,15346,-116,0.49811737211114
2021,"Fond du Lac, WI",NA,9671,8584,-1087,0.4702273349767187
2021,"Forest City, NC",NA,5442,5804,362,0.5160946114173929
2021,"Forrest City, AR",NA,1388,1291,-97,0.48189622993654346
2021,"Fort Collins, CO",NA,52854,49983,-2871,0.48604101636570496
2021,"Fort Dodge, IA",NA,3975,3368,-607,0.45866811929728996
2021,"Fort Leonard Wood, MO",NA,7605,6798,-807,0.4719850031243491
2021,"Fort Madison-Keokuk, IA-IL-MO",NA,5579,4508,-1071,0.44691186675919503
2021,"Fort Morgan, CO",NA,2548,2490,-58,0.4942437475188567
2021,"Fort Payne, AL",NA,5130,4855,-275,0.486229344016024
2021,"Fort Polk South, LA",NA,5280,4524,-756,0.4614443084455324
2021,"Fort Smith, AR-OK",NA,29164,25174,-3990,0.46328536199344844
2021,"Fort Wayne, IN",NA,46806,41565,-5241,0.47034660691855923
2021,"Frankfort, IN",NA,2784,2707,-77,0.49298852668002185
2021,"Frankfort, KY",NA,7992,7923,-69,0.49783223374175306
2021,"Fredericksburg, TX",NA,2525,2941,416,0.5380534211489206
2021,"Freeport, IL",NA,4327,3697,-630,0.46074277168494515
2021,"Fremont, NE",NA,3819,3579,-240,0.483779399837794
2021,"Fremont, OH",NA,3908,3713,-195,0.48720640335913923
2021,"Fresno, CA",FRESNO,76038,69344,-6694,0.4769778927239961
2021,"Gadsden, AL",NA,8095,8122,27,0.5008324597644447
2021,"Gaffney, SC",NA,4034,3502,-532,0.46470276008492567
2021,"Gainesville, FL",NA,38518,38881,363,0.5023449915373583
2021,"Gainesville, GA",NA,16995,19154,2159,0.5298625134858502
2021,"Gainesville, TX",NA,3570,3632,62,0.5043043599000278
2021,"Galesburg, IL",NA,5436,3955,-1481,0.4211479075710787
2021,"Gallup, NM",NA,1895,1547,-348,0.4494479953515398
2021,"Garden City, KS",NA,4261,3335,-926,0.43904686677198523
2021,"Gardnerville Ranchos, NV",NA,5535,5603,68,0.5030526126773209
2021,"Georgetown, SC",NA,4494,5372,878,0.5444962497466045
2021,"Gettysburg, PA",NA,7246,7062,-184,0.4935700307520268
2021,"Gillette, WY",NA,7099,7058,-41,0.49855195309740763
2021,"Glasgow, KY",NA,4791,4893,102,0.5052664188351921
2021,"Glens Falls, NY",NA,13736,13485,-251,0.49538958892031887
2021,"Glenwood Springs, CO",NA,11765,10658,-1107,0.4753155242385051
2021,"Gloversville, NY",NA,5356,4985,-371,0.4820616961609129
2021,"Goldsboro, NC",RALEIGH,10310,9686,-624,0.48439687937587517
2021,"Granbury, TX",NA,6383,7678,1295,0.5460493563757912
2021,"Grand Forks, ND-MN",NA,13946,10501,-3445,0.42954145702949237
2021,"Grand Island, NE",NA,8208,6744,-1464,0.4510433386837881
2021,"Grand Junction, CO",NA,21233,19630,-1603,0.48038567897609086
2021,"Grand Rapids-Kentwood, MI",NA,116335,101355,-14980,0.46559327484036933
2021,"Grand Rapids, MN",NA,4492,4202,-290,0.4833218311479181
2021,"Grants Pass, OR",NA,9195,9208,13,0.5003532032820736
2021,"Grants, NM",NA,966,859,-107,0.4706849315068493
2021,"Great Bend, KS",NA,2907,2614,-293,0.473464952001449
2021,"Great Falls, MT",NA,9796,9092,-704,0.4813638288860652
2021,"Greeley, CO",NA,36742,37969,1227,0.5082116421945898
2021,"Green Bay, WI",NA,36754,32098,-4656,0.4661883460175449
2021,"Greeneville, TN",NA,5077,5934,857,0.5389156298247207
2021,"Greensboro-High Point, NC",NA,78001,71784,-6217,0.4792469205861735
2021,"Greensburg, IN",NA,2902,2429,-473,0.45563684111798913
2021,"Greenville-Anderson, SC",NA,90445,95728,5283,0.5141884161505696
2021,"Greenville, MS",NA,3354,2861,-493,0.4603378921962993
2021,"Greenville, NC",NA,16688,15631,-1057,0.48364739008013863
2021,"Greenville, OH",NA,4140,3703,-437,0.47214076246334313
2021,"Greenwood, MS",NA,1975,1662,-313,0.45697003024470717
2021,"Greenwood, SC",NA,5173,5030,-143,0.492992257179261
2021,"Grenada, MS",NA,1691,1297,-394,0.43406961178045517
2021,"Gulfport-Biloxi, MS",NA,44186,42822,-1364,0.4921616403089371
2021,"Guymon, OK",NA,1411,1050,-361,0.4266558309630232
2021,"Hagerstown-Martinsburg, MD-WV",NA,26645,27429,784,0.5072493249990754
2021,"Hailey, ID",NA,2694,2906,212,0.5189285714285714
2021,"Hammond, LA",NA,10077,10506,429,0.5104212213962979
2021,"Hanford-Corcoran, CA",FRESNO,11466,9925,-1541,0.4639801785797765
2021,"Hannibal, MO",NA,4182,3344,-838,0.44432633537071486
2021,"Harrisburg-Carlisle, PA",NA,59406,57931,-1475,0.49371468505245575
2021,"Harrison, AR",NA,4337,4293,-44,0.4974507531865585
2021,"Harrisonburg, VA",NA,10667,9876,-791,0.4807476999464538
2021,"Hartford-East Hartford-Middletown, CT",NA,118128,114354,-3774,0.4918832425736186
2021,"Hastings, NE",NA,3586,2737,-849,0.4328641467657757
2021,"Hattiesburg, MS",NA,14889,14146,-743,0.48720509729636646
2021,"Hays, KS",NA,3509,3084,-425,0.46776884574548766
2021,"Heber, UT",NA,9393,9879,486,0.5126089663760897
2021,"Helena-West Helena, AR",NA,1361,1156,-205,0.45927691696464046
2021,"Helena, MT",NA,10214,10073,-141,0.49652486814216
2021,"Henderson, NC",RALEIGH,3500,3061,-439,0.46654473403444596
2021,"Hereford, TX",NA,1174,1068,-106,0.47636039250669043
2021,"Hermiston-Pendleton, OR",NA,9248,7331,-1917,0.4421858978225466
2021,"Hickory-Lenoir-Morganton, NC",NA,26651,27569,918,0.5084655108815935
2021,"Hillsdale, MI",NA,4119,4091,-28,0.49829476248477467
2021,"Hilo, HI",NA,17971,18995,1024,0.5138505653844073
2021,"Hilton Head Island-Bluffton, SC",NA,26796,31181,4385,0.5378167204236163
2021,"Hinesville, GA",NA,11934,11550,-384,0.4918242207460399
2021,"Hobbs, NM",NA,5198,4457,-741,0.46162610046607977
2021,"Holland, MI",NA,9573,9161,-412,0.48900395003736524
2021,"Homosassa Springs, FL",NA,23685,27378,3693,0.5361612126197051
2021,"Hood River, OR",NA,2450,2411,-39,0.4959884797366797
2021,"Hope, AR",NA,2026,1685,-341,0.45405551064403127
2021,"Hot Springs, AR",NA,14068,13184,-884,0.4837810068985762
2021,"Houghton, MI",NA,3973,3516,-457,0.4694885832554413
2021,"Houma-Thibodaux, LA",NA,17980,14868,-3112,0.4526302971261568
2021,"Houston-The Woodlands-Sugar Land, TX",HOUSTON,642759,659432,16673,0.5064019026394746
2021,"Hudson, NY",NA,4910,4946,36,0.5018262987012987
2021,"Huntingdon, PA",NA,2255,2146,-109,0.48761645080663485
2021,"Huntington-Ashland, WV-KY-OH",NA,28384,25805,-2579,0.4762036575688793
2021,"Huntington, IN",NA,4262,3643,-619,0.4608475648323846
2021,"Huntsville, AL",NA,48442,51177,2735,0.5137273010168742
2021,"Huntsville, TX",HOUSTON,5559,5464,-95,0.49569082826816657
2021,"Huron, SD",NA,2197,1852,-345,0.4573968881205236
2021,"Hutchinson, KS",NA,7715,6470,-1245,0.45611561508635884
2021,"Hutchinson, MN",NA,3704,3333,-371,0.4736393349438681
2021,"Idaho Falls, ID",NA,14986,14927,-59,0.4990138067061144
2021,"Indiana, PA",NA,5554,5324,-230,0.489428203713918
2021,"Indianapolis-Carmel-Anderson, IN",NA,253611,241333,-12278,0.48759657658240124
2021,"Indianola, MS",NA,1160,1056,-104,0.47653429602888087
2021,"Iowa City, IA",NA,22714,19251,-3463,0.4587394257119028
2021,"Iron Mountain, MI-WI",NA,2882,2772,-110,0.490272373540856
2021,"Ithaca, NY",NA,12003,9976,-2027,0.4538878019928113
2021,"Jackson, MI",NA,15844,14395,-1449,0.4760408743675386
2021,"Jackson, MS",NA,45624,43743,-1881,0.48947598106683676
2021,"Jackson, OH",NA,2456,2534,78,0.507815631262525
2021,"Jackson, TN",NA,16289,16647,358,0.5054347826086957
2021,"Jackson, WY-ID",NA,4663,4241,-422,0.47630278526504943
2021,"Jacksonville, FL",NA,202960,218970,16010,0.5189723413836418
2021,"Jacksonville, IL",NA,2961,2875,-86,0.4926319396847156
2021,"Jacksonville, NC",NA,29686,27419,-2267,0.4801505997723492
2021,"Jacksonville, TX",NA,2952,2816,-136,0.4882108183079057
2021,"Jamestown-Dunkirk-Fredonia, NY",NA,13834,12552,-1282,0.47570681421966193
2021,"Jamestown, ND",NA,2108,1879,-229,0.4712816654125909
2021,"Janesville-Beloit, WI",NA,18023,16030,-1993,0.47073679264675655
2021,"Jasper, AL",NA,4912,4883,-29,0.49851965288412453
2021,"Jasper, IN",NA,4355,4277,-78,0.4954819277108434
2021,"Jefferson City, MO",NA,12137,11443,-694,0.485284139100933
2021,"Jefferson, GA",NA,6641,8667,2026,0.5661745492552913
2021,"Jennings, LA",NA,2268,2088,-180,0.4793388429752066
2021,"Jesup, GA",NA,2740,2639,-101,0.49061163785090167
2021,"Johnson City, TN",NA,19381,20215,834,0.5105313668047278
2021,"Johnstown, PA",NA,8906,8309,-597,0.4826604705198954
2021,"Jonesboro, AR",NA,17633,14423,-3210,0.4499313701023209
2021,"Joplin, MO",NA,21396,19046,-2350,0.47094604618960484
2021,"Juneau, AK",NA,2979,2600,-379,0.46603333930811974
2021,"Kahului-Wailuku-Lahaina, HI",NA,18894,17552,-1342,0.48158920046095594
2021,"Kalamazoo-Portage, MI",NA,33264,25697,-7567,0.43583046420515253
2021,"Kalispell, MT",NA,14452,15621,1169,0.5194360389718352
2021,"Kankakee, IL",CHICAGO,11523,9084,-2439,0.4408210802154608
2021,"Kansas City, MO-KS",NA,235456,229068,-6388,0.49312414428533297
2021,"Kapaa, HI",NA,6723,6071,-652,0.4745193059246522
2021,"Kearney, NE",NA,6016,4886,-1130,0.44817464685378827
2021,"Keene, NH",NA,7625,7363,-262,0.4912596744061916
2021,"Kendallville, IN",NA,4308,3883,-425,0.4740568917104139
2021,"Kennett, MO",NA,3525,3160,-365,0.47270007479431564
2021,"Kennewick-Richland, WA",NA,28965,27635,-1330,0.48825088339222616
2021,"Kerrville, TX",NA,5245,5519,274,0.5127276105536975
2021,"Ketchikan, AK",NA,1588,1263,-325,0.4430024552788495
2021,"Key West, FL",NA,17950,18748,798,0.5108725271131942
2021,"Kill Devil Hills, NC",NA,4212,4380,168,0.5097765363128491
2021,"Killeen-Temple, TX",NA,65367,61517,-3850,0.48482866240030265
2021,"Kingsport-Bristol, TN-VA",NA,25580,27298,1718,0.5162449411853701
2021,"Kingston, NY",NEW YORK,15110,14757,-353,0.4940904677403154
2021,"Kingsville, TX",NA,3067,2520,-547,0.45104707356362983
2021,"Kinston, NC",NA,4403,3909,-494,0.470283926852743
2021,"Kirksville, MO",NA,3569,2664,-905,0.42740253489491414
2021,"Klamath Falls, OR",NA,7191,6868,-323,0.48851269649334944
2021,"Knoxville, TN",NA,86472,89844,3372,0.5095623766419384
2021,"Kokomo, IN",NA,13451,9164,-4287,0.40521777581251384
2021,"La Crosse-Onalaska, WI-MN",NA,16092,13300,-2792,0.4525040827436037
2021,"La Grande, OR",NA,3319,2699,-620,0.4484878697241608
2021,"Laconia, NH",NA,8118,8054,-64,0.4980212713331684
2021,"Lafayette-West Lafayette, IN",NA,28663,21310,-7353,0.42643027234706743
2021,"Lafayette, LA",NA,39337,38134,-1203,0.4922358043655045
2021,"LaGrange, GA-AL",NA,8689,8969,280,0.5079284177143505
2021,"Lake Charles, LA",NA,22572,19609,-2963,0.46487755150423177
2021,"Lake City, FL",NA,6704,7001,297,0.5108354615103977
2021,"Lake Havasu City-Kingman, AZ",NA,29942,35295,5353,0.5410273311157778
2021,"Lakeland-Winter Haven, FL",NA,104508,118579,14071,0.531537023672379
2021,"Lamesa, TX",NA,903,757,-146,0.45602409638554214
2021,"Lancaster, PA",NA,46275,43195,-3080,0.4827875265452107
2021,"Lansing-East Lansing, MI",NA,60134,52439,-7695,0.4658221776091958
2021,"Laramie, WY",NA,5743,4534,-1209,0.4411793324900263
2021,"Laredo, TX",NA,12000,11590,-410,0.4913098770665536
2021,"Las Cruces, NM",NA,18046,18100,54,0.5007469706191556
2021,"Las Vegas-Henderson-Paradise, NV",NA,300769,304697,3928,0.5032437824749862
2021,"Las Vegas, NM",NA,1857,1440,-417,0.4367606915377616
2021,"Laurel, MS",NA,4672,4540,-132,0.4928354320451585
2021,"Laurinburg, NC",NA,2067,2081,14,0.5016875602700096
2021,"Lawrence, KS",NA,15417,13634,-1783,0.4693125882069464
2021,"Lawrenceburg, TN",NA,4217,4141,-76,0.49545345776501554
2021,"Lawton, OK",NA,15114,14135,-979,0.48326438510718317
2021,"Lebanon, MO",NA,3854,3883,29,0.5018741114126922
2021,"Lebanon, NH-VT",NA,22974,22091,-883,0.49020304005325643
2021,"Lebanon, PA",NA,12298,11870,-428,0.4911453161204899
2021,"Levelland, TX",NA,1391,1177,-214,0.4583333333333333
2021,"Lewisburg, PA",NA,2761,2742,-19,0.49827366890786845
2021,"Lewisburg, TN",NA,3160,3209,49,0.5038467577327681
2021,"Lewiston-Auburn, ME",NA,11262,10983,-279,0.49372892784895483
2021,"Lewiston, ID-WA",NA,7578,6482,-1096,0.46102418207681367
2021,"Lewistown, PA",NA,3926,3669,-257,0.48308097432521396
2021,"Lexington-Fayette, KY",NA,59592,56211,-3381,0.48540193259241987
2021,"Lexington, NE",NA,2989,2331,-658,0.4381578947368421
2021,"Liberal, KS",NA,1545,1088,-457,0.4132168628940372
2021,"Lima, OH",NA,9613,8820,-793,0.4784896652742364
2021,"Lincoln, IL",NA,2283,2020,-263,0.46943992563327913
2021,"Lincoln, NE",NA,44312,36006,-8306,0.4482930351851391
2021,"Little Rock-North Little Rock-Conway, AR",NA,82307,80550,-1757,0.49460569702254126
2021,"Lock Haven, PA",NA,3139,2621,-518,0.45503472222222224
2021,"Logan, UT-ID",NA,16856,13216,-3640,0.43947858472998136
2021,"Logansport, IN",NA,4539,3551,-988,0.43893695920889986
2021,"London, KY",NA,10039,9999,-40,0.499001896396846
2021,"Longview, TX",NA,25914,25456,-458,0.4955421452209461
2021,"Longview, WA",NA,11778,11271,-507,0.4890016920473773
2021,"Los Alamos, NM",NA,1998,1822,-176,0.4769633507853403
2021,"Los Angeles-Long Beach-Anaheim, CA",LOS ANGELES,1132975,1014418,-118557,0.4723951321439532
2021,"Louisville/Jefferson County, KY-IN",NA,141782,131569,-10213,0.4813188903644033
2021,"Lubbock, TX",NA,33004,31000,-2004,0.4843447284544716
2021,"Ludington, MI",NA,3185,3204,19,0.5014869306620754
2021,"Lufkin, TX",NA,7229,7164,-65,0.4977419578961995
2021,"Lumberton, NC",NA,8455,7833,-622,0.48090618860510803
2021,"Lynchburg, VA",NA,22871,22667,-204,0.497760112433572
2021,"Macomb, IL",NA,2824,2625,-199,0.481739768764911
2021,"Macon-Bibb County, GA",NA,19899,20362,463,0.5057499813715506
2021,"Madera, CA",FRESNO,9371,9945,574,0.514858148685028
2021,"Madison, IN",NA,3122,2937,-185,0.4847334543654068
2021,"Madison, WI",NA,86678,77422,-9256,0.4717976843388178
2021,"Madisonville, KY",NA,4500,4469,-31,0.49827182517560487
2021,"Magnolia, AR",NA,1701,1578,-123,0.48124428179322964
2021,"Malone, NY",NA,4827,4515,-312,0.4833012202954399
2021,"Malvern, AR",NA,2723,2648,-75,0.49301805995159187
2021,"Manchester-Nashua, NH",NA,43860,41728,-2132,0.48754498294153387
2021,"Manhattan, KS",NA,22743,17001,-5742,0.4277626811594203
2021,"Manitowoc, WI",NA,7408,6480,-928,0.4665898617511521
2021,"Mankato, MN",NA,14173,10420,-3753,0.4236978001870451
2021,"Mansfield, OH",NA,11232,10743,-489,0.48887372013651875
2021,"Marietta, OH",NA,5019,4383,-636,0.46617740906190175
2021,"Marinette, WI-MI",NA,5880,5578,-302,0.48682143480537615
2021,"Marion, IN",NA,7220,6313,-907,0.4664893223971034
2021,"Marion, NC",NA,3227,3464,237,0.5177103571962337
2021,"Marion, OH",NA,5883,5347,-536,0.4761353517364203
2021,"Marquette, MI",NA,8405,7081,-1324,0.45725171122304015
2021,"Marshall, MN",NA,2895,2275,-620,0.4400386847195358
2021,"Marshall, MO",NA,2142,1898,-244,0.4698019801980198
2021,"Marshalltown, IA",NA,4008,3406,-602,0.45940113299163743
2021,"Martin, TN",NA,3332,2778,-554,0.4546644844517185
2021,"Martinsville, VA",NA,4958,4882,-76,0.49613821138211384
2021,"Maryville, MO",NA,1689,1425,-264,0.4576107899807322
2021,"Mason City, IA",NA,6204,5292,-912,0.4603340292275574
2021,"Mayfield, KY",NA,3987,3300,-687,0.45286125977768626
2021,"Maysville, KY",NA,1516,1494,-22,0.4963455149501661
2021,"McAlester, OK",NA,4116,3421,-695,0.45389412232983944
2021,"McAllen-Edinburg-Mission, TX",NA,39726,44134,4408,0.5262818984020987
2021,"McComb, MS",NA,3355,3045,-310,0.47578125
2021,"McMinnville, TN",NA,3977,3844,-133,0.4914972509909219
2021,"McPherson, KS",NA,3189,2689,-500,0.45746852670976523
2021,"Meadville, PA",NA,7673,7012,-661,0.47749404153898534
2021,"Medford, OR",NA,27322,25327,-1995,0.4810537712017322
2021,"Memphis, TN-MS-AR",NA,119937,115567,-4370,0.4907220259528501
2021,"Menomonie, WI",NA,4494,3826,-668,0.4598557692307692
2021,"Merced, CA",FRESNO,19915,18660,-1255,0.48373298768632533
2021,"Meridian, MS",NA,6542,6333,-209,0.49188349514563107
2021,"Mexico, MO",NA,2472,2331,-141,0.4853216739537789
2021,"Miami-Fort Lauderdale-Pompano Beach, FL",NA,754532,750711,-3821,0.4987307697162518
2021,"Miami, OK",NA,3124,2744,-380,0.4676209952283572
2021,"Michigan City-La Porte, IN",CHICAGO,10826,9017,-1809,0.4544171748223555
2021,"Middlesborough, KY",NA,1595,1461,-134,0.4780759162303665
2021,"Midland, MI",NA,8558,8183,-375,0.48879995221312944
2021,"Midland, TX",NA,18549,16031,-2518,0.46359167148640834
2021,"Milledgeville, GA",NA,3443,3476,33,0.5023847376788553
2021,"Milwaukee-Waukesha, WI",NA,179255,163629,-15626,0.4772138682469873
2021,"Minden, LA",NA,3525,2920,-605,0.4530643910007758
2021,"Mineral Wells, TX",NA,2873,2873,0,0.5
2021,"Minneapolis-St. Paul-Bloomington, MN-WI",NA,443367,399188,-44179,0.4737827204158779
2021,"Minot, ND",NA,10216,7581,-2635,0.42597066921391247
2021,"Missoula, MT",NA,15653,14659,-994,0.4836038532594352
2021,"Mitchell, SD",NA,2929,2324,-605,0.4424138587473824
2021,"Moberly, MO",NA,2508,2512,4,0.500398406374502
2021,"Mobile, AL",NA,37701,35718,-1983,0.4864953213745761
2021,"Modesto, CA",NA,43064,37742,-5322,0.4670692770338836
2021,"Monroe, LA",NA,19988,18327,-1661,0.4783244160250555
2021,"Monroe, MI",NA,12657,12030,-627,0.48730100862802284
2021,"Montgomery, AL",NA,39067,36209,-2858,0.48101652585153304
2021,"Montrose, CO",NA,6094,5708,-386,0.4836468395187256
2021,"Morehead City, NC",NA,6248,6853,605,0.5230898404701931
2021,"Morgan City, LA",NA,3544,3288,-256,0.4812646370023419
2021,"Morgantown, WV",NA,13753,11008,-2745,0.44457009006098297
2021,"Morristown, TN",NA,12224,12836,612,0.5122106943335993
2021,"Moscow, ID",NA,5021,4080,-941,0.4483023843533678
2021,"Moses Lake, WA",NA,8703,8226,-477,0.4859117490696438
2021,"Moultrie, GA",NA,3012,2922,-90,0.4924165824064712
2021,"Mount Airy, NC",NA,5135,5046,-89,0.49562911305372753
2021,"Mount Gay-Shamrock, WV",NA,784,830,46,0.5142503097893433
2021,"Mount Pleasant, MI",NA,6522,6089,-433,0.48283244786297674
2021,"Mount Pleasant, TX",NA,3034,3231,197,0.5157222665602554
2021,"Mount Sterling, KY",NA,4437,4454,17,0.5009560229445507
2021,"Mount Vernon-Anacortes, WA",NA,12919,12377,-542,0.48928684376976594
2021,"Mount Vernon, IL",NA,3042,2649,-393,0.4654717975751186
2021,"Mount Vernon, OH",NA,5271,5245,-26,0.4987637885127425
2021,"Mountain Home, AR",NA,4784,4770,-14,0.4992673225873979
2021,"Mountain Home, ID",NA,3972,3575,-397,0.4736981582085597
2021,"Muncie, IN",NA,12075,10388,-1687,0.4624493611717046
2021,"Murray, KY",NA,4672,3914,-758,0.4558583740973678
2021,"Muscatine, IA",NA,4761,3836,-925,0.4462021635454228
2021,"Muskegon, MI",NA,17783,15952,-1831,0.4728620127464058
2021,"Muskogee, OK",NA,7175,6328,-847,0.46863659927423534
2021,"Myrtle Beach-Conway-North Myrtle Beach, SC-NC",NA,62006,78939,16933,0.560069530667991
2021,"Nacogdoches, TX",NA,4957,4605,-352,0.4815938088266053
2021,"Napa, CA",SAN FRANCISCO,12573,11311,-1262,0.47358063975883435
2021,"Naples-Marco Island, FL",NA,87782,98928,11146,0.5298484280434899
2021,"Nashville-Davidson--Murfreesboro--Franklin, TN",NA,231203,233639,2436,0.50262024515857
2021,"Natchez, MS-LA",NA,3269,3072,-197,0.48446617252799246
2021,"Natchitoches, LA",NA,2970,2765,-205,0.48212728857890147
2021,"New Bern, NC",NA,13790,12683,-1107,0.47909190495977033
2021,"New Castle, IN",NA,4285,4054,-231,0.4861494183954911
2021,"New Castle, PA",NA,6746,6458,-288,0.48909421387458346
2021,"New Haven-Milford, CT",NA,81053,77195,-3858,0.48781027248369646
2021,"New Orleans-Metairie, LA",NA,110308,99068,-11240,0.47315833715421063
2021,"New Philadelphia-Dover, OH",NA,7584,6927,-657,0.47736200124043826
2021,"New Ulm, MN",NA,2413,1967,-446,0.44908675799086756
2021,"New York-Newark-Jersey City, NY-NJ-PA",NEW YORK,1626638,1436331,-190307,0.46893422688900865
2021,"Newberry, SC",NA,2394,2628,234,0.5232974910394266
2021,"Newport, OR",NA,8806,8519,-287,0.4917171717171717
2021,"Newport, TN",NA,3156,3392,236,0.518020769700672
2021,"Niles, MI",NA,15855,14627,-1228,0.47985696476609146
2021,"Nogales, AZ",NA,3339,3610,271,0.5194992085192114
2021,"Norfolk, NE",NA,5004,3733,-1271,0.42726336271031246
2021,"North Platte, NE",NA,4233,3544,-689,0.4557027131284557
2021,"North Port-Sarasota-Bradenton, FL",NA,161019,188268,27249,0.539006604883663
2021,"North Vernon, IN",NA,2180,2062,-118,0.4860914662894861
2021,"North Wilkesboro, NC",NA,3378,3694,316,0.522341628959276
2021,"Norwalk, OH",NA,5125,4730,-395,0.47995941146626075
2021,"Norwich-New London, CT",NA,30221,29394,-827,0.4930638262182337
2021,"Oak Harbor, WA",NA,11453,10062,-1391,0.4676737160120846
2021,"Ocala, FL",NA,49715,55304,5589,0.5266094706672126
2021,"Ocean City, NJ",PHILADELPHIA,12307,13622,1315,0.5253577075861005
2021,"Odessa, TX",NA,17450,13589,-3861,0.4378040529656239
2021,"Ogden-Clearfield, UT",NA,61429,58083,-3346,0.48600140571658074
2021,"Ogdensburg-Massena, NY",NA,10900,9104,-1796,0.45510897820435914
2021,"Oil City, PA",NA,3916,3643,-273,0.4819420558274904
2021,"Okeechobee, FL",NA,5200,6552,1352,0.5575221238938053
2021,"Oklahoma City, OK",NA,157521,148279,-9242,0.4848888162197515
2021,"Olean, NY",NA,6784,6089,-695,0.47300551541987107
2021,"Olympia-Lacey-Tumwater, WA",NA,35105,34256,-849,0.49387984602298124
2021,"Omaha-Council Bluffs, NE-IA",NA,109219,99473,-9746,0.4766497997048282
2021,"Oneonta, NY",NA,5128,4565,-563,0.47095842360466317
2021,"Ontario, OR-ID",NA,5506,5207,-299,0.48604499206571455
2021,"Opelousas, LA",NA,5487,5170,-317,0.4851271464764943
2021,"Orangeburg, SC",NA,5404,5633,229,0.5103741958865634
2021,"Orlando-Kissimmee-Sanford, FL",NA,381161,390277,9116,0.5059084463041748
2021,"Oshkosh-Neenah, WI",NA,18423,16854,-1569,0.4777617144314993
2021,"Oskaloosa, IA",NA,1952,1685,-267,0.4632939235633764
2021,"Othello, WA",NA,1192,1194,2,0.5004191114836547
2021,"Ottawa, IL",CHICAGO,11913,10429,-1484,0.46678900725091754
2021,"Ottawa, KS",NA,2478,2315,-163,0.4829960358856666
2021,"Ottumwa, IA",NA,5280,3990,-1290,0.43042071197411
2021,"Owatonna, MN",NA,3812,3487,-325,0.4777366762570215
2021,"Owensboro, KY",NA,12098,11266,-832,0.48219482965245675
2021,"Oxford, MS",NA,6582,4569,-2013,0.4097390368576809
2021,"Oxnard-Thousand Oaks-Ventura, CA",LOS ANGELES,67012,64804,-2208,0.491624688960369
2021,"Ozark, AL",NA,5563,4987,-576,0.4727014218009479
2021,"Paducah, KY-IL",NA,10292,9716,-576,0.4856057576969212
2021,"Pahrump, NV",NA,6081,7117,1036,0.5392483709652978
2021,"Palatka, FL",NA,8368,8813,445,0.5129503521331704
2021,"Palestine, TX",NA,3536,3574,38,0.5026722925457102
2021,"Palm Bay-Melbourne-Titusville, FL",NA,88201,95676,7475,0.5203260875476542
2021,"Pampa, TX",NA,1747,1687,-60,0.4912638322655795
2021,"Panama City, FL",NA,23812,27341,3529,0.5344945555490391
2021,"Paragould, AR",NA,4929,4536,-393,0.4792393026941363
2021,"Paris, TN",NA,3296,3232,-64,0.4950980392156863
2021,"Paris, TX",NA,4771,4618,-153,0.49185216742997123
2021,"Parkersburg-Vienna, WV",NA,7209,7009,-200,0.49296666197777467
2021,"Parsons, KS",NA,2353,1877,-476,0.4437352245862884
2021,"Payson, AZ",NA,6078,5830,-248,0.48958683238159223
2021,"Pearsall, TX",NA,774,859,85,0.5260257195345989
2021,"Pecos, TX",NA,663,634,-29,0.48882035466461066
2021,"Pella, IA",NA,3002,2903,-99,0.49161727349703643
2021,"Pensacola-Ferry Pass-Brent, FL",NA,56856,60016,3160,0.5135190635909371
2021,"Peoria, IL",NA,41135,35873,-5262,0.4658347184708082
2021,"Peru, IN",NA,3744,3012,-732,0.44582593250444047
2021,"Philadelphia-Camden-Wilmington, PA-NJ-DE-MD",PHILADELPHIA,505605,476618,-28987,0.485244185892613
2021,"Phoenix-Mesa-Chandler, AZ",NA,651647,683277,31630,0.5118471163901466
2021,"Picayune, MS",NA,4662,4758,96,0.5050955414012739
2021,"Pierre, SD",NA,2172,2109,-63,0.4926419060967064
2021,"Pine Bluff, AR",NA,6502,5853,-649,0.4737353298259814
2021,"Pinehurst-Southern Pines, NC",RALEIGH,9490,10696,1206,0.5298721886455959
2021,"Pittsburg, KS",NA,5118,4116,-1002,0.4457439896036387
2021,"Pittsburgh, PA",NA,203873,185808,-18065,0.47682078417988044
2021,"Pittsfield, MA",NA,13751,13360,-391,0.49278890487256094
2021,"Plainview, TX",NA,2100,1864,-236,0.47023208879919276
2021,"Platteville, WI",NA,4438,3916,-522,0.46875748144601387
2021,"Plattsburgh, NY",NA,8462,7060,-1402,0.45483829403427395
2021,"Plymouth, IN",NA,4108,3792,-316,0.48
2021,"Pocatello, ID",NA,11178,9186,-1992,0.4510901591043017
2021,"Point Pleasant, WV-OH",NA,3532,3366,-166,0.48796752681936795
2021,"Ponca City, OK",NA,5308,4463,-845,0.4567597994064067
2021,"Pontiac, IL",NA,2820,2486,-334,0.46852619675838675
2021,"Poplar Bluff, MO",NA,6932,6409,-523,0.48039877070684356
2021,"Port Angeles, WA",NA,9045,8915,-130,0.49638084632516705
2021,"Port Lavaca, TX",HOUSTON,1367,1206,-161,0.46871356393315194
2021,"Port St. Lucie, FL",NA,72376,81751,9375,0.530413230647453
2021,"Portales, NM",NA,1581,1471,-110,0.48197903014416776
2021,"Portland-South Portland, ME",NA,64584,66643,2059,0.5078451842989629
2021,"Portland-Vancouver-Hillsboro, OR-WA",NA,326999,305642,-21357,0.48312075885059613
2021,"Portsmouth, OH",NA,5983,5509,-474,0.47937695788374524
2021,"Pottsville, PA",NA,11690,11444,-246,0.49468315034148874
2021,"Poughkeepsie-Newburgh-Middletown, NY",NEW YORK,52180,50826,-1354,0.49342756732617515
2021,"Prescott Valley-Prescott, AZ",NA,32416,34935,2519,0.5187005389674987
2021,"Price, UT",NA,1805,1834,29,0.5039846111569113
2021,"Prineville, OR",NA,3500,3516,16,0.5011402508551881
2021,"Providence-Warwick, RI-MA",NA,153682,148827,-4855,0.4919754453586505
2021,"Provo-Orem, UT",NA,54401,53354,-1047,0.49514175676302724
2021,"Pueblo, CO",NA,18778,17681,-1097,0.4849557036671329
2021,"Pullman, WA",NA,5858,4643,-1215,0.44214836682220743
2021,"Punta Gorda, FL",NA,41922,49119,7197,0.5395261475598906
2021,"Quincy, IL-MO",NA,6383,5620,-763,0.46821627926351744
2021,"Racine, WI",NA,20008,18848,-1160,0.48507309038501134
2021,"Raleigh-Cary, NC",RALEIGH,154465,165216,10751,0.5168152001526521
2021,"Rapid City, SD",NA,18646,19279,633,0.508345418589321
2021,"Raymondville, TX",NA,730,753,23,0.5077545515846258
2021,"Reading, PA",PHILADELPHIA,36095,33878,-2217,0.48415817529618566
2021,"Red Bluff, CA",NA,6718,6305,-413,0.4841434385318283
2021,"Red Wing, MN",NA,4486,4189,-297,0.48288184438040344
2021,"Redding, CA",NA,19998,17982,-2016,0.47345971563981043
2021,"Reno, NV",NA,59630,58864,-766,0.49676776883217716
2021,"Rexburg, ID",NA,7490,5951,-1539,0.44274979540212783
2021,"Richmond-Berea, KY",NA,11473,11267,-206,0.49547053649956024
2021,"Richmond, IN",NA,9755,6451,-3304,0.3980624460076515
2021,"Richmond, VA",NA,131432,131412,-20,0.49996195461947013
2021,"Rio Grande City-Roma, TX",NA,2231,1235,-996,0.35631852279284476
2021,"Riverside-San Bernardino-Ontario, CA",LOS ANGELES,389590,391611,2021,0.5012935211296452
2021,"Riverton, WY",NA,3520,3341,-179,0.4869552543361026
2021,"Roanoke Rapids, NC",RALEIGH,4228,3960,-268,0.4836345872007816
2021,"Roanoke, VA",NA,30418,30091,-327,0.49729792262308087
2021,"Rochelle, IL",NA,4222,3878,-344,0.47876543209876543
2021,"Rochester, MN",NA,24253,22492,-1761,0.4811637608300353
2021,"Rochester, NY",NA,111643,103141,-8502,0.4802080229439809
2021,"Rock Springs, WY",NA,4822,4412,-410,0.47779943686376436
2021,"Rockford, IL",NA,35659,31714,-3945,0.47072269306695563
2021,"Rockingham, NC",NA,3021,2644,-377,0.46672550750220654
2021,"Rockport, TX",NA,2771,3843,1072,0.5810402177199879
2021,"Rocky Mount, NC",RALEIGH,10703,11140,437,0.5100032046880008
2021,"Rolla, MO",NA,5271,4990,-281,0.48630737744859176
2021,"Rome, GA",NA,9369,8308,-1061,0.4699892515698365
2021,"Roseburg, OR",NA,11708,11574,-134,0.49712224035735764
2021,"Roswell, NM",NA,5367,4627,-740,0.4629777866720032
2021,"Ruidoso, NM",NA,2857,2491,-366,0.46578160059835455
2021,"Russellville, AR",NA,9348,8107,-1241,0.46445144657691206
2021,"Ruston, LA",NA,4347,3648,-699,0.45628517823639775
2021,"Rutland, VT",NA,5715,5425,-290,0.486983842010772
2021,"Sacramento-Roseville-Folsom, CA",NA,240672,226990,-13682,0.48537191390363127
2021,"Safford, AZ",NA,3202,2726,-476,0.4598515519568151
2021,"Saginaw, MI",NA,18689,16899,-1790,0.47485107339552657
2021,"Salem, OH",NA,8558,7980,-578,0.4825250937235458
2021,"Salem, OR",NA,55087,43170,-11917,0.4393580101163276
2021,"Salina, KS",NA,7384,5866,-1518,0.44271698113207547
2021,"Salinas, CA",NA,28783,25578,-3205,0.47052114567428854
2021,"Salisbury, MD-DE",NA,42973,47041,4068,0.5225964849912236
2021,"Salt Lake City, UT",NA,140770,124761,-16009,0.4698547438905439
2021,"San Angelo, TX",NA,12118,11206,-912,0.48044932258617734
2021,"San Antonio-New Braunfels, TX",NA,268413,275184,6771,0.5062279593154487
2021,"San Diego-Chula Vista-Carlsbad, CA",NA,366063,342543,-23520,0.4834040355289117
2021,"San Francisco-Oakland-Berkeley, CA",SAN FRANCISCO,512839,444820,-68019,0.4644868371727306
2021,"San Jose-Sunnyvale-Santa Clara, CA",SAN FRANCISCO,231686,204354,-27332,0.468658838638657
2021,"San Luis Obispo-Paso Robles, CA",NA,27774,27517,-257,0.49767593279195527
2021,"Sandpoint, ID",NA,6391,6651,260,0.509967796350253
2021,"Sandusky, OH",NA,9084,7764,-1320,0.46082621082621084
2021,"Sanford, NC",RALEIGH,5827,9223,3396,0.6128239202657807
2021,"Santa Cruz-Watsonville, CA",NA,24005,21070,-2935,0.46744315030504713
2021,"Santa Fe, NM",NA,15177,15921,744,0.5119621840632839
2021,"Santa Maria-Santa Barbara, CA",NA,35644,33146,-2498,0.481843291176043
2021,"Santa Rosa-Petaluma, CA",SAN FRANCISCO,47944,45611,-2333,0.4875313986425098
2021,"Sault Ste. Marie, MI",NA,3445,3198,-247,0.48140900195694714
2021,"Savannah, GA",NA,50338,50351,13,0.5000645552145716
2021,"Sayre, PA",NA,5258,4767,-491,0.4755112219451372
2021,"Scottsbluff, NE",NA,3940,3478,-462,0.4688595308708547
2021,"Scottsboro, AL",NA,4097,4084,-13,0.49920547610316585
2021,"Scottsburg, IN",NA,3251,3042,-209,0.4833942475766725
2021,"Scranton--Wilkes-Barre, PA",NA,49063,46902,-2161,0.48874068670869586
2021,"Searcy, AR",NA,8060,7809,-251,0.4920914991492848
2021,"Seattle-Tacoma-Bellevue, WA",NA,534792,498393,-36399,0.48238505204779397
2021,"Sebastian-Vero Beach, FL",NA,28068,30721,2653,0.5225637449182671
2021,"Sebring-Avon Park, FL",NA,20588,21928,1340,0.5157587731677487
2021,"Sedalia, MO",NA,5081,4473,-608,0.4681808666527109
2021,"Selinsgrove, PA",NA,2105,2032,-73,0.4911771815325115
2021,"Selma, AL",NA,2225,1998,-227,0.47312337201041915
2021,"Seneca Falls, NY",NA,3015,2831,-184,0.48426274375641465
2021,"Seneca, SC",NA,7046,7693,647,0.5219485718162697
2021,"Sevierville, TN",NA,10244,10207,-37,0.49909539875800696
2021,"Seymour, IN",NA,5135,4220,-915,0.4510956707642972
2021,"Shawano, WI",NA,3167,3129,-38,0.49698221092757305
2021,"Shawnee, OK",NA,6925,6470,-455,0.4830160507652109
2021,"Sheboygan, WI",NA,12377,10512,-1865,0.45925990650530824
2021,"Shelby, NC",NA,7757,7617,-140,0.4954468583322493
2021,"Shelbyville, TN",NA,4671,4417,-254,0.48602552816901406
2021,"Shelton, WA",NA,7394,7041,-353,0.48777277450640805
2021,"Sheridan, WY",NA,3631,3660,29,0.5019887532574406
2021,"Sherman-Denison, TX",NA,13786,15652,1866,0.5316937291935594
2021,"Show Low, AZ",NA,10723,12400,1677,0.5362625956839511
2021,"Shreveport-Bossier City, LA",NA,39836,37497,-2339,0.4848770899874568
2021,"Sidney, OH",NA,4163,3431,-732,0.4518040558335528
2021,"Sierra Vista-Douglas, AZ",NA,16545,15892,-653,0.48993433424792676
2021,"Sikeston, MO",NA,4569,4020,-549,0.46804051694027243
2021,"Silver City, NM",NA,2345,2234,-111,0.48787944966149815
2021,"Sioux City, IA-NE-SD",NA,15576,13647,-1929,0.46699517503336413
2021,"Sioux Falls, SD",NA,37638,34319,-3319,0.4769376155203802
2021,"Snyder, TX",NA,1245,1079,-166,0.4642857142857143
2021,"Somerset, KY",NA,6295,6443,148,0.5058093892290784
2021,"Somerset, PA",NA,4468,4324,-144,0.49181073703366696
2021,"Sonora, CA",NA,5449,4919,-530,0.47444058641975306
2021,"South Bend-Mishawaka, IN-MI",NA,36710,30352,-6358,0.4525961050967761
2021,"Spartanburg, SC",NA,29555,31160,1605,0.5132174915589228
2021,"Spearfish, SD",NA,3739,3528,-211,0.48548231732489333
2021,"Spencer, IA",NA,1763,1548,-215,0.4675324675324675
2021,"Spirit Lake, IA",NA,2814,2403,-411,0.4606095457159287
2021,"Spokane-Spokane Valley, WA",NA,68910,66829,-2081,0.492334553812832
2021,"Springfield, IL",NA,22376,20794,-1582,0.4816770905721566
2021,"Springfield, MA",NA,66086,60341,-5745,0.4772793786137455
2021,"Springfield, MO",NA,60885,54618,-6267,0.4728708345237786
2021,"Springfield, OH",NA,11375,10797,-578,0.48696554212520293
2021,"St. Cloud, MN",NA,20881,18893,-1988,0.47500879971840904
2021,"St. George, UT",NA,20909,23510,2601,0.5292780116616763
2021,"St. Joseph, MO-KS",NA,11022,9542,-1480,0.46401478311612526
2021,"St. Louis, MO-IL",NA,264723,249342,-15381,0.48503982959353387
2021,"St. Marys, GA",NA,7998,7204,-794,0.4738850151295882
2021,"St. Marys, PA",NA,2178,1823,-355,0.45563609097725566
2021,"Starkville, MS",NA,5854,4307,-1547,0.4238756027950005
2021,"State College, PA",NA,12246,10494,-1752,0.4614775725593668
2021,"Statesboro, GA",NA,6589,6444,-145,0.4944371978822988
2021,"Staunton, VA",NA,11090,10459,-631,0.4853589493712005
2021,"Steamboat Springs, CO",NA,3552,3123,-429,0.46786516853932586
2021,"Stephenville, TX",NA,4296,4329,33,0.5019130434782608
2021,"Sterling, CO",NA,1937,1558,-379,0.4457796852646638
2021,"Sterling, IL",NA,5834,4931,-903,0.4580585229911751
2021,"Stevens Point, WI",NA,7073,6075,-998,0.46204745968968663
2021,"Stillwater, OK",NA,10642,8616,-2026,0.44739848374701424
2021,"Stockton, CA",NA,57478,57805,327,0.5014182490046234
2021,"Storm Lake, IA",NA,2020,1620,-400,0.44505494505494503
2021,"Sturgis, MI",NA,5724,5204,-520,0.47620790629575405
2021,"Sulphur Springs, TX",NA,2963,2960,-3,0.49974674995779167
2021,"Summerville, GA",NA,2030,2132,102,0.5122537241710716
2021,"Sumter, SC",NA,11594,11284,-310,0.4932249322493225
2021,"Sunbury, PA",NA,7285,6644,-641,0.47699045157584896
2021,"Susanville, CA",NA,2331,2064,-267,0.4696245733788396
2021,"Sweetwater, TX",NA,1468,1273,-195,0.4644290404961693
2021,"Syracuse, NY",NA,69411,62391,-7020,0.47336914462602997
2021,"Tahlequah, OK",NA,3789,3836,47,0.5030819672131147
2021,"Talladega-Sylacauga, AL",NA,6324,6266,-58,0.4976965845909452
2021,"Tallahassee, FL",NA,37001,36362,-639,0.49564494363643796
2021,"Tampa-St. Petersburg-Clearwater, FL",NA,477991,499852,21861,0.5111781748194751
2021,"Taos, NM",NA,2146,2361,215,0.5238517861104948
2021,"Taylorville, IL",NA,3707,2795,-912,0.4298677330052292
2021,"Terre Haute, IN",NA,17672,16647,-1025,0.48506658119409074
2021,"Texarkana, TX-AR",NA,16122,13710,-2412,0.4595736122284795
2021,"The Dalles, OR",NA,2771,2422,-349,0.46639707298286154
2021,"The Villages, FL",NA,25781,34328,8547,0.571095842552696
2021,"Thomaston, GA",NA,2404,2357,-47,0.49506406217181265
2021,"Thomasville, GA",NA,4048,3852,-196,0.4875949367088608
2021,"Tiffin, OH",NA,5039,4612,-427,0.4778779401098332
2021,"Tifton, GA",NA,3395,3296,-99,0.49260200269018084
2021,"Toccoa, GA",NA,2947,2892,-55,0.4952902894331221
2021,"Toledo, OH",NA,65758,59748,-6010,0.47605692158143836
2021,"Topeka, KS",NA,25214,22577,-2637,0.4724111234332824
2021,"Torrington, CT",NA,16513,16813,300,0.5045009902178479
2021,"Traverse City, MI",NA,19843,18837,-1006,0.48699586349534646
2021,"Trenton-Princeton, NJ",PHILADELPHIA,30157,28350,-1807,0.4845574033876288
2021,"Troy, AL",NA,3152,2781,-371,0.4687341985504804
2021,"Truckee-Grass Valley, CA",NA,10376,10263,-113,0.4972624642666796
2021,"Tucson, AZ",NA,135309,136201,892,0.5016426650952083
2021,"Tullahoma-Manchester, TN",NA,9672,10053,381,0.509657794676806
2021,"Tulsa, OK",NA,103331,100458,-2873,0.4929510424998405
2021,"Tupelo, MS",NA,13462,12781,-681,0.48702511145829364
2021,"Tuscaloosa, AL",NA,20854,19320,-1534,0.4809080499825758
2021,"Twin Falls, ID",NA,12053,11485,-568,0.487934403942561
2021,"Tyler, TX",NA,21139,22277,1138,0.5131057674590013
2021,"Ukiah, CA",SAN FRANCISCO,7433,5767,-1666,0.4368939393939394
2021,"Union City, TN",NA,2831,2604,-227,0.47911683532658694
2021,"Union, SC",NA,1838,1736,-102,0.48573027420257414
2021,"Urban Honolulu, HI",NA,103730,88046,-15684,0.45910854330051726
2021,"Urbana, OH",NA,2725,2812,87,0.5078562398410692
2021,"Utica-Rome, NY",NA,27848,24915,-2933,0.47220590186304795
2021,"Uvalde, TX",NA,1859,1681,-178,0.4748587570621469
2021,"Valdosta, GA",NA,14813,14507,-306,0.4947817189631651
2021,"Vallejo, CA",SAN FRANCISCO,39680,37048,-2632,0.48284850380565114
2021,"Van Wert, OH",NA,1878,1752,-126,0.4826446280991736
2021,"Vermillion, SD",NA,1986,1429,-557,0.41844802342606147
2021,"Vernal, UT",NA,3399,3524,125,0.5090278780875344
2021,"Vernon, TX",NA,1134,1031,-103,0.4762124711316397
2021,"Vicksburg, MS",NA,3467,3207,-260,0.480521426430926
2021,"Victoria, TX",NA,8687,8350,-337,0.49010976110817633
2021,"Vidalia, GA",NA,3156,2768,-388,0.46725185685347737
2021,"Vincennes, IN",NA,4421,3853,-568,0.46567561034566113
2021,"Vineland-Bridgeton, NJ",PHILADELPHIA,9717,9183,-534,0.48587301587301585
2021,"Vineyard Haven, MA",NA,2863,3152,289,0.5240232751454696
2021,"Virginia Beach-Norfolk-Newport News, VA-NC",NA,201124,192419,-8705,0.48894021746035377
2021,"Visalia, CA",FRESNO,29346,27964,-1382,0.4879427674053394
2021,"Wabash, IN",NA,2374,2415,41,0.5042806431405303
2021,"Waco, TX",NA,26411,24950,-1461,0.4857771460836043
2021,"Wahpeton, ND-MN",NA,1850,1590,-260,0.4622093023255814
2021,"Walla Walla, WA",NA,5969,5784,-185,0.49212966902067556
2021,"Wapakoneta, OH",NA,3162,3092,-70,0.49440358170770704
2021,"Warner Robins, GA",NA,18009,19119,1110,0.5149482870071105
2021,"Warren, PA",NA,3187,2955,-232,0.4811136437642462
2021,"Warrensburg, MO",NA,6221,5753,-468,0.4804576582595624
2021,"Warsaw, IN",NA,8193,8021,-172,0.49469594177870974
2021,"Washington Court House, OH",NA,2750,2663,-87,0.4919637908738223
2021,"Washington-Arlington-Alexandria, DC-VA-MD-WV",NA,712975,667945,-45030,0.483695652173913
2021,"Washington, IN",NA,2915,2450,-465,0.45666356011183595
2021,"Washington, NC",NA,3146,3647,501,0.5368761960842043
2021,"Waterloo-Cedar Falls, IA",NA,20225,17056,-3169,0.45749845765939756
2021,"Watertown-Fort Atkinson, WI",NA,7541,7016,-525,0.481967438345813
2021,"Watertown-Fort Drum, NY",NA,18636,15195,-3441,0.4491442759599184
2021,"Watertown, SD",NA,3917,3328,-589,0.4593512767425811
2021,"Wauchula, FL",NA,2374,2723,349,0.5342358249950951
2021,"Wausau-Weston, WI",NA,16177,14884,-1293,0.4791861176394836
2021,"Waycross, GA",NA,5305,5060,-245,0.48818137964302943
2021,"Weatherford, OK",NA,3210,2553,-657,0.44299843831337843
2021,"Weirton-Steubenville, WV-OH",NA,9090,8110,-980,0.47151162790697676
2021,"Wenatchee, WA",NA,10910,11002,92,0.5020993063161738
2021,"West Plains, MO",NA,4880,4745,-135,0.492987012987013
2021,"West Point, MS",NA,1183,1107,-76,0.4834061135371179
2021,"Wheeling, WV-OH",NA,10897,10223,-674,0.48404356060606063
2021,"Whitewater, WI",NA,12605,10871,-1734,0.4630686658715284
2021,"Wichita Falls, TX",NA,24478,15338,-9140,0.3852220212979707
2021,"Wichita, KS",NA,88368,71660,-16708,0.447796635588772
2021,"Williamsport, PA",NA,10587,10150,-437,0.48946327819838936
2021,"Williston, ND",NA,7964,5194,-2770,0.39474084207326343
2021,"Willmar, MN",NA,4794,4317,-477,0.473822851498189
2021,"Wilmington, NC",NA,34986,36876,1890,0.5131502045587376
2021,"Wilmington, OH",NA,3673,3568,-105,0.4927496202182019
2021,"Wilson, NC",RALEIGH,6071,5961,-110,0.49542885638297873
2021,"Winchester, VA-WV",NA,13120,13088,-32,0.4993894993894994
2021,"Winfield, KS",NA,3945,3367,-578,0.46047592997811815
2021,"Winnemucca, NV",NA,2452,1795,-657,0.4226512832587709
2021,"Winona, MN",NA,4609,3834,-775,0.4541039914722255
2021,"Winston-Salem, NC",NA,58600,58390,-210,0.4991024873920848
2021,"Wisconsin Rapids-Marshfield, WI",NA,7597,6990,-607,0.4791938027010352
2021,"Woodward, OK",NA,2458,1938,-520,0.4408553230209281
2021,"Wooster, OH",NA,8730,8229,-501,0.48522908190341413
2021,"Worcester, MA-CT",NA,93690,88047,-5643,0.48447481800623976
2021,"Worthington, MN",NA,1804,1331,-473,0.4245614035087719
2021,"Yakima, WA",NA,19611,17085,-2526,0.46558207979071287
2021,"Yankton, SD",NA,2749,2435,-314,0.4697145061728395
2021,"York-Hanover, PA",NA,41950,40261,-1689,0.48972765201736995
2021,"Youngstown-Warren-Boardman, OH-PA",NA,47440,43648,-3792,0.47918496399086596
2021,"Yuba City, CA",NA,14644,14376,-268,0.49538249483115093
2021,"Yuma, AZ",NA,21141,25366,4225,0.5454232696153267
2021,"Zanesville, OH",NA,8026,7583,-443,0.4858094688961497
2021,"Zapata, TX",NA,360,382,22,0.5148247978436657
2021,NA,NA,1498267,1455225,-43042,0.4927133711552291
2022,"Aberdeen, SD",NA,4548,3592,-956,0.4412776412776413
2022,"Aberdeen, WA",NA,8248,7139,-1109,0.46396308572171313
2022,"Abilene, TX",NA,19152,16985,-2167,0.47001688020588317
2022,"Ada, OK",NA,2916,2755,-161,0.4858049726679598
2022,"Adrian, MI",NA,8393,7188,-1205,0.46133110840125796
2022,"Akron, OH",NA,59818,56942,-2876,0.48768413840356284
2022,"Alamogordo, NM",NA,6515,6199,-316,0.48757275444392006
2022,"Albany-Lebanon, OR",NA,13615,13593,-22,0.4995957071449574
2022,"Albany-Schenectady-Troy, NY",NA,86318,79014,-7304,0.4779111121863886
2022,"Albany, GA",NA,12563,11937,-626,0.48722448979591837
2022,"Albemarle, NC",NA,4059,4915,856,0.5476933363048808
2022,"Albert Lea, MN",NA,2598,2159,-439,0.45385747319739334
2022,"Albertville, AL",NA,7376,7283,-93,0.4968278873047275
2022,"Albuquerque, NM",NA,80343,75260,-5083,0.4836667673502439
2022,"Alexander City, AL",NA,3169,2825,-344,0.4713046379713046
2022,"Alexandria, LA",NA,11936,10939,-997,0.47820765027322404
2022,"Alexandria, MN",NA,4159,3802,-357,0.4775781936942595
2022,"Alice, TX",NA,2252,2095,-157,0.48194156889809064
2022,"Allentown-Bethlehem-Easton, PA-NJ",NEW YORK,68849,65958,-2891,0.48927726305013836
2022,"Alma, MI",NA,3609,3311,-298,0.4784682080924855
2022,"Alpena, MI",NA,2979,2539,-440,0.4601304820587169
2022,"Altoona, PA",NA,9334,8759,-575,0.48410987674791356
2022,"Altus, OK",NA,2182,2097,-85,0.49006777284412245
2022,"Amarillo, TX",NA,23865,21450,-2415,0.473353194306521
2022,"Americus, GA",NA,2040,2029,-11,0.49864831653969033
2022,"Ames, IA",NA,14671,12075,-2596,0.451469378598669
2022,"Amsterdam, NY",NA,4768,4446,-322,0.48252658997178205
2022,"Anchorage, AK",NA,40649,37058,-3591,0.47689397351589946
2022,"Andrews, TX",NA,1258,1007,-251,0.4445916114790287
2022,"Angola, IN",NA,4702,3593,-1109,0.4331525015069319
2022,"Ann Arbor, MI",NA,37446,30768,-6678,0.45105110387896913
2022,"Anniston-Oxford, AL",NA,9312,8744,-568,0.48427115640230395
2022,"Appleton, WI",NA,22488,19650,-2838,0.46632493236508615
2022,"Arcadia, FL",NA,3568,5137,1569,0.5901206203331418
2022,"Ardmore, OK",NA,5395,4995,-400,0.4807507218479307
2022,"Arkadelphia, AR",NA,2296,2090,-206,0.47651618787049704
2022,"Asheville, NC",NA,48525,50086,1561,0.5079149384957053
2022,"Ashland, OH",NA,3682,3759,77,0.5051740357478833
2022,"Ashtabula, OH",NA,8294,7403,-891,0.4716187806587246
2022,"Astoria, OR",NA,5287,4602,-685,0.46536555769036303
2022,"Atchison, KS",NA,1694,1206,-488,0.41586206896551725
2022,"Athens-Clarke County, GA",NA,17142,15805,-1337,0.479709837010957
2022,"Athens, OH",NA,5239,4188,-1051,0.44425586082528906
2022,"Athens, TN",NA,4485,4930,445,0.5236325013276686
2022,"Athens, TX",NA,8970,9321,351,0.509594882729211
2022,"Atlanta-Sandy Springs-Alpharetta, GA",NA,588319,581990,-6329,0.49729601327512646
2022,"Atlantic City-Hammonton, NJ",PHILADELPHIA,21529,21395,-134,0.4984391016680645
2022,"Atmore, AL",NA,2367,2196,-171,0.4812623274161736
2022,"Auburn-Opelika, AL",NA,13929,13079,-850,0.48426392180094785
2022,"Auburn, IN",NA,4262,3615,-647,0.45893106512631715
2022,"Auburn, NY",NA,6879,6025,-854,0.4669094854308741
2022,"Augusta-Richmond County, GA-SC",NA,51293,52311,1018,0.5049129377244121
2022,"Augusta-Waterville, ME",NA,13787,12786,-1001,0.4811650923870094
2022,"Austin-Round Rock-Georgetown, TX",NA,286299,281172,-5127,0.49548258853756405
2022,"Austin, MN",NA,3475,3166,-309,0.4767354314109321
2022,"Bainbridge, GA",NA,1953,2013,60,0.5075642965204236
2022,"Bakersfield, CA",NA,62755,58185,-4570,0.4811063337191996
2022,"Baltimore-Columbia-Towson, MD",NA,241769,228402,-13367,0.4857849590893526
2022,"Bangor, ME",NA,15715,14667,-1048,0.4827529458231848
2022,"Baraboo, WI",NA,6150,5575,-575,0.47547974413646055
2022,"Bardstown, KY",NA,3817,3724,-93,0.49383370905715424
2022,"Barnstable Town, MA",NA,32973,32185,-788,0.49395316001105005
2022,"Barre, VT",NA,5772,5366,-406,0.48177410666187825
2022,"Bartlesville, OK",NA,4988,4542,-446,0.47660020986358864
2022,"Batavia, NY",NA,4771,4285,-486,0.473166961130742
2022,"Batesville, AR",NA,5334,5162,-172,0.4918064024390244
2022,"Baton Rouge, LA",NA,56909,54505,-2404,0.48921140969716553
2022,"Battle Creek, MI",NA,14738,12200,-2538,0.4528918256737694
2022,"Bay City, MI",NA,9118,8055,-1063,0.4690502533046061
2022,"Bay City, TX",HOUSTON,2551,2457,-94,0.4906150159744409
2022,"Beatrice, NE",NA,2088,1804,-284,0.4635149023638232
2022,"Beaumont-Port Arthur, TX",NA,31374,28899,-2475,0.47946841869493806
2022,"Beaver Dam, WI",NA,7279,6377,-902,0.4669742237844171
2022,"Beckley, WV",NA,5870,5096,-774,0.46470910085719497
2022,"Bedford, IN",NA,4445,3871,-574,0.4654882154882155
2022,"Beeville, TX",NA,1221,1172,-49,0.4897618052653573
2022,"Bellefontaine, OH",NA,3843,3484,-359,0.4755015695373277
2022,"Bellingham, WA",NA,25801,24368,-1433,0.4857182722398294
2022,"Bemidji, MN",NA,3955,3641,-314,0.4793312269615587
2022,"Bend, OR",NA,26881,27422,541,0.5049813085833196
2022,"Bennettsville, SC",NA,1462,1269,-193,0.46466495789088247
2022,"Bennington, VT",NA,3547,3186,-361,0.47319174216545373
2022,"Berlin, NH",NA,3554,3242,-312,0.47704532077692763
2022,"Big Rapids, MI",NA,4648,4282,-366,0.47950727883538635
2022,"Big Spring, TX",NA,2382,2143,-239,0.47359116022099446
2022,"Big Stone Gap, VA",NA,2593,2252,-341,0.4648090815273478
2022,"Billings, MT",NA,22141,19578,-2563,0.46928258107816584
2022,"Binghamton, NY",NA,24034,20537,-3497,0.4607704561261807
2022,"Birmingham-Hoover, AL",NA,87767,83622,-4145,0.4879076253435168
2022,"Bismarck, ND",NA,14559,12060,-2499,0.4530598444719937
2022,"Blackfoot, ID",NA,3199,2951,-248,0.47983739837398376
2022,"Blacksburg-Christiansburg, VA",NA,15387,13349,-2038,0.46453925389755013
2022,"Bloomington, IL",NA,15359,13511,-1848,0.46799445791479044
2022,"Bloomington, IN",NA,26464,15392,-11072,0.367737003058104
2022,"Bloomsburg-Berwick, PA",NA,7191,6423,-768,0.4717937417364478
2022,"Bluefield, WV-VA",NA,7305,6325,-980,0.4640498899486427
2022,"Blytheville, AR",NA,3348,2745,-603,0.4505169867060561
2022,"Bogalusa, LA",NA,3426,2709,-717,0.4415647921760391
2022,"Boise City, ID",NA,87037,82615,-4422,0.4869674392285384
2022,"Bonham, TX",NA,2491,2664,173,0.5167798254122211
2022,"Boone, NC",NA,4900,4273,-627,0.46582361277662704
2022,"Borger, TX",NA,1959,1333,-626,0.4049210206561361
2022,"Boston-Cambridge-Newton, MA-NH",NA,463211,415923,-47288,0.4731053514026303
2022,"Boulder, CO",NA,49806,41933,-7873,0.45709022335102845
2022,"Bowling Green, KY",NA,17441,17071,-370,0.49463954566527585
2022,"Bozeman, MT",NA,18516,15953,-2563,0.46282166584467205
2022,"Bradford, PA",NA,3208,2839,-369,0.4694890028113114
2022,"Brainerd, MN",NA,13677,12237,-1440,0.47221579069228986
2022,"Branson, MO",NA,9018,7579,-1439,0.45664879195035246
2022,"Breckenridge, CO",NA,4215,3832,-383,0.47620231142040514
2022,"Bremerton-Silverdale-Port Orchard, WA",NA,33635,28668,-4967,0.46013835609842224
2022,"Brenham, TX",HOUSTON,2631,2879,248,0.5225045372050817
2022,"Brevard, NC",NA,2595,3126,531,0.5464079706345044
2022,"Bridgeport-Stamford-Norwalk, CT",NEW YORK,72388,71866,-522,0.49819069141930206
2022,"Brookhaven, MS",NA,1795,1778,-17,0.49762104673943464
2022,"Brookings, OR",NA,2625,2685,60,0.5056497175141242
2022,"Brookings, SD",NA,3827,2815,-1012,0.4238181270701596
2022,"Brownsville-Harlingen, TX",NA,17860,21234,3374,0.5431524019031053
2022,"Brownsville, TN",NA,1295,1095,-200,0.4581589958158996
2022,"Brownwood, TX",NA,3271,3491,220,0.5162673765158238
2022,"Brunswick, GA",NA,11241,11881,640,0.5138396332497189
2022,"Bucyrus-Galion, OH",NA,3936,3759,-177,0.4884990253411306
2022,"Buffalo-Cheektowaga, NY",NA,102284,93771,-8513,0.47828925556604013
2022,"Burley, ID",NA,3407,3362,-45,0.4966760230462402
2022,"Burlington-South Burlington, VT",NA,28299,22424,-5875,0.442087415965144
2022,"Burlington, IA-IL",NA,4740,4005,-735,0.45797598627787306
2022,"Burlington, NC",NA,13889,14799,910,0.5158602900167317
2022,"Butte-Silver Bow, MT",NA,3373,3333,-40,0.4970175961825231
2022,"Cadillac, MI",NA,5027,4606,-421,0.4781480328039032
2022,"Calhoun, GA",NA,4738,4857,119,0.5062011464304326
2022,"California-Lexington Park, MD",NA,8328,7903,-425,0.4869077690838519
2022,"Cambridge, MD",NA,2250,2354,104,0.5112945264986968
2022,"Cambridge, OH",NA,3723,3013,-710,0.4472980997624703
2022,"Camden, AR",NA,1918,1826,-92,0.4877136752136752
2022,"Campbellsville, KY",NA,3385,3098,-287,0.47786518587073884
2022,"Ca√±on City, CO",NA,5035,4689,-346,0.4822089675030852
2022,"Canton-Massillon, OH",NA,32724,30320,-2404,0.4809339508914409
2022,"Cape Coral-Fort Myers, FL",NA,170619,170015,-604,0.4991134179207008
2022,"Cape Girardeau, MO-IL",NA,8680,7279,-1401,0.45610627232282724
2022,"Carbondale-Marion, IL",NA,13990,11818,-2172,0.45792002479851207
2022,"Carlsbad-Artesia, NM",NA,3873,3749,-124,0.4918656520598268
2022,"Carroll, IA",NA,1763,1443,-320,0.45009357454772303
2022,"Carson City, NV",NA,7451,6216,-1235,0.45481817516645934
2022,"Casper, WY",NA,7738,8088,350,0.5110577530645772
2022,"Cedar City, UT",NA,5519,5203,-316,0.48526394329416156
2022,"Cedar Rapids, IA",NA,31209,26546,-4663,0.4596312007618388
2022,"Cedartown, GA",NA,4729,3694,-1035,0.43856108274961414
2022,"Celina, OH",NA,2300,2040,-260,0.4700460829493088
2022,"Central City, KY",NA,2084,1793,-291,0.4624709827185969
2022,"Centralia, IL",NA,3778,3266,-512,0.46365701306076096
2022,"Centralia, WA",NA,7732,7087,-645,0.47823739793508335
2022,"Chambersburg-Waynesboro, PA",NA,11129,10464,-665,0.4846014912240078
2022,"Champaign-Urbana, IL",NA,24402,19803,-4599,0.4479809976247031
2022,"Charleston-Mattoon, IL",NA,5517,4914,-603,0.4710957722174288
2022,"Charleston-North Charleston, SC",NA,90131,91896,1765,0.5048481818631302
2022,"Charleston, WV",NA,17068,15429,-1639,0.47478228759577806
2022,"Charlotte-Concord-Gastonia, NC-SC",NA,254074,265717,11643,0.5111996937230541
2022,"Charlottesville, VA",NA,21676,20241,-1435,0.48288283989789343
2022,"Chattanooga, TN-GA",NA,53189,51621,-1568,0.49251979772922433
2022,"Cheyenne, WY",NA,11863,11059,-804,0.48246226332780734
2022,"Chicago-Naperville-Elgin, IL-IN-WI",CHICAGO,807008,740339,-66669,0.4784569976870088
2022,"Chico, CA",NA,21617,20053,-1564,0.4812335013198944
2022,"Chillicothe, OH",NA,5912,5345,-567,0.47481567024962246
2022,"Cincinnati, OH-KY-IN",NA,179832,171959,-7873,0.4888101173708253
2022,"Clarksburg, WV",NA,6191,5555,-636,0.472926953856632
2022,"Clarksdale, MS",NA,1291,1262,-29,0.4943204073638856
2022,"Clarksville, TN-KY",NA,43141,37806,-5335,0.46704633896253106
2022,"Clearlake, CA",NA,6083,5227,-856,0.462157382847038
2022,"Cleveland-Elyria, OH",NA,174232,165151,-9081,0.48662130984757634
2022,"Cleveland, MS",NA,1476,1104,-372,0.42790697674418604
2022,"Cleveland, TN",NA,10889,10713,-176,0.49592630312008146
2022,"Clewiston, FL",NA,3110,4563,1453,0.5946826534601851
2022,"Clinton, IA",NA,4346,3656,-690,0.45688577855536117
2022,"Clovis, NM",NA,5038,4562,-476,0.47520833333333334
2022,"Coeur d'Alene, ID",NA,20994,21137,143,0.5016970876551707
2022,"Coffeyville, KS",NA,4245,3050,-1195,0.41809458533241944
2022,"Coldwater, MI",NA,4373,3630,-743,0.4535799075346745
2022,"College Station-Bryan, TX",NA,27179,23790,-3389,0.46675430163432674
2022,"Colorado Springs, CO",NA,108062,98498,-9564,0.4768493415956623
2022,"Columbia, MO",NA,22407,19777,-2630,0.46882704342878817
2022,"Columbia, SC",NA,68966,69519,553,0.5019966061306279
2022,"Columbus, GA-AL",NA,29781,27626,-2155,0.48123051195847194
2022,"Columbus, IN",NA,9514,7846,-1668,0.45195852534562214
2022,"Columbus, MS",NA,4438,4032,-406,0.47603305785123967
2022,"Columbus, NE",NA,3234,2753,-481,0.4598296308668782
2022,"Columbus, OH",NA,210781,200349,-10432,0.48731301534794347
2022,"Concord, NH",NA,13447,13044,-403,0.49239364312407985
2022,"Connersville, IN",NA,3017,2386,-631,0.4416065148991301
2022,"Cookeville, TN",NA,10410,11004,594,0.513869431213225
2022,"Coos Bay, OR",NA,8975,7683,-1292,0.4612198343138432
2022,"Cordele, GA",NA,1480,1520,40,0.5066666666666667
2022,"Corinth, MS",NA,2391,2336,-55,0.4941823566744235
2022,"Cornelia, GA",NA,3437,3415,-22,0.4983946293053123
2022,"Corning, NY",NA,10009,8871,-1138,0.4698622881355932
2022,"Corpus Christi, TX",NA,38225,36976,-1249,0.49169558915439954
2022,"Corsicana, TX",NA,3318,3712,394,0.528022759601707
2022,"Cortland, NY",NA,4338,4120,-218,0.48711279262236934
2022,"Corvallis, OR",NA,11287,8848,-2439,0.43943382170350137
2022,"Coshocton, OH",NA,2517,2535,18,0.5017814726840855
2022,"Craig, CO",NA,1311,1077,-234,0.4510050251256281
2022,"Crawfordsville, IN",NA,3823,3304,-519,0.4635891679528553
2022,"Crescent City, CA",NA,2331,2151,-180,0.4799196787148594
2022,"Crestview-Fort Walton Beach-Destin, FL",NA,38204,42675,4471,0.5276400548968212
2022,"Crossville, TN",NA,5679,6278,599,0.5250480889855315
2022,"Cullman, AL",NA,6367,6582,215,0.5083017993667465
2022,"Cullowhee, NC",NA,5382,5513,131,0.5060119320789352
2022,"Cumberland, MD-WV",NA,6496,5780,-716,0.4708374063212773
2022,"Dallas-Fort Worth-Arlington, TX",NA,765408,769394,3986,0.5012985388343252
2022,"Dalton, GA",NA,9398,9028,-370,0.4899598393574297
2022,"Danville, IL",NA,7083,6107,-976,0.46300227445034114
2022,"Danville, KY",NA,4739,4598,-141,0.49244939488058265
2022,"Danville, VA",NA,6616,6460,-156,0.4940348730498623
2022,"Daphne-Fairhope-Foley, AL",NA,24195,28510,4315,0.5409353951238023
2022,"Davenport-Moline-Rock Island, IA-IL",NA,40727,33865,-6862,0.45400311025311024
2022,"Dayton-Kettering, OH",NA,75366,70752,-4614,0.48421139079374204
2022,"Dayton, TN",NA,2841,2944,103,0.5089023336214348
2022,"Decatur, AL",NA,10789,10581,-208,0.49513336452971457
2022,"Decatur, IL",NA,11892,9037,-2855,0.4317932055998853
2022,"Decatur, IN",NA,2441,2030,-411,0.4540371281592485
2022,"Defiance, OH",NA,3108,2757,-351,0.47007672634271097
2022,"Del Rio, TX",NA,3021,2705,-316,0.47240656653859586
2022,"Deltona-Daytona Beach-Ormond Beach, FL",NA,91630,100989,9359,0.5242940727550242
2022,"Deming, NM",NA,2041,1862,-179,0.477068921342557
2022,"Denver-Aurora-Lakewood, CO",NA,393953,373188,-20765,0.48646598213366254
2022,"DeRidder, LA",NA,2717,2582,-135,0.4872617474995282
2022,"Des Moines-West Des Moines, IA",NA,79927,74252,-5675,0.48159606690924184
2022,"Detroit-Warren-Dearborn, MI",NA,371036,332639,-38397,0.472716808185597
2022,"Dickinson, ND",NA,3521,3287,-234,0.48281433607520563
2022,"Dixon, IL",NA,2821,2544,-277,0.47418452935694316
2022,"Dodge City, KS",NA,2586,2034,-552,0.44025974025974024
2022,"Dothan, AL",NA,14180,12898,-1282,0.4763276460595317
2022,"Douglas, GA",NA,3329,3247,-82,0.49376520681265207
2022,"Dover, DE",PHILADELPHIA,14232,15421,1189,0.5200485616969616
2022,"Dublin, GA",NA,4319,4051,-268,0.48399044205495817
2022,"DuBois, PA",NA,4146,3815,-331,0.47921115437759076
2022,"Dubuque, IA",NA,9524,7872,-1652,0.4525178201885491
2022,"Duluth, MN-WI",NA,30114,26344,-3770,0.4666123490027985
2022,"Dumas, TX",NA,1527,937,-590,0.380275974025974
2022,"Duncan, OK",NA,4228,3473,-755,0.45098039215686275
2022,"Durango, CO",NA,7203,7195,-8,0.4997221836366162
2022,"Durant, OK",NA,5220,4940,-280,0.4862204724409449
2022,"Durham-Chapel Hill, NC",RALEIGH,57630,55753,-1877,0.49172274503232405
2022,"Dyersburg, TN",NA,3407,2956,-451,0.46456074178846457
2022,"Eagle Pass, TX",NA,1558,1566,8,0.501280409731114
2022,"East Stroudsburg, PA",NA,14083,11752,-2331,0.45488678149796785
2022,"Easton, MD",NA,2456,2722,266,0.5256855928930089
2022,"Eau Claire, WI",NA,18275,16160,-2115,0.46928996660374617
2022,"Edwards, CO",NA,5225,3912,-1313,0.42814928313450806
2022,"Effingham, IL",NA,2349,2163,-186,0.47938829787234044
2022,"El Campo, TX",HOUSTON,2966,2531,-435,0.4604329634346007
2022,"El Centro, CA",NA,10081,9952,-129,0.49678031248440074
2022,"El Dorado, AR",NA,3165,2684,-481,0.4588818601470337
2022,"El Paso, TX",NA,58737,53500,-5237,0.4766699038641446
2022,"Elizabeth City, NC",NA,4131,4583,452,0.5259352765664448
2022,"Elizabethtown-Fort Knox, KY",NA,17121,15347,-1774,0.4726807933965751
2022,"Elk City, OK",NA,2079,1800,-279,0.46403712296983757
2022,"Elkhart-Goshen, IN",NA,17974,15204,-2770,0.45825547049249504
2022,"Elkins, WV",NA,2006,1508,-498,0.42914058053500287
2022,"Elko, NV",NA,5728,4400,-1328,0.4344391785150079
2022,"Ellensburg, WA",NA,7553,4845,-2708,0.3907888369091789
2022,"Elmira, NY",NA,7841,7199,-642,0.478656914893617
2022,"Emporia, KS",NA,3720,2873,-847,0.4357652055210071
2022,"Enid, OK",NA,5925,5076,-849,0.4614125988546496
2022,"Enterprise, AL",NA,5202,5062,-140,0.4931800467653936
2022,"Erie, PA",NA,25372,21897,-3475,0.4632422941039582
2022,"Escanaba, MI",NA,3265,3041,-224,0.48223913732952745
2022,"Espa√±ola, NM",NA,882,764,-118,0.4641555285540705
2022,"Eufaula, AL-GA",NA,1333,1322,-11,0.49792843691148775
2022,"Eugene-Springfield, OR",NA,44779,40169,-4610,0.47286575316664314
2022,"Eureka-Arcata, CA",NA,12981,10814,-2167,0.4544652237865098
2022,"Evanston, WY",NA,1835,1473,-362,0.4452841596130592
2022,"Evansville, IN-KY",NA,31395,29193,-2202,0.48182808476926126
2022,"Fairbanks, AK",NA,10735,8133,-2602,0.43104727581089675
2022,"Fairfield, IA",NA,2052,1598,-454,0.4378082191780822
2022,"Fairmont, MN",NA,1653,1508,-145,0.47706422018348627
2022,"Fairmont, WV",NA,3918,3263,-655,0.4543935385043866
2022,"Fallon, NV",NA,2845,2659,-186,0.4831031976744186
2022,"Fargo, ND-MN",NA,36813,29115,-7698,0.44161812886785584
2022,"Faribault-Northfield, MN",NA,5433,4951,-482,0.47679121725731893
2022,"Farmington, MO",NA,6680,6002,-678,0.4732692004415707
2022,"Farmington, NM",NA,7941,7151,-790,0.4738271932149483
2022,"Fayetteville-Springdale-Rogers, AR",NA,57187,55066,-2121,0.4905525910220662
2022,"Fayetteville, NC",RALEIGH,59325,53208,-6117,0.4728213057503132
2022,"Fergus Falls, MN",NA,6311,5817,-494,0.4796339050131926
2022,"Fernley, NV",NA,6927,6317,-610,0.47697070371488975
2022,"Findlay, OH",NA,6435,5413,-1022,0.45687035786630653
2022,"Fitzgerald, GA",NA,1501,1414,-87,0.4850771869639794
2022,"Flagstaff, AZ",NA,15700,12577,-3123,0.4447784418431941
2022,"Flint, MI",NA,43534,37660,-5874,0.4638273764071237
2022,"Florence-Muscle Shoals, AL",NA,11447,11566,119,0.5025854951549125
2022,"Florence, SC",NA,13822,13408,-414,0.4923980903415351
2022,"Fond du Lac, WI",NA,9636,7649,-1987,0.44252241828174715
2022,"Forest City, NC",NA,5059,5633,574,0.5268424990647212
2022,"Forrest City, AR",NA,1400,1225,-175,0.4666666666666667
2022,"Fort Collins, CO",NA,50015,45461,-4554,0.4761510746156102
2022,"Fort Dodge, IA",NA,3865,3249,-616,0.4567050885577734
2022,"Fort Leonard Wood, MO",NA,6560,6052,-508,0.479860450364732
2022,"Fort Madison-Keokuk, IA-IL-MO",NA,5241,4119,-1122,0.44006410256410255
2022,"Fort Morgan, CO",NA,2045,2083,38,0.5046027131782945
2022,"Fort Payne, AL",NA,4894,4433,-461,0.475286801758336
2022,"Fort Polk South, LA",NA,5026,4313,-713,0.4618267480458293
2022,"Fort Smith, AR-OK",NA,26739,22409,-4330,0.45594937739073815
2022,"Fort Wayne, IN",NA,44436,37685,-6751,0.45889601928861073
2022,"Frankfort, IN",NA,2628,2374,-254,0.47461015593762496
2022,"Frankfort, KY",NA,6989,7356,367,0.5127919135587312
2022,"Fredericksburg, TX",NA,2276,2418,142,0.5151256923732425
2022,"Freeport, IL",NA,4154,3549,-605,0.4607295858756329
2022,"Fremont, NE",NA,3646,3413,-233,0.48349624592718515
2022,"Fremont, OH",NA,3700,3522,-178,0.4876765438936583
2022,"Fresno, CA",FRESNO,71184,63557,-7627,0.47169755308332284
2022,"Gadsden, AL",NA,7154,7259,105,0.5036425449247207
2022,"Gaffney, SC",NA,3728,3305,-423,0.4699274847149154
2022,"Gainesville, FL",NA,35793,34984,-809,0.49428486655269366
2022,"Gainesville, GA",NA,15784,17343,1559,0.5235306547529206
2022,"Gainesville, TX",NA,3528,3386,-142,0.48973098061903386
2022,"Galesburg, IL",NA,5116,3866,-1250,0.43041638833222
2022,"Gallup, NM",NA,1999,1632,-367,0.4494629578628477
2022,"Garden City, KS",NA,3927,2945,-982,0.42855064027939466
2022,"Gardnerville Ranchos, NV",NA,5155,5206,51,0.5024611523984172
2022,"Georgetown, SC",NA,4503,4828,325,0.5174150680527275
2022,"Gettysburg, PA",NA,6594,6679,85,0.5032019890002261
2022,"Gillette, WY",NA,6275,6274,-1,0.49996015618774403
2022,"Glasgow, KY",NA,4069,4209,140,0.5084561488282193
2022,"Glens Falls, NY",NA,13111,12532,-579,0.4887103693015638
2022,"Glenwood Springs, CO",NA,10004,8973,-1031,0.4728355377562312
2022,"Gloversville, NY",NA,4845,4613,-232,0.4877352505815183
2022,"Goldsboro, NC",RALEIGH,9344,9035,-309,0.4915936666848033
2022,"Granbury, TX",NA,6129,7072,943,0.5357169911370351
2022,"Grand Forks, ND-MN",NA,12979,9544,-3435,0.42374461661412777
2022,"Grand Island, NE",NA,7294,5953,-1341,0.4493847663621952
2022,"Grand Junction, CO",NA,19729,18212,-1517,0.48000843414775574
2022,"Grand Rapids-Kentwood, MI",NA,107411,93289,-14122,0.4648181365221724
2022,"Grand Rapids, MN",NA,4584,4238,-346,0.48038993425527093
2022,"Grants Pass, OR",NA,9111,8737,-374,0.4895226355894218
2022,"Grants, NM",NA,764,723,-41,0.4862138533960995
2022,"Great Bend, KS",NA,2591,2207,-384,0.45998332638599415
2022,"Great Falls, MT",NA,8494,7693,-801,0.4752579230246494
2022,"Greeley, CO",NA,35211,36232,1021,0.5071455565975673
2022,"Green Bay, WI",NA,34461,28928,-5533,0.4563567811449936
2022,"Greeneville, TN",NA,4788,5698,910,0.5433911882510013
2022,"Greensboro-High Point, NC",NA,70925,64952,-5973,0.47802056271480825
2022,"Greensburg, IN",NA,2593,2327,-266,0.47296747967479674
2022,"Greenville-Anderson, SC",NA,84873,87319,2446,0.507102536703215
2022,"Greenville, MS",NA,2987,2624,-363,0.467652824808412
2022,"Greenville, NC",NA,15204,14688,-516,0.4913689281413087
2022,"Greenville, OH",NA,3848,3529,-319,0.4783787447471872
2022,"Greenwood, MS",NA,1986,1631,-355,0.4509261819187172
2022,"Greenwood, SC",NA,4987,4688,-299,0.48454780361757105
2022,"Grenada, MS",NA,1451,1187,-264,0.44996209249431385
2022,"Gulfport-Biloxi, MS",NA,41372,38023,-3349,0.47890925121229294
2022,"Guymon, OK",NA,1279,872,-407,0.40539284053928404
2022,"Hagerstown-Martinsburg, MD-WV",NA,24645,25555,910,0.5090637450199204
2022,"Hailey, ID",NA,2739,2730,-9,0.49917718047174986
2022,"Hammond, LA",NA,9017,9195,178,0.504886887766308
2022,"Hanford-Corcoran, CA",FRESNO,11382,9867,-1515,0.4643512635888748
2022,"Hannibal, MO",NA,3952,3178,-774,0.44572230014025244
2022,"Harrisburg-Carlisle, PA",NA,56754,54855,-1899,0.4914926215627772
2022,"Harrison, AR",NA,4225,3925,-300,0.4815950920245399
2022,"Harrisonburg, VA",NA,9653,9173,-480,0.48725167321789015
2022,"Hartford-East Hartford-Middletown, CT",NA,108454,104514,-3940,0.49074978400510877
2022,"Hastings, NE",NA,3018,2366,-652,0.43945022288261515
2022,"Hattiesburg, MS",NA,13629,12291,-1338,0.4741898148148148
2022,"Hays, KS",NA,3368,2791,-577,0.45315798019158954
2022,"Heber, UT",NA,8388,8169,-219,0.4933864830585251
2022,"Helena-West Helena, AR",NA,1191,1067,-124,0.47254207263064657
2022,"Helena, MT",NA,8474,8796,322,0.5093225246091488
2022,"Henderson, NC",RALEIGH,3108,2859,-249,0.4791352438411262
2022,"Hereford, TX",NA,1043,874,-169,0.4559207094418362
2022,"Hermiston-Pendleton, OR",NA,8182,6524,-1658,0.44362845097239223
2022,"Hickory-Lenoir-Morganton, NC",NA,25088,25991,903,0.508839249006441
2022,"Hillsdale, MI",NA,3953,3617,-336,0.47780713342140024
2022,"Hilo, HI",NA,16257,16514,257,0.5039211497970767
2022,"Hilton Head Island-Bluffton, SC",NA,24319,26975,2656,0.5258899676375405
2022,"Hinesville, GA",NA,11413,10868,-545,0.4877698487500561
2022,"Hobbs, NM",NA,4026,3630,-396,0.47413793103448276
2022,"Holland, MI",NA,9614,8531,-1083,0.4701570680628272
2022,"Homosassa Springs, FL",NA,22259,26007,3748,0.5388265031284962
2022,"Hood River, OR",NA,2207,2084,-123,0.4856676765322769
2022,"Hope, AR",NA,1825,1459,-366,0.44427527405602923
2022,"Hot Springs, AR",NA,12463,11603,-860,0.4821324690434638
2022,"Houghton, MI",NA,3735,3298,-437,0.4689321768804209
2022,"Houma-Thibodaux, LA",NA,13207,11715,-1492,0.47006660781638715
2022,"Houston-The Woodlands-Sugar Land, TX",HOUSTON,591059,602315,11256,0.5047160404030924
2022,"Hudson, NY",NA,4365,4282,-83,0.4952006476234532
2022,"Huntingdon, PA",NA,1996,1866,-130,0.4831693423096841
2022,"Huntington-Ashland, WV-KY-OH",NA,25797,22994,-2803,0.47127544014264927
2022,"Huntington, IN",NA,4135,3301,-834,0.4439214631522324
2022,"Huntsville, AL",NA,44875,47649,2774,0.5149907051143487
2022,"Huntsville, TX",HOUSTON,5113,5456,343,0.5162267007285457
2022,"Huron, SD",NA,1930,1664,-266,0.46299387868670006
2022,"Hutchinson, KS",NA,7441,5841,-1600,0.43976810721276915
2022,"Hutchinson, MN",NA,3307,2863,-444,0.4640194489465154
2022,"Idaho Falls, ID",NA,14346,13560,-786,0.4859170070952483
2022,"Indiana, PA",NA,5029,4881,-148,0.4925327951564077
2022,"Indianapolis-Carmel-Anderson, IN",NA,235511,222150,-13361,0.48540295109262094
2022,"Indianola, MS",NA,937,825,-112,0.4682179341657208
2022,"Iowa City, IA",NA,20900,17219,-3681,0.4517169915265353
2022,"Iron Mountain, MI-WI",NA,2613,2444,-169,0.4832904884318766
2022,"Ithaca, NY",NA,11359,9163,-2196,0.44649644284182827
2022,"Jackson, MI",NA,14898,13364,-1534,0.47286108555657774
2022,"Jackson, MS",NA,40858,38632,-2226,0.4859982387721726
2022,"Jackson, OH",NA,2236,2123,-113,0.4870383115393439
2022,"Jackson, TN",NA,15397,14111,-1286,0.4782092991731056
2022,"Jackson, WY-ID",NA,4550,3884,-666,0.46051695518140856
2022,"Jacksonville, FL",NA,185701,199634,13933,0.5180790740524479
2022,"Jacksonville, IL",NA,2735,2637,-98,0.49087862993298587
2022,"Jacksonville, NC",NA,27211,25611,-1600,0.4848547953504222
2022,"Jacksonville, TX",NA,2949,2653,-296,0.473580863977151
2022,"Jamestown-Dunkirk-Fredonia, NY",NA,13034,12110,-924,0.48162583518930957
2022,"Jamestown, ND",NA,1798,1579,-219,0.4675747705063666
2022,"Janesville-Beloit, WI",NA,16477,14006,-2471,0.45946921234786603
2022,"Jasper, AL",NA,4504,4408,-96,0.49461400359066426
2022,"Jasper, IN",NA,4347,3863,-484,0.4705237515225335
2022,"Jefferson City, MO",NA,11237,10124,-1113,0.47394784888347924
2022,"Jefferson, GA",NA,6167,8329,2162,0.5745722958057395
2022,"Jennings, LA",NA,1978,1830,-148,0.4805672268907563
2022,"Jesup, GA",NA,2813,2545,-268,0.4749906681597611
2022,"Johnson City, TN",NA,17875,18070,195,0.5027124773960217
2022,"Johnstown, PA",NA,8130,7571,-559,0.4821985860773199
2022,"Jonesboro, AR",NA,15464,12526,-2938,0.44751697034655236
2022,"Joplin, MO",NA,18801,17058,-1743,0.475696477871664
2022,"Juneau, AK",NA,2702,2392,-310,0.469572045543777
2022,"Kahului-Wailuku-Lahaina, HI",NA,16907,15508,-1399,0.4784204843436681
2022,"Kalamazoo-Portage, MI",NA,30283,23794,-6489,0.4400022190580099
2022,"Kalispell, MT",NA,13789,13959,170,0.5030632838402768
2022,"Kankakee, IL",CHICAGO,10832,8405,-2427,0.43691843842595
2022,"Kansas City, MO-KS",NA,212654,205996,-6658,0.49204825032843663
2022,"Kapaa, HI",NA,5840,5115,-725,0.4669100867183934
2022,"Kearney, NE",NA,5904,4676,-1228,0.44196597353497163
2022,"Keene, NH",NA,7342,6900,-442,0.4844825165004915
2022,"Kendallville, IN",NA,4141,3450,-691,0.4544855750230536
2022,"Kennett, MO",NA,2854,2271,-583,0.4431219512195122
2022,"Kennewick-Richland, WA",NA,25988,24292,-1696,0.48313444709626097
2022,"Kerrville, TX",NA,5178,4923,-255,0.4873774873774874
2022,"Ketchikan, AK",NA,1299,1155,-144,0.4706601466992665
2022,"Key West, FL",NA,15918,16524,606,0.5093397447752913
2022,"Kill Devil Hills, NC",NA,3769,3676,-93,0.4937541974479516
2022,"Killeen-Temple, TX",NA,63442,55781,-7661,0.4678711322479723
2022,"Kingsport-Bristol, TN-VA",NA,22742,24026,1284,0.5137273349298666
2022,"Kingston, NY",NEW YORK,14532,13248,-1284,0.476889848812095
2022,"Kingsville, TX",NA,2903,2090,-813,0.41858602042860005
2022,"Kinston, NC",NA,4065,3678,-387,0.47500968616815187
2022,"Kirksville, MO",NA,3252,2455,-797,0.43017347117574906
2022,"Klamath Falls, OR",NA,5981,5900,-81,0.4965911960272704
2022,"Knoxville, TN",NA,79016,78127,-889,0.4971713662078489
2022,"Kokomo, IN",NA,11851,8443,-3408,0.41603429585099044
2022,"La Crosse-Onalaska, WI-MN",NA,14789,11982,-2807,0.4475738672444063
2022,"La Grande, OR",NA,3477,2521,-956,0.4203067689229743
2022,"Laconia, NH",NA,7996,7478,-518,0.48326224634871395
2022,"Lafayette-West Lafayette, IN",NA,26910,19117,-7793,0.4153431681404393
2022,"Lafayette, LA",NA,34105,32782,-1323,0.4901101858358126
2022,"LaGrange, GA-AL",NA,8042,7672,-370,0.48822705867379407
2022,"Lake Charles, LA",NA,17601,16557,-1044,0.484718074828737
2022,"Lake City, FL",NA,6013,6378,365,0.5147284319263982
2022,"Lake Havasu City-Kingman, AZ",NA,28786,32205,3419,0.5280287255496713
2022,"Lakeland-Winter Haven, FL",NA,99090,109826,10736,0.5256945375174711
2022,"Lamesa, TX",NA,740,605,-135,0.44981412639405205
2022,"Lancaster, PA",NA,41986,38735,-3251,0.479862737082048
2022,"Lansing-East Lansing, MI",NA,55959,47461,-8498,0.45891510346161285
2022,"Laramie, WY",NA,5428,4094,-1334,0.42995169082125606
2022,"Laredo, TX",NA,9700,9816,116,0.5029719204755073
2022,"Las Cruces, NM",NA,16749,16999,250,0.5037039231954487
2022,"Las Vegas-Henderson-Paradise, NV",NA,269482,264441,-5041,0.4952792818440112
2022,"Las Vegas, NM",NA,1885,1483,-402,0.4403206650831354
2022,"Laurel, MS",NA,4019,3901,-118,0.49255050505050507
2022,"Laurinburg, NC",NA,1880,1992,112,0.5144628099173554
2022,"Lawrence, KS",NA,13696,11963,-1733,0.4662301726489731
2022,"Lawrenceburg, TN",NA,3896,3912,16,0.5010245901639344
2022,"Lawton, OK",NA,13597,11795,-1802,0.4645163831127914
2022,"Lebanon, MO",NA,3633,3542,-91,0.49365853658536585
2022,"Lebanon, NH-VT",NA,22068,19827,-2241,0.4732545649838883
2022,"Lebanon, PA",NA,11064,10829,-235,0.4946329877129676
2022,"Levelland, TX",NA,1457,1114,-343,0.43329443796188255
2022,"Lewisburg, PA",NA,2736,2415,-321,0.46884100174723353
2022,"Lewisburg, TN",NA,2831,3106,275,0.5231598450395822
2022,"Lewiston-Auburn, ME",NA,11484,10843,-641,0.4856451829623326
2022,"Lewiston, ID-WA",NA,6590,5747,-843,0.4658344816405933
2022,"Lewistown, PA",NA,3903,3719,-184,0.4879296772500656
2022,"Lexington-Fayette, KY",NA,53681,49395,-4286,0.47920951530909234
2022,"Lexington, NE",NA,2669,2059,-610,0.43549069373942473
2022,"Liberal, KS",NA,1208,1001,-207,0.45314622000905386
2022,"Lima, OH",NA,9221,8445,-776,0.4780369070530963
2022,"Lincoln, IL",NA,2068,1772,-296,0.46145833333333336
2022,"Lincoln, NE",NA,40946,32767,-8179,0.4445213191702956
2022,"Little Rock-North Little Rock-Conway, AR",NA,75688,71880,-3808,0.48709747370703677
2022,"Lock Haven, PA",NA,2872,2492,-380,0.4645786726323639
2022,"Logan, UT-ID",NA,15911,12153,-3758,0.4330458950969213
2022,"Logansport, IN",NA,3685,2890,-795,0.43954372623574145
2022,"London, KY",NA,8593,8867,274,0.5078465063001145
2022,"Longview, TX",NA,24234,23092,-1142,0.48793475045429574
2022,"Longview, WA",NA,10282,10019,-263,0.4935224865770159
2022,"Los Alamos, NM",NA,1843,1904,61,0.508139845209501
2022,"Los Angeles-Long Beach-Anaheim, CA",LOS ANGELES,950165,862688,-87477,0.47587311271239313
2022,"Louisville/Jefferson County, KY-IN",NA,128568,118290,-10278,0.4791823639501252
2022,"Lubbock, TX",NA,31322,28024,-3298,0.4722137970545614
2022,"Ludington, MI",NA,3014,2828,-186,0.484080794248545
2022,"Lufkin, TX",NA,7029,6561,-468,0.4827814569536424
2022,"Lumberton, NC",NA,8384,7576,-808,0.47468671679197993
2022,"Lynchburg, VA",NA,20997,20617,-380,0.4954342288652857
2022,"Macomb, IL",NA,2872,2582,-290,0.4734140080674734
2022,"Macon-Bibb County, GA",NA,17937,18772,835,0.5113732327222207
2022,"Madera, CA",FRESNO,8571,8992,421,0.5119854239025223
2022,"Madison, IN",NA,2885,2753,-132,0.4882937211777226
2022,"Madison, WI",NA,78876,68846,-10030,0.4660510959775795
2022,"Madisonville, KY",NA,4500,4040,-460,0.47306791569086654
2022,"Magnolia, AR",NA,1580,1346,-234,0.4600136705399863
2022,"Malone, NY",NA,4549,4166,-383,0.47802639127940333
2022,"Malvern, AR",NA,2455,2391,-64,0.49339661576557986
2022,"Manchester-Nashua, NH",NA,41103,38008,-3095,0.4804388770208947
2022,"Manhattan, KS",NA,19946,14944,-5002,0.4283175695041559
2022,"Manitowoc, WI",NA,6575,5786,-789,0.46808510638297873
2022,"Mankato, MN",NA,21025,9670,-11355,0.3150350219905522
2022,"Mansfield, OH",NA,10869,9749,-1120,0.4728392666601998
2022,"Marietta, OH",NA,4520,4063,-457,0.47337760689735525
2022,"Marinette, WI-MI",NA,5848,5151,-697,0.46831530139103555
2022,"Marion, IN",NA,6652,5976,-676,0.47323408299018055
2022,"Marion, NC",NA,3126,3248,122,0.509570128647631
2022,"Marion, OH",NA,5190,4913,-277,0.4862912006334752
2022,"Marquette, MI",NA,8089,6469,-1620,0.44436048907817005
2022,"Marshall, MN",NA,2668,2070,-598,0.4368932038834951
2022,"Marshall, MO",NA,1891,1696,-195,0.47281851129077224
2022,"Marshalltown, IA",NA,3576,3245,-331,0.4757366954991937
2022,"Martin, TN",NA,3172,2484,-688,0.4391796322489392
2022,"Martinsville, VA",NA,5037,4594,-443,0.477001349807912
2022,"Maryville, MO",NA,1572,1332,-240,0.45867768595041325
2022,"Mason City, IA",NA,5675,4758,-917,0.45605290903862744
2022,"Mayfield, KY",NA,4079,2894,-1185,0.4150293991108562
2022,"Maysville, KY",NA,1434,1373,-61,0.4891343070894193
2022,"McAlester, OK",NA,3657,2911,-746,0.4432095006090134
2022,"McAllen-Edinburg-Mission, TX",NA,36336,39957,3621,0.523730879635091
2022,"McComb, MS",NA,2935,2453,-482,0.4552709725315516
2022,"McMinnville, TN",NA,3667,3553,-114,0.4921052631578947
2022,"McPherson, KS",NA,2887,2652,-235,0.4787867846181621
2022,"Meadville, PA",NA,7505,6640,-865,0.46942382467302934
2022,"Medford, OR",NA,24772,23875,-897,0.49078052089543034
2022,"Memphis, TN-MS-AR",NA,110013,103161,-6852,0.4839286216893242
2022,"Menomonie, WI",NA,4399,3587,-812,0.4491610318056599
2022,"Merced, CA",FRESNO,19862,17003,-2859,0.46122338261223383
2022,"Meridian, MS",NA,5753,5518,-235,0.4895750155265726
2022,"Mexico, MO",NA,2059,1931,-128,0.4839598997493734
2022,"Miami-Fort Lauderdale-Pompano Beach, FL",NA,673678,647093,-26585,0.4899358026486045
2022,"Miami, OK",NA,2854,2309,-545,0.44722060817354253
2022,"Michigan City-La Porte, IN",CHICAGO,9732,8194,-1538,0.45710141693629364
2022,"Middlesborough, KY",NA,1329,1268,-61,0.4882556796303427
2022,"Midland, MI",NA,8292,7341,-951,0.4695835732105162
2022,"Midland, TX",NA,16228,14424,-1804,0.47057288268302233
2022,"Milledgeville, GA",NA,3015,2968,-47,0.4960722045796423
2022,"Milwaukee-Waukesha, WI",NA,162081,145391,-16690,0.47285931727116615
2022,"Minden, LA",NA,3266,2671,-595,0.4498905170961765
2022,"Mineral Wells, TX",NA,2575,2459,-116,0.4884783472387763
2022,"Minneapolis-St. Paul-Bloomington, MN-WI",NA,404079,367016,-37063,0.47596729326477283
2022,"Minot, ND",NA,9147,6541,-2606,0.4169428862825089
2022,"Missoula, MT",NA,14407,13068,-1339,0.4756323930846224
2022,"Mitchell, SD",NA,2593,2107,-486,0.4482978723404255
2022,"Moberly, MO",NA,2122,2044,-78,0.49063850216034566
2022,"Mobile, AL",NA,31909,29641,-2268,0.48157595450852964
2022,"Modesto, CA",NA,39652,34118,-5534,0.4624915277212959
2022,"Monroe, LA",NA,17555,16104,-1451,0.478445586618735
2022,"Monroe, MI",NA,11718,10912,-806,0.4821917808219178
2022,"Montgomery, AL",NA,33591,30149,-3442,0.47299968622529026
2022,"Montrose, CO",NA,5668,5228,-440,0.4798091042584435
2022,"Morehead City, NC",NA,5826,6235,409,0.5169554763286627
2022,"Morgan City, LA",NA,2939,2598,-341,0.4692071518873036
2022,"Morgantown, WV",NA,12075,9648,-2427,0.4441375500621461
2022,"Morristown, TN",NA,11816,12008,192,0.5040295500335796
2022,"Moscow, ID",NA,4879,3716,-1163,0.43234438627108784
2022,"Moses Lake, WA",NA,10430,9430,-1000,0.47482376636455187
2022,"Moultrie, GA",NA,2935,2747,-188,0.4834565293910595
2022,"Mount Airy, NC",NA,4736,4680,-56,0.4970263381478335
2022,"Mount Gay-Shamrock, WV",NA,877,899,22,0.5061936936936937
2022,"Mount Pleasant, MI",NA,6255,5727,-528,0.47796695042563847
2022,"Mount Pleasant, TX",NA,2844,2861,17,0.501489921121823
2022,"Mount Sterling, KY",NA,3949,3725,-224,0.4854052645295804
2022,"Mount Vernon-Anacortes, WA",NA,12672,11920,-752,0.4847104749512036
2022,"Mount Vernon, IL",NA,2832,2307,-525,0.44892002335084646
2022,"Mount Vernon, OH",NA,4812,4541,-271,0.4855126697316369
2022,"Mountain Home, AR",NA,4678,4431,-247,0.4864419804588868
2022,"Mountain Home, ID",NA,3637,3117,-520,0.46150429375185076
2022,"Muncie, IN",NA,11433,9585,-1848,0.4560376819868684
2022,"Murray, KY",NA,4161,3464,-697,0.45429508196721313
2022,"Muscatine, IA",NA,4397,3479,-918,0.44172168613509394
2022,"Muskegon, MI",NA,16812,15049,-1763,0.4723329462352092
2022,"Muskogee, OK",NA,7876,5657,-2219,0.4180152220498042
2022,"Myrtle Beach-Conway-North Myrtle Beach, SC-NC",NA,57510,71614,14104,0.5546141693256095
2022,"Nacogdoches, TX",NA,5182,4122,-1060,0.4430352536543422
2022,"Napa, CA",SAN FRANCISCO,11223,10083,-1140,0.47324697268375104
2022,"Naples-Marco Island, FL",NA,84442,90635,6193,0.5176865036526785
2022,"Nashville-Davidson--Murfreesboro--Franklin, TN",NA,213138,206983,-6155,0.49267472942318996
2022,"Natchez, MS-LA",NA,3224,2922,-302,0.47543117474780344
2022,"Natchitoches, LA",NA,2567,2400,-167,0.48318904771491844
2022,"New Bern, NC",NA,12945,11889,-1056,0.47873882580333416
2022,"New Castle, IN",NA,3924,3689,-235,0.4845658741626166
2022,"New Castle, PA",NA,6438,5948,-490,0.4802196027773292
2022,"New Haven-Milford, CT",NA,74730,71075,-3655,0.4874661362779054
2022,"New Orleans-Metairie, LA",NA,92612,81532,-11080,0.4681872473355384
2022,"New Philadelphia-Dover, OH",NA,7055,6368,-687,0.47440959547046113
2022,"New Ulm, MN",NA,2177,1991,-186,0.47768714011516317
2022,"New York-Newark-Jersey City, NY-NJ-PA",NEW YORK,1344383,1195165,-149218,0.47062114990541626
2022,"Newberry, SC",NA,1998,2313,315,0.5365344467640919
2022,"Newport, OR",NA,7661,6807,-854,0.47048659109759466
2022,"Newport, TN",NA,2954,3109,155,0.5127824509318819
2022,"Niles, MI",NA,14937,13432,-1505,0.47347456730938703
2022,"Nogales, AZ",NA,2752,2909,157,0.513866807984455
2022,"Norfolk, NE",NA,4271,3492,-779,0.4498260981579286
2022,"North Platte, NE",NA,3821,3106,-715,0.4483903565757182
2022,"North Port-Sarasota-Bradenton, FL",NA,155519,171143,15624,0.5239146273518193
2022,"North Vernon, IN",NA,2076,1906,-170,0.4786539427423405
2022,"North Wilkesboro, NC",NA,3349,3186,-163,0.4875286916602907
2022,"Norwalk, OH",NA,5027,4283,-744,0.46004296455424276
2022,"Norwich-New London, CT",NA,28735,27115,-1620,0.485496866606983
2022,"Oak Harbor, WA",NA,10368,9189,-1179,0.4698573400828348
2022,"Ocala, FL",NA,47018,53379,6361,0.5316792334432304
2022,"Ocean City, NJ",PHILADELPHIA,11947,12165,218,0.5045205706702057
2022,"Odessa, TX",NA,14851,12382,-2469,0.45466896779642346
2022,"Ogden-Clearfield, UT",NA,57014,52443,-4571,0.47911965429346687
2022,"Ogdensburg-Massena, NY",NA,11117,9300,-1817,0.4555027673017583
2022,"Oil City, PA",NA,3700,3603,-97,0.49335889360536767
2022,"Okeechobee, FL",NA,4666,6125,1459,0.5676026318228153
2022,"Oklahoma City, OK",NA,143006,132370,-10636,0.4806882226483063
2022,"Olean, NY",NA,6431,5837,-594,0.4757906749266384
2022,"Olympia-Lacey-Tumwater, WA",NA,33069,31822,-1247,0.49039157972600206
2022,"Omaha-Council Bluffs, NE-IA",NA,99184,88502,-10682,0.47154289611372185
2022,"Oneonta, NY",NA,4928,4227,-701,0.46171490988530856
2022,"Ontario, OR-ID",NA,5493,4970,-523,0.47500716811621907
2022,"Opelousas, LA",NA,5291,4675,-616,0.46909492273730685
2022,"Orangeburg, SC",NA,4869,4987,118,0.5059862012987013
2022,"Orlando-Kissimmee-Sanford, FL",NA,344210,338097,-6113,0.4955203449473624
2022,"Oshkosh-Neenah, WI",NA,17335,15668,-1667,0.4747447201769536
2022,"Oskaloosa, IA",NA,1855,1543,-312,0.4540906415538552
2022,"Othello, WA",NA,984,886,-98,0.4737967914438503
2022,"Ottawa, IL",CHICAGO,11217,9767,-1450,0.4654498665650019
2022,"Ottawa, KS",NA,2347,2154,-193,0.4785603199289047
2022,"Ottumwa, IA",NA,4779,3486,-1293,0.42177858439201454
2022,"Owatonna, MN",NA,3606,3301,-305,0.47792094976111194
2022,"Owensboro, KY",NA,10733,9962,-771,0.4813723121526939
2022,"Oxford, MS",NA,5129,4010,-1119,0.4387788598314914
2022,"Oxnard-Thousand Oaks-Ventura, CA",LOS ANGELES,58968,57638,-1330,0.4942970344579181
2022,"Ozark, AL",NA,5224,4443,-781,0.459604841212372
2022,"Paducah, KY-IL",NA,9509,8408,-1101,0.46927499023273983
2022,"Pahrump, NV",NA,5937,6242,305,0.5125215534937188
2022,"Palatka, FL",NA,7600,7953,353,0.5113482929338391
2022,"Palestine, TX",NA,3528,3483,-45,0.496790757381258
2022,"Palm Bay-Melbourne-Titusville, FL",NA,82340,88768,6428,0.5187834584005423
2022,"Pampa, TX",NA,1574,1320,-254,0.4561161022805805
2022,"Panama City, FL",NA,22511,25654,3143,0.5326274265545521
2022,"Paragould, AR",NA,4030,3874,-156,0.4901315789473684
2022,"Paris, TN",NA,3051,2961,-90,0.49251497005988026
2022,"Paris, TX",NA,4344,4247,-97,0.49435455709463394
2022,"Parkersburg-Vienna, WV",NA,6497,6043,-454,0.4818979266347687
2022,"Parsons, KS",NA,2052,1706,-346,0.45396487493347526
2022,"Payson, AZ",NA,5368,5218,-150,0.49291517098054033
2022,"Pearsall, TX",NA,728,796,68,0.5223097112860893
2022,"Pecos, TX",NA,542,581,39,0.5173642030276047
2022,"Pella, IA",NA,2915,2771,-144,0.48733731973267674
2022,"Pensacola-Ferry Pass-Brent, FL",NA,51206,54225,3019,0.5143174208724189
2022,"Peoria, IL",NA,39059,33171,-5888,0.45924131247404126
2022,"Peru, IN",NA,3505,2824,-681,0.4462000316005688
2022,"Philadelphia-Camden-Wilmington, PA-NJ-DE-MD",PHILADELPHIA,456796,425375,-31421,0.48219109447034647
2022,"Phoenix-Mesa-Chandler, AZ",NA,605718,618798,13080,0.5053408857050459
2022,"Picayune, MS",NA,4394,4211,-183,0.4893666472980825
2022,"Pierre, SD",NA,2096,1921,-175,0.47821757530495396
2022,"Pine Bluff, AR",NA,5718,5268,-450,0.4795193883123976
2022,"Pinehurst-Southern Pines, NC",RALEIGH,8862,9750,888,0.5238555770470664
2022,"Pittsburg, KS",NA,4852,3760,-1092,0.43660009289363677
2022,"Pittsburgh, PA",NA,188250,168956,-19294,0.47299317480669417
2022,"Pittsfield, MA",NA,12812,11622,-1190,0.4756486862568552
2022,"Plainview, TX",NA,1672,1442,-230,0.4630700064226076
2022,"Platteville, WI",NA,3975,3538,-437,0.4709170770664182
2022,"Plattsburgh, NY",NA,8146,6912,-1234,0.4590251029353168
2022,"Plymouth, IN",NA,3800,3453,-347,0.4760788639183786
2022,"Pocatello, ID",NA,9804,8399,-1405,0.4614074603087403
2022,"Point Pleasant, WV-OH",NA,3521,3098,-423,0.4680465327088684
2022,"Ponca City, OK",NA,4742,3872,-870,0.4495008126306013
2022,"Pontiac, IL",NA,2581,2270,-311,0.46794475365903937
2022,"Poplar Bluff, MO",NA,6264,5314,-950,0.4589739160476766
2022,"Port Angeles, WA",NA,8623,7904,-719,0.4782477158588976
2022,"Port Lavaca, TX",HOUSTON,1684,1136,-548,0.40283687943262414
2022,"Port St. Lucie, FL",NA,66906,75273,8367,0.5294241765661596
2022,"Portales, NM",NA,1592,1547,-45,0.49283211213762346
2022,"Portland-South Portland, ME",NA,61272,61179,-93,0.4996202562657716
2022,"Portland-Vancouver-Hillsboro, OR-WA",NA,289177,269493,-19684,0.4823831600050119
2022,"Portsmouth, OH",NA,5250,4940,-310,0.4847890088321884
2022,"Pottsville, PA",NA,11929,11425,-504,0.4892095572492935
2022,"Poughkeepsie-Newburgh-Middletown, NY",NEW YORK,49298,46141,-3157,0.4834606397803833
2022,"Prescott Valley-Prescott, AZ",NA,32195,32285,90,0.5006978908188585
2022,"Price, UT",NA,1444,1500,56,0.5095108695652174
2022,"Prineville, OR",NA,3156,3216,60,0.504708097928437
2022,"Providence-Warwick, RI-MA",NA,142328,137480,-4848,0.4913369167429094
2022,"Provo-Orem, UT",NA,51032,49267,-1765,0.49120130808881446
2022,"Pueblo, CO",NA,17504,16086,-1418,0.47889252753795775
2022,"Pullman, WA",NA,5347,4141,-1206,0.4364460370994941
2022,"Punta Gorda, FL",NA,42995,46345,3350,0.5187486008506828
2022,"Quincy, IL-MO",NA,5962,5017,-945,0.4569632935604336
2022,"Racine, WI",NA,18191,16826,-1365,0.4805094668303967
2022,"Raleigh-Cary, NC",RALEIGH,142250,149270,7020,0.5120403402854007
2022,"Rapid City, SD",NA,17050,17460,410,0.5059403071573457
2022,"Raymondville, TX",NA,506,496,-10,0.49500998003992014
2022,"Reading, PA",PHILADELPHIA,32064,30407,-1657,0.4867378463607114
2022,"Red Bluff, CA",NA,6511,5980,-531,0.4787446961812505
2022,"Red Wing, MN",NA,4492,3894,-598,0.46434533746720724
2022,"Redding, CA",NA,18510,16225,-2285,0.4671081042176479
2022,"Reno, NV",NA,56818,53739,-3079,0.486075056305797
2022,"Rexburg, ID",NA,7116,5311,-1805,0.4273758751106462
2022,"Richmond-Berea, KY",NA,10508,10338,-170,0.49592247913268733
2022,"Richmond, IN",NA,7920,5339,-2581,0.40266988460668224
2022,"Richmond, VA",NA,118499,118648,149,0.5003141511383234
2022,"Rio Grande City-Roma, TX",NA,1868,1039,-829,0.35741314069487445
2022,"Riverside-San Bernardino-Ontario, CA",LOS ANGELES,355777,351991,-3786,0.49732539476212545
2022,"Riverton, WY",NA,3033,2896,-137,0.4884466183167482
2022,"Roanoke Rapids, NC",RALEIGH,3983,3789,-194,0.4875193000514668
2022,"Roanoke, VA",NA,26916,26906,-10,0.4999071011853889
2022,"Rochelle, IL",NA,3832,3557,-275,0.4813912572743267
2022,"Rochester, MN",NA,23271,21028,-2243,0.47468340143118354
2022,"Rochester, NY",NA,108336,99201,-9135,0.47799187614738575
2022,"Rock Springs, WY",NA,4188,3766,-422,0.47347246668342974
2022,"Rockford, IL",NA,33115,30200,-2915,0.4769801784727158
2022,"Rockingham, NC",NA,3152,2693,-459,0.46073567151411465
2022,"Rockport, TX",NA,2646,3650,1004,0.579733163913596
2022,"Rocky Mount, NC",RALEIGH,9726,10213,487,0.512212247354431
2022,"Rolla, MO",NA,4568,4382,-186,0.48960893854748605
2022,"Rome, GA",NA,8905,7443,-1462,0.45528505015904086
2022,"Roseburg, OR",NA,11253,10901,-352,0.49205561072492554
2022,"Roswell, NM",NA,4677,4170,-507,0.47134621905730756
2022,"Ruidoso, NM",NA,2771,2234,-537,0.4463536463536463
2022,"Russellville, AR",NA,8021,6875,-1146,0.46153329752953814
2022,"Ruston, LA",NA,4351,3178,-1173,0.42210120865984857
2022,"Rutland, VT",NA,5730,5174,-556,0.47450476889214965
2022,"Sacramento-Roseville-Folsom, CA",NA,221024,206219,-14805,0.4826737945384711
2022,"Safford, AZ",NA,3078,2254,-824,0.42273068267066766
2022,"Saginaw, MI",NA,17470,15398,-2072,0.4684799805281733
2022,"Salem, OH",NA,8120,7544,-576,0.4816138917262513
2022,"Salem, OR",NA,51273,39588,-11685,0.4356984844982996
2022,"Salina, KS",NA,6418,5230,-1188,0.4490041208791209
2022,"Salinas, CA",NA,27665,23751,-3914,0.4619379181577719
2022,"Salisbury, MD-DE",NA,38987,41053,2066,0.5129060469765118
2022,"Salt Lake City, UT",NA,123967,107483,-16484,0.4643897170015122
2022,"San Angelo, TX",NA,10752,9574,-1178,0.47102233592443177
2022,"San Antonio-New Braunfels, TX",NA,247881,249631,1750,0.5017587515477013
2022,"San Diego-Chula Vista-Carlsbad, CA",NA,322424,296146,-26278,0.47875907334658974
2022,"San Francisco-Oakland-Berkeley, CA",SAN FRANCISCO,414312,372237,-42075,0.47325341459972614
2022,"San Jose-Sunnyvale-Santa Clara, CA",SAN FRANCISCO,185340,167118,-18222,0.47415011150264713
2022,"San Luis Obispo-Paso Robles, CA",NA,25162,24153,-1009,0.48976984690256514
2022,"Sandpoint, ID",NA,6054,5934,-120,0.494994994994995
2022,"Sandusky, OH",NA,8319,7024,-1295,0.4577983445219318
2022,"Sanford, NC",RALEIGH,5350,8813,3463,0.6222551719268516
2022,"Santa Cruz-Watsonville, CA",NA,21347,18431,-2916,0.4633465734828297
2022,"Santa Fe, NM",NA,13974,14375,401,0.5070725598786553
2022,"Santa Maria-Santa Barbara, CA",NA,31462,28062,-3400,0.47144009139170756
2022,"Santa Rosa-Petaluma, CA",SAN FRANCISCO,41455,39154,-2301,0.48572740016623456
2022,"Sault Ste. Marie, MI",NA,3346,2952,-394,0.46872022864401397
2022,"Savannah, GA",NA,47607,44846,-2761,0.4850680886504494
2022,"Sayre, PA",NA,4983,4499,-484,0.47447795823665895
2022,"Scottsbluff, NE",NA,3821,3262,-559,0.46053931949738813
2022,"Scottsboro, AL",NA,3931,3864,-67,0.49570237331622835
2022,"Scottsburg, IN",NA,3012,2703,-309,0.47296587926509187
2022,"Scranton--Wilkes-Barre, PA",NA,46509,43220,-3289,0.48167259191565714
2022,"Searcy, AR",NA,7074,6963,-111,0.4960461637101945
2022,"Seattle-Tacoma-Bellevue, WA",NA,485703,442029,-43674,0.47646195237417704
2022,"Sebastian-Vero Beach, FL",NA,25980,28125,2145,0.5198225672303853
2022,"Sebring-Avon Park, FL",NA,18839,20657,1818,0.5230149888596314
2022,"Sedalia, MO",NA,4463,3802,-661,0.46001209921355113
2022,"Selinsgrove, PA",NA,2283,1998,-285,0.4667133847231955
2022,"Selma, AL",NA,1627,1437,-190,0.46899477806788514
2022,"Seneca Falls, NY",NA,3204,2576,-628,0.44567474048442907
2022,"Seneca, SC",NA,6950,7119,169,0.5060061127301159
2022,"Sevierville, TN",NA,9201,8956,-245,0.49325329074186264
2022,"Seymour, IN",NA,4166,3834,-332,0.47925
2022,"Shawano, WI",NA,3098,2615,-483,0.45772798879747945
2022,"Shawnee, OK",NA,6082,5925,-157,0.4934621470808695
2022,"Sheboygan, WI",NA,11289,9420,-1869,0.4548746921628278
2022,"Shelby, NC",NA,7393,6885,-508,0.4822103936125508
2022,"Shelbyville, TN",NA,3956,3942,-14,0.4991136996708027
2022,"Shelton, WA",NA,7327,6315,-1012,0.46290866441870693
2022,"Sheridan, WY",NA,3559,3223,-336,0.4752285461515777
2022,"Sherman-Denison, TX",NA,13492,14726,1234,0.521865475937345
2022,"Show Low, AZ",NA,10660,11236,576,0.5131530873218852
2022,"Shreveport-Bossier City, LA",NA,34135,31525,-2610,0.4801248857752056
2022,"Sidney, OH",NA,3526,3014,-512,0.46085626911314986
2022,"Sierra Vista-Douglas, AZ",NA,16604,14559,-2045,0.46718865321053815
2022,"Sikeston, MO",NA,4394,3605,-789,0.45068133516689585
2022,"Silver City, NM",NA,2416,1950,-466,0.44663307375171785
2022,"Sioux City, IA-NE-SD",NA,14772,12024,-2748,0.44872369010300045
2022,"Sioux Falls, SD",NA,34501,29786,-4715,0.46332851120755364
2022,"Snyder, TX",NA,1473,967,-506,0.3963114754098361
2022,"Somerset, KY",NA,5939,6086,147,0.5061122661122661
2022,"Somerset, PA",NA,4042,3800,-242,0.4845702626880898
2022,"Sonora, CA",NA,5261,4576,-685,0.46518247433160514
2022,"South Bend-Mishawaka, IN-MI",NA,34281,27493,-6788,0.44505779130378476
2022,"Spartanburg, SC",NA,26554,28838,2284,0.5206166955517042
2022,"Spearfish, SD",NA,3798,3290,-508,0.4641647855530474
2022,"Spencer, IA",NA,1485,1302,-183,0.4671689989235737
2022,"Spirit Lake, IA",NA,2652,2338,-314,0.4685370741482966
2022,"Spokane-Spokane Valley, WA",NA,65256,61063,-4193,0.4834031301704415
2022,"Springfield, IL",NA,20625,18637,-1988,0.4746828994956956
2022,"Springfield, MA",NA,62398,55737,-6661,0.47180767765691795
2022,"Springfield, MO",NA,56788,48616,-8172,0.4612348677469546
2022,"Springfield, OH",NA,10474,9629,-845,0.47898323633288564
2022,"St. Cloud, MN",NA,20939,17601,-3338,0.4566943435391801
2022,"St. George, UT",NA,19386,20636,1250,0.5156164109739643
2022,"St. Joseph, MO-KS",NA,10497,8651,-1846,0.45179653227491123
2022,"St. Louis, MO-IL",NA,235419,220774,-14645,0.48394867961586435
2022,"St. Marys, GA",NA,7901,6585,-1316,0.45457683280408673
2022,"St. Marys, PA",NA,2065,1852,-213,0.4728108246106714
2022,"Starkville, MS",NA,5418,3764,-1654,0.40993247658462206
2022,"State College, PA",NA,11710,9673,-2037,0.4523687041107422
2022,"Statesboro, GA",NA,5654,5442,-212,0.4904470079307859
2022,"Staunton, VA",NA,10269,9743,-526,0.4868578852688387
2022,"Steamboat Springs, CO",NA,3641,2837,-804,0.43794380981784503
2022,"Stephenville, TX",NA,4354,4012,-342,0.47956012431269424
2022,"Sterling, CO",NA,1923,1603,-320,0.4546228020419739
2022,"Sterling, IL",NA,5575,4673,-902,0.45599141295862605
2022,"Stevens Point, WI",NA,6278,5288,-990,0.45720214421580496
2022,"Stillwater, OK",NA,9310,7591,-1719,0.4491450210046743
2022,"Stockton, CA",NA,54119,54434,315,0.5014509041666283
2022,"Storm Lake, IA",NA,2105,1519,-586,0.41915011037527594
2022,"Sturgis, MI",NA,5045,4677,-368,0.4810738531166427
2022,"Sulphur Springs, TX",NA,2698,2858,160,0.5143988480921526
2022,"Summerville, GA",NA,2002,2020,18,0.5022376926902039
2022,"Sumter, SC",NA,10201,10027,-174,0.49569903104607477
2022,"Sunbury, PA",NA,7244,6598,-646,0.47666522178875886
2022,"Susanville, CA",NA,2310,1961,-349,0.45914305783188947
2022,"Sweetwater, TX",NA,1358,1273,-85,0.48384644621816797
2022,"Syracuse, NY",NA,68739,60152,-8587,0.46668890768168453
2022,"Tahlequah, OK",NA,3223,3121,-102,0.4919609079445145
2022,"Talladega-Sylacauga, AL",NA,5622,5661,39,0.5017282637596384
2022,"Tallahassee, FL",NA,32816,32511,-305,0.49766559003168676
2022,"Tampa-St. Petersburg-Clearwater, FL",NA,448717,453505,4788,0.5026534489294209
2022,"Taos, NM",NA,2276,2028,-248,0.4711895910780669
2022,"Taylorville, IL",NA,3552,2682,-870,0.4302213666987488
2022,"Terre Haute, IN",NA,16249,15035,-1214,0.4805971103439458
2022,"Texarkana, TX-AR",NA,14809,12153,-2656,0.4507454936577405
2022,"The Dalles, OR",NA,2500,2187,-313,0.46660977170898227
2022,"The Villages, FL",NA,24811,32933,8122,0.5703276530894985
2022,"Thomaston, GA",NA,2214,2119,-95,0.4890376182783291
2022,"Thomasville, GA",NA,3815,3664,-151,0.48990506752239604
2022,"Tiffin, OH",NA,4773,4204,-569,0.46830789796145705
2022,"Tifton, GA",NA,3180,3274,94,0.5072823055469476
2022,"Toccoa, GA",NA,2612,2594,-18,0.498271225509028
2022,"Toledo, OH",NA,59184,53273,-5911,0.47371884364690503
2022,"Topeka, KS",NA,22857,20054,-2803,0.4673393768497588
2022,"Torrington, CT",NA,15289,14888,-401,0.4933558670510654
2022,"Traverse City, MI",NA,19599,17662,-1937,0.4740076755857331
2022,"Trenton-Princeton, NJ",PHILADELPHIA,26423,24076,-2347,0.4767619160775461
2022,"Troy, AL",NA,2873,2544,-329,0.46963263799150823
2022,"Truckee-Grass Valley, CA",NA,9690,9617,-73,0.4981094939659191
2022,"Tucson, AZ",NA,122120,123843,1723,0.503502559328029
2022,"Tullahoma-Manchester, TN",NA,9346,9208,-138,0.496281125363803
2022,"Tulsa, OK",NA,93666,88940,-4726,0.4870595708793796
2022,"Tupelo, MS",NA,12739,11602,-1137,0.47664434493241853
2022,"Tuscaloosa, AL",NA,18448,16779,-1669,0.4763107843415562
2022,"Twin Falls, ID",NA,11013,10044,-969,0.4769910243624448
2022,"Tyler, TX",NA,20570,20395,-175,0.49786403026974246
2022,"Ukiah, CA",SAN FRANCISCO,7056,5671,-1385,0.4455881197454231
2022,"Union City, TN",NA,2377,2263,-114,0.4877155172413793
2022,"Union, SC",NA,1714,1627,-87,0.486979946123915
2022,"Urban Honolulu, HI",NA,92182,78134,-14048,0.4587590126588224
2022,"Urbana, OH",NA,2619,2736,117,0.5109243697478991
2022,"Utica-Rome, NY",NA,26109,23839,-2270,0.477276367422119
2022,"Uvalde, TX",NA,1789,1443,-346,0.4464727722772277
2022,"Valdosta, GA",NA,12427,12519,92,0.5018439830032871
2022,"Vallejo, CA",SAN FRANCISCO,36310,34823,-1487,0.4895477485836391
2022,"Van Wert, OH",NA,1748,1682,-66,0.4903790087463557
2022,"Vermillion, SD",NA,2003,1427,-576,0.41603498542274053
2022,"Vernal, UT",NA,2709,2549,-160,0.48478508938759984
2022,"Vernon, TX",NA,1171,976,-195,0.4545877969259432
2022,"Vicksburg, MS",NA,3007,2827,-180,0.4845731916352417
2022,"Victoria, TX",NA,7928,7304,-624,0.4795168067226891
2022,"Vidalia, GA",NA,3041,2603,-438,0.4611977321048901
2022,"Vincennes, IN",NA,3991,3635,-356,0.476658798846053
2022,"Vineland-Bridgeton, NJ",PHILADELPHIA,9417,8992,-425,0.48845673311966975
2022,"Vineyard Haven, MA",NA,2719,2598,-121,0.48862140304683094
2022,"Virginia Beach-Norfolk-Newport News, VA-NC",NA,181687,172485,-9202,0.487009136803587
2022,"Visalia, CA",FRESNO,28298,25340,-2958,0.47242626496140794
2022,"Wabash, IN",NA,2349,2230,-119,0.4870058964839485
2022,"Waco, TX",NA,24166,22122,-2044,0.47792084341514
2022,"Wahpeton, ND-MN",NA,1783,1443,-340,0.4473031618102914
2022,"Walla Walla, WA",NA,5233,5029,-204,0.4900604170726954
2022,"Wapakoneta, OH",NA,3141,3020,-121,0.49018016555753935
2022,"Warner Robins, GA",NA,16746,17911,1165,0.5168075713420088
2022,"Warren, PA",NA,2955,2662,-293,0.47391846181235536
2022,"Warrensburg, MO",NA,5421,5189,-232,0.489066918001885
2022,"Warsaw, IN",NA,7703,6936,-767,0.47380285538629685
2022,"Washington Court House, OH",NA,2315,2301,-14,0.4984835355285962
2022,"Washington-Arlington-Alexandria, DC-VA-MD-WV",NA,603655,568556,-35099,0.4850287192322884
2022,"Washington, IN",NA,2673,2291,-382,0.4615229653505238
2022,"Washington, NC",NA,3072,3277,205,0.5161442746889274
2022,"Waterloo-Cedar Falls, IA",NA,18275,15474,-2801,0.45850247414738216
2022,"Watertown-Fort Atkinson, WI",NA,6900,6196,-704,0.4731215638362859
2022,"Watertown-Fort Drum, NY",NA,18357,14251,-4106,0.4370399901864573
2022,"Watertown, SD",NA,3681,3128,-553,0.45939198120135116
2022,"Wauchula, FL",NA,2642,2758,116,0.5107407407407407
2022,"Wausau-Weston, WI",NA,14263,12836,-1427,0.4736706151518506
2022,"Waycross, GA",NA,4955,4788,-167,0.49142974443189985
2022,"Weatherford, OK",NA,3302,2344,-958,0.41516117605384345
2022,"Weirton-Steubenville, WV-OH",NA,8680,7449,-1231,0.46183892367784735
2022,"Wenatchee, WA",NA,10298,10019,-279,0.493133828813309
2022,"West Plains, MO",NA,4517,4219,-298,0.4829441391941392
2022,"West Point, MS",NA,1133,1079,-54,0.48779385171790235
2022,"Wheeling, WV-OH",NA,9525,8700,-825,0.4773662551440329
2022,"Whitewater, WI",NA,12023,9742,-2281,0.4475993567654491
2022,"Wichita Falls, TX",NA,26261,14231,-12030,0.351452138694063
2022,"Wichita, KS",NA,79585,64160,-15425,0.4463459598594734
2022,"Williamsport, PA",NA,9617,9329,-288,0.49239945107146627
2022,"Williston, ND",NA,6668,4901,-1767,0.42363212032154896
2022,"Willmar, MN",NA,4539,3912,-627,0.46290379836705714
2022,"Wilmington, NC",NA,31716,33078,1362,0.5105102324289286
2022,"Wilmington, OH",NA,3337,3531,194,0.5141234711706465
2022,"Wilson, NC",RALEIGH,5222,5477,255,0.5119170015889335
2022,"Winchester, VA-WV",NA,11904,11545,-359,0.4923450893428291
2022,"Winfield, KS",NA,3905,3194,-711,0.44992252429919705
2022,"Winnemucca, NV",NA,2064,1694,-370,0.45077168706758913
2022,"Winona, MN",NA,4398,3650,-748,0.45352882703777336
2022,"Winston-Salem, NC",NA,53998,54195,197,0.5009104101004687
2022,"Wisconsin Rapids-Marshfield, WI",NA,6971,6149,-822,0.4686737804878049
2022,"Woodward, OK",NA,2413,1748,-665,0.4200913242009132
2022,"Wooster, OH",NA,8330,7545,-785,0.4752755905511811
2022,"Worcester, MA-CT",NA,88044,81914,-6130,0.4819661328092823
2022,"Worthington, MN",NA,1834,1227,-607,0.4008493956223456
2022,"Yakima, WA",NA,18821,15377,-3444,0.4496461781390725
2022,"Yankton, SD",NA,2721,2245,-476,0.45207410390656466
2022,"York-Hanover, PA",NA,38276,37013,-1263,0.49161232052491066
2022,"Youngstown-Warren-Boardman, OH-PA",NA,44605,40394,-4211,0.4752291203425923
2022,"Yuba City, CA",NA,14349,13642,-707,0.4873709406594977
2022,"Yuma, AZ",NA,19595,23701,4106,0.5474177753141167
2022,"Zanesville, OH",NA,7238,6885,-353,0.4875026552432203
2022,"Zapata, TX",NA,293,304,11,0.509212730318258
2022,NA,NA,1404544,1314236,-90308,0.4833918154466342
