zipcode,city,state,outbound,inbound,netgain,pct_inbound
01001,AGAWAM,MA,6411,6504,93,0.5036004645760743
01002,AMHERST,MA,13239,9671,-3568,0.42213007420340465
01004,AMHERST,MA,650,439,-211,0.40312213039485767
01005,BARRE,MA,1365,1519,154,0.5266990291262136
01007,BELCHERTOWN,MA,4727,4919,192,0.5099523118391043
01008,BLANDFORD,MA,173,180,7,0.509915014164306
01009,BONDSVILLE,MA,305,368,63,0.5468053491827637
01010,BRIMFIELD,MA,1119,1176,57,0.5124183006535947
01011,CHESTER,MA,214,134,-80,0.3850574712643678
01012,CHESTERFIELD,MA,58,24,-34,0.2926829268292683
01013,CHICOPEE,MA,9951,8581,-1370,0.4630369091301533
01014,CHICOPEE,MA,505,188,-317,0.2712842712842713
01020,CHICOPEE,MA,11451,10579,-872,0.4802088061733999
01021,CHICOPEE,MA,1213,687,-526,0.36157894736842106
01022,CHICOPEE,MA,805,886,81,0.5239503252513306
01022,WESTOVER AFB,MA,16,15,-1,0.4838709677419355
01026,CUMMINGTON,MA,178,190,12,0.5163043478260869
01027,EASTHAMPTON,MA,8059,6918,-1141,0.4619082593309742
01028,EAST LONGMEADOW,MA,4912,5175,263,0.5130365817388718
01029,EAST OTIS,MA,430,556,126,0.563894523326572
01030,FEEDING HILLS,MA,3238,3270,32,0.5024585125998771
01031,GILBERTVILLE,MA,482,408,-74,0.4584269662921348
01032,GOSHEN,MA,130,36,-94,0.21686746987951808
01033,GRANBY,MA,2064,2018,-46,0.4943655071043606
01034,GRANVILLE,MA,597,504,-93,0.45776566757493187
01034,TOLLAND,MA,46,71,25,0.6068376068376068
01035,HADLEY,MA,2411,2250,-161,0.48272902810555673
01036,HAMPDEN,MA,1255,1395,140,0.5264150943396226
01037,HARDWICK,MA,24,17,-7,0.4146341463414634
01038,HATFIELD,MA,856,828,-28,0.4916864608076009
01039,HAYDENVILLE,MA,267,299,32,0.5282685512367491
01039,WEST WHATELY,MA,42,31,-11,0.4246575342465753
01040,HOLYOKE,MA,17657,15373,-2284,0.46542537087496216
01041,HOLYOKE,MA,1487,869,-618,0.36884550084889645
01050,HUNTINGTON,MA,855,779,-76,0.47674418604651164
01050,MONTGOMERY,MA,26,19,-7,0.4222222222222222
01053,LEEDS,MA,987,868,-119,0.4679245283018868
01054,LEVERETT,MA,537,603,66,0.5289473684210526
01056,LUDLOW,MA,6389,6064,-325,0.486950935517546
01057,MONSON,MA,2331,2430,99,0.5103969754253308
01060,NORTHAMPTON,MA,10149,8551,-1598,0.4572727272727273
01061,NORTHAMPTON,MA,331,226,-105,0.40574506283662476
01062,FLORENCE,MA,3828,3863,35,0.5022753868157587
01066,NORTH HATFIELD,MA,16,0,-16,0
01068,OAKHAM,MA,515,550,35,0.5164319248826291
01069,PALMER,MA,3133,3044,-89,0.4927958555933301
01070,PLAINFIELD,MA,49,69,20,0.5847457627118644
01071,RUSSELL,MA,266,203,-63,0.43283582089552236
01072,SHUTESBURY,MA,430,430,0,0.5
01073,SOUTHAMPTON,MA,1624,1772,148,0.5217903415783275
01074,SOUTH BARRE,MA,118,37,-81,0.23870967741935484
01075,SOUTH HADLEY,MA,5964,5890,-74,0.49687869073730384
01077,SOUTHWICK,MA,3244,3283,39,0.5029875900107247
01079,THORNDIKE,MA,240,155,-85,0.3924050632911392
01080,THREE RIVERS,MA,1046,1047,1,0.5002388915432394
01081,WALES,MA,552,564,12,0.5053763440860215
01082,WARE,MA,4699,4350,-349,0.48071610122665487
01083,WARREN,MA,1036,879,-157,0.4590078328981723
01085,MONTGOMERY,MA,276,327,51,0.5422885572139303
01085,WESTFIELD,MA,13713,12723,-990,0.4812755333635951
01086,WESTFIELD,MA,837,434,-403,0.34146341463414637
01088,WEST HATFIELD,MA,23,34,11,0.5964912280701754
01089,WEST SPRINGFIELD,MA,12188,10700,-1488,0.4674938832576022
01090,WEST SPRINGFIELD,MA,674,324,-350,0.3246492985971944
01092,WEST WARREN,MA,303,223,-80,0.42395437262357416
01093,WHATELY,MA,70,23,-47,0.24731182795698925
01095,WILBRAHAM,MA,3931,4378,447,0.5268985437477434
01096,WILLIAMSBURG,MA,730,922,192,0.5581113801452785
01098,WORTHINGTON,MA,164,210,46,0.5614973262032086
01101,SPRINGFIELD,MA,1240,2293,1053,0.649023492782338
01103,SPRINGFIELD,MA,2454,2042,-412,0.4541814946619217
01104,SPRINGFIELD,MA,9946,8856,-1090,0.471013721944474
01105,SPRINGFIELD,MA,7413,6133,-1280,0.4527535803927359
01106,LONGMEADOW,MA,4337,4971,634,0.5340567253975075
01107,SPRINGFIELD,MA,5135,4233,-902,0.45185738684884713
01108,SPRINGFIELD,MA,15596,12529,-3067,0.44547555555555557
01109,SPRINGFIELD,MA,12654,11350,-1304,0.47283786035660724
01115,INDIAN ORCHARD,MA,0,15,15,1
01116,LONGMEADOW,MA,26,0,-26,0
01118,SPRINGFIELD,MA,4597,4548,-49,0.4973209404045927
01119,SPRINGFIELD,MA,4244,4052,-192,0.4884281581485053
01128,SPRINGFIELD,MA,549,603,54,0.5234375
01129,SPRINGFIELD,MA,2366,2442,76,0.5079034941763727
01138,SPRINGFIELD,MA,242,659,417,0.7314095449500555
01139,SPFLD,MA,0,16,16,1
01139,SPRINGFIELD,MA,23,304,281,0.9296636085626911
01151,INDIAN ORCH,MA,493,397,-96,0.4460674157303371
01151,INDIAN ORCHARD,MA,4268,3501,-767,0.45063714763804863
01151,SPRINGFIELD,MA,150,152,2,0.5033112582781457
01201,PITTSFIELD,MA,19156,17727,-1429,0.48062793156738876
01202,PITTSFIELD,MA,984,702,-282,0.41637010676156583
01220,ADAMS,MA,3782,3316,-466,0.4671738517892364
01222,ASHLEY FALLS,MA,11,92,81,0.8932038834951457
01223,BECKET,MA,1072,1158,86,0.5192825112107623
01223,WASHINGTON,MA,72,158,86,0.6869565217391305
01225,CHESHIRE,MA,1009,1028,19,0.5046637211585665
01226,DALTON,MA,2116,2206,90,0.5104118463674225
01230,EGREMONT,MA,53,72,19,0.576
01230,GREAT BARRINGTON,MA,3576,4189,613,0.53947198969736
01230,NEW MARLBOROUGH,MA,104,66,-38,0.38823529411764707
01235,HINSDALE,MA,858,927,69,0.519327731092437
01235,PERU,MA,150,104,-46,0.4094488188976378
01236,HOUSATONIC,MA,600,522,-78,0.46524064171123
01237,HANCOCK,MA,43,43,0,0.5
01237,LANESBOROUGH,MA,1087,1125,38,0.5085895117540687
01238,LEE,MA,2502,2728,226,0.5216061185468451
01240,LENOX,MA,3306,3638,332,0.523905529953917
01242,LENOX DALE,MA,42,44,2,0.5116279069767442
01244,MILL RIVER,MA,16,22,6,0.5789473684210527
01245,MONTEREY,MA,389,485,96,0.5549199084668193
01245,WEST OTIS,MA,0,27,27,1
01247,CLARKSBURG,MA,154,116,-38,0.42962962962962964
01247,NORTH ADAMS,MA,6650,5855,-795,0.4682127149140344
01253,OTIS,MA,686,672,-14,0.4948453608247423
01254,RICHMOND,MA,281,379,98,0.5742424242424242
01255,SANDISFIELD,MA,111,208,97,0.6520376175548589
01256,SAVOY,MA,0,34,34,1
01257,SHEFFIELD,MA,933,1078,145,0.5360517155643958
01258,S EGREMONT,MA,22,0,-22,0
01258,SOUTH EGREMONT,MA,199,433,234,0.685126582278481
01259,SOUTHFIELD,MA,52,182,130,0.7777777777777778
01262,STOCKBRIDGE,MA,1387,1281,-106,0.4801349325337331
01264,TYRINGHAM,MA,18,0,-18,0
01266,ALFORD,MA,14,0,-14,0
01266,W STOCKBRIDGE,MA,11,37,26,0.7708333333333334
01266,WEST STOCKBRIDGE,MA,983,867,-116,0.46864864864864864
01267,WILLIAMSTOWN,MA,2844,3051,207,0.517557251908397
01270,WINDSOR,MA,14,15,1,0.5172413793103449
01301,GREENFIELD,MA,8003,7401,-602,0.4804596208776941
01302,GREENFIELD,MA,292,241,-51,0.4521575984990619
01330,ASHFIELD,MA,393,435,42,0.5253623188405797
01331,ATHOL,MA,5696,5757,61,0.502663057714136
01337,BERNARDSTON,MA,749,724,-25,0.49151391717583165
01337,LEYDEN,MA,54,71,17,0.568
01339,CHARLEMONT,MA,436,440,4,0.502283105022831
01339,HAWLEY,MA,92,53,-39,0.36551724137931035
01340,COLRAIN,MA,487,476,-11,0.49428868120456904
01341,CONWAY,MA,134,275,141,0.6723716381418093
01342,DEERFIELD,MA,339,221,-118,0.39464285714285713
01344,ERVING,MA,212,168,-44,0.4421052631578947
01346,HEATH,MA,11,22,11,0.6666666666666666
01347,LAKE PLEASANT,MA,0,11,11,1
01349,MILLERS FALLS,MA,48,77,29,0.616
01351,MONTAGUE,MA,861,783,-78,0.4762773722627737
01354,GILL,MA,187,329,142,0.6375968992248062
01355,NEW SALEM,MA,11,25,14,0.6944444444444444
01360,NORTHFIELD,MA,955,1014,59,0.5149822244794312
01364,ORANGE,MA,3136,3158,22,0.5017476962186209
01366,PETERSHAM,MA,63,255,192,0.8018867924528302
01367,ROWE,MA,12,0,-12,0
01368,ROYALSTON,MA,115,202,87,0.637223974763407
01370,SHELBURNE FALLS,MA,1441,1523,82,0.5138326585695007
01370,SHELBURNE FLS,MA,70,61,-9,0.46564885496183206
01373,S DEERFIELD,MA,200,274,74,0.5780590717299579
01373,SOUTH DEERFIELD,MA,1317,1470,153,0.527448869752422
01375,SUNDERLAND,MA,2376,1834,-542,0.4356294536817102
01376,TURNERS FALLS,MA,2435,2207,-228,0.475441619991383
01378,WARWICK,MA,12,36,24,0.75
01379,WENDELL,MA,70,62,-8,0.4696969696969697
01420,FITCHBURG,MA,21006,19636,-1370,0.483145514492397
01430,ASHBURNHAM,MA,2128,2205,77,0.5088852988691438
01431,ASHBY,MA,1024,925,-99,0.4746023601847101
01432,AYER,MA,3181,3134,-47,0.4962787015043547
01434,DEVENS,MA,98,162,64,0.6230769230769231
01436,BALDWINVILLE,MA,866,986,120,0.5323974082073434
01438,EAST TEMPLETON,MA,56,12,-44,0.17647058823529413
01440,GARDNER,MA,10007,9135,-872,0.4772228607251071
01450,GROTON,MA,2793,3155,362,0.5304303967720242
01451,HARVARD,MA,1395,1659,264,0.5432220039292731
01452,HUBBARDSTON,MA,1194,1218,24,0.5049751243781094
01453,LEOMINSTER,MA,18739,17809,-930,0.4872770055817008
01460,LITTLETON,MA,3024,3255,231,0.5183946488294314
01462,LUNENBURG,MA,4162,4129,-33,0.49800989024243153
01463,PEPPERELL,MA,3509,3775,266,0.5182591982427238
01464,SHIRLEY,MA,1860,1889,29,0.5038676980528141
01464,SHIRLEY CTR,MA,93,88,-5,0.4861878453038674
01468,TEMPLETON,MA,1641,1735,94,0.5139218009478673
01469,TOWNSEND,MA,2404,2123,-281,0.46896399381488846
01473,WESTMINSTER,MA,2485,2694,209,0.5201776404711335
01474,TOWNSEND,MA,13,0,-13,0
01474,W TOWNSEND,MA,52,37,-15,0.4157303370786517
01474,WEST TOWNSEND,MA,277,266,-11,0.48987108655616945
01475,WINCHENDON,MA,3722,3785,63,0.5041960836552551
01501,AUBURN,MA,5734,5488,-246,0.48903938691855287
01503,BERLIN,MA,1240,1548,308,0.5552367288378766
01504,BLACKSTONE,MA,2943,2958,15,0.5012709710218607
01505,BOYLSTON,MA,1310,1753,443,0.5723147241266732
01506,BROOKFIELD,MA,1261,1210,-51,0.48968029138000807
01507,CHARLTON,MA,3562,3871,309,0.520785685456747
01508,CHARLTON CITY,MA,92,27,-65,0.226890756302521
01510,CLINTON,MA,7139,6171,-968,0.4636363636363636
01515,E BROOKFIELD,MA,105,98,-7,0.4827586206896552
01515,EAST BROOKFIELD,MA,608,656,48,0.5189873417721519
01516,DOUGLAS,MA,2167,2477,310,0.5333763996554695
01516,EAST DOUGLAS,MA,180,187,7,0.5095367847411444
01518,FISKDALE,MA,1290,1313,23,0.5044179792547061
01519,GRAFTON,MA,2266,2286,20,0.5021968365553603
01520,HOLDEN,MA,4186,4475,289,0.5166839856829465
01521,HOLLAND,MA,858,913,55,0.515527950310559
01522,JEFFERSON,MA,812,916,104,0.5300925925925926
01523,LANCASTER,MA,2075,2090,15,0.5018007202881153
01524,LEICESTER,MA,2158,2080,-78,0.49079754601226994
01525,LINWOOD,MA,23,40,17,0.6349206349206349
01527,MILLBURY,MA,4624,4816,192,0.5101694915254237
01529,MILLVILLE,MA,866,816,-50,0.48513674197384066
01531,NEW BRAINTREE,MA,33,43,10,0.5657894736842105
01532,NORTHAMPTON,MA,117,131,14,0.5282258064516129
01532,NORTHBOROUGH,MA,5039,5147,108,0.5053013940702925
01534,NORTHBRIDGE,MA,2410,2073,-337,0.4624135623466429
01535,N BROOKFIELD,MA,166,173,7,0.5103244837758112
01535,NORTH BROOKFIELD,MA,1530,1513,-17,0.4972067039106145
01536,NORTH GRAFTON,MA,2280,2384,104,0.5111492281303602
01537,GRAFTON,MA,29,20,-9,0.40816326530612246
01537,NORTH OXFORD,MA,888,905,17,0.5047406581148912
01538,N UXBRIDGE,MA,17,0,-17,0
01538,NORTH UXBRIDGE,MA,58,0,-58,0
01540,OXFORD,MA,3399,3386,-13,0.4990420044215181
01541,PRINCETON,MA,991,1136,145,0.5340855665256229
01542,ROCHDALE,MA,745,626,-119,0.4566010211524435
01543,RUTLAND,MA,2410,2699,289,0.5282834214131924
01545,SHREWSBURY,MA,13524,13535,11,0.5002032595439595
01550,SOUTHBRIDGE,MA,10959,9119,-1840,0.4541787030580735
01560,SO GRAFTON,MA,36,31,-5,0.4626865671641791
01560,SOUTH GRAFTON,MA,1625,1552,-73,0.488511174063582
01561,SOUTH LANCASTER,MA,70,22,-48,0.2391304347826087
01562,SPENCER,MA,4887,4899,12,0.5006131207847946
01564,STERLING,MA,2187,2564,377,0.5396758577141655
01566,STURBRIDGE,MA,2685,2806,121,0.5110180295028228
01568,UPTON,MA,2081,2565,484,0.5520878174773999
01569,UXBRIDGE,MA,3978,4381,403,0.5241057542768274
01570,WEBSTER,MA,8719,8270,-449,0.4867855671316734
01571,DUDLEY,MA,3440,3309,-131,0.4902948584975552
01581,WESTBOROUGH,MA,9664,9550,-114,0.4970334131362548
01583,WEST BOYLSTON,MA,2449,2506,57,0.5057517658930374
01585,W BROOKFIELD,MA,111,110,-1,0.497737556561086
01585,WEST BROOKFIELD,MA,1332,1466,134,0.5239456754824875
01588,WHITINSVILLE,MA,3749,3557,-192,0.48686011497399395
01590,SUTTON,MA,2587,2945,358,0.5323571945047
01601,WORCESTER,MA,244,109,-135,0.3087818696883853
01602,WORCESTER,MA,9415,8378,-1037,0.4708593267015118
01603,WORCESTER,MA,10056,8586,-1470,0.46057289990344386
01604,WORCESTER,MA,20518,16867,-3651,0.4511702554500468
01605,WORCESTER,MA,15552,12395,-3157,0.44351808780906715
01606,WORCESTER,MA,8843,7820,-1023,0.46930324671427714
01607,WORCESTER,MA,4866,4078,-788,0.45594812164579607
01608,WORCESTER,MA,4472,3749,-723,0.4560272472935166
01609,WORCESTER,MA,9113,7906,-1207,0.4645396321758035
01610,WORCESTER,MA,13817,10691,-3126,0.4362249061530929
01611,CHERRY VALLEY,MA,770,725,-45,0.48494983277591974
01612,PAXTON,MA,994,1173,179,0.541301338255653
01613,WORCESTER,MA,1269,2094,825,0.6226583407671722
01614,WORCESTER,MA,14,0,-14,0
01701,FRAMINGHAM,MA,11963,11707,-256,0.4945923109421208
01702,FRAMINGHAM,MA,19208,15424,-3784,0.4453684453684454
01704,FRAMINGHAM,MA,12,56,44,0.8235294117647058
01718,ACTON,MA,13,72,59,0.8470588235294118
01719,BOXBORO,MA,149,166,17,0.526984126984127
01719,BOXBOROUGH,MA,1992,1938,-54,0.49312977099236643
01720,ACTON,MA,8007,7756,-251,0.492038317579141
01721,ASHLAND,MA,7176,6857,-319,0.4886339342977268
01730,BEDFORD,MA,5218,5215,-3,0.49985622543851244
01731,BEDFORD,MA,129,92,-37,0.416289592760181
01731,HANSCOM AFB,MA,1316,1245,-71,0.4861382272549785
01740,BOLTON,MA,1348,1677,329,0.5543801652892562
01741,CARLISLE,MA,1414,1632,218,0.535784635587656
01742,CONCORD,MA,6901,7288,387,0.5136373246881387
01745,FAYVILLE,MA,22,0,-22,0
01745,SOUTHBOROUGH,MA,0,11,11,1
01746,HOLLISTON,MA,3767,4184,417,0.5262231165891083
01747,HOPEDALE,MA,1795,1688,-107,0.48463967843812805
01748,HOPKINTON,MA,5598,6493,895,0.5370109999172938
01749,HUDSON,MA,7874,7168,-706,0.476532376013828
01752,MARLBOROUGH,MA,22209,18602,-3607,0.4558084830070324
01754,MAYNARD,MA,3843,3990,147,0.5093833780160858
01756,MENDON,MA,1873,1875,2,0.5002668089647813
01757,MILFORD,MA,11099,9474,-1625,0.46050648908763914
01760,NATICK,MA,13727,13031,-696,0.48699454368786904
01770,SHERBORN,MA,1232,1469,237,0.5438726397630507
01772,SOUTHBOROUGH,MA,2991,3399,408,0.531924882629108
01773,LINCOLN,MA,2182,2389,207,0.5226427477576022
01775,STOW,MA,1829,2122,293,0.5370792204505188
01776,SUDBURY,MA,4765,5812,1047,0.5494941854968327
01778,WAYLAND,MA,4064,4473,409,0.5239545507789621
01801,WOBURN,MA,17909,16513,-1396,0.4797222706408692
01803,BURLINGTON,MA,11260,10572,-688,0.4842433125687065
01810,ANDOVER,MA,11205,12095,890,0.519098712446352
01821,BILLERICA,MA,8665,8554,-111,0.4967768163075672
01824,CHELMSFORD,MA,7975,8550,575,0.5173978819969742
01826,DRACUT,MA,9488,9379,-109,0.49711135845656435
01827,DUNSTABLE,MA,730,864,134,0.5420326223337516
01830,HAVERHILL,MA,10725,10438,-287,0.49321929783112034
01831,HAVERHILL,MA,328,561,233,0.6310461192350956
01832,HAVERHILL,MA,9848,9441,-407,0.4894499455648297
01833,GEORGETOWN,MA,1927,2128,201,0.5247842170160296
01833,HAVERHILL,MA,72,106,34,0.5955056179775281
01834,GROVELAND,MA,1560,1700,140,0.5214723926380368
01835,BRADFORD,MA,1622,1748,126,0.5186943620178042
01835,HAVERHILL,MA,3450,3269,-181,0.4865307337401399
01840,LAWRENCE,MA,3242,3429,187,0.5140158896717134
01841,LAWRENCE,MA,17302,13700,-3602,0.4419069737436294
01842,LAWRENCE,MA,576,1263,687,0.6867862969004894
01843,LAWRENCE,MA,11217,9608,-1609,0.4613685474189676
01844,METHUEN,MA,16492,16678,186,0.502803738317757
01845,NO ANDOVER,MA,211,190,-21,0.47381546134663344
01845,NORTH ANDOVER,MA,9438,9561,123,0.5032370124743407
01850,LOWELL,MA,7510,6033,-1477,0.44546998449383446
01851,LOWELL,MA,14984,12558,-2426,0.45595817297218794
01852,LOWELL,MA,16858,14292,-2566,0.4588121990369181
01853,LOWELL,MA,974,1722,748,0.6387240356083086
01854,LOWELL,MA,10865,9230,-1635,0.45931823836775315
01860,MERRIMAC,MA,1896,2223,327,0.5396941005098325
01862,N BILLERICA,MA,182,206,24,0.5309278350515464
01862,NORTH BILLERICA,MA,3678,4134,456,0.5291858678955453
01863,N CHELMSFORD,MA,449,378,-71,0.4570737605804111
01863,NORTH CHELMSFORD,MA,3077,2677,-400,0.4652415710809871
01864,NORTH READING,MA,4195,4648,453,0.525613479588375
01867,READING,MA,6074,6819,745,0.5288916466299542
01876,TEWKSBURY,MA,9571,9602,31,0.5008084285192719
01879,TYNGSBORO,MA,3200,3722,522,0.5377058653568333
01880,WAKEFIELD,MA,8591,8671,80,0.5023172285946008
01886,WESTFORD,MA,7133,8217,1084,0.5353094462540716
01887,WILMINGTON,MA,5651,5973,322,0.5138506538196834
01888,WOBURN,MA,392,350,-42,0.4716981132075472
01890,WINCHESTER,MA,6417,7222,805,0.5295109612141653
01901,LYNN,MA,1775,2043,268,0.535096909376637
01902,LYNN,MA,19266,15543,-3723,0.4465224510902353
01903,LYNN,MA,862,1001,139,0.5373054213633924
01904,EAST LYNN,MA,253,260,7,0.50682261208577
01904,LYNN,MA,5633,5488,-145,0.4934808020861433
01905,LYNN,MA,9653,8416,-1237,0.4657701034921689
01906,SAUGUS,MA,8838,9381,543,0.5149020253581426
01907,SWAMPSCOTT,MA,5489,5506,17,0.5007730786721237
01908,NAHANT,MA,1412,1403,-9,0.4984014209591474
01913,AMESBURY,MA,7438,6823,-615,0.478437697216184
01915,BEVERLY,MA,15793,15199,-594,0.49041688177594217
01921,BOXFORD,MA,2002,2287,285,0.5332245278619725
01922,BYFIELD,MA,654,829,175,0.5590020229265004
01922,NEWBURY,MA,0,29,29,1
01923,DANVERS,MA,10143,10020,-123,0.4969498586519863
01929,ESSEX,MA,1293,1315,22,0.504217791411043
01930,GLOUCESTER,MA,11099,11488,389,0.5086111480054899
01931,GLOUCESTER,MA,265,232,-33,0.46680080482897385
01936,HAMILTON,MA,13,0,-13,0
01938,IPSWICH,MA,4941,5223,282,0.5138724911452184
01940,LYNNFIELD,MA,3621,3809,188,0.5126514131897711
01944,MANCHESTER,MA,1477,1570,93,0.5152609123728258
01944,MANCHESTER BY THE SEA,MA,714,900,186,0.5576208178438662
01945,MARBLEHEAD,MA,7538,7985,447,0.5143979900792373
01949,MIDDLETON,MA,2435,2680,245,0.5239491691104594
01950,NEWBURYPORT,MA,8181,7953,-228,0.4929341762737077
01951,NEWBURY,MA,1294,1415,121,0.5223329641934293
01952,SALISBURY,MA,3931,4132,201,0.5124643432965398
01960,PEABODY,MA,18816,17313,-1503,0.47919953499958484
01961,PEABODY,MA,237,283,46,0.5442307692307692
01965,PRIDES CROSSING,MA,30,24,-6,0.4444444444444444
01966,ROCKPORT,MA,3683,3550,-133,0.4908060279275543
01969,ROWLEY,MA,1666,1941,275,0.5381203215968949
01970,SALEM,MA,20745,19611,-1134,0.485950044603033
01982,S HAMILTON,MA,419,402,-17,0.48964677222898906
01982,SOUTH HAMILTON,MA,1672,1867,195,0.527550155411133
01983,TOPSFIELD,MA,1715,1895,180,0.5249307479224377
01984,HAMILTON,MA,25,25,0,0.5
01984,WENHAM,MA,1115,1277,162,0.5338628762541806
01985,WEST NEWBURY,MA,1118,1319,201,0.5412392285597045
02018,ACCORD,MA,11,11,0,0.5
02019,BELLINGHAM,MA,5050,5331,281,0.5135343415855891
02020,BRANT ROCK,MA,23,57,34,0.7125
02021,CANTON,MA,8472,8811,339,0.5098073251171672
02025,COHASSET,MA,2884,3271,387,0.5314378554021121
02026,DEDHAM,MA,8549,8138,-411,0.4876850242703901
02027,DEDHAM,MA,26,72,46,0.7346938775510204
02030,DOVER,MA,1572,1953,381,0.5540425531914893
02032,EAST WALPOLE,MA,1371,1457,86,0.5152050919377652
02035,FOXBORO,MA,6223,6367,144,0.5057188244638602
02035,FOXBOROUGH,MA,146,184,38,0.5575757575757576
02038,FRANKLIN,MA,9871,10597,726,0.517735000977135
02041,GREEN HARBOR,MA,69,120,51,0.6349206349206349
02043,HINGHAM,MA,8138,8909,771,0.5226139496685633
02045,HULL,MA,5474,5474,0,0.5
02047,HUMAROCK,MA,758,393,-365,0.34144222415291053
02048,MANSFIELD,MA,7350,7359,9,0.5003059351417499
02048,MEDFIELD,MA,164,153,-11,0.48264984227129337
02050,MARSHFIELD,MA,7648,7647,-1,0.49996730957829355
02051,MARSHFIELD HILLS,MA,11,30,19,0.7317073170731707
02052,MEDFIELD,MA,2873,3394,521,0.5415669379288336
02053,MEDWAY,MA,3184,3426,242,0.5183055975794251
02054,MILLIS,MA,2463,2991,528,0.5484048404840484
02056,NORFOLK,MA,2196,2676,480,0.5492610837438424
02060,NORTH SCITUATE,MA,13,0,-13,0
02061,NORWELL,MA,2911,3187,276,0.5226303706133159
02062,NORWOOD,MA,13511,12548,-963,0.4815226984918838
02065,OCEAN BLUFF,MA,0,38,38,1
02066,SCITUATE,MA,5630,6290,660,0.5276845637583892
02067,SHARON,MA,4621,5726,1105,0.5533971199381463
02070,SHELDONVILLE,MA,0,13,13,1
02071,SOUTH WALPOLE,MA,38,11,-27,0.22448979591836735
02072,STOUGHTON,MA,10126,9683,-443,0.48881821394315716
02081,WALPOLE,MA,5262,6055,793,0.5350357868693116
02090,WESTWOOD,MA,4416,4902,486,0.5260785576303928
02093,WRENTHAM,MA,3145,3965,820,0.5576652601969058
02108,BOSTON,MA,4602,3053,-1549,0.39882429784454604
02109,BOSTON,MA,5840,5178,-662,0.46995825013614084
02110,BOSTON,MA,4132,3029,-1103,0.42298561653400363
02111,BOSTON,MA,7052,4915,-2137,0.41071279351550094
02112,BOSTON,MA,26,67,41,0.7204301075268817
02113,BOSTON,MA,7453,4387,-3066,0.3705236486486487
02114,BOSTON,MA,17108,13124,-3984,0.43410955279174385
02115,BOSTON,MA,12684,8028,-4656,0.38760139049826187
02116,BOSTON,MA,18985,13644,-5341,0.4181556284286984
02117,BOSTON,MA,282,198,-84,0.4125
02118,BOSTON,MA,20494,15169,-5325,0.42534279224967053
02119,BOSTON,MA,1946,1609,-337,0.45260196905766525
02119,ROXBURY,MA,10886,8708,-2178,0.44442176176380527
02120,BOSTON,MA,728,498,-230,0.4061990212071778
02120,MISSION HILL,MA,1853,1137,-716,0.3802675585284281
02120,ROXBURY,MA,1428,822,-606,0.36533333333333334
02120,ROXBURY CROSSING,MA,3817,2134,-1683,0.3585951940850277
02121,BOSTON,MA,451,414,-37,0.47861271676300576
02121,DORCHESTER,MA,10553,8153,-2400,0.4358494600662889
02122,DORCHESTER,MA,11519,9162,-2357,0.44301532807891303
02123,BOSTON,MA,656,69,-587,0.09517241379310344
02124,BOSTON,MA,466,386,-80,0.45305164319248825
02124,DORCHESTER,MA,5307,4357,-950,0.45084850993377484
02124,DORCHESTER CENTER,MA,14557,11812,-2745,0.4479502446054079
02125,BOSTON,MA,3569,2625,-944,0.4237972231191476
02125,DORCHESTER,MA,12168,9195,-2973,0.4304170762533352
02125,UPHAMS CORNER,MA,2402,1913,-489,0.4433371958285052
02126,MATTAPAN,MA,9376,7791,-1585,0.4538358478476146
02127,BOSTON,MA,3465,2613,-852,0.4299111549851925
02127,SOUTH BOSTON,MA,26090,16833,-9257,0.3921673694755725
02128,BOSTON,MA,3869,3090,-779,0.4440293145566892
02128,EAST BOSTON,MA,17936,15089,-2847,0.45689629068887205
02129,BOSTON,MA,570,363,-207,0.3890675241157556
02129,CHARLEMONT,MA,159,124,-35,0.4381625441696113
02129,CHARLESTOWN,MA,11512,9516,-1996,0.4525394711812821
02130,BOSTON,MA,788,705,-83,0.4722036168787676
02130,JAMAICA PLAIN,MA,24482,19831,-4651,0.44752104348611016
02131,BOSTON,MA,211,187,-24,0.46984924623115576
02131,ROSLINDALE,MA,11660,10145,-1515,0.465260261407934
02132,WEST ROXBURY,MA,9277,8954,-323,0.4911414623443585
02134,ALLSTON,MA,17620,10577,-7043,0.37511082739298507
02134,BOSTON,MA,1192,773,-419,0.3933842239185751
02135,BOSTON,MA,752,450,-302,0.37437603993344426
02135,BRIGHTON,MA,35731,24359,-11372,0.4053752704276918
02136,BOSTON,MA,191,232,41,0.5484633569739953
02136,HYDE PARK,MA,11280,9344,-1936,0.4530643910007758
02136,JAMAICA PLAIN,MA,241,166,-75,0.40786240786240785
02137,HYDE PARK,MA,0,11,11,1
02137,READVILLE,MA,0,32,32,1
02138,CAMBRIDGE,MA,22694,16208,-6486,0.41663667677754357
02139,CAMBRIDGE,MA,27481,19024,-8457,0.40907429308676485
02140,CAMBRIDGE,MA,16059,12931,-3128,0.44605036219385996
02141,CAMBRIDGE,MA,12527,9596,-2931,0.4337567237716404
02142,CAMBRIDGE,MA,5670,4391,-1279,0.43643772984792767
02143,SOMERVILLE,MA,21095,15176,-5919,0.4184058890022332
02144,SOMERVILLE,MA,17870,12493,-5377,0.41145473108717845
02144,W SOMERVILLE,MA,1644,993,-651,0.37656427758816835
02145,SOMERVILLE,MA,17775,13501,-4274,0.43167284819030566
02148,MALDEN,MA,33986,27760,-6226,0.44958377870631294
02149,EVERETT,MA,19840,15552,-4288,0.4394213381555154
02150,CHELSEA,MA,16286,12711,-3575,0.4383556919681346
02151,REVERE,MA,25254,21836,-3418,0.4637077935867488
02152,WINTHROP,MA,6885,6317,-568,0.4784881078624451
02155,MEDFORD,MA,28976,23882,-5094,0.4518142949033259
02163,BOSTON,MA,1062,798,-264,0.4290322580645161
02169,QUINCY,MA,32839,28737,-4102,0.4666915681434325
02170,QUINCY,MA,7222,5766,-1456,0.4439482599322451
02170,WOLLASTON,MA,614,519,-95,0.4580759046778464
02171,NORTH QUINCY,MA,236,173,-63,0.4229828850855746
02171,QUINCY,MA,10167,8935,-1232,0.4677520678462988
02176,MELROSE,MA,10715,10216,-499,0.48807988151545556
02180,STONEHAM,MA,7939,8134,195,0.5060660735394762
02184,BRAINTREE,MA,11719,11558,-161,0.4965416505563432
02184,EAST BRAINTREE,MA,229,253,24,0.524896265560166
02185,BRAINTREE,MA,135,181,46,0.5727848101265823
02186,MILTON,MA,6328,6663,335,0.5128935416827034
02188,WEYMOUTH,MA,6520,6169,-351,0.4861691228623217
02189,EAST WEYMOUTH,MA,5037,4386,-651,0.4654568608723337
02189,WEYMOUTH,MA,1212,1017,-195,0.45625841184387617
02190,S WEYMOUTH,MA,570,640,70,0.5289256198347108
02190,SOUTH WEYMOUTH,MA,6144,6224,80,0.5032341526520052
02190,WEYMOUTH,MA,703,817,114,0.5375
02191,N WEYMOUTH,MA,184,169,-15,0.47875354107648727
02191,NORTH WEYMOUTH,MA,2105,2055,-50,0.49399038461538464
02191,WEYMOUTH,MA,337,358,21,0.5151079136690647
02196,BOSTON,MA,110,190,80,0.6333333333333333
02199,BOSTON,MA,1851,1700,-151,0.47873838355392845
02205,BOSTON,MA,848,972,124,0.5340659340659341
02210,BOSTON,MA,8840,8489,-351,0.4898724681170293
02215,BOSTON,MA,13792,8184,-5608,0.3724062613760466
02238,CAMBRIDGE,MA,302,188,-114,0.3836734693877551
02269,QUINCY,MA,589,504,-85,0.46111619396157366
02284,BOSTON,MA,152,0,-152,0
02301,BROCKTON,MA,23309,19515,-3794,0.45570240986362787
02302,BROCKTON,MA,10278,9115,-1163,0.47001495384932707
02303,BROCKTON,MA,820,1503,683,0.6470081790787774
02305,BROCKTON,MA,23,87,64,0.7909090909090909
02322,AVON,MA,1534,1514,-20,0.4967191601049869
02324,BRIDGEWATER,MA,8220,7974,-246,0.49240459429418304
02327,BRYANTVILLE,MA,0,13,13,1
02330,CARVER,MA,2922,3296,374,0.5300739787713091
02331,DUXBURY,MA,1007,606,-401,0.3756974581525109
02332,DUXBURY,MA,4082,4659,577,0.533005376959158
02333,E BRIDGEWATER,MA,187,190,3,0.5039787798408488
02333,EAST BRIDGEWATER,MA,3117,3174,57,0.5045302813543157
02334,EASTON,MA,41,12,-29,0.22641509433962265
02338,HALIFAX,MA,2377,2120,-257,0.4714253947075828
02339,HANOVER,MA,3424,3741,317,0.5221214235868806
02341,HANSON,MA,2400,2866,466,0.5442461071021648
02343,HOLBROOK,MA,3359,3198,-161,0.4877230440750343
02345,MANOMET,MA,441,329,-112,0.42727272727272725
02346,MIDDLEBORO,MA,8393,8353,-40,0.4988056849396871
02347,LAKEVILLE,MA,3297,3767,470,0.5332672706681767
02350,MONPONSETT,MA,198,11,-187,0.05263157894736842
02351,ABINGTON,MA,5144,5200,56,0.502706883217324
02355,NORTH CARVER,MA,44,0,-44,0
02356,NORTH EASTON,MA,3294,3686,392,0.528080229226361
02358,NORTH PEMBROKE,MA,0,13,13,1
02359,PEMBROKE,MA,4282,4767,485,0.526798541275279
02360,PLYMOUTH,MA,22326,25117,2791,0.5294142444617752
02361,PLYMOUTH,MA,250,119,-131,0.3224932249322493
02362,PLYMOUTH,MA,1068,623,-445,0.3684210526315789
02364,KINGSTON,MA,3911,4357,446,0.5269714562167392
02366,SOUTH CARVER,MA,25,13,-12,0.34210526315789475
02367,PLYMPTON,MA,672,773,101,0.5349480968858131
02368,RANDOLPH,MA,12175,11667,-508,0.48934653133126416
02370,ROCKLAND,MA,5746,5426,-320,0.4856784819190834
02375,SOUTH EASTON,MA,4078,3813,-265,0.4832087187935623
02379,W BRIDGEWATER,MA,83,85,2,0.5059523809523809
02379,WEST BRIDGEWATER,MA,1957,1949,-8,0.4989759344598054
02381,WHITE HORSE BEACH,MA,0,11,11,1
02382,WHITMAN,MA,4641,4634,-7,0.499622641509434
02420,LEXINGTON,MA,4236,4739,503,0.5280222841225627
02421,LEXINGTON,MA,6211,6515,304,0.5119440515480119
02445,BROOKLINE,MA,10994,8551,-2443,0.4375031977487849
02446,BROOKLINE,MA,19907,14311,-5596,0.4182301712548951
02447,BROOKLINE VILLAGE,MA,0,48,48,1
02451,NORTH WALTHAM,MA,482,371,-111,0.4349355216881594
02451,WALTHAM,MA,9798,8091,-1707,0.45228911621666945
02452,NORTH WALTHAM,MA,846,699,-147,0.4524271844660194
02452,WALTHAM,MA,5315,4393,-922,0.45251339101771737
02453,SOUTH WALTHAM,MA,1059,828,-231,0.43879173290937995
02453,WALTHAM,MA,14039,11476,-2563,0.44977464236723497
02454,WALTHAM,MA,246,442,196,0.6424418604651163
02455,NORTH WALTHAM,MA,28,0,-28,0
02456,NEW TOWN,MA,12,0,-12,0
02458,NEWTON,MA,5355,4891,-464,0.4773570173726332
02458,NEWTONVILLE,MA,291,224,-67,0.4349514563106796
02459,NEWTON,MA,883,856,-27,0.49223691776883266
02459,NEWTON CENTER,MA,4691,5005,314,0.5161922442244224
02459,NEWTON CENTRE,MA,451,488,37,0.5197018104366348
02460,NEWTON,MA,454,423,-31,0.4823261117445838
02460,NEWTONVILLE,MA,3396,3416,20,0.5014679976512038
02461,NEWTON,MA,634,606,-28,0.48870967741935484
02461,NEWTON HIGHLANDS,MA,2001,2090,89,0.5108775360547544
02461,NEWTON HLDS,MA,97,82,-15,0.4581005586592179
02462,NEWTON,MA,76,44,-32,0.36666666666666664
02462,NEWTON L F,MA,52,35,-17,0.40229885057471265
02462,NEWTON LOWER FALLS,MA,358,280,-78,0.438871473354232
02464,NEWTON,MA,351,297,-54,0.4583333333333333
02464,NEWTON U F,MA,121,125,4,0.508130081300813
02464,NEWTON UPPER FALLS,MA,1216,1046,-170,0.4624226348364279
02465,NEWTON,MA,607,575,-32,0.48646362098138746
02465,WEST NEWTON,MA,3071,3153,82,0.5065874035989717
02466,AUBURNDALE,MA,3219,2890,-329,0.47307251596005895
02467,CHESTNUT HILL,MA,7570,7243,-327,0.48896239789374196
02468,WABAN,MA,1701,1842,141,0.5198983911939035
02471,WATERTOWN,MA,11,55,44,0.8333333333333334
02472,EAST WATERTOWN,MA,261,241,-20,0.4800796812749004
02472,WATERTOWN,MA,19074,17167,-1907,0.4736900195910709
02474,ARLINGTON,MA,11470,10448,-1022,0.47668582899899625
02476,ARLINGTON,MA,6022,5676,-346,0.48521114720465036
02478,BELMONT,MA,9917,9879,-38,0.49904021014346334
02481,WELLESLEY,MA,548,511,-37,0.4825306893295562
02481,WELLESLEY HILLS,MA,3550,4067,517,0.5339372456347643
02481,WELLESLEY HLS,MA,468,576,108,0.5517241379310345
02482,WELLESLEY,MA,3946,3685,-261,0.4828987026602018
02492,NEEDHAM,MA,4945,5923,978,0.5449944792050055
02493,WESTON,MA,3389,4100,711,0.5474696221124316
02494,NEEDHAM,MA,1155,1308,153,0.5310596833130329
02494,NEEDHAM HEIGHTS,MA,2969,3181,212,0.5172357723577236
02494,NEEDHAM HGTS,MA,190,217,27,0.5331695331695332
02532,BOURNE,MA,844,894,50,0.5143843498273878
02532,BUZZARDS BAY,MA,4573,4758,185,0.5099131925838603
02534,CATAUMET,MA,432,411,-21,0.4875444839857651
02535,AQUINNAH,MA,546,173,-373,0.24061196105702365
02535,CHICOPEE,MA,165,172,7,0.5103857566765578
02535,CHILMARK,MA,857,1475,618,0.6325042881646655
02536,E FALMOUTH,MA,2527,2453,-74,0.49257028112449797
02536,EAST FALMOUTH,MA,5675,6106,431,0.5182921653509889
02536,TEATICKET,MA,1806,2063,257,0.5332127164642027
02537,E SANDWICH,MA,227,415,188,0.6464174454828661
02537,EAST SANDWICH,MA,1942,1974,32,0.5040858018386108
02538,E WAREHAM,MA,263,318,55,0.5473321858864028
02538,EAST WAREHAM,MA,1542,1636,94,0.5147891755821271
02538,EASTWAREHAM,MA,44,54,10,0.5510204081632653
02539,EDGARTOWN,MA,3173,3673,500,0.5365176745544844
02540,FALMOUTH,MA,4882,5442,560,0.5271212708252615
02541,FALMOUTH,MA,213,250,37,0.5399568034557235
02542,BUZZARDS BAY,MA,162,103,-59,0.3886792452830189
02542,OTIS ANGB,MA,0,11,11,1
02543,WOODS HOLE,MA,683,817,134,0.5446666666666666
02553,MONUMENT BEACH,MA,307,215,-92,0.4118773946360153
02554,NANTUCKET,MA,7514,7927,413,0.5133734861731754
02556,N FALMOUTH,MA,35,46,11,0.5679012345679012
02556,NORTH FALMOUTH,MA,2635,2508,-127,0.4876531207466459
02557,OAK BLUFFS,MA,2598,2279,-319,0.46729546852573306
02558,ONSET,MA,1279,1278,-1,0.49980445834962844
02559,POCASSET,MA,2163,2051,-112,0.4867109634551495
02561,SAGAMORE,MA,89,77,-12,0.463855421686747
02562,SAGAMORE BCH,MA,169,185,16,0.5225988700564972
02562,SAGAMORE BEACH,MA,1311,1420,109,0.5199560600512633
02563,SANDWICH,MA,3782,4009,227,0.5145680913874984
02564,NANTUCKET,MA,92,18,-74,0.16363636363636364
02564,SIASCONSET,MA,857,804,-53,0.48404575556893437
02568,VINEYARD HAVEN,MA,3478,3502,24,0.5017191977077364
02571,WAREHAM,MA,4417,4531,114,0.5063701385784533
02574,W FALMOUTH,MA,41,39,-2,0.4875
02574,WEST FALMOUTH,MA,805,404,-401,0.33416046319272125
02575,WEST TISBURY,MA,831,955,124,0.5347144456886898
02576,WEST WAREHAM,MA,1476,1579,103,0.5168576104746317
02584,NANTUCKET,MA,887,883,-4,0.49887005649717514
02601,HYANNIS,MA,8743,7976,-767,0.47706202524074404
02630,BARNSTABLE,MA,1025,1172,147,0.5334547109695039
02631,BREWSTER,MA,6245,6641,396,0.5153655129598014
02632,CENTERVILLE,MA,5133,5328,195,0.5093203326641812
02633,CHATHAM,MA,3228,3839,611,0.5432290929673128
02635,COTUIT,MA,2286,2194,-92,0.48973214285714284
02637,BARNSTABLE,MA,0,11,11,1
02637,CUMMAQUID,MA,105,58,-47,0.3558282208588957
02638,DENNIS,MA,2460,2570,110,0.510934393638171
02639,DENNIS PORT,MA,2914,2840,-74,0.49356969064998263
02639,DENNISPORT,MA,191,276,85,0.5910064239828694
02641,EAST DENNIS,MA,949,730,-219,0.43478260869565216
02642,EASTHAM,MA,2957,3398,441,0.5346970889063729
02643,EAST ORLEANS,MA,952,679,-273,0.41630901287553645
02644,FORESTDALE,MA,1609,1545,-64,0.489854153455929
02645,E HARWICH,MA,166,140,-26,0.45751633986928103
02645,HARWICH,MA,4353,4906,553,0.5298628361594124
02646,HARWICH PORT,MA,2005,2164,159,0.5190693211801392
02647,HYANNIS PORT,MA,410,336,-74,0.450402144772118
02648,MARSTONS MILLS,MA,2542,2597,55,0.5053512356489589
02648,MARSTONS MLS,MA,157,71,-86,0.31140350877192985
02649,MASHPEE,MA,9725,10326,601,0.514986783701561
02650,NORTH CHATHAM,MA,934,1031,97,0.5246819338422392
02651,NORTH EASTHAM,MA,1051,1025,-26,0.49373795761079
02651,WALTHAM,MA,18,14,-4,0.4375
02652,NORTH TRURO,MA,1117,1446,329,0.5641825985173625
02653,ORLEANS,MA,3018,3860,842,0.5612096539691771
02655,OSTERVILLE,MA,3477,3416,-61,0.49557522123893805
02657,PROVINCETOWN,MA,5032,5348,316,0.5152215799614643
02659,SOUTH CHATHAM,MA,811,935,124,0.5355097365406644
02660,SOUTH DENNIS,MA,3771,3696,-75,0.49497790277219766
02661,SOUTH HARWICH,MA,24,85,61,0.7798165137614679
02662,SOUTH ORLEANS,MA,424,277,-147,0.39514978601997147
02663,S WELLFLEET,MA,69,72,3,0.5106382978723404
02663,SOUTH WELLFLEET,MA,291,266,-25,0.47755834829443444
02664,S YARMOUTH,MA,846,912,66,0.5187713310580204
02664,SOUTH YARMOUTH,MA,4879,4822,-57,0.4970621585403567
02666,TRURO,MA,1742,1794,52,0.5073529411764706
02667,WELLFLEET,MA,3186,3426,240,0.5181488203266787
02668,W BARNSTABLE,MA,128,109,-19,0.459915611814346
02668,WEST BARNSTABLE,MA,969,1136,167,0.539667458432304
02669,WEST CHATHAM,MA,467,423,-44,0.4752808988764045
02670,WEST DENNIS,MA,1716,1723,7,0.5010177377144519
02671,WEST HARWICH,MA,1457,1327,-130,0.4766522988505747
02672,W HYANNISPORT,MA,12,0,-12,0
02672,WEST HYANNISPORT,MA,533,354,-179,0.399098083427283
02673,W YARMOUTH,MA,378,260,-118,0.40752351097178685
02673,WEST YARMOUTH,MA,4645,4647,2,0.500107619457598
02675,YARMOUTH PORT,MA,3493,3555,62,0.5043984108967083
02702,ASSONET,MA,1105,1120,15,0.503370786516854
02702,FRAMINGHAM,MA,48,75,27,0.6097560975609756
02703,ATTLEBORO,MA,15418,15430,12,0.5001945020746889
02713,CUTTYHUNK,MA,0,15,15,1
02715,DIGHTON,MA,949,976,27,0.507012987012987
02717,EAST FREETOWN,MA,1344,1230,-114,0.47785547785547783
02718,EAST TAUNTON,MA,1779,1832,53,0.5073386873442259
02719,FAIRHAVEN,MA,5311,5282,-29,0.4986311715283678
02720,FALL RIVER,MA,14587,13491,-1096,0.480482940380369
02720,NEW BEDFORD,MA,313,258,-55,0.45183887915936954
02721,FALL RIVER,MA,11182,9930,-1252,0.470348616900341
02721,SOMERSET,MA,224,219,-5,0.49435665914221216
02722,DORCHESTER,MA,13,0,-13,0
02722,FALL RIVER,MA,479,751,272,0.6105691056910569
02722,ROCHESTER,MA,15,17,2,0.53125
02723,FALL RIVER,MA,7444,6862,-582,0.4796588843841745
02724,FALL RIVER,MA,7347,6956,-391,0.486331538838006
02725,DORCHESTER,MA,15,0,-15,0
02725,SOMERSET,MA,551,586,35,0.5153913808267371
02726,FALL RIVER,MA,72,91,19,0.558282208588957
02726,SOMERSET,MA,3796,4096,300,0.5190065889508363
02738,MARION,MA,2323,2613,290,0.5293760129659644
02739,MATTAPOISETT,MA,2754,2991,237,0.5206266318537859
02740,NEW BEDFORD,MA,19285,16590,-2695,0.4624390243902439
02741,NEW BEDFORD,MA,0,24,24,1
02742,NEW BEDFORD,MA,42,253,211,0.8576271186440678
02743,ACUSHNET,MA,2376,2531,155,0.5157937640105971
02744,ACUSHNET,MA,100,70,-30,0.4117647058823529
02744,NEW BEDFORD,MA,4898,4436,-462,0.47525176773087635
02745,NEW BEDFORD,MA,8297,8071,-226,0.4930962854349951
02746,NEW BEDFORD,MA,6672,5682,-990,0.45993200582807187
02747,DARTMOUTH,MA,1250,1393,143,0.5270525917517972
02747,N DARTMOUTH,MA,786,931,145,0.5422248107163657
02747,NORTH DARTMOUTH,MA,2571,2614,43,0.5041465766634523
02748,DARTMOUTH,MA,806,913,107,0.5311227457824317
02748,NONQUITT,MA,64,77,13,0.5460992907801419
02748,S DARTMOUTH,MA,316,307,-9,0.492776886035313
02748,SOUTH DARTMOUTH,MA,2747,3264,517,0.5430044917650974
02760,N ATTLEBORO,MA,755,859,104,0.5322180916976456
02760,NORTH ATTLEBORO,MA,7778,7453,-325,0.48933096973278184
02761,N ATTLEBORO,MA,0,13,13,1
02761,NORTH ATTLEBORO,MA,45,73,28,0.6186440677966102
02762,PLAINVILLE,MA,3893,3550,-343,0.47695821577320974
02763,ATTLEBORO FALLS,MA,570,673,103,0.5414320193081255
02763,N ATTLEBORO,MA,19,14,-5,0.42424242424242425
02763,NORTH ATTLEBORO,MA,53,66,13,0.5546218487394958
02764,N DIGHTON,MA,187,161,-26,0.46264367816091956
02764,NORTH DIGHTON,MA,861,924,63,0.5176470588235295
02766,NORTON,MA,4904,4925,21,0.5010682673720622
02767,RAYNHAM,MA,4113,4688,575,0.5326667424156346
02768,RAYNHAM CENTER,MA,170,23,-147,0.11917098445595854
02769,REHOBOTH,MA,3109,3605,496,0.5369377420315758
02770,ROCHESTER,MA,1285,1455,170,0.531021897810219
02771,SEEKONK,MA,3868,4409,541,0.5326809230397487
02777,SWANSEA,MA,4435,4890,455,0.524396782841823
02779,BERKLEY,MA,1227,1504,277,0.5507140241669718
02780,TAUNTON,MA,18529,18020,-509,0.4930367451913869
02790,WESTPORT,MA,5019,5708,689,0.5321152232683882
02791,WESTPORT POINT,MA,25,47,22,0.6527777777777778
02801,ADAMSVILLE,RI,0,12,12,1
02802,ALBION,RI,225,174,-51,0.43609022556390975
02804,ASHAWAY,RI,782,924,142,0.5416178194607268
02806,BARRINGTON,RI,4724,5579,855,0.5414927690963797
02807,BLOCK ISLAND,RI,1875,1340,-535,0.416796267496112
02807,NEW SHOREHAM,RI,63,14,-49,0.18181818181818182
02808,BRADFORD,RI,606,618,12,0.5049019607843137
02809,BRISTOL,RI,7415,7462,47,0.5015796195469516
02812,CAROLINA,RI,47,82,35,0.6356589147286822
02813,CHARLESTOWN,RI,4278,4505,227,0.5129226915632472
02814,CHEPACHET,RI,1909,2295,386,0.5459086584205518
02816,COVENTRY,RI,10825,11045,220,0.5050297210791038
02817,W GREENWICH,RI,104,145,41,0.5823293172690763
02817,WEST GREENWICH,RI,1886,2071,185,0.5233762951731109
02818,E GREENWICH,RI,265,394,129,0.5978755690440061
02818,EAST GREENWICH,RI,7136,7519,383,0.5130672125554419
02822,EXETER,RI,1677,1899,222,0.5310402684563759
02824,FORESTDALE,RI,0,11,11,1
02825,FOSTER,RI,1275,1518,243,0.5435016111707841
02826,GLENDALE,RI,66,38,-28,0.36538461538461536
02827,COVENTRY,RI,26,121,95,0.8231292517006803
02827,GREENE,RI,292,460,168,0.6117021276595744
02828,GREENVILLE,RI,2191,2331,140,0.5154798761609907
02830,BURRILLVILLE,RI,31,40,9,0.5633802816901409
02830,HARRISVILLE,RI,1838,1882,44,0.5059139784946236
02831,HOPE,RI,978,1255,277,0.5620241827138379
02832,HOPE VALLEY,RI,1578,1667,89,0.5137134052388289
02833,HOPKINTON,RI,17,0,-17,0
02835,JAMESTOWN,RI,3181,3285,104,0.508042066192391
02837,L COMPTON,RI,242,232,-10,0.48945147679324896
02837,LITTLE COMPTON,RI,1533,1930,397,0.5573202425642506
02838,MANVILLE,RI,1927,1677,-250,0.4653163152053274
02839,MAPLEVILLE,RI,348,337,-11,0.491970802919708
02840,NEWPORT,RI,15596,14673,-923,0.4847533780435429
02842,MIDDLETOWN,RI,8510,8100,-410,0.4876580373269115
02852,N KINGSTOWN,RI,1239,1131,-108,0.4772151898734177
02852,NORTH KINGSTOWN,RI,7322,7909,587,0.519269910051868
02857,N SCITUATE,RI,172,190,18,0.5248618784530387
02857,NORTH SCITUATE,RI,1896,2242,346,0.541807636539391
02857,SCITUATE,RI,103,142,39,0.5795918367346938
02859,PASCOAG,RI,2085,2187,102,0.511938202247191
02860,PAWTUCKET,RI,21130,18937,-2193,0.4726333391569122
02861,PAWTUCKET,RI,9867,9450,-417,0.48920639850908526
02862,PAWTUCKET,RI,411,993,582,0.7072649572649573
02863,CENTRAL FALLS,RI,7613,6349,-1264,0.45473427875662514
02864,CUMBERLAND,RI,11000,11640,640,0.5141342756183745
02865,LINCOLN,RI,5325,5841,516,0.5231058570660935
02871,PORTSMOUTH,RI,6970,7178,208,0.5073508623126943
02872,PRUDENCE ISLAND,RI,13,43,30,0.7678571428571429
02873,ROCKVILLE,RI,0,16,16,1
02874,SAUNDERSTOWN,RI,1743,2003,260,0.5347036839295248
02875,SHANNOCK,RI,0,11,11,1
02876,SLATERSVILLE,RI,1032,835,-197,0.44724156400642745
02878,TIVERTON,RI,5434,5914,480,0.5211491011632006
02879,PEACE DALE,RI,170,181,11,0.5156695156695157
02879,S KINGSTOWN,RI,805,874,69,0.5205479452054794
02879,SOUTH KINGSTOWN,RI,984,1070,86,0.5209347614410905
02879,WAKEFIELD,RI,6617,7339,722,0.5258670106047578
02880,WAKEFIELD,RI,596,846,250,0.5866851595006934
02881,KINGSTON,RI,1145,916,-229,0.4444444444444444
02882,NARRAGANSETT,RI,7166,7407,241,0.5082687161188499
02885,WARREN,RI,4466,4606,140,0.5077160493827161
02886,WARWICK,RI,11906,12019,113,0.5023615464994775
02887,WARWICK,RI,63,151,88,0.705607476635514
02888,WARWICK,RI,6559,6801,242,0.5090568862275449
02889,WARWICK,RI,9714,9833,119,0.5030439453624597
02891,WESTERLY,RI,10521,10842,321,0.5075129897486308
02892,RICHMOND,RI,84,104,20,0.5531914893617021
02892,WEST KINGSTON,RI,1289,1399,110,0.5204613095238095
02893,WEST WARWICK,RI,14464,13608,-856,0.4847534910230835
02894,WOOD RIVER JUNCTION,RI,12,12,0,0.5
02895,WOONSOCKET,RI,21545,20349,-1196,0.4857258796008975
02896,N SMITHFIELD,RI,696,752,56,0.5193370165745856
02896,NORTH SMITHFIELD,RI,2340,2746,406,0.5399134880062918
02898,RICHMOND,RI,60,102,42,0.6296296296296297
02898,WYOMING,RI,403,554,151,0.5788923719958202
02901,PROVIDENCE,RI,0,11,11,1
02903,PROVIDENCE,RI,8602,7709,-893,0.4726258353258537
02904,NORTH PROVIDENCE,RI,10285,9787,-498,0.4875946592267836
02904,PROVIDENCE,RI,2687,2524,-163,0.48436000767606985
02905,CRANSTON,RI,4764,4606,-158,0.49156883671291357
02905,PROVIDENCE,RI,5558,5124,-434,0.4796854521625164
02906,PROVIDENCE,RI,15343,13020,-2323,0.4590487607093749
02907,CRANSTON,RI,780,580,-200,0.4264705882352941
02907,PROVIDENCE,RI,11720,10270,-1450,0.4670304683947249
02908,PROVIDENCE,RI,17165,14985,-2180,0.4660964230171073
02909,PROVIDENCE,RI,19664,16649,-3015,0.45848594167378076
02910,CRANSTON,RI,8047,7879,-168,0.49472560592741427
02911,N PROVIDENCE,RI,391,407,16,0.5100250626566416
02911,NORTH PROVIDENCE,RI,5632,5669,37,0.5016370232722768
02914,EAST PROVIDENCE,RI,8099,7779,-320,0.4899231641264643
02914,NORTH PROVIDENCE,RI,212,170,-42,0.44502617801047123
02915,RIVERSIDE,RI,5849,5911,62,0.5026360544217687
02916,RUMFORD,RI,2845,2969,124,0.5106639146886824
02917,SMITHFIELD,RI,3512,4038,526,0.5348344370860927
02919,JOHNSTON,RI,10101,10665,564,0.513579890205143
02920,CRANSTON,RI,13229,12729,-500,0.4903690577086062
02921,CRANSTON,RI,2885,3473,588,0.5462409562755584
02940,PROVIDENCE,RI,1196,1932,736,0.6176470588235294
03031,AMHERST,NH,3708,4073,365,0.5234545688214882
03032,AUBURN,NH,1412,1636,224,0.536745406824147
03033,BROOKLINE,NH,1326,1538,212,0.5370111731843575
03034,CANDIA,NH,1277,1281,4,0.5007818608287725
03036,CHESTER,NH,1337,1440,103,0.518545192653943
03037,DEERFIELD,NH,1334,1561,227,0.5392055267702937
03038,DERRY,NH,14674,12939,-1735,0.4685836381414551
03041,EAST DERRY,NH,28,0,-28,0
03042,EPPING,NH,2748,2821,73,0.5065541389836595
03043,FRANCESTOWN,NH,334,484,150,0.5916870415647921
03044,FREMONT,NH,1273,1351,78,0.5148628048780488
03044,PEMBROKE,NH,29,35,6,0.546875
03045,GOFFSTOWN,NH,4610,4528,-82,0.4955132414094988
03046,DUNBARTON,NH,666,746,80,0.5283286118980169
03047,GREENFIELD,NH,360,491,131,0.5769682726204466
03048,GREENVILLE,NH,759,731,-28,0.4906040268456376
03048,MASON,NH,325,316,-9,0.49297971918876754
03049,HOLLIS,NH,2296,2831,535,0.5521747610688512
03051,HUDSON,NH,8547,7892,-655,0.4800778636170083
03052,LITCHFIELD,NH,2184,2114,-70,0.49185667752442996
03053,LONDONDERRY,NH,8336,8984,648,0.5187066974595843
03054,MERRIMACK,NH,9327,9939,612,0.5158829025225786
03055,MILFORD,NH,6542,6290,-252,0.49018079800498754
03057,MONT VERNON,NH,579,741,162,0.5613636363636364
03060,NASHUA,NH,17794,14776,-3018,0.45366902057107766
03061,NASHUA,NH,974,1371,397,0.5846481876332622
03062,NASHUA,NH,12037,11072,-965,0.47912068890908305
03063,NASHUA,NH,7555,6676,-879,0.4691167170262104
03064,NASHUA,NH,6895,6213,-682,0.47398535245651513
03070,NEW BOSTON,NH,1599,1726,127,0.5190977443609023
03071,NEW IPSWICH,NH,1557,1610,53,0.5083675402589201
03073,NORTH SALEM,NH,38,45,7,0.54216867469879515
03076,PELHAM,NH,3649,3934,285,0.5187920348147171
03077,RAYMOND,NH,4078,4127,49,0.5029859841560025
03079,SALEM,NH,11179,11446,267,0.5059005524861878
03082,LYNDEBOROUGH,NH,160,351,191,0.6868884540117417
03084,TEMPLE,NH,321,269,-52,0.4559322033898305
03086,WILTON,NH,1669,1554,-115,0.48215947874650944
03087,WINDHAM,NH,4388,4884,496,0.5267471958584987
03101,MANCHESTER,NH,4137,3315,-822,0.44484702093397743
03102,MANCHESTER,NH,19870,16882,-2988,0.4593491510666086
03103,MANCHESTER,NH,18628,16618,-2010,0.47148612608522955
03104,MANCHESTER,NH,17007,15791,-1216,0.48146228428562715
03105,MANCHESTER,NH,630,633,3,0.501187648456057
03106,HOOKSETT,NH,5437,5778,341,0.5152028533214444
03108,MANCHESTER,NH,1147,998,-149,0.46526806526806525
03109,MANCHESTER,NH,3884,3965,81,0.5051598929799974
03110,BEDFORD,NH,8428,8632,204,0.505978898007034
03215,WATERVILLE VALLEY,NH,243,368,125,0.602291325695581
03216,ANDOVER,NH,807,867,60,0.517921146953405
03217,ASHLAND,NH,1350,1142,-208,0.4582664526484751
03218,BARNSTEAD,NH,301,165,-136,0.3540772532188841
03220,BELMONT,NH,2920,3008,88,0.5074224021592443
03221,BRADFORD,NH,826,821,-5,0.49848208864602306
03222,ALEXANDRIA,NH,454,456,2,0.5010989010989011
03222,BRISTOL,NH,3203,3045,-158,0.48735595390524966
03223,CAMPTON,NH,2430,2119,-311,0.4658166630028578
03224,CANTERBURY,NH,556,694,138,0.5552
03225,CENTER BARNSTEAD,NH,1689,1681,-8,0.498813056379822
03226,CENTER HARBOR,NH,1853,1339,-514,0.41948621553884713
03227,CENTER SANDWICH,NH,309,350,41,0.5311077389984825
03227,CTR SANDWICH,NH,0,23,23,1
03227,SANDWICH,NH,27,108,81,0.8
03229,CONTOOCOOK,NH,1169,1259,90,0.5185337726523888
03229,HOPKINTON,NH,801,1019,218,0.5598901098901099
03230,DANBURY,NH,424,379,-45,0.47198007471980075
03233,ELKINS,NH,40,36,-4,0.47368421052631576
03234,EPSOM,NH,1768,1870,102,0.514018691588785
03235,FRANKLIN,NH,5064,4178,-886,0.45206665223977494
03237,GILMANTON,NH,837,841,4,0.50119189511323
03237,GREENFIELD,NH,28,38,10,0.5757575757575758
03240,GRAFTON,NH,406,440,34,0.5200945626477541
03241,HEBRON,NH,377,432,55,0.5339925834363412
03242,HENNIKER,NH,1659,1675,16,0.5023995200959808
03243,HILL,NH,301,189,-112,0.38571428571428573
03244,DEERING,NH,142,189,47,0.5709969788519638
03244,HILLSBORO,NH,83,57,-26,0.40714285714285714
03244,HILLSBOROUGH,NH,3613,3355,-258,0.48148679678530426
03245,HOLDERNESS,NH,1201,1092,-109,0.4762320104666376
03246,LACONIA,NH,9558,9108,-450,0.4879459980713597
03247,LACONIA,NH,1453,1527,74,0.5124161073825504
03249,BELMONT,NH,70,99,29,0.5857988165680473
03249,GILFORD,NH,3380,3230,-150,0.4886535552193646
03249,WARREN,NH,54,82,28,0.6029411764705882
03251,LINCOLN,NH,1453,992,-461,0.40572597137014316
03252,LOCHMERE,NH,12,46,34,0.7931034482758621
03253,MEREDITH,NH,3911,4074,163,0.5102066374452098
03254,MOULTONBORO,NH,228,475,247,0.6756756756756757
03254,MOULTONBOROUGH,NH,2821,2756,-65,0.49417249417249415
03255,MOUNT SUNAPEE,NH,14,20,6,0.5882352941176471
03255,NEWBURY,NH,1392,1232,-160,0.4695121951219512
03256,NEW HAMPTON,NH,910,971,61,0.5162147793726741
03257,NEW LONDON,NH,2380,2467,87,0.5089746234784402
03258,CHICHESTER,NH,728,826,98,0.5315315315315315
03259,NORTH SANDWICH,NH,27,11,-16,0.2894736842105263
03260,NORTH SUTTON,NH,100,77,-23,0.4350282485875706
03261,NORTHWOOD,NH,1780,1813,33,0.5045922627330921
03262,N WOODSTOCK,NH,97,39,-58,0.2867647058823529
03262,NORTH WOODSTOCK,NH,453,426,-27,0.48464163822525597
03263,PITTSFIELD,NH,1933,1981,48,0.50613183444047
03264,PLYMOUTH,NH,3511,2633,-878,0.4285481770833333
03266,DORCHESTER,NH,67,29,-38,0.3020833333333333
03266,RUMNEY,NH,989,892,-97,0.47421584263689526
03268,SALISBURY,NH,148,268,120,0.6442307692307693
03269,SANBORNTON,NH,1090,1124,34,0.5076784101174345
03273,SOUTH SUTTON,NH,0,31,31,1
03275,ALLENSTOWN,NH,1566,1514,-52,0.4915584415584416
03275,PEMBROKE,NH,1932,1931,-1,0.49987056691690396
03275,SUNCOOK,NH,1286,1181,-105,0.4787190920145926
03276,NORTHFIELD,NH,616,702,86,0.5326251896813353
03276,TILTON,NH,2914,3026,112,0.5094276094276095
03278,WARNER,NH,1208,1225,17,0.5034936292642828
03279,TILTON,NH,0,13,13,1
03279,WARREN,NH,222,52,-170,0.1897810218978102
03280,WASHINGTON,NH,492,535,43,0.5209347614410905
03281,WEARE,NH,3180,3132,-48,0.49619771863117873
03282,WENTWORTH,NH,198,174,-24,0.46774193548387094
03284,SPRINGFIELD,NH,11,91,80,0.8921568627450981
03285,THORNTON,NH,366,522,156,0.5878378378378378
03287,WILMOT,NH,264,375,111,0.5868544600938967
03289,WINNISQUAM,NH,93,11,-82,0.10576923076923077
03290,NOTTINGHAM,NH,1331,1652,321,0.5538048944016091
03301,CONCORD,NH,15378,14168,-1210,0.47952345495160087
03302,CONCORD,NH,2104,1273,-831,0.37696180041456917
03303,BOSCAWEN,NH,1202,1263,61,0.5123732251521298
03303,CONCORD,NH,1813,1881,68,0.5092041147807255
03303,PENACOOK,NH,2855,2890,35,0.5030461270670148
03303,WEBSTER,NH,372,382,10,0.506631299734748
03304,BOW,NH,2296,2285,-11,0.4987993887797424
03307,LOUDON,NH,1612,1711,99,0.5148961781522721
03431,KEENE,NH,13852,12176,-1676,0.4678039034885508
03440,ANTRIM,NH,1157,1241,84,0.5175145954962469
03441,ASHUELOT,NH,50,12,-38,0.1935483870967742
03442,BENNINGTON,NH,422,408,-14,0.491566265060241
03443,CHESTERFIELD,NH,47,72,25,0.6050420168067226
03444,DUBLIN,NH,585,650,65,0.5263157894736842
03445,SULLIVAN,NH,57,27,-30,0.32142857142857145
03446,SWANZEY,NH,2188,2315,127,0.5141017099711304
03447,FITZWILLIAM,NH,1050,1046,-4,0.49904580152671757
03448,GILSUM,NH,78,101,23,0.5642458100558659
03449,HANCOCK,NH,487,620,133,0.5600722673893406
03450,HARRISVILLE,NH,279,301,22,0.5189655172413793
03451,HINSDALE,NH,1732,1607,-125,0.4812818209044624
03452,JAFFREY,NH,2565,2444,-121,0.4879217408664404
03455,MARLBOROUGH,NH,1011,879,-132,0.4650793650793651
03456,MARLOW,NH,90,75,-15,0.45454545454545453
03456,STODDARD,NH,14,17,3,0.5483870967741935
03457,MUNSONVILLE,NH,0,49,49,1
03457,NELSON,NH,108,119,11,0.5242290748898678
03458,PETERBOROUGH,NH,2577,2878,301,0.5275893675527039
03458,SHARON,NH,338,471,133,0.5822002472187886
03461,RINDGE,NH,1962,2158,196,0.5237864077669903
03462,SPOFFORD,NH,769,715,-54,0.48180592991913745
03464,STODDARD,NH,387,446,59,0.5354141656662665
03465,TROY,NH,768,869,101,0.5308491142333537
03466,W CHESTERFLD,NH,25,12,-13,0.32432432432432434
03466,WEST CHESTERFIELD,NH,233,227,-6,0.4934782608695652
03467,WESTMORELAND,NH,249,366,117,0.5951219512195122
03469,WEST SWANZEY,NH,12,35,23,0.7446808510638298
03470,RICHMOND,NH,357,353,-4,0.4971830985915493
03470,WINCHESTER,NH,1680,1582,-98,0.48497854077253216
03561,LITTLETON,NH,4024,3303,-721,0.45079841681452165
03570,BERLIN,NH,5554,4532,-1022,0.44933571286932383
03574,BETHLEHEM,NH,1306,1334,28,0.5053030303030303
03576,COLEBROOK,NH,1602,1439,-163,0.47319960539296285
03576,STEWARTSTOWN,NH,179,220,41,0.5513784461152882
03579,ERROL,NH,75,87,12,0.5370370370370371
03580,EASTON,NH,49,23,-26,0.3194444444444444
03580,FRANCONIA,NH,887,723,-164,0.44906832298136645
03581,GORHAM,NH,1473,1343,-130,0.47691761363636365
03581,SHELBURNE,NH,90,112,22,0.5544554455445545
03582,GROVETON,NH,918,891,-27,0.4925373134328358
03582,NORTHUMBERLAND,NH,32,35,3,0.5223880597014925
03582,STARK,NH,327,319,-8,0.4938080495356037
03583,JEFFERSON,NH,327,300,-27,0.4784688995215311
03584,LANCASTER,NH,1700,1699,-1,0.49985289791115034
03585,LANDAFF,NH,51,59,8,0.5363636363636364
03585,LISBON,NH,1058,1048,-10,0.4976258309591643
03585,LYMAN,NH,89,123,34,0.5801886792452831
03586,SUGAR HILL,NH,15,99,84,0.868421052631579
03588,DUMMER,NH,69,63,-6,0.4772727272727273
03588,MILAN,NH,414,438,24,0.5140845070422535
03590,N STRATFORD,NH,0,12,12,1
03590,NORTH STRATFORD,NH,227,270,43,0.5432595573440644
03590,STRATFORD,NH,11,12,1,0.5217391304347826
03592,CLARKSVILLE,NH,40,59,19,0.5959595959595959
03592,PITTSBURG,NH,331,401,70,0.5478142076502732
03593,RANDOLPH,NH,90,74,-16,0.45121951219512196
03595,TWIN MOUNTAIN,NH,201,161,-40,0.4447513812154696
03598,DALTON,NH,122,157,35,0.5627240143369175
03598,WHITEFIELD,NH,1668,1720,52,0.5076741440377804
03601,ACWORTH,NH,11,78,67,0.8764044943820225
03602,ALSTEAD,NH,846,868,22,0.5064177362893816
03602,LANGDON,NH,178,153,-25,0.4622356495468278
03603,CHARLESTOWN,NH,2170,1911,-259,0.46826758147512865
03605,LEMPSTER,NH,377,261,-116,0.4090909090909091
03607,SOUTH ACWORTH,NH,80,14,-66,0.14893617021276595
03608,WALPOLE,NH,1057,1194,137,0.5304309195912927
03609,NORTH WALPOLE,NH,104,56,-48,0.35
03740,BATH,NH,263,232,-31,0.4686868686868687
03741,CANAAN,NH,1580,1503,-77,0.48751216347713267
03741,ORANGE,NH,225,209,-16,0.4815668202764977
03743,CLAREMONT,NH,8177,6933,-1244,0.4588352084712111
03745,CORNISH,NH,188,188,0,0.5
03746,CORNISH FLAT,NH,12,0,-12,0
03748,ENFIELD,NH,2334,2254,-80,0.49128160418482997
03750,ETNA,NH,106,236,130,0.6900584795321637
03751,GEORGES MILLS,NH,119,103,-16,0.46396396396396394
03752,GOSHEN,NH,167,238,71,0.5876543209876544
03753,GRANTHAM,NH,1809,1872,63,0.508557457212714
03754,GUILD,NH,11,0,-11,0
03755,HANOVER,NH,3784,3388,-396,0.4723926380368098
03765,HAVERHILL,NH,14,11,-3,0.44
03766,LEBANON,NH,6862,5936,-926,0.4638224722612908
03768,LYME,NH,526,555,29,0.513413506012951
03770,MERIDEN,NH,40,0,-40,0
03771,MONROE,NH,92,117,25,0.5598086124401914
03773,CROYDON,NH,161,156,-5,0.4921135646687697
03773,NEWPORT,NH,3666,3498,-168,0.4882747068676717
03774,N HAVERHILL,NH,72,51,-21,0.4146341463414634
03774,NORTH HAVERHILL,NH,517,671,154,0.5648148148148148
03777,ORFORD,NH,458,577,119,0.557487922705314
03779,PIERMONT,NH,102,164,62,0.6165413533834586
03781,PLAINFIELD,NH,324,330,6,0.5045871559633027
03782,SUNAPEE,NH,2193,2019,-174,0.4793447293447293
03784,WEST LEBANON,NH,2684,2535,-149,0.4857252347192949
03785,BENTON,NH,109,48,-61,0.3057324840764331
03785,WOODSVILLE,NH,1162,1018,-144,0.4669724770642202
03801,NEWINGTON,NH,276,269,-7,0.4935779816513762
03801,PORTSMOUTH,NH,13495,13052,-443,0.4916563076807172
03802,PORTSMOUTH,NH,1903,1480,-423,0.43748152527342593
03809,ALTON,NH,1743,1859,116,0.5161021654636313
03810,ALTON BAY,NH,1405,1495,90,0.5155172413793103
03811,ATKINSON,NH,2298,2562,264,0.5271604938271605
03812,BARTLETT,NH,0,11,11,1
03813,CENTER CONWAY,NH,1290,1290,0,0.5
03813,CHATHAM,NH,53,45,-8,0.45918367346938777
03814,CENTER OSSIPEE,NH,1345,1228,-117,0.4772638942868247
03814,CTR OSSIPEE,NH,49,50,1,0.5050505050505051
03816,CENTER TUFTONBORO,NH,162,222,60,0.578125
03816,CTR TUFTNBORO,NH,13,17,4,0.5666666666666667
03817,CHOCORUA,NH,115,72,-43,0.3850267379679144
03818,ALBANY,NH,260,244,-16,0.48412698412698413
03818,CONWAY,NH,1655,1419,-236,0.4616135328562134
03819,DANVILLE,NH,1225,1385,160,0.5306513409961686
03820,DOVER,NH,17708,16204,-1504,0.47782495871667846
03820,NEWMARKET,NH,390,331,-59,0.4590846047156727
03821,DOVER,NH,714,1000,286,0.5834305717619603
03823,MADBURY,NH,363,353,-10,0.4930167597765363
03824,DURHAM,NH,3038,3062,24,0.5019672131147541
03825,BARRINGTON,NH,3252,3151,-101,0.49211307199750115
03826,E HAMPSTEAD,NH,44,77,33,0.6363636363636364
03826,EAST HAMPSTEAD,NH,999,1009,10,0.5024900398406374
03827,EAST KINGSTON,NH,473,623,150,0.5684306569343066
03827,SOUTH HAMPTON,NH,349,345,-4,0.49711815561959655
03830,E WAKEFIELD,NH,11,44,33,0.8
03830,EAST WAKEFIELD,NH,1254,1261,7,0.5013916500994036
03833,BRENTWOOD,NH,627,734,107,0.5393093313739897
03833,EXETER,NH,6379,6844,465,0.5175829993193678
03833,KENSINGTON,NH,1371,1490,119,0.5207969241523943
03835,FARMINGTON,NH,2804,2822,18,0.5015997156061145
03836,FREEDOM,NH,1173,1266,93,0.5190651906519065
03837,GILMANTON IRON WORKS,NH,303,320,17,0.5136436597110754
03837,GILMANTON IW,NH,56,63,7,0.5294117647058824
03838,GLEN,NH,779,804,25,0.5078963992419456
03839,ROCHESTER,NH,2222,2116,-106,0.48778238819732594
03840,GREENLAND,NH,1717,1797,80,0.5113830392714855
03841,HAMPSTEAD,NH,2307,2350,43,0.5046167060339274
03842,HAMPTON,NH,8033,7988,-45,0.498595593283815
03843,HAMPTON,NH,823,888,65,0.5189947399181765
03844,HAMPTON FALLS,NH,843,1075,232,0.5604796663190824
03845,INTERVALE,NH,704,581,-123,0.4521400778210117
03846,JACKSON,NH,296,384,88,0.5647058823529412
03848,KINGSTON,NH,2100,2093,-7,0.4991652754590985
03849,MADISON,NH,332,386,54,0.5376044568245125
03850,MELVIN VILLAGE,NH,306,422,116,0.5796703296703297
03850,MELVIN VLG,NH,0,11,11,1
03851,MILTON,NH,1632,1791,159,0.523225241016652
03852,MILTON MILLS,NH,25,71,46,0.7395833333333334
03853,MIRROR LAKE,NH,669,536,-133,0.44481327800829873
03854,NEW CASTLE,NH,399,489,90,0.5506756756756757
03855,NEW DURHAM,NH,1163,1089,-74,0.4835701598579041
03856,NEWFIELDS,NH,284,420,136,0.5965909090909091
03857,NEWMARKET,NH,4854,4268,-586,0.4678798509098882
03858,NEWTON,NH,1317,1370,53,0.5098622999627838
03859,NEWTON JUNCTION,NH,0,11,11,1
03860,HALES LOCATION,NH,42,35,-7,0.45454545454545453
03860,NORTH CONWAY,NH,2143,2071,-72,0.49145704793545325
03861,LEE,NH,1249,1462,213,0.5392843969015123
03862,NORTH HAMPTON,NH,1992,2219,227,0.5269532177630016
03864,OSSIPEE,NH,762,946,184,0.5538641686182669
03865,PLAISTOW,NH,2681,2805,124,0.511301494713817
03866,ROCHESTER,NH,733,940,207,0.5618649133293485
03867,ROCHESTER,NH,10708,9935,-773,0.48127694618030326
03868,ROCHESTER,NH,2393,2373,-20,0.49790180444817456
03869,ROLLINSFORD,NH,982,1062,80,0.5195694716242661
03870,RYE,NH,2762,2576,-186,0.4825777444735856
03871,RYE BEACH,NH,189,225,36,0.5434782608695652
03872,BROOKFIELD,NH,156,136,-20,0.4657534246575342
03872,SANBORNVILLE,NH,1969,1962,-7,0.49910964131264307
03873,SANDOWN,NH,1709,1879,170,0.5236900780379041
03874,SEABROOK,NH,4562,4803,241,0.5128670581954085
03875,SILVER LAKE,NH,125,236,111,0.6537396121883656
03878,SOMERSWORTH,NH,6864,6054,-810,0.46864839758476545
03882,EFFINGHAM,NH,509,555,46,0.5216165413533834
03884,STRAFFORD,NH,1225,1365,140,0.527027027027027
03885,STRATHAM,NH,2618,3022,404,0.5358156028368795
03886,TAMWORTH,NH,631,714,83,0.5308550185873606
03887,MIDDLETON,NH,574,590,16,0.506872852233677
03887,UNION,NH,97,71,-26,0.4226190476190476
03890,WEST OSSIPEE,NH,580,439,-141,0.4308145240431796
03894,WOLFEBORO,NH,3175,3660,485,0.5354791514264814
03896,WOLFEBORO FALLS,NH,793,493,-300,0.3833592534992224
03896,WOLFEBORO FLS,NH,149,107,-42,0.41796875
03901,BERWICK,ME,2665,2669,4,0.5003749531308587
03902,CAPE NEDDICK,ME,1090,1270,180,0.538135593220339
03903,ELIOT,ME,2729,2483,-246,0.4764006139677667
03904,KITTERY,ME,4553,4501,-52,0.49712834106472276
03905,KITTERY POINT,ME,816,978,162,0.5451505016722408
03906,NORTH BERWICK,ME,1530,1758,228,0.5346715328467153
03907,OGUNQUIT,ME,1862,1858,-4,0.49946236559139784
03908,SOUTH BERWICK,ME,2244,2384,140,0.5151253241140882
03909,YORK,ME,4260,4882,622,0.5340188142638372
03910,YORK BEACH,ME,1167,783,-384,0.4015384615384615
03911,YORK HARBOR,ME,586,419,-167,0.41691542288557215
04001,ACTON,ME,1135,1425,290,0.556640625
04002,ALFRED,ME,466,704,238,0.6017094017094017
04002,LYMAN,ME,1994,2147,153,0.5184737985993721
04003,BAILEY IS,ME,17,0,-17,0
04003,BAILEY ISLAND,ME,210,303,93,0.5906432748538012
04004,BAR MILLS,ME,0,12,12,1
04005,BIDDEFORD,ME,10894,10626,-268,0.4937732342007435
04005,DAYTON,ME,1355,1441,86,0.515379113018598
04006,BIDDEFORD PL,ME,26,11,-15,0.2972972972972973
04006,BIDDEFORD POOL,ME,257,251,-6,0.4940944881889764
04008,BOWDOINHAM,ME,924,1033,109,0.5278487480838018
04009,BRIDGTON,ME,3006,3599,593,0.544890234670704
04010,BROWNFIELD,ME,553,555,2,0.5009025270758123
04011,BRUNSWICK,ME,9442,10382,940,0.5237086359967716
04014,CAPE PORPOISE,ME,154,72,-82,0.3185840707964602
04015,CASCO,ME,1824,2170,346,0.543314972458688
04016,CENTER LOVELL,ME,75,111,36,0.5967741935483871
04017,CHEBEAGUE ISLAND,ME,98,282,184,0.7421052631578947
04020,CORNISH,ME,457,722,265,0.6123833757421544
04021,CUMBERLAND,ME,426,491,65,0.5354416575790621
04021,CUMBERLAND CENTER,ME,1514,1882,368,0.5541813898704359
04022,DENMARK,ME,473,603,130,0.5604089219330854
04024,EAST BALDWIN,ME,0,47,47,1
04027,LEBANON,ME,1858,2040,182,0.5233453052847614
04029,SEBAGO,ME,1019,1298,279,0.5602071644367717
04030,E WATERBORO,ME,63,69,6,0.5227272727272727
04030,EAST WATERBORO,ME,527,614,87,0.5381244522348817
04032,FREEPORT,ME,3444,3788,344,0.5237831858407079
04037,FRYEBURG,ME,1549,1740,191,0.5290361812100942
04038,GORHAM,ME,5232,5872,640,0.5288184438040345
04039,GRAY,ME,3388,3536,148,0.510687463893703
04040,HARRISON,ME,1314,1451,137,0.5247739602169982
04040,SWEDEN,ME,251,284,33,0.5308411214953271
04041,BALDWIN,ME,16,0,-16,0
04041,HIRAM,ME,389,522,133,0.5729967069154775
04042,HOLLIS CENTER,ME,1391,1637,246,0.5406208718626155
04043,KENNEBUNK,ME,5296,6417,1121,0.5478528131136344
04046,ARUNDEL,ME,1214,986,-228,0.4481818181818182
04046,KENNEBUNKPORT,ME,2891,3527,636,0.5495481458398255
04047,PARSONSFIELD,ME,755,873,118,0.5362407862407862
04048,LIMERICK,ME,1216,1417,201,0.5381693885301937
04049,LIMINGTON,ME,1143,1284,141,0.5290482076637825
04050,LONG ISLAND,ME,120,118,-2,0.4957983193277311
04051,LOVELL,ME,551,648,97,0.5404503753127606
04054,MOODY,ME,1077,1126,49,0.5111211983658648
04055,NAPLES,ME,2688,2884,196,0.5175879396984925
04057,NORTH BRIDGTON,ME,0,32,32,1
04061,N WATERBORO,ME,146,237,91,0.618798955613577
04061,NORTH WATERBORO,ME,995,998,3,0.5007526342197692
04062,N WINDHAM,ME,451,512,61,0.5316718587746625
04062,WINDHAM,ME,6101,6824,723,0.5279690522243714
04063,OCEAN PARK,ME,311,571,260,0.6473922902494331
04064,OLD ORCHARD BEACH,ME,6981,6940,-41,0.49852740464047124
04066,ORRS ISLAND,ME,392,497,105,0.5590551181102362
04068,PORTER,ME,368,363,-5,0.49658002735978113
04069,POWNAL,ME,239,405,166,0.6288819875776398
04070,SCARBOROUGH,ME,1290,1019,-271,0.44131658726721523
04071,FRYE ISLAND,ME,505,186,-319,0.2691751085383502
04071,RAYMOND,ME,2497,3283,786,0.5679930795847751
04072,SACO,ME,9138,9694,556,0.5147621070518267
04073,SANFORD,ME,7519,7225,-294,0.49002984264785676
04074,SCARBOROUGH,ME,9011,10942,1931,0.5483887134766702
04076,N SHAPLEIGH,ME,74,91,17,0.5515151515151515
04076,SHAPLEIGH,ME,1093,1207,114,0.5247826086956522
04077,SOUTH CASCO,ME,154,216,62,0.5837837837837838
04078,S FREEPORT,ME,0,13,13,1
04078,SOUTH FREEPORT,ME,38,74,36,0.6607142857142857
04079,HARPSWELL,ME,2695,2876,181,0.5162448393466164
04083,SPRINGVALE,ME,1981,1973,-8,0.49898836621143144
04084,STANDISH,ME,2944,3328,384,0.5306122448979592
04085,STEEP FALLS,ME,396,414,18,0.5111111111111111
04086,TOPSHAM,ME,3604,3948,344,0.5227754237288136
04087,WATERBORO,ME,864,901,37,0.5104815864022663
04088,WATERFORD,ME,701,788,87,0.529214237743452
04090,WELLS,ME,6117,7642,1525,0.5554182716767206
04091,WEST BALDWIN,ME,61,98,37,0.6163522012578616
04092,WESTBROOK,ME,9809,8985,-824,0.4780781100351176
04093,BUXTON,ME,2376,2464,88,0.509090909090909
04094,W KENNEBUNK,ME,0,11,11,1
04094,WEST KENNEBUNK,ME,93,90,-3,0.4918032786885246
04095,WEST NEWFIELD,ME,454,602,148,0.5700757575757576
04096,YARMOUTH,ME,3989,4398,409,0.524382973649696
04097,N YARMOUTH,ME,100,119,19,0.54337899543379
04097,NORTH YARMOUTH,ME,878,1152,274,0.5674876847290641
04098,WESTBROOK,ME,236,401,165,0.6295133437990581
04101,PORTLAND,ME,21575,15124,-6451,0.412109321779885
04102,PORTLAND,ME,11215,9433,-1782,0.45684812088337856
04103,PORTLAND,ME,18393,15318,-3075,0.4543917415680342
04104,PORTLAND,ME,1282,1351,69,0.5131029244208127
04105,FALMOUTH,ME,5113,5754,641,0.5294929603386399
04105,PORTLAND,ME,111,183,72,0.6224489795918368
04106,S PORTLAND,ME,876,810,-66,0.4804270462633452
04106,SOUTH PORTLAND,ME,12586,12363,-223,0.4955308830013227
04107,CAPE ELIZ,ME,41,34,-7,0.4533333333333333
04107,CAPE ELIZABETH,ME,3597,3924,327,0.5217391304347826
04108,PEAKS ISLAND,ME,680,835,155,0.5511551155115512
04110,CUMB FORESIDE,ME,65,74,9,0.5323741007194245
04110,CUMBERLAND FORESIDE,ME,851,842,-9,0.49734199645599525
04112,PORTLAND,ME,883,661,-222,0.42810880829015546
04116,SOUTH PORTLAND,ME,493,446,-47,0.4749733759318424
04210,AUBURN,ME,11461,10352,-1109,0.4745793792692431
04211,AUBURN,ME,48,152,104,0.76
04212,AUBURN,ME,78,174,96,0.6904761904761905
04216,ANDOVER,ME,153,121,-32,0.4416058394160584
04217,ALBANY TWP,ME,75,76,1,0.5033112582781457
04217,BETHEL,ME,1476,1483,7,0.5011828320378506
04217,GILEAD,ME,130,138,8,0.5149253731343284
04219,BRYANT POND,ME,306,392,86,0.5616045845272206
04219,MILTON TWP,ME,42,55,13,0.5670103092783505
04220,BUCKFIELD,ME,616,737,121,0.5447154471544715
04220,HARTFORD,ME,332,404,72,0.5489130434782609
04221,CANTON,ME,45,112,67,0.7133757961783439
04222,DURHAM,ME,969,1184,215,0.5499303297724106
04224,ANDOVER,ME,16,18,2,0.5294117647058824
04224,CARTHAGE,ME,73,111,38,0.6032608695652174
04224,DIXFIELD,ME,875,866,-9,0.4974152785755313
04231,STONEHAM,ME,11,13,2,0.5416666666666666
04236,GREENE,ME,1669,1699,30,0.5044536817102138
04237,HANOVER,ME,18,0,-18,0
04238,HEBRON,ME,106,139,33,0.5673469387755102
04239,JAY,ME,1698,1775,77,0.5110855168442269
04240,LEWISTON,ME,19150,17101,-2049,0.4717387106562578
04241,LEWISTON,ME,66,51,-15,0.4358974358974359
04243,LEWISTON,ME,601,366,-235,0.3784901758014478
04250,LISBON,ME,1964,2033,69,0.5086314736052039
04252,LISBON FALLS,ME,1984,1739,-245,0.46709642761214076
04253,LIVERMORE,ME,585,666,81,0.5323741007194245
04254,LIVERMORE FALLS,ME,1540,1457,-83,0.4861528194861528
04254,LIVERMORE FLS,ME,28,20,-8,0.4166666666666667
04255,GREENWOOD,ME,213,300,87,0.5847953216374269
04256,MECHANIC FALLS,ME,1137,1181,44,0.5094909404659189
04257,MEXICO,ME,1411,1449,38,0.5066433566433567
04258,MINOT,ME,686,832,146,0.5480895915678524
04259,MONMOUTH,ME,1233,1268,35,0.5069972011195522
04260,NEW GLOUCESTER,ME,1794,1964,170,0.5226184140500266
04261,NEWRY,ME,136,237,101,0.6353887399463807
04261,UPTON,ME,25,51,26,0.6710526315789473
04263,LEEDS,ME,578,633,55,0.5227085053674649
04265,MONMOUTH,ME,0,12,12,1
04265,N MONMOUTH,ME,12,34,22,0.7391304347826086
04265,NORTH MONMOUTH,ME,57,112,55,0.6627218934911243
04268,NORWAY,ME,2291,2556,265,0.5273364968021457
04270,OTISFIELD,ME,624,543,-81,0.4652956298200514
04270,OXFORD,ME,2071,2427,356,0.5395731436193864
04274,POLAND,ME,2042,2242,200,0.523342670401494
04275,BYRON,ME,0,32,32,1
04275,ROXBURY,ME,80,58,-22,0.42028985507246375
04276,RUMFORD,ME,3154,2871,-283,0.47651452282157675
04280,SABATTUS,ME,2411,2376,-35,0.4963442657196574
04280,WALES,ME,85,93,8,0.5224719101123596
04281,SOUTH PARIS,ME,2143,2158,15,0.5017437805161591
04282,TURNER,ME,2027,2219,192,0.5226095148374941
04284,WAYNE,ME,519,588,69,0.5311653116531165
04285,WELD,ME,168,179,11,0.515850144092219
04287,BOWDOIN,ME,609,751,142,0.5522058823529412
04289,WEST PARIS,ME,914,551,-363,0.37610921501706485
04290,LEWISTON,ME,12,24,12,0.6666666666666666
04290,PERU,ME,522,569,47,0.5215398716773603
04292,SUMNER,ME,117,127,10,0.5204918032786885
04294,WILTON,ME,1586,1554,-32,0.4949044585987261
04330,AUGUSTA,ME,11729,11642,-87,0.49813871892516365
04330,CHELSEA,ME,271,308,37,0.531951640759931
04330,SIDNEY,ME,280,236,-44,0.4573643410852713
04332,AUGUSTA,ME,639,451,-188,0.41376146788990825
04342,DRESDEN,ME,394,605,211,0.6056056056056056
04343,EAST WINTHROP,ME,11,34,23,0.7555555555555555
04344,FARMINGDALE,ME,1094,1046,-48,0.48878504672897194
04345,GARDINER,ME,2846,3106,260,0.5218413978494624
04345,PITTSTON,ME,675,727,52,0.5185449358059915
04345,WEST GARDINER,ME,943,1027,84,0.5213197969543147
04346,RANDOLPH,ME,638,622,-16,0.4936507936507937
04347,HALLOWELL,ME,1452,1480,28,0.504774897680764
04348,JEFFERSON,ME,1067,1240,173,0.5374945817078457
04348,SOMERVILLE,ME,112,150,38,0.5725190839694656
04349,FAYETTE,ME,299,375,76,0.5563798219584569
04349,KENTS HILL,ME,112,217,105,0.6595744680851063
04350,LITCHFIELD,ME,1418,1634,216,0.5353866317169069
04351,MANCHESTER,ME,1817,1242,-575,0.40601503759398494
04352,MOUNT VERNON,ME,659,715,56,0.5203784570596798
04353,WHITEFIELD,ME,537,642,105,0.544529262086514
04354,PALERMO,ME,517,593,76,0.5342342342342342
04355,READFIELD,ME,764,923,159,0.5471250740960285
04357,RICHMOND,ME,1359,1488,129,0.5226554267650158
04358,CHINA,ME,323,280,-43,0.46434494195688225
04358,SOUTH CHINA,ME,1168,1324,156,0.5313001605136437
04359,SOUTH GARDINER,ME,36,0,-36,0
04360,VIENNA,ME,41,70,29,0.6306306306306306
04363,WINDSOR,ME,959,834,-125,0.4651422197434467
04364,WINTHROP,ME,2593,2871,278,0.5254392386530015
04401,BANGOR,ME,19539,17733,-1806,0.4757726980038635
04401,GLENBURN,ME,559,458,-101,0.4503441494591937
04401,HERMON,ME,2525,2301,-224,0.47679237463738083
04401,VEAZIE,ME,897,796,-101,0.47017129356172477
04402,BANGOR,ME,1620,1326,-294,0.45010183299389
04406,ABBOT,ME,205,247,42,0.5464601769911505
04406,BLANCHARD TWP,ME,29,23,-6,0.4423076923076923
04408,AURORA,ME,36,0,-36,0
04410,BRADFORD,ME,127,229,102,0.6432584269662921
04411,BRADLEY,ME,434,379,-55,0.4661746617466175
04412,BREWER,ME,4855,4626,-229,0.48792321485075413
04413,FOREST CITY TWP,ME,28,11,-17,0.28205128205128205
04414,BARNARD TWP,ME,0,16,16,1
04414,BROWNVILLE,ME,395,620,225,0.6108374384236454
04414,EBEEMEE TWP,ME,96,50,-46,0.3424657534246575
04414,WILIAMSBG TWP,ME,12,0,-12,0
04416,BUCKSPORT,ME,2643,2336,-307,0.4691705161679052
04416,VERONA ISLAND,ME,90,45,-45,0.3333333333333333
04417,BURLINGTON,ME,66,34,-32,0.34
04418,GREENBUSH,ME,381,409,28,0.5177215189873418
04418,GREENFIELD TWP,ME,27,17,-10,0.38636363636363635
04419,CARMEL,ME,1116,1168,52,0.51138353765324
04419,THORNDIKE,ME,31,17,-14,0.3541666666666667
04421,CASTINE,ME,1214,837,-377,0.4080936128717699
04422,CHARLESTON,ME,157,206,49,0.5674931129476584
04424,DANFORTH,ME,290,330,40,0.532258064516129
04424,WESTON,ME,40,67,27,0.6261682242990654
04426,ATKINSON,ME,43,51,8,0.5425531914893617
04426,DOVER FOXCROFT,ME,2396,2409,13,0.5013527575442248
04427,CORINTH,ME,1014,1049,35,0.508482792050412
04428,CLIFTON,ME,221,225,4,0.5044843049327354
04428,EDDINGTON,ME,780,812,32,0.5100502512562815
04429,DEDHAM,ME,342,327,-15,0.48878923766816146
04429,HOLDEN,ME,1944,1988,44,0.5055951169888098
04430,EAST MILLINOCKET,ME,456,445,-11,0.4938956714761376
04431,EAST ORLAND,ME,68,11,-57,0.13924050632911392
04434,ETNA,ME,82,140,58,0.6306306306306306
04435,EXETER,ME,71,49,-22,0.4083333333333333
04438,FRANKFORT,ME,313,277,-36,0.4694915254237288
04441,BEAVER COVE,ME,49,70,21,0.5882352941176471
04441,FRENCHTOWN TWP,ME,50,12,-38,0.1935483870967742
04441,FRENCHTWN TWP,ME,27,26,-1,0.49056603773584906
04441,GREENVILLE,ME,1116,990,-126,0.4700854700854701
04442,GREENVILLE JUNCTION,ME,187,156,-31,0.45481049562682213
04443,GUILFORD,ME,1129,1094,-35,0.49212775528565
04443,PARKMAN,ME,75,100,25,0.5714285714285714
04444,HAMPDEN,ME,3228,3312,84,0.5064220183486239
04444,NEWBURGH,ME,405,406,1,0.5006165228113441
04448,EDINBURG,ME,12,12,0,0.5
04448,HOWLAND,ME,348,297,-51,0.4604651162790698
04449,HUDSON,ME,363,362,-1,0.4993103448275862
04450,KENDUSKEAG,ME,343,255,-88,0.42642140468227424
04453,LAGRANGE,ME,91,92,1,0.5027322404371585
04453,MAXFIELD,ME,0,11,11,1
04455,LEE,ME,158,204,46,0.56353591160221
04456,LEVANT,ME,1073,1196,123,0.5271044513001322
04457,CHESTER,ME,500,498,-2,0.49899799599198397
04457,LINCOLN,ME,2585,2341,-244,0.475233455136013
04457,WOODVILLE,ME,47,106,59,0.6928104575163399
04459,MATTAWAMKEAG,ME,58,36,-22,0.3829787234042553
04459,MOLUNKUS TWP,ME,0,14,14,1
04460,GRINDSTONE,ME,0,13,13,1
04460,GRINDSTONE TWP,ME,25,25,0,0.5
04460,MEDWAY,ME,297,259,-38,0.4658273381294964
04461,MILFORD,ME,1168,1111,-57,0.4874945151382185
04462,MILLINOCKET,ME,2442,2321,-121,0.48729792147806006
04463,LAKE VIEW PLT,ME,36,33,-3,0.4782608695652174
04463,MEDFORD,ME,173,183,10,0.5140449438202247
04463,MILO,ME,1289,1340,51,0.5096995055154051
04463,ORNEVILLE TWP,ME,67,83,16,0.5533333333333333
04464,MONSON,ME,98,204,106,0.6754966887417219
04468,ALTON,ME,277,167,-110,0.3761261261261261
04468,INDIAN ISLAND,ME,220,161,-59,0.4225721784776903
04468,OLD TOWN,ME,4575,3595,-980,0.44002447980416154
04471,AMITY,ME,14,49,35,0.7777777777777778
04471,CARY PLT,ME,0,11,11,1
04471,ORIENT,ME,29,51,22,0.6375
04472,ORLAND,ME,1059,997,-62,0.48492217898832685
04473,ORONO,ME,3763,2962,-801,0.4404460966542751
04474,ORRINGTON,ME,1411,1568,157,0.5263511245384357
04475,PASSADUMKEAG,ME,0,11,11,1
04476,PENOBSCOT,ME,397,402,5,0.5031289111389237
04478,ROCKWOOD,ME,247,176,-71,0.4160756501182033
04479,SANGERVILLE,ME,569,463,-106,0.4486434108527132
04481,SEBEC,ME,22,64,42,0.7441860465116279
04487,CARROLL PLT,ME,40,68,28,0.6296296296296297
04487,LAKEVILLE,ME,51,55,4,0.5188679245283019
04487,PRENTISS TWP,ME,42,65,23,0.6074766355140186
04487,ROCKWOOD,ME,30,0,-30,0
04487,SPRINGFIELD,ME,136,228,92,0.6263736263736264
04487,WEBSTER PLT,ME,38,28,-10,0.42424242424242425
04488,STETSON,ME,268,322,54,0.5457627118644067
04489,STILLWATER,ME,67,0,-67,0
04493,ENFIELD,ME,64,73,9,0.5328467153284672
04493,LOWELL,ME,150,197,47,0.5677233429394812
04493,WEST ENFIELD,ME,448,346,-102,0.4357682619647355
04495,WINN,ME,14,0,-14,0
04496,WINTERPORT,ME,1393,1457,64,0.5112280701754386
04497,HAYNESVILLE,ME,0,11,11,1
04530,ARROWSIC,ME,97,156,59,0.616600790513834
04530,BATH,ME,5314,5152,-162,0.49226065354481174
04530,WEST BATH,ME,498,536,38,0.5183752417794971
04535,ALNA,ME,60,84,24,0.5833333333333334
04537,BOOTHBAY,ME,1122,1181,59,0.5128093790707773
04538,BOOTHBAY HARBOR,ME,2032,1885,-147,0.48123563952004084
04538,BOOTHBAY HBR,ME,79,270,191,0.7736389684813754
04539,BRISTOL,ME,337,365,28,0.51994301994302
04541,CHAMBERLAIN,ME,62,13,-49,0.17333333333333334
04543,DAMARISCOTTA,ME,1380,1351,-29,0.49469058952764555
04544,EAST BOOTHBAY,ME,989,988,-1,0.49974709155285785
04547,FRIENDSHIP,ME,607,594,-13,0.4945878434637802
04548,GEORGETOWN,ME,585,811,226,0.580945558739255
04551,BREMEN,ME,262,341,79,0.5655058043117744
04553,NEWCASTLE,ME,912,990,78,0.5205047318611987
04554,NEW HARBOR,ME,731,850,119,0.5376344086021505
04555,NOBLEBORO,ME,713,953,240,0.5720288115246098
04556,EDGECOMB,ME,505,579,74,0.5341328413284133
04558,PEMAQUID,ME,75,84,9,0.5283018867924528
04562,PHIPPSBURG,ME,1051,1341,290,0.56061872909699
04563,CUSHING,ME,624,705,81,0.5304740406320542
04564,ROUND POND,ME,211,246,35,0.5382932166301969
04568,SOUTH BRISTOL,ME,853,706,-147,0.45285439384220655
04571,TREVETT,ME,55,133,78,0.7074468085106383
04572,WALDOBORO,ME,1911,2011,100,0.5127485976542581
04573,WALPOLE,ME,50,61,11,0.5495495495495496
04574,WASHINGTON,ME,365,398,33,0.5216251638269986
04575,W BOOTHBAY HA,ME,0,35,35,1
04575,W BOOTHBY HBR,ME,27,0,-27,0
04575,WEST BOOTHBAY HARBOR,ME,257,230,-27,0.4722792607802875
04576,NEWAGEN,ME,0,227,227,1
04576,SOUTHPORT,ME,734,639,-95,0.4654042243262928
04578,WESTPORT ISLAND,ME,428,379,-49,0.46964064436183395
04578,WISCASSET,ME,1806,1806,0,0.5
04579,WOOLWICH,ME,1061,1177,116,0.5259159964253798
04605,ELLSWORTH,ME,7736,7515,-221,0.4927545734705921
04606,ADDISON,ME,567,563,-4,0.4982300884955752
04607,GOULDSBORO,ME,449,452,3,0.5016648168701443
04609,BAR HARBOR,ME,3250,3305,55,0.5041952707856598
04611,BEALS,ME,11,0,-11,0
04612,BERNARD,ME,186,202,16,0.520618556701031
04613,BIRCH HARBOR,ME,38,0,-38,0
04614,BLUE HILL,ME,2382,2110,-272,0.4697239536954586
04616,BROOKLIN,ME,645,546,-99,0.45843828715365237
04617,BROOKSVILLE,ME,630,598,-32,0.48697068403908794
04619,CALAIS,ME,1929,1843,-86,0.4886002120890774
04622,BEDDINGTON,ME,83,71,-12,0.461038961038961
04622,CHERRYFIELD,ME,284,455,171,0.6156968876860622
04622,DEBLOIS,ME,0,14,14,1
04623,CENTERVILLE,ME,14,14,0,0.5
04623,COLUMBIA,ME,42,28,-14,0.4
04623,COLUMBIA FALLS,ME,43,79,36,0.6475409836065574
04624,COREA,ME,66,63,-3,0.4883720930232558
04625,CRANBERRY ISLES,ME,0,11,11,1
04626,CUTLER,ME,36,74,38,0.6727272727272727
04627,DEER ISLE,ME,1425,1254,-171,0.46808510638297873
04628,DENNYSVILLE,ME,13,0,-13,0
04628,EDMUNDS TWP,ME,12,15,3,0.5555555555555556
04628,MARION TWP,ME,13,0,-13,0
04630,EAST MACHIAS,ME,464,499,35,0.5181723779854621
04631,EASTPORT,ME,1021,982,-39,0.49026460309535697
04634,EASTBROOK,ME,174,155,-19,0.47112462006079026
04634,FRANKLIN,ME,894,914,20,0.5055309734513275
04640,HANCOCK,ME,1210,1469,259,0.5483389324374767
04642,HARBORSIDE,ME,81,106,25,0.5668449197860963
04643,HARRINGTON,ME,169,237,68,0.583743842364532
04644,HULLS COVE,ME,36,70,34,0.660377358490566
04646,ISLESFORD,ME,68,74,6,0.5211267605633803
04648,JONESBORO,ME,11,51,40,0.8225806451612904
04649,JONESPORT,ME,453,510,57,0.5295950155763239
04650,LITTLE DEER ISLE,ME,160,156,-4,0.4936708860759494
04652,LUBEC,ME,1011,1215,204,0.545822102425876
04652,TRESCOTT TWP,ME,50,31,-19,0.38271604938271603
04653,BASS HARBOR,ME,273,260,-13,0.4878048780487805
04654,MACHIAS,ME,1045,1153,108,0.5245677888989991
04654,MARSHFIELD,ME,207,192,-15,0.48120300751879697
04654,NORTHFIELD,ME,46,24,-22,0.34285714285714286
04654,ROQUE BLUFFS,ME,242,205,-37,0.45861297539149887
04654,WHITNEYVILLE,ME,124,87,-37,0.41232227488151657
04655,MACHIASPORT,ME,166,253,87,0.60381861575179
04657,CATHANCE TWP,ME,0,26,26,1
04657,COOPER,ME,43,11,-32,0.2037037037037037
04657,MEDDYBEMPS,ME,0,14,14,1
04658,MILBRIDGE,ME,550,641,91,0.5382031905961377
04660,MOUNT DESERT,ME,1430,1263,-167,0.46899368733754176
04662,NE HARBOR,ME,0,21,21,1
04662,NORTHEAST HARBOR,ME,1190,656,-534,0.3553629469122427
04664,NORTH SULLIVAN,ME,0,20,20,1
04664,SULLIVAN,ME,434,471,37,0.5204419889502763
04666,CHARLOTTE,ME,85,118,33,0.5812807881773399
04666,PEMBROKE,ME,207,299,92,0.5909090909090909
04667,PERRY,ME,365,444,79,0.5488257107540173
04667,PLEASANT POINT,ME,12,38,26,0.76
04668,BIG LAKE TWP,ME,25,11,-14,0.3055555555555556
04668,GRAND LAKE STREAM,ME,61,91,30,0.5986842105263158
04668,GREENLAW CHOPPING TWP,ME,17,0,-17,0
04668,INDIAN TWP,ME,0,35,35,1
04668,PRINCETON,ME,389,330,-59,0.45897079276773295
04669,PROSPECT HARBOR,ME,120,91,-29,0.4312796208530806
04671,ROBBINSTON,ME,35,165,130,0.825
04674,SEAL COVE,ME,37,94,57,0.7175572519083969
04675,SEAL HARBOR,ME,242,151,-91,0.3842239185750636
04675,SOUTH WEST,ME,0,36,36,1
04676,SEDGWICK,ME,340,434,94,0.5607235142118863
04677,SORRENTO,ME,229,294,65,0.5621414913957935
04679,SOUTHWEST HARBOR,ME,1823,1512,-311,0.4533733133433283
04679,SOUTHWEST HBR,ME,371,167,-204,0.3104089219330855
04680,STEUBEN,ME,511,531,20,0.5095969289827256
04681,STONINGTON,ME,1106,767,-339,0.40950347036839296
04683,SUNSET,ME,0,23,23,1
04684,SURRY,ME,1066,1028,-38,0.4909264565425024
04685,SWANS ISLAND,ME,150,114,-36,0.4318181818181818
04691,WHITING,ME,25,12,-13,0.32432432432432434
04693,WINTER HARBOR,ME,415,373,-42,0.4733502538071066
04694,ALEXANDER,ME,258,216,-42,0.45569620253164556
04694,BAILEYVILLE,ME,527,518,-9,0.49569377990430624
04694,BARING PLT,ME,24,30,6,0.5555555555555556
04694,CRAWFORD,ME,0,12,12,1
04694,WOODLAND WASHINGTON COUNTY,ME,48,93,45,0.6595744680851063
04730,HOULTON,ME,4307,3842,-465,0.47146889188857527
04730,LINNEUS,ME,87,80,-7,0.47904191616766467
04730,LITTLETON,ME,192,184,-8,0.48936170212765956
04730,LUDLOW,ME,111,111,0,0.5
04732,ASHLAND,ME,314,329,15,0.5116640746500778
04732,GARFIELD PLT,ME,77,34,-43,0.3063063063063063
04732,MASARDIS,ME,182,187,5,0.5067750677506775
04734,BLAINE,ME,41,169,128,0.8047619047619048
04736,CARIBOU,ME,4116,3729,-387,0.47533460803059274
04736,CONNOR TWP,ME,76,83,7,0.5220125786163522
04736,WOODLAND,ME,132,98,-34,0.4260869565217391
04739,EAGLE LAKE,ME,414,361,-53,0.46580645161290324
04739,WINTERVILLE PLT,ME,72,46,-26,0.3898305084745763
04740,EASTON,ME,194,227,33,0.5391923990498813
04742,FORT FAIRFIELD,ME,1360,1247,-113,0.4783275795934024
04742,FT FAIRFIELD,ME,36,35,-1,0.49295774647887325
04743,FORT KENT,ME,1821,1681,-140,0.480011422044546
04743,NEW CANADA,ME,92,90,-2,0.4945054945054945
04745,FRENCHVILLE,ME,112,77,-35,0.4074074074074074
04746,GRAND ISLE,ME,0,11,11,1
04747,CRYSTAL,ME,40,63,23,0.6116504854368932
04747,DYER BROOK,ME,56,38,-18,0.40425531914893614
04747,ISLAND FALLS,ME,411,374,-37,0.4764331210191083
04750,CASWELL,ME,105,62,-43,0.3712574850299401
04750,LIMESTONE,ME,872,748,-124,0.4617283950617284
04756,MADAWASKA,ME,1703,1606,-97,0.48534300392867935
04757,CASTLE HILL,ME,37,69,32,0.6509433962264151
04757,CHAPMAN,ME,16,43,27,0.7288135593220338
04757,MAPLETON,ME,528,611,83,0.5364354697102721
04758,MARS HILL,ME,639,356,-283,0.3577889447236181
04760,MONTICELLO,ME,46,81,35,0.6377952755905512
04761,NEW LIMERICK,ME,77,40,-37,0.3418803418803419
04762,NEW SWEDEN,ME,29,23,-6,0.4423076923076923
04763,OAKFIELD,ME,108,103,-5,0.4881516587677725
04765,MOUNT CHASE,ME,43,33,-10,0.4342105263157895
04765,PATTEN,ME,518,437,-81,0.45759162303664924
04766,PERHAM,ME,13,0,-13,0
04768,PORTAGE,ME,12,80,68,0.8695652173913043
04769,PRESQUE ISLE,ME,4493,4273,-220,0.48745151722564456
04772,SAINT AGATHA,ME,87,81,-6,0.48214285714285715
04773,SAINT DAVID,ME,119,180,61,0.6020066889632107
04774,ALLAGASH,ME,22,13,-9,0.37142857142857144
04774,SAINT FRANCIS,ME,38,55,17,0.5913978494623656
04776,SHERMAN,ME,134,54,-80,0.2872340425531915
04776,SILVER RIDGE TWP,ME,12,0,-12,0
04777,STACYVILLE,ME,11,0,-11,0
04779,CROSS LAKE TWP,ME,39,55,16,0.5851063829787234
04779,SINCLAIR,ME,146,197,51,0.5743440233236151
04780,MERRILL,ME,24,23,-1,0.48936170212765956
04780,SMYRNA MILLS,ME,33,44,11,0.5714285714285714
04781,WALLAGRASS,ME,25,53,28,0.6794871794871795
04783,STOCKHOLM,ME,130,127,-3,0.49416342412451364
04783,WESTMANLAND,ME,0,19,19,1
04785,CYR PLT,ME,28,27,-1,0.4909090909090909
04785,HAMLIN,ME,32,23,-9,0.41818181818181815
04785,VAN BUREN,ME,1195,948,-247,0.44237050863275784
04786,WADE,ME,22,22,0,0.5
04786,WASHBURN,ME,403,521,118,0.5638528138528138
04787,WESTFIELD,ME,11,0,-11,0
04841,ROCKLAND,ME,4602,4386,-216,0.48798397863818427
04843,CAMDEN,ME,3568,3714,146,0.5100247184839329
04847,HOPE,ME,481,528,47,0.5232903865213082
04848,ISLESBORO,ME,698,684,-14,0.49493487698986977
04849,LINCOLNVILLE,ME,1488,1768,280,0.542997542997543
04849,NORTHPORT,ME,745,818,73,0.5233525271912988
04850,LINCOLNVILLE CENTER,ME,0,33,33,1
04852,MONHEGAN,ME,0,37,37,1
04853,NORTH HAVEN,ME,391,388,-3,0.4980744544287548
04854,OWLS HEAD,ME,562,822,260,0.5939306358381503
04855,PORT CLYDE,ME,194,226,32,0.5380952380952381
04856,ROCKPORT,ME,2330,2301,-29,0.49686892679766786
04858,S THOMASTON,ME,16,34,18,0.68
04858,SOUTH THOMASTON,ME,597,662,65,0.5258141382049245
04859,SPRUCE HEAD,ME,270,314,44,0.5376712328767124
04860,SAINT GEORGE,ME,237,317,80,0.572202166064982
04860,TENANTS HARBOR,ME,686,688,2,0.5007278020378457
04861,THOMASTON,ME,1228,1311,83,0.5163450177235132
04862,APPLETON,ME,629,644,15,0.5058915946582875
04862,UNION,ME,926,968,42,0.5110876451953538
04863,VINALHAVEN,ME,1223,872,-351,0.4162291169451074
04864,WARREN,ME,1438,1563,125,0.5208263912029324
04865,WEST ROCKPORT,ME,11,0,-11,0
04901,BENTON,ME,443,439,-4,0.4977324263038549
04901,WATERVILLE,ME,10426,9296,-1130,0.4713517898793226
04901,WINSLOW,ME,2116,1966,-150,0.4816266536011759
04903,WATERVILLE,ME,957,598,-359,0.38456591639871385
04910,ALBION,ME,711,559,-152,0.4401574803149606
04911,ANSON,ME,717,748,31,0.510580204778157
04911,STARKS,ME,156,145,-11,0.48172757475083056
04912,ATHENS,ME,80,100,20,0.5555555555555556
04915,BELFAST,ME,4404,4668,264,0.5145502645502645
04915,SWANVILLE,ME,826,727,-99,0.46812620734063104
04915,WALDO,ME,66,52,-14,0.4406779661016949
04917,BELGRADE,ME,1454,1558,104,0.5172642762284196
04918,BELGRADE LAKES,ME,374,527,153,0.5849056603773585
04920,BINGHAM,ME,381,402,21,0.5134099616858238
04920,CONCORD TWP,ME,59,34,-25,0.3655913978494624
04920,MOSCOW,ME,38,79,41,0.6752136752136753
04920,PLEASANT RIDGE PLT,ME,14,16,2,0.5333333333333333
04921,BROOKS,ME,487,462,-25,0.4868282402528978
04921,JACKSON,ME,142,107,-35,0.42971887550200805
04922,BURNHAM,ME,414,344,-70,0.45382585751978893
04923,CAMBRIDGE,ME,13,11,-2,0.4583333333333333
04924,CANAAN,ME,896,899,3,0.5008356545961002
04925,CARATUNK,ME,0,36,36,1
04926,CHINA VILLAGE,ME,51,50,-1,0.49504950495049505
04927,CLINTON,ME,1363,1282,-81,0.48468809073724006
04928,CORINNA,ME,889,877,-12,0.49660249150622876
04929,DETROIT,ME,77,155,78,0.6681034482758621
04930,DEXTER,ME,2350,2307,-43,0.49538329396607256
04932,DIXMONT,ME,535,378,-157,0.4140197152245345
04936,EUSTIS,ME,30,23,-7,0.4339622641509434
04937,FAIRFIELD,ME,2869,2552,-317,0.4707618520568161
04938,CHESTERVILLE,ME,828,791,-37,0.48857319332921556
04938,FARMINGTON,ME,3568,3280,-288,0.47897196261682246
04939,GARLAND,ME,70,169,99,0.7071129707112971
04941,FREEDOM,ME,316,370,54,0.5393586005830904
04941,MONTVILLE,ME,163,261,98,0.6155660377358491
04942,HARMONY,ME,122,151,29,0.5531135531135531
04942,MAYFIELD TWP,ME,11,0,-11,0
04942,WELLINGTON,ME,31,35,4,0.5303030303030303
04943,HARTLAND,ME,960,920,-40,0.48936170212765956
04945,JACKMAN,ME,384,342,-42,0.47107438016528924
04945,LONG POND TWP,ME,33,19,-14,0.36538461538461536
04945,MOOSE RIVER,ME,27,41,14,0.6029411764705882
04945,PARLIN PD TWP,ME,21,20,-1,0.4878048780487805
04947,CARRABASSETT VALLEY,ME,302,346,44,0.5339506172839507
04947,KINGFIELD,ME,1117,893,-224,0.44427860696517413
04949,LIBERTY,ME,391,378,-13,0.49154746423927176
04950,MADISON,ME,2217,2167,-50,0.4942974452554745
04951,MONROE,ME,161,109,-52,0.40370370370370373
04952,BELMONT,ME,234,263,29,0.5291750503018109
04952,MORRILL,ME,311,328,17,0.513302034428795
04953,NEWPORT,ME,2050,1961,-89,0.48890550984791825
04955,NEW SHARON,ME,439,462,23,0.5127635960044395
04956,NEW VINEYARD,ME,92,121,29,0.568075117370892
04957,MERCER,ME,209,188,-21,0.473551637279597
04957,NORRIDGEWOCK,ME,1282,1310,28,0.5054012345679012
04958,EMBDEN,ME,223,273,50,0.5504032258064516
04958,NORTH ANSON,ME,506,541,35,0.5167144221585482
04961,DEAD RIVER TWP,ME,15,0,-15,0
04961,LEXINGTON TWP,ME,19,51,32,0.7285714285714285
04961,NEW PORTLAND,ME,175,195,20,0.527027027027027
04962,N VASSALBORO,ME,14,0,-14,0
04963,OAKLAND,ME,3541,3178,-363,0.47298705164459
04963,ROME,ME,290,223,-67,0.4346978557504873
04964,OQUOSSOC,ME,722,495,-227,0.4067378800328677
04965,PALMYRA,ME,706,737,31,0.5107415107415108
04966,AVON,ME,280,187,-93,0.4004282655246253
04966,MADRID TWP,ME,159,128,-31,0.445993031358885
04966,PHILLIPS,ME,774,479,-295,0.3822825219473264
04967,PITTSFIELD,ME,1619,1616,-3,0.49953632148377125
04969,PLYMOUTH,ME,239,193,-46,0.44675925925925924
04970,RANGELEY,ME,1779,1248,-531,0.4122893954410307
04970,SANDY RIVER PLT,ME,21,60,39,0.7407407407407407
04971,SAINT ALBANS,ME,751,879,128,0.5392638036809816
04973,SEARSMONT,ME,486,541,55,0.5267770204479065
04974,SEARSPORT,ME,1599,1505,-94,0.4848582474226804
04976,CORNVILLE,ME,213,164,-49,0.4350132625994695
04976,SKOWHEGAN,ME,4437,4409,-28,0.49841736378023965
04978,SMITHFIELD,ME,280,310,30,0.5254237288135594
04979,SOLON,ME,285,282,-3,0.4973544973544973
04981,PROSPECT,ME,178,149,-29,0.45565749235474007
04981,STOCKTON SPGS,ME,133,122,-11,0.47843137254901963
04981,STOCKTON SPRINGS,ME,969,981,12,0.5030769230769231
04982,STRATTON,ME,415,217,-198,0.34335443037974683
04983,SALEM TWP,ME,126,114,-12,0.475
04983,STRONG,ME,572,612,40,0.5168918918918919
04984,TEMPLE,ME,12,24,12,0.6666666666666666
04986,KNOX,ME,89,111,22,0.555
04986,THORNDIKE,ME,147,228,81,0.608
04987,TROY,ME,148,204,56,0.5795454545454546
04988,UNITY,ME,986,904,-82,0.4783068783068783
04989,VASSALBORO,ME,1492,1500,8,0.5013368983957219
04992,WEST FARMINGTON,ME,25,26,1,0.5098039215686274
05001,WHITE RIV JCT,VT,74,76,2,0.5066666666666667
05001,WHITE RIVER JUNCTION,VT,3634,3603,-31,0.49785822854774076
05030,ASCUTNEY,VT,194,72,-122,0.2706766917293233
05031,BARNARD,VT,37,66,29,0.6407766990291263
05031,BURLINGTON,VT,16,0,-16,0
05032,BETHEL,VT,1104,1104,0,0.5
05033,BRADFORD,VT,1175,1283,108,0.5219690805532954
05034,BRIDGEWATER,VT,13,13,0,0.5
05035,BRDGEWTR CORS,VT,12,0,-12,0
05035,BRIDGEWATER CORNERS,VT,66,60,-6,0.47619047619047616
05036,BROOKFIELD,VT,145,232,87,0.6153846153846154
05037,BROWNSVILLE,VT,120,252,132,0.6774193548387096
05038,CHELSEA,VT,376,348,-28,0.48066298342541436
05039,CORINTH,VT,49,141,92,0.7421052631578947
05040,EAST CORINTH,VT,23,22,-1,0.4888888888888889
05041,EAST RANDOLPH,VT,14,23,9,0.6216216216216216
05042,EAST RYEGATE,VT,15,11,-4,0.4230769230769231
05043,EAST THETFORD,VT,123,150,27,0.5494505494505495
05045,FAIRLEE,VT,823,770,-53,0.48336472065285624
05046,GROTON,VT,303,349,46,0.5352760736196319
05047,HARTFORD,VT,36,77,41,0.6814159292035398
05048,HARTLAND,VT,649,773,124,0.5436005625879043
05051,NEWBURY,VT,171,132,-39,0.43564356435643564
05055,NORWICH,VT,1442,1490,48,0.5081855388813097
05056,PLYMOUTH,VT,0,77,77,1
05058,POST MILLS,VT,34,0,-34,0
05059,QUECHEE,VT,1919,1509,-410,0.4401983663943991
05060,BRAINTREE,VT,139,141,2,0.5035714285714286
05060,RANDOLPH,VT,2120,2058,-62,0.4925801819052178
05061,RANDOLPH CENTER,VT,392,587,195,0.599591419816139
05061,RANDOLPH CTR,VT,0,12,12,1
05062,READING,VT,24,34,10,0.5862068965517241
05065,SHARON,VT,254,270,16,0.5152671755725191
05067,SOUTH POMFRET,VT,26,12,-14,0.3157894736842105
05068,S ROYALTON,VT,285,287,2,0.5017482517482518
05068,SOUTH ROYALTON,VT,1528,1295,-233,0.4587318455543748
05069,SOUTH RYEGATE,VT,0,11,11,1
05071,SOUTH WOODSTOCK,VT,35,36,1,0.5070422535211268
05072,STRAFFORD,VT,51,56,5,0.5233644859813084
05075,THETFORD CENTER,VT,97,185,88,0.6560283687943262
05076,TOPSHAM,VT,0,23,23,1
05077,TUNBRIDGE,VT,177,235,58,0.5703883495145631
05079,VERSHIRE,VT,57,121,64,0.6797752808988764
05081,WELLS RIVER,VT,138,228,90,0.6229508196721312
05083,WEST FAIRLEE,VT,0,23,23,1
05086,WEST TOPSHAM,VT,26,23,-3,0.46938775510204084
05088,WILDER,VT,351,234,-117,0.4
05089,WEST WINDSOR,VT,55,49,-6,0.47115384615384615
05089,WINDSOR,VT,1725,1875,150,0.5208333333333334
05091,WOODSTOCK,VT,1768,1973,205,0.5273990911520984
05101,BELLOWS FALLS,VT,1887,1849,-38,0.49491434689507496
05142,CAVENDISH,VT,67,112,45,0.6256983240223464
05143,ATHENS,VT,78,77,-1,0.4967741935483871
05143,CHESTER,VT,2158,2074,-84,0.4900756143667297
05146,GRAFTON,VT,80,96,16,0.5454545454545454
05148,LANDGROVE,VT,32,31,-1,0.49206349206349204
05148,LONDONDERRY,VT,627,735,108,0.539647577092511
05149,LUDLOW,VT,1741,1797,56,0.5079140757490107
05150,N SPRINGFIELD,VT,16,60,44,0.7894736842105263
05150,NORTH SPRINGFIELD,VT,387,264,-123,0.4055299539170507
05151,PERKINSVILLE,VT,200,308,108,0.6062992125984252
05152,PERU,VT,50,132,82,0.7252747252747253
05153,PROCTORSVILLE,VT,324,114,-210,0.2602739726027397
05153,SOUTH READING,VT,12,0,-12,0
05153,SPRINGFIELD,VT,0,13,13,1
05154,SAXTONS RIVER,VT,52,112,60,0.6829268292682927
05155,S LONDONDERRY,VT,45,24,-21,0.34782608695652173
05155,SOUTH LONDONDERRY,VT,230,289,59,0.5568400770712909
05155,STRATTON MNT,VT,22,13,-9,0.37142857142857144
05156,SPRINGFIELD,VT,3985,3934,-51,0.49677989645157217
05158,WESTMINSTER,VT,87,52,-35,0.37410071942446044
05161,WESTON,VT,38,278,240,0.879746835443038
05201,BENNINGTON,VT,6875,6234,-641,0.47555114806621407
05250,ARLINGTON,VT,1071,1170,99,0.5220883534136547
05250,SANDGATE,VT,17,24,7,0.5853658536585366
05250,SUNDERLAND,VT,101,106,5,0.5120772946859904
05250,WEST ARLINGTON,VT,82,113,31,0.5794871794871795
05251,DORSET,VT,1231,1302,71,0.5140150019739439
05252,EAST ARLINGTON,VT,11,0,-11,0
05253,EAST DORSET,VT,37,11,-26,0.22916666666666666
05254,MANCHESTER,VT,771,620,-151,0.44572250179726813
05255,MANCHESTER CENTER,VT,2230,2249,19,0.502121009153829
05257,N BENNINGTON,VT,62,107,45,0.6331360946745562
05257,NORTH BENNINGTON,VT,968,872,-96,0.47391304347826085
05261,POWNAL,VT,904,805,-99,0.47103569338794615
05262,SHAFTSBURY,VT,767,793,26,0.5083333333333333
05301,BRATTLEBORO,VT,5335,5162,-173,0.4917595503477184
05301,DUMMERSTON,VT,974,988,14,0.5035677879714577
05301,GUILFORD,VT,650,660,10,0.5038167938931297
05302,BRATTLEBORO,VT,375,328,-47,0.4665718349928876
05303,BRATTLEBORO,VT,205,146,-59,0.41595441595441596
05304,BRATTLEBORO,VT,12,0,-12,0
05340,BONDVILLE,VT,732,681,-51,0.4819532908704883
05340,WINHALL,VT,30,75,45,0.7142857142857143
05341,EAST DOVER,VT,22,0,-22,0
05342,JACKSONVILLE,VT,117,42,-75,0.2641509433962264
05343,JAMAICA,VT,102,285,183,0.7364341085271318
05344,MARLBORO,VT,36,80,44,0.6896551724137931
05345,BROOKLINE,VT,211,159,-52,0.4297297297297297
05345,NEWFANE,VT,534,484,-50,0.47544204322200395
05346,EAST DUMMERSTON,VT,129,136,7,0.5132075471698113
05346,PUTNEY,VT,1656,1704,48,0.5071428571428571
05346,WESTMINSTER WEST,VT,27,27,0,0.5
05350,READSBORO,VT,138,72,-66,0.34285714285714286
05351,SOUTH NEWFANE,VT,24,13,-11,0.35135135135135137
05352,STAMFORD,VT,23,11,-12,0.3235294117647059
05353,TOWNSHEND,VT,349,267,-82,0.43344155844155846
05354,VERNON,VT,780,661,-119,0.4587092297015961
05355,WARDSBORO,VT,0,16,16,1
05356,MOUNT SNOW,VT,20,16,-4,0.4444444444444444
05356,WEST DOVER,VT,1086,923,-163,0.4594325535092086
05358,WEST HALIFAX,VT,14,12,-2,0.46153846153846156
05359,WEST TOWNSHEND,VT,25,97,72,0.7950819672131147
05359,WINDHAM,VT,13,11,-2,0.4583333333333333
05360,STRATTON,VT,0,24,24,1
05360,W WARDSBORO,VT,0,13,13,1
05360,WEST WARDSBORO,VT,68,37,-31,0.3523809523809524
05361,WHITINGHAM,VT,83,86,3,0.5088757396449705
05363,SEARSBURG,VT,13,20,7,0.6060606060606061
05363,WEST MARLBORO,VT,131,75,-56,0.3640776699029126
05363,WILMINGTON,VT,1271,1275,4,0.5007855459544384
05401,BURLINGTON,VT,32210,16816,-15394,0.34300167258189534
05402,BURLINGTON,VT,872,995,123,0.5329405463310123
05402,SOUTH BURLINGTON,VT,15,19,4,0.5588235294117647
05403,SOUTH BURLINGTON,VT,11890,10679,-1211,0.4731711639859985
05404,WINOOSKI,VT,6334,4862,-1472,0.43426223651304036
05406,BURLINGTON,VT,235,146,-89,0.38320209973753283
05407,SOUTH BURLINGTON,VT,223,188,-35,0.45742092457420924
05408,BURLINGTON,VT,4662,4163,-499,0.47172804532577906
05440,ALBURG,VT,66,75,9,0.5319148936170213
05440,ALBURGH,VT,1332,1158,-174,0.4650602409638554
05443,BRISTOL,VT,2007,2181,174,0.5207736389684814
05443,LINCOLN,VT,533,497,-36,0.4825242718446602
05444,CAMBRIDGE,VT,518,500,-18,0.4911591355599214
05445,CHARLOTTE,VT,1683,1940,257,0.5354678443279051
05446,COLCHESTER,VT,8510,8188,-322,0.4903581267217631
05448,E FAIRFIELD,VT,0,37,37,1
05448,EAST FAIRFIELD,VT,119,138,19,0.5369649805447471
05448,SWANTON,VT,11,16,5,0.5925925925925926
05450,ENOSBURG FALLS,VT,1789,1906,117,0.5158322056833559
05451,ESSEX,VT,174,26,-148,0.13
05451,ESSEX JUNCTION,VT,16,11,-5,0.4074074074074074
05452,ESSEX JCT,VT,632,703,71,0.5265917602996255
05452,ESSEX JUNCTION,VT,8856,8559,-297,0.49147286821705427
05453,ESSEX JUNCTION,VT,140,100,-40,0.4166666666666667
05454,FAIRFAX,VT,1661,1907,246,0.5344730941704036
05455,FAIRFIELD,VT,136,132,-4,0.4925373134328358
05455,SHELDON,VT,16,0,-16,0
05456,FERRISBURGH,VT,241,255,14,0.5141129032258065
05457,FRANKLIN,VT,487,496,9,0.5045778229908443
05458,GRAND ISLE,VT,1081,1214,133,0.5289760348583878
05459,HIGHGATE CENTER,VT,538,531,-7,0.49672591206735267
05459,HIGHGATE CTR,VT,14,11,-3,0.44
05460,HIGHGATE SPRINGS,VT,34,11,-23,0.24444444444444444
05461,HINESBURG,VT,1708,1857,149,0.5208976157082749
05462,HUNTINGTON,VT,601,459,-142,0.4330188679245283
05463,ISLE LA MOTTE,VT,314,258,-56,0.45104895104895104
05464,JEFFERSONVILLE,VT,1159,1133,-26,0.4943280977312391
05464,JEFFERSONVLLE,VT,25,16,-9,0.3902439024390244
05465,JERICHO,VT,1573,1755,182,0.52734375
05468,MILTON,VT,5352,4964,-388,0.48119426134160526
05470,MONTGOMERY,VT,13,0,-13,0
05471,MONTGOMERY CENTER,VT,238,146,-92,0.3802083333333333
05471,MONTGOMRY CTR,VT,13,15,2,0.5357142857142857
05472,NEW HAVEN,VT,659,518,-141,0.44010195412064573
05473,N FERRISBURGH,VT,11,37,26,0.7708333333333334
05473,NORTH FERRISBURGH,VT,626,598,-28,0.48856209150326796
05474,NORTH HERO,VT,738,849,111,0.5349716446124764
05476,RICHFORD,VT,1603,1346,-257,0.4564259070871482
05477,BOLTON VALLEY,VT,47,43,-4,0.4777777777777778
05477,RICHMOND,VT,1601,1740,139,0.5208021550434002
05478,SAINT ALBANS,VT,8620,7669,-951,0.4708085210878507
05481,SAINT ALBANS BAY,VT,201,164,-37,0.44931506849315067
05481,ST ALBANS BAY,VT,11,37,26,0.7708333333333334
05482,SHELBURNE,VT,3456,3979,523,0.5351714862138534
05483,SHELDON,VT,338,271,-67,0.44499178981937604
05486,SOUTH HERO,VT,1373,1407,34,0.5061151079136691
05487,STARKSBORO,VT,315,241,-74,0.43345323741007197
05488,SWANTON,VT,3440,3329,-111,0.4918008568473925
05489,UNDERHILL,VT,764,906,142,0.5425149700598803
05491,VERGENNES,VT,2572,2697,125,0.5118618333649649
05492,BELVIDERE CENTER,VT,15,0,-15,0
05492,WATERVILLE,VT,50,11,-39,0.18032786885245902
05494,WESTFORD,VT,510,457,-53,0.4725956566701138
05495,SAINT GEORGE,VT,56,103,47,0.6477987421383647
05495,ST GEORGE,VT,294,316,22,0.5180327868852459
05495,WILLISTON,VT,4941,5208,267,0.5131540053207213
05601,MONTPELIER,VT,776,415,-361,0.34844668345927793
05602,BERLIN,VT,76,64,-12,0.45714285714285713
05602,MIDDLESEX,VT,86,82,-4,0.4880952380952381
05602,MONTPELIER,VT,5475,5474,-1,0.4999543337291077
05640,ADAMANT,VT,13,0,-13,0
05641,BARRE,VT,7401,7150,-251,0.49137516321902275
05641,ORANGE,VT,107,146,39,0.5770750988142292
05647,CABOT,VT,448,345,-103,0.43505674653215637
05648,CALAIS,VT,48,11,-37,0.1864406779661017
05649,EAST BARRE,VT,264,128,-136,0.32653061224489793
05650,EAST CALAIS,VT,239,269,30,0.5295275590551181
05651,E MONTPELIER,VT,15,28,13,0.6511627906976745
05651,EAST MONTPELIER,VT,473,442,-31,0.4830601092896175
05652,EDEN,VT,144,188,44,0.5662650602409639
05653,EDEN MILLS,VT,13,0,-13,0
05654,GRANITEVILLE,VT,332,301,-31,0.4755134281200632
05655,HYDE PARK,VT,916,1012,96,0.524896265560166
05656,JOHNSON,VT,1557,1433,-124,0.47926421404682273
05657,LAKE ELMORE,VT,15,0,-15,0
05658,MARSHFIELD,VT,211,418,207,0.6645468998410174
05660,MORETOWN,VT,355,496,141,0.5828437132784959
05660,SOUTH DUXBURY,VT,143,157,14,0.5233333333333333
05661,ELMORE,VT,161,188,27,0.5386819484240688
05661,MORRISTOWN,VT,211,232,21,0.5237020316027088
05661,MORRISVILLE,VT,2632,2563,-69,0.4933589990375361
05663,NORTHFIELD,VT,2133,2147,14,0.5016355140186916
05667,PLAINFIELD,VT,936,957,21,0.5055467511885895
05669,ROXBURY,VT,22,30,8,0.5769230769230769
05670,SOUTH BARRE,VT,24,14,-10,0.3684210526315789
05672,STOWE,VT,3639,3815,176,0.5118057418835524
05673,WAITSFIELD,VT,1642,1648,6,0.5009118541033435
05674,WARREN,VT,1100,1137,37,0.5082700044702727
05675,WASHINGTON,VT,73,102,29,0.5828571428571429
05676,WATERBURY,VT,2650,2499,-151,0.48533695863274423
05677,WATERBURY CENTER,VT,816,911,95,0.527504342790967
05677,WATERBURY CTR,VT,13,19,6,0.59375
05679,WILLIAMSTOWN,VT,1192,1291,99,0.5199355618203786
05680,WOLCOTT,VT,570,576,6,0.5026178010471204
05681,WOODBURY,VT,24,0,-24,0
05682,N MIDDLESEX,VT,0,44,44,1
05682,NORTH MIDDLESEX,VT,0,13,13,1
05682,WORCESTER,VT,143,124,-19,0.46441947565543074
05701,RUTLAND,VT,9092,8975,-117,0.49676205236065757
05702,RUTLAND,VT,1441,532,-909,0.26964014191586416
05730,BELMONT,VT,23,92,69,0.8
05731,BENSON,VT,16,0,-16,0
05732,BOMOSEEN,VT,487,401,-86,0.45157657657657657
05733,BRANDON,VT,1875,1848,-27,0.49637389202256244
05733,GOSHEN,VT,232,256,24,0.5245901639344263
05733,LEICESTER,VT,196,243,47,0.5535307517084282
05733,SUDBURY,VT,91,40,-51,0.3053435114503817
05734,BRIDPORT,VT,370,371,1,0.5006747638326585
05735,CASTLETON,VT,969,1041,72,0.517910447761194
05736,CENTER RUTLAND,VT,23,0,-23,0
05737,CHITTENDEN,VT,57,66,9,0.5365853658536586
05738,CUTTINGSVILLE,VT,150,120,-30,0.4444444444444444
05738,SHREWSBURY,VT,59,56,-3,0.48695652173913045
05739,DANBY,VT,266,234,-32,0.468
05740,E MIDDLEBURY,VT,0,12,12,1
05740,EAST MIDDLEBURY,VT,114,0,-114,0
05742,EAST WALLINGFORD,VT,50,90,40,0.6428571428571429
05743,BENSON,VT,42,33,-9,0.44
05743,FAIR HAVEN,VT,1603,1500,-103,0.4834031582339671
05743,WEST HAVEN,VT,73,66,-7,0.4748201438848921
05747,GRANVILLE,VT,0,14,14,1
05748,HANCOCK,VT,11,12,1,0.5217391304347826
05751,KILLINGTON,VT,1517,1503,-14,0.49768211920529803
05753,CORNWALL,VT,246,257,11,0.510934393638171
05753,MIDDLEBURY,VT,3785,3659,-126,0.4915368081676518
05753,WEYBRIDGE,VT,280,254,-26,0.4756554307116105
05757,MIDDLETOWN SPRINGS,VT,143,188,45,0.56797583081571
05758,MOUNT HOLLY,VT,101,144,43,0.5877551020408164
05759,N CLARENDON,VT,12,0,-12,0
05759,NORTH CLARENDON,VT,660,575,-85,0.46558704453441296
05760,ORWELL,VT,226,295,69,0.5662188099808061
05761,PAWLET,VT,148,179,31,0.5474006116207951
05762,PITTSFIELD,VT,24,36,12,0.6
05763,NORTH CHITTENDEN,VT,12,20,8,0.625
05763,PITTSFORD,VT,890,793,-97,0.471182412358883
05764,POULTNEY,VT,1411,1372,-39,0.49299317283507005
05765,PROCTOR,VT,465,461,-4,0.4978401727861771
05766,RIPTON,VT,11,48,37,0.8135593220338984
05767,ROCHESTER,VT,351,474,123,0.5745454545454546
05769,SALISBURY,VT,404,418,14,0.5085158150851582
05770,SHOREHAM,VT,277,179,-98,0.3925438596491228
05772,STOCKBRIDGE,VT,22,62,40,0.7380952380952381
05773,TINMOUTH,VT,57,64,7,0.5289256198347108
05773,WALLINGFORD,VT,654,648,-6,0.4976958525345622
05774,WELLS,VT,487,467,-20,0.48951781970649894
05775,WEST PAWLET,VT,0,13,13,1
05777,WEST RUTLAND,VT,1470,1196,-274,0.4486121530382596
05778,WHITING,VT,11,25,14,0.6944444444444444
05819,SAINT JOHNSBURY,VT,3210,3174,-36,0.49718045112781956
05819,ST JOHNSBURY,VT,696,637,-59,0.4778694673668417
05819,WATERFORD,VT,150,149,-1,0.4983277591973244
05821,BARNET,VT,200,305,105,0.6039603960396039
05822,BARTON,VT,1089,1066,-23,0.49466357308584685
05824,CONCORD,VT,221,248,27,0.5287846481876333
05825,COVENTRY,VT,12,0,-12,0
05826,CRAFTSBURY,VT,218,226,8,0.509009009009009
05827,CRAFTSBRY CMN,VT,13,0,-13,0
05827,CRAFTSBURY COMMON,VT,63,49,-14,0.4375
05828,DANVILLE,VT,528,622,94,0.5408695652173913
05829,DERBY,VT,1317,1280,-37,0.4928763958413554
05830,DERBY LINE,VT,797,562,-235,0.41353936718175127
05832,EAST BURKE,VT,496,371,-125,0.4279123414071511
05836,EAST HARDWICK,VT,128,241,113,0.6531165311653117
05839,GLOVER,VT,167,203,36,0.5486486486486486
05841,GREENSBORO,VT,256,359,103,0.583739837398374
05842,GREENSBORO BEND,VT,23,52,29,0.6933333333333334
05843,HARDWICK,VT,1149,917,-232,0.44385285575992256
05845,IRASBURG,VT,363,284,-79,0.43894899536321486
05846,BRIGHTON,VT,14,28,14,0.6666666666666666
05846,ISLAND POND,VT,543,500,-43,0.4793863854266539
05847,LOWELL,VT,84,154,70,0.6470588235294118
05850,LYNDON CENTER,VT,30,30,0,0.5
05851,LYNDONVILLE,VT,2422,2112,-310,0.4658138509042788
05853,MORGAN,VT,195,220,25,0.5301204819277109
05855,NEWPORT,VT,4194,3764,-430,0.47298316159839154
05857,NEWPORT CENTER,VT,535,553,18,0.5082720588235294
05857,NEWPORT CTR,VT,50,31,-19,0.38271604938271603
05859,JAY,VT,108,104,-4,0.49056603773584906
05859,NORTH TROY,VT,636,608,-28,0.4887459807073955
05860,BROWNINGTON,VT,111,115,4,0.5088495575221239
05860,ORLEANS,VT,1160,1067,-93,0.4791198922317018
05862,PEACHAM,VT,11,28,17,0.717948717948718
05866,SHEFFIELD,VT,39,11,-28,0.22
05867,SUTTON,VT,23,14,-9,0.3783783783783784
05868,TROY,VT,12,13,1,0.52
05871,WEST BURKE,VT,422,456,34,0.5193621867881549
05872,WEST CHARLESTON,VT,203,228,25,0.5290023201856149
05873,WEST DANVILLE,VT,181,255,74,0.5848623853211009
05874,WESTFIELD,VT,91,55,-36,0.3767123287671233
05875,WEST GLOVER,VT,13,36,23,0.7346938775510204
05903,CANAAN,VT,151,165,14,0.5221518987341772
05903,LEMINGTON,VT,19,0,-19,0
05904,GILMAN,VT,0,27,27,1
05905,BLOOMFIELD,VT,0,18,18,1
05905,BRUNSWICK,VT,15,12,-3,0.4444444444444444
05905,GUILDHALL,VT,62,90,28,0.5921052631578947
05905,MAIDSTONE,VT,0,29,29,1
05906,LUNENBURG,VT,309,343,34,0.5260736196319018
06001,AVON,CT,6839,7505,666,0.5232152816508645
06002,BLOOMFIELD,CT,9098,8966,-132,0.49634632418069086
06010,BRISTOL,CT,24283,23231,-1052,0.488929578650503
06011,BRISTOL,CT,1086,958,-128,0.46868884540117417
06013,BURLINGTON,CT,2430,2831,401,0.5381106253563961
06016,BROAD BROOK,CT,2674,2610,-64,0.4939439818319455
06018,CANAAN,CT,1211,1092,-119,0.47416413373860183
06019,CANTON,CT,2111,2261,150,0.5171546203110704
06019,COLLINSVILLE,CT,1076,1060,-16,0.49625468164794007
06021,COLCHESTER,CT,20,0,-20,0
06021,COLEBROOK,CT,204,317,113,0.6084452975047985
06023,EAST BERLIN,CT,283,541,258,0.6565533980582524
06024,EAST CANAAN,CT,22,18,-4,0.45
06026,EAST GRANBY,CT,1771,1699,-72,0.48962536023054753
06027,EAST HARTLAND,CT,199,180,-19,0.47493403693931396
06029,ELLINGTON,CT,5593,5844,251,0.5109731572964938
06031,FALLS VILLAGE,CT,283,600,317,0.6795016987542469
06032,FARMINGTON,CT,7886,8006,120,0.5037754845205135
06033,GLASTONBURY,CT,10769,11140,371,0.5084668401113698
06034,FARMINGTON,CT,136,130,-6,0.48872180451127817
06035,GRANBY,CT,2405,2793,388,0.5373220469411312
06037,BERLIN,CT,3955,4450,495,0.529446757882213
06037,KENSINGTON,CT,899,973,74,0.5197649572649573
06039,LAKEVILLE,CT,1308,1489,181,0.5323560958169468
06040,MANCHESTER,CT,16218,14836,-1382,0.4777484382044181
06042,MANCHESTER,CT,12676,11403,-1273,0.4735661779974251
06043,BOLTON,CT,1311,1437,126,0.5229257641921398
06045,MANCHESTER,CT,694,544,-150,0.4394184168012924
06050,NEW BRITAIN,CT,892,1441,549,0.6176596656665237
06051,NEW BRITAIN,CT,18085,15614,-2471,0.46333719101457016
06052,NEW BRITAIN,CT,3601,3182,-419,0.4691139613740233
06053,NEW BRITAIN,CT,14454,13394,-1060,0.4809681126113186
06057,NEW HARTFORD,CT,1974,2110,136,0.5166503428011753
06058,NORFOLK,CT,770,769,-1,0.4996751137102014
06060,NORTH GRANBY,CT,418,628,210,0.6003824091778203
06061,PINE MEADOW,CT,21,0,-21,0
06062,PLAINVILLE,CT,6444,6322,-122,0.49522168259439137
06063,BARKHAMSTED,CT,700,831,131,0.542782495101241
06063,PLEASANT VALLEY,CT,44,62,18,0.5849056603773585
06063,PLEASANT VLY,CT,42,41,-1,0.4939759036144578
06063,WINSTED,CT,25,11,-14,0.3055555555555556
06065,RIVERTON,CT,38,46,8,0.5476190476190477
06066,VERNON,CT,2966,2738,-228,0.4800140252454418
06066,VERNON ROCKVILLE,CT,12676,11817,-859,0.48246437757726696
06067,ROCKY HILL,CT,9357,9053,-304,0.49174361759913093
06068,SALISBURY,CT,867,1080,213,0.5546995377503852
06069,SHARON,CT,1193,1570,377,0.568222946073109
06070,SIMSBURY,CT,4893,5478,585,0.5282036447787098
06071,SOMERS,CT,2466,2788,322,0.5306433193757137
06073,S GLASTONBURY,CT,186,211,25,0.5314861460957179
06073,SOUTH GLASTONBURY,CT,1325,1647,322,0.5541722745625841
06074,SOUTH WINDSOR,CT,8855,9213,358,0.5099070179322559
06076,STAFFORD SPGS,CT,383,376,-7,0.49538866930171277
06076,STAFFORD SPRINGS,CT,4001,4135,134,0.5082350049164208
06076,UNION,CT,187,167,-20,0.4717514124293785
06078,SUFFIELD,CT,3229,3717,488,0.5351281312985892
06079,TACONIC,CT,0,16,16,1
06081,TARIFFVILLE,CT,367,423,56,0.5354430379746835
06082,ENFIELD,CT,14556,13762,-794,0.48598064835087224
06083,ENFIELD,CT,660,598,-62,0.4753577106518283
06084,TOLLAND,CT,3742,3991,249,0.5160998318893055
06085,UNIONVILLE,CT,2247,2268,21,0.5023255813953489
06088,EAST WINDSOR,CT,2233,2220,-13,0.4985403099034359
06089,WEATOGUE,CT,2139,2538,399,0.5426555484284797
06090,WEST GRANBY,CT,69,90,21,0.5660377358490566
06092,WEST SIMSBURY,CT,1018,1086,68,0.5161596958174905
06092,WINSTED,CT,40,52,12,0.5652173913043478
06093,WEST SUFFIELD,CT,879,957,78,0.5212418300653595
06095,WINDSOR,CT,10294,10633,339,0.508099584269126
06096,WINDSOR LOCKS,CT,4609,4663,54,0.5029119930974978
06098,WINSTED,CT,5098,4677,-421,0.47846547314578003
06103,HARTFORD,CT,3873,3331,-542,0.4623820099944475
06104,HARTFORD,CT,17,0,-17,0
06105,HARTFORD,CT,14816,10512,-4304,0.4150347441566646
06106,HARTFORD,CT,20018,16026,-3992,0.4446232382643436
06107,HARTFORD,CT,403,374,-29,0.48133848133848134
06107,WEST HARTFORD,CT,6068,6151,83,0.5033963499468042
06108,EAST HARTFORD,CT,11351,10225,-1126,0.4739061920652577
06109,WETHERSFIELD,CT,8073,8674,601,0.5179435122708544
06110,WEST HARTFORD,CT,5042,4498,-544,0.4714884696016772
06110,WEST HARTFRD,CT,104,100,-4,0.49019607843137253
06111,NEWINGTON,CT,9212,9113,-99,0.4972987721691678
06112,HARTFORD,CT,8909,7785,-1124,0.4663352102551815
06114,HARTFORD,CT,13857,11632,-2225,0.4563537212130723
06117,WEST HARTFORD,CT,4399,5391,992,0.5506639427987743
06117,WEST HARTFRD,CT,105,93,-12,0.4696969696969697
06118,EAST HARTFORD,CT,9833,9364,-469,0.48778454966921914
06118,HARTFORD,CT,209,212,3,0.503562945368171
06119,HARTFORD,CT,117,109,-8,0.4823008849557522
06119,WEST HARTFORD,CT,7289,6393,-896,0.46725624908639085
06120,HARTFORD,CT,5893,5011,-882,0.459556126192223
06123,HARTFORD,CT,38,58,20,0.6041666666666666
06126,HARTFORD,CT,240,716,476,0.7489539748953975
06127,WEST HARTFORD,CT,35,124,89,0.779874213836478
06128,EAST HARTFORD,CT,56,95,39,0.6291390728476821
06129,WETHERSFIELD,CT,21,36,15,0.631578947368421
06131,NEWINGTON,CT,85,77,-8,0.47530864197530864
06132,HARTFORD,CT,24,120,96,0.8333333333333334
06133,WEST HARTFORD,CT,23,270,247,0.9215017064846417
06134,HARTFORD,CT,52,72,20,0.5806451612903226
06137,WEST HARTFORD,CT,13,0,-13,0
06138,EAST HARTFORD,CT,48,193,145,0.8008298755186722
06141,HARTFORD,CT,24,118,94,0.8309859154929577
06143,HARTFORD,CT,29,48,19,0.6233766233766234
06144,HARTFORD,CT,11,0,-11,0
06226,WILLIMANTIC,CT,9502,7809,-1693,0.4511004563572295
06231,AMSTON,CT,943,1121,178,0.5431201550387597
06232,ANDOVER,CT,910,1000,90,0.5235602094240838
06234,BROOKLYN,CT,2887,2900,13,0.501123207188526
06235,CHAPLIN,CT,799,847,48,0.5145808019441069
06237,COLUMBIA,CT,1564,1733,169,0.5256293600242645
06237,WAUREGAN,CT,33,36,3,0.5217391304347826
06238,COVENTRY,CT,3585,3827,242,0.5163248785752833
06239,DANIELSON,CT,5445,4680,-765,0.4622222222222222
06241,DAYVILLE,CT,2609,2694,85,0.5080143315104658
06241,KILLINGLY,CT,38,68,30,0.6415094339622641
06242,EASTFORD,CT,314,495,181,0.6118665018541409
06243,EAST KILLINGLY,CT,25,0,-25,0
06246,GROSVENOR DALE,CT,12,0,-12,0
06247,HAMPTON,CT,568,617,49,0.5206751054852321
06248,HEBRON,CT,1495,1696,201,0.5314948292071451
06249,LEBANON,CT,1907,2213,306,0.5371359223300971
06250,MANSFIELD CENTER,CT,1643,1635,-8,0.4987797437461867
06250,MANSFIELD CTR,CT,108,107,-1,0.49767441860465117
06254,N FRANKLIN,CT,24,55,31,0.6962025316455697
06254,NORTH FRANKLIN,CT,298,412,114,0.5802816901408451
06254,NORTH WINDHAM,CT,13,14,1,0.5185185185185185
06255,N GROSVENORDL,CT,29,39,10,0.5735294117647058
06255,NORTH GROSVENORDALE,CT,1455,1502,47,0.5079472438282042
06256,NORTH WINDHAM,CT,801,805,4,0.5012453300124533
06259,POMFRET CENTER,CT,1087,1152,65,0.5145154086645825
06259,POMFRET CTR,CT,68,58,-10,0.4603174603174603
06260,PUTNAM,CT,4538,4315,-223,0.4874053992996724
06262,QUINEBAUG,CT,70,11,-59,0.13580246913580246
06263,ROGERS,CT,16,0,-16,0
06266,SOUTH WINDHAM,CT,0,47,47,1
06268,STORRS,CT,240,204,-36,0.4594594594594595
06268,STORRS MANFLD,CT,279,174,-105,0.3841059602649007
06268,STORRS MANSFIELD,CT,2703,2218,-485,0.45072139808981915
06277,THOMPSON,CT,1226,1409,183,0.5347248576850094
06278,ASHFORD,CT,1566,1591,25,0.5039594551789673
06279,WILLINGTON,CT,2416,2055,-361,0.4596287184075151
06280,WINDHAM,CT,999,1125,126,0.5296610169491526
06281,WOODSTOCK,CT,2174,2553,379,0.5400888512798815
06281,WOODSTOCK VALLEY,CT,37,56,19,0.6021505376344086
06282,WOODSTOCK VALLEY,CT,121,223,102,0.6482558139534884
06282,WOODSTOCK VLY,CT,0,11,11,1
06320,NEW LONDON,CT,17689,14282,-3407,0.4467173375871884
06330,BALTIC,CT,1142,1046,-96,0.4780621572212066
06331,CANTERBURY,CT,1442,1493,51,0.5086882453151619
06332,CENTRAL VILLAGE,CT,81,58,-23,0.4172661870503597
06333,EAST LYME,CT,2707,3145,438,0.5374231032125769
06334,BOZRAH,CT,663,918,255,0.5806451612903226
06335,GALES FERRY,CT,2341,2328,-13,0.498607838937674
06339,LEDYARD,CT,2767,2838,71,0.5063336306868867
06340,GROTON,CT,18703,16156,-2547,0.46346711035887433
06351,GRISWOLD,CT,815,884,69,0.5203060623896409
06351,JEWETT CITY,CT,3868,4188,320,0.5198609731876862
06351,LISBON,CT,652,712,60,0.5219941348973607
06353,MONTVILLE,CT,11,13,2,0.5416666666666666
06354,MOOSUP,CT,2440,2457,17,0.5017357565856647
06355,MYSTIC,CT,5456,5996,540,0.5235766678309466
06357,NIANTIC,CT,5477,5868,391,0.517232260907889
06359,N STONINGTON,CT,143,145,2,0.5034722222222222
06359,NORTH STONINGTON,CT,1224,1394,170,0.5324675324675324
06360,NORWICH,CT,22170,18881,-3289,0.4599400745414241
06365,PRESTON,CT,1212,1359,147,0.5285880980163361
06365,WATERFORD,CT,25,38,13,0.6031746031746031
06370,OAKDALE,CT,2164,2390,226,0.5248133509003075
06371,LYME,CT,186,284,98,0.6042553191489362
06371,OLD LYME,CT,4205,4618,413,0.5234047376175904
06372,OLD MYSTIC,CT,0,46,46,1
06373,ONECO,CT,12,12,0,0.5
06374,PLAINFIELD,CT,3168,2749,-419,0.4645935440256887
06375,QUAKER HILL,CT,1386,1350,-36,0.4934210526315789
06376,SOUTH LYME,CT,172,230,58,0.572139303482587
06377,STERLING,CT,911,814,-97,0.4718840579710145
06378,STONINGTON,CT,2699,2908,209,0.518637417513822
06379,PAWCATUCK,CT,3039,3268,229,0.5181544315839544
06380,TAFTVILLE,CT,2412,2272,-140,0.4850555081127242
06382,UNCASVILLE,CT,3616,3523,-93,0.49348648270065837
06384,VOLUNTOWN,CT,800,906,106,0.5310668229777257
06385,WATERFORD,CT,5862,6335,473,0.5193900139378536
06387,WAUREGAN,CT,211,77,-134,0.2673611111111111
06390,FISHERS ISLAND,NY,423,388,-35,0.4784217016029593
06390,FISHERS ISLE,NY,51,0,-51,0
06401,ANSONIA,CT,7053,6641,-412,0.48495691543741787
06403,BEACON FALLS,CT,1883,2127,244,0.5304239401496259
06405,BRANFORD,CT,11521,12106,585,0.512379904346722
06409,CENTERBROOK,CT,76,91,15,0.5449101796407185
06410,CHESHIRE,CT,6652,7595,943,0.5330946866006878
06412,CHESTER,CT,1268,1416,148,0.5275707898658718
06413,CLINTON,CT,4566,4914,348,0.5183544303797468
06415,COLCHESTER,CT,5549,5719,170,0.5075434859779908
06416,CROMWELL,CT,4626,4958,332,0.5173205342237062
06417,DEEP RIVER,CT,1601,1601,0,0.5
06418,DERBY,CT,4617,4446,-171,0.49056603773584906
06418,HADDAM,CT,122,108,-14,0.46956521739130436
06419,KILLINGWORTH,CT,1647,1894,247,0.5348771533465123
06420,COLCHESTER,CT,27,17,-10,0.38636363636363635
06420,SALEM,CT,1200,1501,301,0.5557201036653091
06422,DURHAM,CT,1761,1909,148,0.5201634877384196
06423,EAST HADDAM,CT,1401,1633,232,0.538233355306526
06424,EAST HAMPTON,CT,4165,4517,352,0.5202718267680257
06426,ESSEX,CT,1912,2243,331,0.5398315282791817
06437,GUILFORD,CT,7190,8001,811,0.5266934369034296
06438,HADDAM,CT,751,807,56,0.517971758664955
06440,HAWLEYVILLE,CT,0,15,15,1
06441,HIGGANUM,CT,1367,1544,177,0.5304019237375472
06442,IVORYTON,CT,770,813,43,0.5135818066961465
06443,MADISON,CT,6451,7316,865,0.5314157042202368
06444,MARION,CT,38,64,26,0.6274509803921569
06447,MARLBOROUGH,CT,1619,1825,206,0.5299070847851336
06450,MERIDEN,CT,17083,15545,-1538,0.47643128601201423
06451,MERIDEN,CT,10577,9734,-843,0.47924769829156616
06455,MIDDLEFIELD,CT,879,828,-51,0.4850615114235501
06456,MIDDLE HADDAM,CT,0,37,37,1
06457,MIDDLETOWN,CT,22679,19927,-2752,0.46770407923766605
06460,MILFORD,CT,15081,15261,180,0.5029661854854657
06461,MILFORD,CT,3953,4561,608,0.5357058961710125
06467,MILLDALE,CT,60,52,-8,0.4642857142857143
06468,MONROE,CT,4354,4760,406,0.522273425499232
06469,MOODUS,CT,1242,1193,-49,0.48993839835728953
06470,NEWTOWN,CT,4453,5235,782,0.5403592072667217
06471,N BRANFORD,CT,79,91,12,0.5352941176470588
06471,NORTH BRANFORD,CT,2129,2270,141,0.5160263696294612
06472,NORTHFORD,CT,1941,1725,-216,0.4705400981996727
06473,NORTH HAVEN,CT,7208,7720,512,0.5171489817792069
06475,OLD SAYBROOK,CT,5575,5975,400,0.5173160173160173
06477,ORANGE,CT,3521,4173,652,0.5423706784507408
06478,OXFORD,CT,3016,4037,1021,0.5723805472848433
06479,PLANTSVILLE,CT,2793,3172,379,0.5317686504610226
06480,PORTLAND,CT,3243,3142,-101,0.49209083790133124
06481,ROCKFALL,CT,178,185,7,0.509641873278237
06482,SANDY HOOK,CT,2706,3024,318,0.5277486910994764
06483,SEYMOUR,CT,5034,4894,-140,0.4929492344883159
06484,SHELTON,CT,13447,14908,1461,0.5257626520895785
06488,SOUTHBURY,CT,7016,7698,682,0.5231752072855783
06489,SOUTHINGTON,CT,9540,10334,794,0.5199758478414008
06492,WALLINGFORD,CT,14013,13514,-499,0.49093617175863696
06492,YALESVILLE,CT,902,916,14,0.5038503850385039
06498,WESTBROOK,CT,3347,3428,81,0.5059778597785978
06510,NEW HAVEN,CT,4329,3058,-1271,0.41397048869635844
06511,NEW HAVEN,CT,31019,24834,-6185,0.4446314432528244
06512,EAST HAVEN,CT,6906,6861,-45,0.49836565700588364
06512,NEW HAVEN,CT,3923,3999,76,0.5047967684928049
06513,EAST HAVEN,CT,304,244,-60,0.44525547445255476
06513,NEW HAVEN,CT,15227,13124,-2103,0.4629113611512821
06514,HAMDEN,CT,10711,10437,-274,0.49352184603745036
06515,NEW HAVEN,CT,7281,6637,-644,0.4768644920247162
06516,WEST HAVEN,CT,20653,18568,-2085,0.47341985161010686
06517,HAMDEN,CT,5509,5779,270,0.5119596031183558
06518,HAMDEN,CT,6748,6571,-177,0.49335535700878447
06519,NEW HAVEN,CT,7094,6301,-793,0.4703994027622247
06520,NEW HAVEN,CT,1511,196,-1315,0.11482132396016403
06520,NL,CT,12,0,-12,0
06524,BETHANY,CT,1201,1441,240,0.54542013626040875
06525,NEW HAVEN,CT,111,133,22,0.5450819672131147
06525,WOODBRIDGE,CT,2390,3109,719,0.5653755228223313
06530,NEW HAVEN,CT,23,65,42,0.7386363636363636
06531,NEW HAVEN,CT,12,15,3,0.5555555555555556
06532,NEW HAVEN,CT,64,102,38,0.6144578313253012
06533,NEW HAVEN,CT,11,11,0,0.5
06601,BRIDGEPORT,CT,293,970,677,0.768012668250198
06604,BRIDGEPORT,CT,11416,8992,-2424,0.4406115248921991
06605,BRIDGEPORT,CT,9459,7883,-1576,0.45456118094798753
06606,BRIDGEPORT,CT,14195,11718,-2477,0.45220545672056495
06607,BRIDGEPORT,CT,3461,2921,-540,0.45769351300532746
06608,BRIDGEPORT,CT,5407,4576,-831,0.4583792447160172
06610,BPT,CT,172,146,-26,0.4591194968553459
06610,BRIDGEPORT,CT,8182,7182,-1000,0.4674563915646967
06611,TRUMBULL,CT,8663,10109,1446,0.5385148092904326
06612,EASTON,CT,1789,2348,559,0.5675610345661107
06614,STRATFORD,CT,8943,9375,432,0.5117916803144448
06615,STRATFORD,CT,6886,6815,-71,0.4974089482519524
06702,WATERBURY,CT,2036,1904,-132,0.483248730964467
06703,WATERBURY,CT,0,38,38,1
06704,WATERBURY,CT,11597,10298,-1299,0.470335693080612
06705,WATERBURY,CT,11553,10573,-980,0.4778541082888909
06706,WATERBURY,CT,5563,5016,-547,0.4741468947915682
06708,WATERBURY,CT,11744,10905,-839,0.4814782109585412
06710,WATERBURY,CT,5609,4804,-805,0.46134639393066357
06712,PROSPECT,CT,2312,2680,368,0.5368589743589743
06716,WOLCOTT,CT,3995,4487,492,0.5290025937278944
06720,WATERBURY,CT,0,26,26,1
06721,WATERBURY,CT,11,87,76,0.8877551020408163
06722,WATERBURY,CT,0,12,12,1
06750,BANTAM,CT,512,473,-39,0.48020304568527916
06751,BETHLEHEM,CT,1285,1205,-80,0.4839357429718876
06752,BRIDGEWATER,CT,455,577,122,0.5591085271317829
06753,CORNWALL,CT,0,11,11,1
06754,CORNWALL BRIDGE,CT,172,356,184,0.6742424242424242
06754,WARREN,CT,118,186,68,0.6118421052631579
06755,GAYLORDSVILLE,CT,116,148,32,0.5606060606060606
06756,GOSHEN,CT,1091,1345,254,0.5521346469622331
06757,KENT,CT,946,1028,82,0.5207700101317123
06759,LITCHFIELD,CT,2288,2589,301,0.5308591347139635
06762,MIDDLEBURY,CT,2339,2783,444,0.5433424443576728
06763,MORRIS,CT,749,761,12,0.5039735099337749
06770,NAUGATUCK,CT,11195,10881,-314,0.4928882043848523
06776,NEW MILFORD,CT,9261,9193,-68,0.49815758101224666
06777,NEW PRESTON,CT,139,161,22,0.5366666666666666
06777,NEW PRESTON MARBLE DALE,CT,403,337,-66,0.4554054054054054
06777,WARREN,CT,89,174,85,0.6615969581749049
06778,NORTHFIELD,CT,100,42,-58,0.29577464788732394
06779,OAKVILLE,CT,2818,2538,-280,0.47386109036594476
06782,PLYMOUTH,CT,690,706,16,0.505730659025788
06783,NEW MILFORD,CT,25,69,44,0.7340425531914894
06783,ROXBURY,CT,918,1057,139,0.5351898734177215
06784,SHERMAN,CT,1689,1784,95,0.513676936366254
06785,KENT,CT,0,34,34,1
06785,SOUTH KENT,CT,73,195,122,0.7276119402985075
06786,TERRYVILLE,CT,3025,2977,-48,0.49600133288903697
06787,THOMASTON,CT,2517,2552,35,0.503452357466956
06790,TORRINGTON,CT,14705,14370,-335,0.4942390369733448
06791,HARWINTON,CT,1490,1662,172,0.5272842639593909
06793,WASHINGTON,CT,311,605,294,0.6604803493449781
06793,WASHINGTON DEPOT,CT,0,11,11,1
06794,WASHINGTON DEPOT,CT,335,478,143,0.5879458794587946
06794,WASHINGTON DT,CT,28,35,7,0.5555555555555556
06795,WATERTOWN,CT,4145,4162,17,0.5010232334175996
06796,WEST CORNWALL,CT,123,353,230,0.7415966386554622
06798,WOODBURY,CT,3655,3870,215,0.5142857142857142
06801,BETHEL,CT,6158,6678,520,0.5202555313181677
06804,BROOKFIELD,CT,5431,6131,700,0.5302715793115378
06807,COS COB,CT,2613,2737,124,0.511588785046729
06810,DANBURY,CT,21251,18676,-2575,0.4677536504120019
06811,DANBURY,CT,8960,8677,-283,0.4919770936100244
06812,NEW FAIRFIELD,CT,3481,4165,684,0.544729270206644
06813,DANBURY,CT,811,946,135,0.5384177575412635
06820,DARIEN,CT,6232,7455,1223,0.544677431139037
06824,FAIRFIELD,CT,9310,10623,1313,0.5329353333667787
06825,FAIRFIELD,CT,6067,6728,661,0.5258304025009769
06829,GEORGETOWN,CT,11,0,-11,0
06830,GREENWICH,CT,12432,11957,-475,0.49026200336217146
06831,GREENWICH,CT,5739,6907,1168,0.5461806104697138
06836,GREENWICH,CT,18,174,156,0.90625
06838,GREENS FARMS,CT,0,14,14,1
06840,NEW CANAAN,CT,7227,8528,1301,0.5412884798476674
06850,NORWALK,CT,9380,9183,-197,0.49469374562301355
06851,NORWALK,CT,9905,9913,8,0.5002018367140983
06852,NORWALK,CT,137,215,78,0.6107954545454546
06853,NORWALK,CT,1652,1782,130,0.5189283634245777
06854,NORWALK,CT,11008,9683,-1325,0.4679812478855541
06855,NORWALK,CT,3446,3426,-20,0.49854481955762514
06856,NORWALK,CT,62,200,138,0.7633587786259542
06870,OLD GREENWICH,CT,2726,2822,96,0.5086517664023071
06877,RIDGEFIELD,CT,7338,8699,1361,0.5424331234021326
06878,RIVERSIDE,CT,2442,2756,314,0.5302039245863793
06880,WESTPORT,CT,9686,11206,1520,0.5363775607888187
06881,WESTPORT,CT,50,207,157,0.8054474708171206
06883,WESTON,CT,2939,3613,674,0.5514346764346765
06890,SOUTHPORT,CT,1611,1902,291,0.5414175918018788
06890,TAFTVILLE,CT,23,26,3,0.5306122448979592
06896,REDDING,CT,2206,2614,408,0.5423236514522821
06896,WEST REDDING,CT,239,314,75,0.5678119349005425
06897,WILTON,CT,5963,6520,557,0.5223103420652087
06901,STAMFORD,CT,10347,9285,-1062,0.47295232273838633
06902,STAMFORD,CT,31113,27787,-3326,0.47176570458404077
06903,STAMFORD,CT,3837,4904,1067,0.5610342066125157
06904,STAMFORD,CT,0,49,49,1
06905,RIDGEWAY,CT,211,152,-59,0.418732782369146
06905,STAMFORD,CT,9454,9040,-414,0.48880718070725643
06906,STAMFORD,CT,3633,3443,-190,0.4865743357829282
06907,STAMFORD,CT,3478,3359,-119,0.4912973526400468
06911,STAMFORD,CT,45,188,143,0.8068669527896996
07001,AVENEL,NJ,5512,5367,-145,0.4933357845390201
07002,BAYONNE,NJ,26269,23999,-2270,0.47742102331503145
07003,BLOOMFIELD,NJ,19033,17217,-1816,0.474951724137931
07004,FAIRFIELD,NJ,2469,2722,253,0.5243691003660181
07005,BOONTON,NJ,4511,4806,295,0.5158312761618546
07005,BOONTON TOWNSHIP,NJ,524,557,33,0.515263644773358
07005,BOONTON TWP,NJ,90,148,58,0.6218487394957983
07006,CALDWELL,NJ,3983,4425,442,0.5262844909609895
07006,N CALDWELL,NJ,152,208,56,0.5777777777777777
07006,NORTH CALDWELL,NJ,143,130,-13,0.47619047619047616
07006,WEST CALDWELL,NJ,1672,1921,249,0.5346507097133315
07007,CALDWELL,NJ,0,57,57,1
07007,WEST CALDWELL,NJ,0,25,25,1
07008,CARTERET,NJ,9216,7521,-1695,0.4493636852482524
07009,CEDAR GROVE,NJ,2649,3798,1149,0.5891112145183807
07009,GR,NJ,49,58,9,0.5420560747663551
07010,CLIFFSIDE PARK,NJ,9703,8450,-1253,0.46548779816008373
07011,CLIFTON,NJ,11750,9560,-2190,0.44861567339277336
07012,CLIFTON,NJ,4503,4476,-27,0.4984964918142332
07013,CLIFTON,NJ,7449,7623,174,0.5057722929936306
07014,CLIFTON,NJ,1757,1464,-293,0.4545172306737038
07015,CLIFTON,NJ,472,845,373,0.6416097190584662
07016,CRANFORD,NJ,5770,6605,835,0.5337373737373737
07017,EAST ORANGE,NJ,12461,11057,-1404,0.4701505230036568
07017,RIDGEFIELD,NJ,288,242,-46,0.45660377358490567
07018,EAST ORANGE,NJ,10727,9113,-1614,0.45932459677419357
07018,NEWARK,NJ,191,148,-43,0.4365781710914454
07019,EAST ORANGE,NJ,1003,1458,455,0.592442096708655
07020,EDGEWATER,NJ,9490,8285,-1205,0.4661040787623066
07021,ESSEX FELLS,NJ,448,474,26,0.5140997830802603
07022,FAIRVIEW,NJ,4102,3181,-921,0.43677056158176575
07023,FANWOOD,NJ,1675,1712,37,0.5054620608207854
07024,FORT LEE,NJ,18607,17676,-931,0.4871703001405617
07026,GARFIELD,NJ,12350,9014,-3336,0.4219247331960307
07027,GARWOOD,NJ,1364,1405,41,0.5074033947273384
07028,GARFIELD,NJ,66,73,7,0.5251798561151079
07028,GLEN RIDGE,NJ,1688,1979,291,0.5396782110717208
07029,EAST NEWARK,NJ,1516,1343,-173,0.4697446659671214
07029,HARRISON,NJ,9907,8542,-1365,0.4630061249932246
07030,HOBOKEN,NJ,40258,29122,-11136,0.4197463245892188
07031,N ARLINGTON,NJ,320,342,22,0.5166163141993958
07031,NORTH ARLINGTON,NJ,4357,4109,-248,0.4853531774155445
07032,KEARNY,NJ,12392,10603,-1789,0.461100239182431
07033,KENILWORTH,NJ,2329,2124,-205,0.47698181001571976
07034,LAKE HIAWATHA,NJ,2794,2618,-176,0.483739837398374
07035,LINCOLN PARK,NJ,2874,2893,19,0.501647303624068
07036,LINDEN,NJ,14445,12509,-1936,0.46408696297395563
07039,LIVINGSTON,NJ,7589,9342,1753,0.5517689445396019
07040,MAPLEWOOD,NJ,7460,7702,242,0.5079804775095634
07041,MILLBURN,NJ,2719,2663,-56,0.4947974730583426
07042,MONTCLAIR,NJ,11840,10786,-1054,0.476708211791744
07043,MONTCLAIR,NJ,2092,2473,381,0.5417305585980284
07043,UPPER MONTCLAIR,NJ,881,1094,213,0.5539240506329114
07043,UPR MONTCLAIR,NJ,85,106,21,0.5549738219895288
07044,VERONA,NJ,3883,4179,296,0.5183577276110146
07045,MONTVILLE,NJ,2618,2969,351,0.5314122069088957
07046,MOUNTAIN LAKES,NJ,1250,1525,275,0.5495495495495496
07046,MOUNTAIN LKS,NJ,52,60,8,0.5357142857142857
07047,NORTH BERGEN,NJ,22128,18436,-3692,0.45449166748841335
07050,ORANGE,NJ,9051,7259,-1792,0.4450643776824034
07051,ORANGE,NJ,37,379,342,0.9110576923076923
07051,PATERSON,NJ,0,15,15,1
07052,WEST ORANGE,NJ,13635,13941,306,0.5055483028720626
07054,PARSIPPANY,NJ,11749,9639,-2110,0.45067327473349544
07055,PASSAIC,NJ,20226,16235,-3991,0.44527028880173336
07057,WALLINGTON,NJ,3705,3207,-498,0.4639756944444444
07058,PINE BROOK,NJ,2013,1912,-101,0.48713375796178343
07059,WARREN,NJ,3447,4689,1242,0.5763274336283186
07060,NORTH PLAINFIELD,NJ,5485,4522,-963,0.4518836814230039
07060,PLAINFIELD,NJ,5468,4495,-973,0.4511693265080799
07061,PLAINFIELD,NJ,61,551,490,0.9003267973856209
07062,N PLAINFIELD,NJ,66,90,24,0.5769230769230769
07062,NORTH PLAINFIELD,NJ,171,164,-7,0.48955223880597015
07062,PLAINFIELD,NJ,3733,3308,-425,0.4698196278937651
07063,NORTH PLAINFIELD,NJ,915,828,-87,0.4750430292598967
07063,PLAINFIELD,NJ,2031,1788,-243,0.46818538884524746
07064,PORT READING,NJ,947,1133,186,0.5447115384615384
07065,RAHWAY,NJ,10450,9765,-685,0.4830571357902548
07066,CLARK,NJ,3526,3607,81,0.5056778354128698
07067,COLONIA,NJ,3478,3731,253,0.5175475100568734
07068,ROSELAND,NJ,2197,2446,249,0.5268145595520138
07069,WATCHUNG,NJ,1761,1999,238,0.5316489361702128
07070,RUTHERFORD,NJ,5855,6024,169,0.5071133933832814
07071,LYNDHURST,NJ,8441,7443,-998,0.46858473936036266
07072,CARLSTADT,NJ,2119,1975,-144,0.4824132877381534
07073,E RUTHERFORD,NJ,289,328,39,0.5316045380875203
07073,EAST RUTHERFORD,NJ,4293,3910,-383,0.47665488236011216
07074,MOONACHIE,NJ,791,659,-132,0.45448275862068965
07075,WOOD RIDGE,NJ,3452,3657,205,0.514418342945562
07076,SCOTCH PLAINS,NJ,5554,6140,586,0.5250555840602018
07077,SEWAREN,NJ,491,500,9,0.5045408678102926
07078,SHORT HILLS,NJ,3745,4554,809,0.5487408121460416
07079,SOUTH ORANGE,NJ,5509,5802,293,0.512951993634515
07080,S PLAINFIELD,NJ,674,662,-12,0.49550898203592814
07080,SOUTH PLAINFIELD,NJ,5336,5322,-14,0.49934321636329515
07081,SPRINGFIELD,NJ,5926,5940,14,0.5005899207820664
07082,TOWACO,NJ,1127,1397,270,0.553486529318542
07083,UNION,NJ,14912,15119,207,0.5034464386800306
07086,WEEHAWKEN,NJ,9694,9615,-79,0.497954321818841
07087,UNION CITY,NJ,21690,16799,-4891,0.43646236587076825
07088,VAUXHALL,NJ,1021,1002,-19,0.495304003954523
07090,WESTFIELD,NJ,7164,8350,1186,0.5382235400283615
07092,MOUNTAINSIDE,NJ,1512,1902,390,0.5571177504393673
07093,GUTTENBERG,NJ,9270,7376,-1894,0.44310945572509913
07093,WEST NEW YORK,NJ,15798,12542,-3256,0.4425546930134086
07094,SECAUCUS,NJ,9519,8574,-945,0.47388492787265796
07094,WMSTWN,NJ,258,223,-35,0.46361746361746364
07095,WOODBRIDGE,NJ,8079,7795,-284,0.4910545546176137
07096,SECAUCUS,NJ,33,27,-6,0.45
07101,NEWARK,NJ,587,1423,836,0.7079601990049751
07102,NEWARK,NJ,6222,5794,-428,0.48219041278295605
07103,NEWARK,NJ,10883,10119,-764,0.4818112560708504
07104,NEWARK,NJ,15632,12806,-2826,0.4503129615303467
07105,IRVINGTON,NJ,3322,2403,-919,0.41973799126637557
07105,NEWARK,NJ,6914,4959,-1955,0.41767034447907014
07106,NEWARK,NJ,9432,8159,-1273,0.4638167244613723
07107,NEWARK,NJ,11795,9442,-2353,0.44460140321137637
07108,NEWARK,NJ,9113,7893,-1220,0.46413030695048807
07109,BELLEVILLE,NJ,12085,10979,-1106,0.47602323968088794
07110,NUTLEY,NJ,8328,8060,-268,0.4918232853307298
07111,IRVINGTON,NJ,18841,15507,-3334,0.45146733434261094
07112,NEWARK,NJ,9732,8414,-1318,0.463683456409126
07114,NEWARK,NJ,3244,2649,-595,0.4495163753605973
07201,ELIZABETH,NJ,9014,6804,-2210,0.4301428752054621
07202,ELIZABETH,NJ,13294,10610,-2684,0.4438587684069612
07203,ROSELLE,NJ,7255,6984,-271,0.490483882295105
07204,ROSELLE PARK,NJ,3681,3599,-82,0.4943681318681319
07205,HILLSIDE,NJ,5796,5354,-442,0.48017937219730944
07206,ELIZABETH,NJ,2555,1982,-573,0.4368525457350672
07206,ELIZABETHPORT,NJ,6078,4867,-1211,0.44467793513019643
07207,ELIZABETH,NJ,750,1819,1069,0.7080576099649669
07208,ELIZABETH,NJ,10790,7895,-2895,0.42253144233342255
07302,JERSEY CITY,NJ,45279,40349,-4930,0.47121268743868827
07303,JERSEY CITY,NJ,267,430,163,0.6169296987087518
07304,JERSEY CITY,NJ,20327,18218,-2109,0.4726423660656376
07305,JERSEY CITY,NJ,22998,20412,-2586,0.4702142363510712
07306,JERSEY CITY,NJ,26103,19637,-6466,0.4293178836904241
07307,JERSEY CITY,NJ,19184,15252,-3932,0.4429085840399582
07310,JERSEY CITY,NJ,16608,14735,-1873,0.4701209201416584
07311,JERSEY CITY,NJ,2430,1921,-509,0.441507699379453
07401,ALLENDALE,NJ,1576,1899,323,0.5464748201438849
07403,BLOOMINGDALE,NJ,2445,2279,-166,0.48243014394580863
07405,BUTLER,NJ,1375,1510,135,0.5233968804159446
07405,KINNELON,NJ,2837,3237,400,0.532927230819888
07407,ELMWOOD PARK,NJ,6469,5848,-621,0.47479093935211497
07410,FAIR LAWN,NJ,8386,8982,596,0.5171579917088899
07416,FRANKLIN,NJ,2112,1814,-298,0.46204788588894546
07417,FRANKLIN LAKES,NJ,3022,3906,884,0.5637990762124712
07417,FRANKLIN LKS,NJ,32,40,8,0.5555555555555556
07418,GLENWOOD,NJ,327,356,29,0.5212298682284041
07419,HAMBURG,NJ,3788,3940,152,0.5098343685300207
07420,HASKELL,NJ,1369,1322,-47,0.49126718691936083
07421,HEWITT,NJ,2054,2069,15,0.5018190637885035
07422,HIGHLAND LAKES,NJ,1671,1820,149,0.5213405900887997
07422,HIGHLAND LKS,NJ,86,76,-10,0.4691358024691358
07423,HO HO KUS,NJ,990,1171,181,0.5418787598334105
07424,LITTLE FALLS,NJ,4145,4056,-89,0.4945738324594562
07424,WOODLAND PARK,NJ,3717,3590,-127,0.49130970302449706
07430,MAHWAH,NJ,7517,7733,216,0.5070819672131147
07432,MIDLAND PARK,NJ,1959,1852,-107,0.485961689845185
07435,NEWFOUNDLAND,NJ,736,881,145,0.5448361162646876
07436,OAKLAND,NJ,2755,3040,285,0.5245901639344263
07438,OAK RIDGE,NJ,2582,2832,250,0.523088289619505
07439,OGDENSBURG,NJ,540,484,-56,0.47265625
07440,PEQUANNOCK,NJ,888,1030,142,0.5370177267987487
07442,POMPTON LAKES,NJ,3128,3218,90,0.5070910809959029
07444,POMPTON PLAINS,NJ,3336,3210,-126,0.4903758020164986
07446,RAMSEY,NJ,4014,4490,476,0.5279868297271872
07450,RIDGEWOOD,NJ,6202,6796,594,0.5228496691798739
07451,RIDGEWOOD,NJ,177,82,-95,0.3166023166023166
07452,GLEN ROCK,NJ,2565,3000,435,0.5390835579514824
07456,RINGWOOD,NJ,2566,2882,316,0.5290014684287812
07457,RIVERDALE,NJ,1767,1637,-130,0.4809048178613396
07458,SADDLE RIVER,NJ,1785,2207,422,0.5528557114228457
07458,UPPER SADDLE RIVER,NJ,1629,1985,356,0.5492529053680133
07460,STOCKHOLM,NJ,809,784,-25,0.4921531701192718
07461,SUSSEX,NJ,4551,4846,295,0.5156964988826221
07461,WANTAGE,NJ,640,798,158,0.5549374130737135
07462,VERNON,NJ,2525,2379,-146,0.4851141924959217
07463,WALDWICK,NJ,2192,2346,154,0.5169678272366681
07465,WANAQUE,NJ,2141,2180,39,0.5045128442490164
07470,WAYNE,NJ,13205,13969,764,0.514057555015824
07474,WAYNE,NJ,430,448,18,0.510250569476082
07480,WEST MILFORD,NJ,3727,4165,438,0.527749619868221
07481,WYCKOFF,NJ,3427,4451,1024,0.564991114496065
07495,MAHWAH,NJ,13,0,-13,0
07501,PATERSON,NJ,11015,9141,-1874,0.45351260170668783
07502,PATERSON,NJ,4193,3571,-622,0.4599433281813498
07502,TOTOWA,NJ,55,57,2,0.5089285714285714
07503,PATERSON,NJ,5776,4368,-1408,0.4305993690851735
07504,PATERSON,NJ,3835,3010,-825,0.4397370343316289
07505,PATERSON,NJ,687,669,-18,0.49336283185840707
07506,HAWTHORNE,NJ,5442,5266,-176,0.49178184534927155
07507,HAWTHORNE,NJ,0,12,12,1
07508,HALEDON,NJ,3117,2964,-153,0.4874198322644302
07508,NORTH HALEDON,NJ,3238,2942,-296,0.4760517799352751
07508,PROSPECT PARK,NJ,194,209,15,0.5186104218362283
07509,PATERSON,NJ,422,1206,784,0.7407862407862408
07511,TOTOWA,NJ,27,101,74,0.7890625
07512,TOTOWA,NJ,2783,2858,75,0.5066477574898067
07513,PATERSON,NJ,3031,2409,-622,0.44283088235294116
07514,PATERSON,NJ,5370,4529,-841,0.45752096171330436
07522,PATERSON,NJ,6516,5376,-1140,0.4520686175580222
07524,PATERSON,NJ,3522,2807,-715,0.44351398325169855
07538,HALEDON,NJ,0,106,106,1
07601,HACKENSACK,NJ,20819,17064,-3755,0.45043951112636277
07602,HACKENSACK,NJ,40,94,54,0.7014925373134329
07603,BOGOTA,NJ,2521,2351,-170,0.4825533661740558
07604,HASBROUCK HEIGHTS,NJ,2836,2717,-119,0.48928507113272107
07604,HASBROUCK HTS,NJ,359,327,-32,0.47667638483965014
07605,LEONIA,NJ,2662,2617,-45,0.49573782913430575
07606,S HACKENSACK,NJ,167,128,-39,0.43389830508474575
07606,SOUTH HACKENSACK,NJ,797,845,48,0.5146163215590743
07607,MAYWOOD,NJ,2761,2687,-74,0.49320851688693096
07620,ALPINE,NJ,572,636,64,0.5264900662251656
07621,BERGENFIELD,NJ,6630,6166,-464,0.4818693341669272
07624,CLOSTER,NJ,2177,2502,325,0.5347296430861295
07626,CRESSKILL,NJ,2328,2668,340,0.5340272217774219
07627,DEMAREST,NJ,1221,1478,257,0.5476102260096332
07628,DUMONT,NJ,4107,4009,-98,0.49396254312469196
07630,EMERSON,NJ,1406,1560,154,0.5259608900876601
07631,ENGLEWOOD,NJ,10560,10022,-538,0.4869303274706054
07632,ENGLEWD CLFS,NJ,728,824,96,0.5309278350515464
07632,ENGLEWOOD CLIFFS,NJ,1341,1694,353,0.558154859967051
07640,HARRINGTON PARK,NJ,968,1246,278,0.5627822944896116
07640,HARRINGTON PK,NJ,37,39,2,0.5131578947368421
07641,HAWORTH,NJ,747,922,175,0.5524266027561414
07642,HILLSDALE,NJ,2099,2293,194,0.5220856102003643
07643,LITTLE FERRY,NJ,3583,3365,-218,0.4843120322394934
07644,LODI,NJ,9695,7647,-2048,0.44095260062276553
07645,MONTVALE,NJ,2282,3206,924,0.5841836734693877
07646,NEW MILFORD,NJ,4801,4275,-526,0.4710224768620538
07647,NORTHVALE,NJ,1060,1290,230,0.548936170212766
07647,ROCKLEIGH,NJ,71,81,10,0.5328947368421053
07648,NORWOOD,NJ,1683,1743,60,0.5087565674255692
07649,ORADELL,NJ,1658,1996,338,0.5462506841817186
07650,PALISADES PARK,NJ,8228,7587,-641,0.4797344293392349
07650,PALISADES PK,NJ,138,133,-5,0.4907749077490775
07652,PARAMUS,NJ,5780,6245,465,0.5193347193347193
07653,PARAMUS,NJ,555,175,-380,0.23972602739726026
07656,PARK RIDGE,NJ,2261,2720,459,0.5460750853242321
07657,RIDGEFIELD,NJ,3713,3504,-209,0.4855202992933352
07660,RIDGEFIELD PARK,NJ,4259,3700,-559,0.4648825229300163
07660,RIDGEFIELD PK,NJ,110,76,-34,0.40860215053763443
07661,RIVER EDGE,NJ,2810,3050,240,0.5204778156996587
07662,ROCHELLE PARK,NJ,1759,1768,9,0.5012758718457613
07663,SADDLE BROOK,NJ,4086,4033,-53,0.49673605123783715
07666,RIDGEFIELD,NJ,279,290,11,0.5096660808435852
07666,TEANECK,NJ,10629,11055,426,0.5098229109020476
07670,TENAFLY,NJ,4295,4928,633,0.5343163829556543
07675,OLD TAPPAN,NJ,719,842,123,0.5393978219090326
07675,RIVER VALE,NJ,1894,2011,117,0.5149807938540333
07675,WESTWOOD,NJ,4361,4610,249,0.5138780514992755
07676,TOWNSHIP OF WASHINGTON,NJ,1568,1891,323,0.5466897947383637
07676,WASHINGTON TWPS,NJ,60,80,20,0.5714285714285714
07677,WOODCLIFF LAKE,NJ,1356,1675,319,0.5526228967337512
07701,RED BANK,NJ,8447,8604,157,0.504603835552167
07701,TINTON FALLS,NJ,229,196,-33,0.4611764705882353
07702,SHREWSBURY,NJ,1427,1538,111,0.5187183811129848
07704,FAIR HAVEN,NJ,1168,1415,247,0.5478126209833527
07710,ADELPHIA,NJ,0,12,12,1
07711,ALLENHURST,NJ,648,620,-28,0.4889589905362776
07711,LOCH ARBOUR,NJ,68,34,-34,0.3333333333333333
07711,W ALLENHURST,NJ,54,75,21,0.5813953488372093
07711,WEST ALLENHURST,NJ,49,61,12,0.5545454545454546
07712,ASBURY PARK,NJ,4448,4282,-166,0.49049255441008016
07712,INTERLAKEN,NJ,595,452,-143,0.43170964660936006
07712,OCEAN,NJ,9585,8742,-843,0.47700114585038467
07712,TINTON FALLS,NJ,585,641,56,0.5228384991843393
07716,ATLANTIC HIGHLANDS,NJ,3185,3301,116,0.5089423373419674
07717,AVON BY SEA,NJ,169,111,-58,0.3964285714285714
07717,AVON BY THE SEA,NJ,807,958,151,0.5427762039660057
07718,BELFORD,NJ,1308,1431,123,0.5224534501642936
07719,BELMAR,NJ,4511,4428,-83,0.49535742253048437
07719,LAKE COMO,NJ,169,127,-42,0.42905405405405406
07719,WALL,NJ,301,308,7,0.5057471264367817
07719,WALL TOWNSHIP,NJ,2978,3207,229,0.5185125303152789
07720,BRADLEY BEACH,NJ,2394,2149,-245,0.47303543913713403
07721,CLIFFWOOD,NJ,1438,1379,-59,0.4895278665246716
07722,COLTS NECK,NJ,2547,3118,571,0.5503971756398941
07723,DEAL,NJ,778,789,11,0.5035098915124442
07724,EATONTOWN,NJ,6113,6000,-113,0.4953355898621316
07724,TINTON FALLS,NJ,1836,1859,23,0.5031123139377537
07726,ENGLISHTOWN,NJ,2437,2305,-132,0.486081822016027
07726,MANALAPAN,NJ,8013,9172,1159,0.5337212685481525
07727,FARMINGDALE,NJ,2249,2450,201,0.521387529261545
07727,WALL TOWNSHIP,NJ,124,170,46,0.5782312925170068
07728,FREEHOLD,NJ,13889,14446,557,0.5098288335980237
07730,HAZLET,NJ,3774,4119,345,0.5218548080577727
07731,HOWELL,NJ,9153,9100,-53,0.49854818386018734
07732,HIGHLANDS,NJ,2401,2395,-6,0.4993744787322769
07733,HOLMDEL,NJ,3970,4991,1021,0.5569690882713982
07734,HAZLET TOWNSHIP,NJ,461,505,44,0.5227743271221532
07734,HAZLET TWP,NJ,128,138,10,0.518796992481203
07734,KEANSBURG,NJ,3989,3917,-72,0.4954464963318998
07735,KEYPORT,NJ,4847,4574,-273,0.4855110922407388
07735,UNION BEACH,NJ,924,805,-119,0.46558704453441296
07737,LEONARDO,NJ,914,924,10,0.5027203482045702
07738,LINCROFT,NJ,1420,2053,633,0.5911315865246185
07739,LITTLE SILVER,NJ,1681,2023,342,0.5461663066954644
07740,LONG BRANCH,NJ,12037,9972,-2065,0.453087373347267
07746,MARLBORO,NJ,3516,4469,953,0.5596743894802755
07747,ABERDEEN,NJ,1125,1109,-16,0.4964189794091316
07747,MATAWAN,NJ,8416,8439,23,0.5006822901216257
07748,MIDDLETOWN,NJ,5538,6141,603,0.525815566401233
07748,NEW MONMOUTH,NJ,405,465,60,0.5344827586206896
07748,NORTH MIDDLETOWN,NJ,292,273,-19,0.4831858407079646
07750,MONMOUTH BCH,NJ,185,317,132,0.6314741035856574
07750,MONMOUTH BEACH,NJ,1734,1558,-176,0.4732685297691373
07751,MORGANVILLE,NJ,4605,5537,932,0.5459475448629462
07752,NAVESINK,NJ,16,0,-16,0
07753,NEPTUNE,NJ,8583,8329,-254,0.49249053926206243
07753,NEPTUNE CITY,NJ,489,471,-18,0.490625
07753,TINTON FALLS,NJ,2935,2720,-215,0.48099027409372236
07753,WALL TOWNSHIP,NJ,243,268,25,0.5244618395303327
07754,NEPTUNE,NJ,167,513,346,0.7544117647058823
07755,OAKHURST,NJ,2418,2017,-401,0.4547914317925592
07756,OCEAN GROVE,NJ,2314,2449,135,0.5141717404996851
07757,OCEANPORT,NJ,1859,2163,304,0.5377921432123322
07758,PORT MONMOUTH,NJ,1228,1333,105,0.5204998047637641
07760,RUMSON,NJ,3039,3458,419,0.5322456518393105
07760,SEA BRIGHT,NJ,581,641,60,0.5245499181669394
07762,SPRING LAKE,NJ,4568,4985,417,0.5218256045221397
07764,WEST LONG BRANCH,NJ,2323,2158,-165,0.4815889310421781
07801,DOVER,NJ,6569,5570,-999,0.45885163522530686
07802,DOVER,NJ,512,122,-390,0.19242902208201892
07803,MINE HILL,NJ,932,972,40,0.5105042016806722
07821,ANDOVER,NJ,1314,1325,11,0.5020841227737779
07821,BYRAM TOWNSHIP,NJ,953,1217,264,0.5608294930875576
07821,BYRAM TWP,NJ,53,40,-13,0.43010752688172044
07821,GREEN TOWNSHIP,NJ,38,49,11,0.5632183908045977
07822,AUGUSTA,NJ,72,65,-7,0.4744525547445255
07823,BELVIDERE,NJ,2078,2192,114,0.5133489461358314
07825,BLAIRSTOWN,NJ,1912,2249,337,0.5404950732996876
07825,HARDWICK,NJ,318,378,60,0.5431034482758621
07826,BRANCHVILLE,NJ,1100,1212,112,0.5242214532871973
07826,SANDYSTON,NJ,668,715,47,0.5169920462762111
07827,MONTAGUE,NJ,1207,1273,66,0.5133064516129032
07827,SANDYSTON,NJ,27,28,1,0.509090909090909
07828,BUDD LAKE,NJ,5093,4764,-329,0.4833113523384397
07830,CALIFON,NJ,1655,1969,314,0.5433222958057395
07832,COLUMBIA,NJ,974,1062,88,0.5216110019646365
07834,DENVILLE,NJ,4953,5287,334,0.51630859375
07836,FLANDERS,NJ,4034,4051,17,0.5010513296227582
07838,GREAT MEADOWS,NJ,755,829,74,0.5233585858585859
07840,HACKETTSTOWN,NJ,9838,9592,-246,0.4936695831188883
07843,HOPATCONG,NJ,3554,3613,59,0.5041160876238314
07843,LAWRENCE,MA,62,77,15,0.5539568345323741
07847,KENVIL,NJ,227,274,47,0.5469061876247505
07848,LAFAYETTE,NJ,1035,1207,172,0.5383586083853702
07849,LAKE HOPATCONG,NJ,2836,2681,-155,0.48595251042233095
07849,LK HOPATCONG,NJ,42,36,-6,0.46153846153846156
07850,LANDING,NJ,1810,1802,-8,0.4988925802879291
07852,LEDGEWOOD,NJ,1359,1511,152,0.5264808362369338
07853,LONG VALLEY,NJ,2335,2977,642,0.5604292168674698
07856,MOUNT ARLINGTON,NJ,2252,2125,-127,0.48549234635595157
07856,MT ARLINGTON,NJ,415,350,-65,0.45751633986928103
07857,NETCONG,NJ,1329,1251,-78,0.4848837209302326
07860,NEWTON,NJ,7130,7744,614,0.5206400430281027
07863,OXFORD,NJ,1099,1045,-54,0.48740671641791045
07865,PORT MURRAY,NJ,633,835,202,0.5688010899182562
07866,ROCKAWAY,NJ,5274,5725,451,0.5205018638058005
07866,ROCKAWAY BOROUGH,NJ,264,267,3,0.5028248587570622
07869,RANDOLPH,NJ,6719,7006,287,0.5104553734061931
07871,SPARTA,NJ,6075,6975,900,0.5344827586206896
07874,STANHOPE,NJ,2507,2387,-120,0.48774008990600737
07876,SUCCASUNNA,NJ,2050,2372,322,0.5364088647670737
07878,MOUNT TABOR,NJ,60,12,-48,0.16666666666666666
07882,WASHINGTON,NJ,4260,4698,438,0.5244474212993971
07885,WHARTON,NJ,4250,4573,323,0.5183044315992292
07901,SUMMIT,NJ,7307,7137,-170,0.49411520354472444
07902,SUMMIT,NJ,0,165,165,1
07920,BASKING RIDGE,NJ,7453,8961,1508,0.5459363957597173
07921,BEDMINSTER,NJ,3575,3303,-272,0.4802268101192207
07922,BERKELEY HEIGHTS,NJ,2539,3583,1044,0.585266252858543
07922,BERKELEY HTS,NJ,50,55,5,0.5238095238095238
07924,BERNARDSVILLE,NJ,2077,2351,274,0.5309394760614273
07926,BROOKSIDE,NJ,12,0,-12,0
07927,CEDAR KNOLLS,NJ,1731,1669,-62,0.4908823529411765
07928,CHATHAM,NJ,4718,4752,34,0.5017951425554382
07928,CHATHAM TWP,NJ,663,723,60,0.5216450216450217
07930,CHESTER,NJ,2299,2606,307,0.5312945973496432
07931,FAR HILLS,NJ,1063,1413,350,0.5706785137318255
07932,FLORHAM PARK,NJ,4783,5596,813,0.5391656228923788
07933,GILLETTE,NJ,642,765,123,0.5437100213219617
07934,GLADSTONE,NJ,309,339,30,0.5231481481481481
07935,GREEN VILLAGE,NJ,12,24,12,0.6666666666666666
07936,EAST HANOVER,NJ,2310,2551,241,0.5247891380374409
07938,LIBERTY COR,NJ,0,11,11,1
07938,LIBERTY CORNER,NJ,11,121,110,0.9166666666666666
07940,MADISON,NJ,4685,4970,285,0.5147591921284309
07945,MENDHAM,NJ,2392,3637,1245,0.6032509537236689
07946,MILLINGTON,NJ,580,758,178,0.5665171898355755
07950,MORRIS PLAI,NJ,153,129,-24,0.4574468085106383
07950,MORRIS PLAINS,NJ,5946,6099,153,0.5063511830635118
07960,MORRISTOWN,NJ,16804,16159,-645,0.4902163031277493
07961,CONVENT STA,NJ,12,0,-12,0
07962,MORRISTOWN,NJ,34,52,18,0.6046511627906976
07963,MORRISTOWN,NJ,0,11,11,1
07974,NEW PROVIDENCE,NJ,3233,3592,359,0.5263003663003663
07976,NEW VERNON,NJ,235,309,74,0.5680147058823529
07977,PEAPACK,NJ,0,43,43,1
07979,POTTERSVILLE,NJ,13,0,-13,0
07980,STIRLING,NJ,512,581,69,0.5315645013723697
07981,WHIPPANY,NJ,1957,2249,292,0.5347123157394199
08001,ALLOWAY,NJ,155,13,-142,0.07738095238095238
08002,CHERRY HILL,NJ,9309,8978,-331,0.4909498550883141
08003,CHERRY HILL,NJ,8259,9414,1155,0.5326769648616534
08003,CHERRYHILL,NJ,180,194,14,0.5187165775401069
08004,ATCO,NJ,2897,3067,170,0.5142521797451375
08005,BARNEGAT,NJ,9341,10522,1181,0.5297286411921663
08006,BARNEGAT LGT,NJ,46,0,-46,0
08006,BARNEGAT LIGHT,NJ,935,803,-132,0.4620253164556962
08007,BARRINGTON,NJ,1694,1672,-22,0.49673202614379086
08007,LEHT,NJ,33,47,14,0.5875
08008,BEACH HAVEN,NJ,1414,2132,718,0.6012408347433729
08008,HARVEY CEDARS,NJ,2040,1448,-592,0.4151376146788991
08008,LONG BCH TWP,NJ,519,126,-393,0.19534883720930232
08008,LONG BEACH,NJ,773,350,-423,0.3116651825467498
08008,LONG BEACH TOWNSHIP,NJ,1283,1635,352,0.5603152844413982
08008,SHIP BOTTOM,NJ,1303,2603,1300,0.66641065028161806
08008,SURF CITY,NJ,786,1055,269,0.5730581205866377
08009,BERLIN,NJ,4405,4920,515,0.5276139410187668
08009,BERLIN BORO,NJ,69,82,13,0.543046357615894
08010,BEVERLY,NJ,2755,2427,-328,0.46835198764955616
08010,EDGEWATER PARK,NJ,743,724,-19,0.49352419904567146
08010,EDGEWATER PRK,NJ,290,294,4,0.5034246575342466
08012,BLACKWOOD,NJ,11058,10609,-449,0.48963862094429317
08012,TURNERSVILLE,NJ,1770,1831,61,0.5084698694806998
08014,BRIDGEPORT,NJ,27,0,-27,0
08015,BROWNS MILLS,NJ,7135,7068,-67,0.4976413433781595
08016,BURLINGTON,NJ,10220,10217,-3,0.49992660370895925
08016,BURLINGTON TOWNSHIP,NJ,167,209,42,0.5558510638297872
08019,CHATSWORTH,NJ,25,12,-13,0.32432432432432434
08020,CLARKSBORO,NJ,736,1151,415,0.6099629040805511
08021,CLEMENTON,NJ,11201,10242,-959,0.4776383901506319
08021,LAUREL SPRINGS,NJ,5066,4580,-486,0.47480821065726725
08021,LINDENWOLD,NJ,1006,1051,45,0.5109382596013612
08021,PINE HILL,NJ,805,769,-36,0.48856416772554
08022,COLUMBUS,NJ,2259,2519,260,0.527208036835496
08023,DEEPWATER,NJ,89,11,-78,0.11
08026,GIBBSBORO,NJ,473,647,174,0.5776785714285714
08027,GIBBSTOWN,NJ,1248,1321,73,0.514207862981705
08028,GLASSBORO,NJ,6495,6247,-248,0.49026840370428504
08029,GLENDORA,NJ,1300,1379,79,0.5147443075774543
08030,BROOKLAWN,NJ,351,358,7,0.5049365303244006
08030,GLOUCESTER CITY,NJ,4103,3989,-114,0.49295600593178446
08030,GLOUCESTER CY,NJ,92,81,-11,0.4682080924855491
08030,GLOUCSTR CITY,NJ,96,135,39,0.5844155844155844
08031,BELLMAWR,NJ,3143,3145,2,0.5001590330788804
08032,GRENLOCH,NJ,0,12,12,1
08033,HADDONFIELD,NJ,5423,5528,105,0.5047940827321705
08034,CHERRY HILL,NJ,6565,6702,137,0.5051631868546016
08035,HADDON HEIGHTS,NJ,1819,1857,38,0.5051686615886833
08035,HADDON HGTS,NJ,51,51,0,0.5
08035,HADDON HTS,NJ,35,46,11,0.5679012345679012
08036,HAINESPORT,NJ,1489,1538,49,0.5080938222662702
08036,HAINESPORT TOWNSHIP,NJ,31,36,5,0.5373134328358209
08037,HAMMONTON,NJ,6345,6515,170,0.5066096423017107
08038,HANCOCKS BRIDGE,NJ,0,11,11,1
08039,HARRISONVILLE,NJ,17,0,-17,0
08041,JOBSTOWN,NJ,48,12,-36,0.2
08043,VOORHEES,NJ,11462,11098,-364,0.49193262411347516
08045,LAWNSIDE,NJ,923,1109,186,0.5457677165354331
08046,WILLINGBORO,NJ,9966,10470,504,0.5123311802701116
08048,LUMBERTON,NJ,4066,4071,5,0.5003072385400025
08049,MAGNOLIA,NJ,1545,1545,0,0.5
08050,MANAHAWKIN,NJ,9245,9956,711,0.5185146606947555
08051,MANTUA,NJ,3504,3448,-56,0.49597238204833144
08051,WEST DEPTFORD,NJ,111,76,-35,0.40641711229946526
08052,MAPLE SHADE,NJ,8921,7706,-1215,0.46346304204005534
08053,MARLTON,NJ,19619,16313,-3306,0.4539964377156852
08054,MOUNT LAUREL,NJ,15369,16535,1166,0.5182735707121364
08054,MT LAUREL,NJ,395,443,48,0.5286396181384249
08055,MEDFORD,NJ,7426,8695,1269,0.5393586005830904
08055,MEDFORD LAKES,NJ,140,191,51,0.5770392749244713
08056,MICKLETON,NJ,828,985,157,0.5432984004412575
08057,MOORESTOWN,NJ,5977,7031,1054,0.5405135301353013
08059,MOUNT EPHRAIM,NJ,1517,1629,112,0.5178003814367451
08059,WEST COLLINGSWOOD HEIGHTS,NJ,27,36,9,0.5714285714285714
08060,EASTAMPTON,NJ,431,502,71,0.5380493033226152
08060,EASTAMPTON TOWNSHIP,NJ,523,496,-27,0.4867517173699706
08060,MOUNT HOLLY,NJ,6653,6801,148,0.5055002229820128
08060,WESTAMPTON,NJ,1503,1646,143,0.5227056208320101
08061,MOUNT ROYAL,NJ,989,946,-43,0.4888888888888889
08062,MULLICA HILL,NJ,3648,4106,458,0.5295331441836472
08063,NATIONAL PARK,NJ,798,797,-1,0.49968652037617556
08063,WEST DEPTFORD,NJ,38,40,2,0.5128205128205128
08065,PALMYRA,NJ,2782,2635,-147,0.48643160420897175
08066,DEPTFORD,NJ,49,56,7,0.5333333333333333
08066,PAULSBORO,NJ,2858,2684,-174,0.48430169613857815
08066,WEST DEPTFORD,NJ,262,231,-31,0.4685598377281947
08067,PEDRICKTOWN,NJ,153,234,81,0.6046511627906976
08068,NEW JERSEY,NJ,49,62,13,0.5585585585585585
08068,PEMBERTON,NJ,2729,2553,-176,0.4833396440742143
08069,CARNEYS POINT,NJ,1138,1172,34,0.5073593073593073
08069,PENNS GROVE,NJ,3462,3393,-69,0.4949671772428884
08070,PENNSVILLE,NJ,4605,4639,34,0.5018390307226309
08071,PITMAN,NJ,2712,2609,-103,0.49032136816387895
08072,QUINTON,NJ,23,0,-23,0
08073,RANCOCAS,NJ,23,0,-23,0
08075,DELANCO,NJ,5411,5035,-376,0.4820026804518476
08075,DELRAN,NJ,1345,1315,-30,0.4943609022556391
08075,RIVERSIDE,NJ,1358,1211,-147,0.4713896457765668
08077,CINNAMINSON,NJ,4005,4425,420,0.5249110320284698
08077,RIVERTON,NJ,1017,1124,107,0.5249883232134517
08078,RUNNEMEDE,NJ,2368,2306,-62,0.4933675652545999
08079,SALEM,NJ,3596,3471,-125,0.4911560775435121
08080,SEWELL,NJ,9494,10596,1102,0.5274265803882529
08081,SICKLERVILLE,NJ,16549,15117,-1432,0.4773889976631087
08083,HI NELLA,NJ,234,208,-26,0.47058823529411764
08083,SOMERDALE,NJ,3188,2844,-344,0.47148541114058357
08084,STRATFORD,NJ,2103,1967,-136,0.4832923832923833
08085,SWEDESBORO,NJ,5480,5835,355,0.515687140963323
08086,THOROFARE,NJ,509,530,21,0.5101058710298364
08086,WEST DEPTFORD,NJ,2165,2216,51,0.5058205889066423
08087,LITTLE EGG HARBOR,NJ,2042,2088,46,0.5055690072639225
08087,LITTLE EGG HARBOR TWP,NJ,5771,6186,415,0.5173538513004934
08087,TUCKERTON,NJ,1793,1936,143,0.5191740412979351
08088,SHAMONG,NJ,960,987,27,0.5069337442218799
08088,SOUTHAMPTON,NJ,4140,4333,193,0.511389118376018
08088,TABERNACLE,NJ,413,434,21,0.512396694214876
08088,VINCENTOWN,NJ,984,1199,215,0.5492441594136509
08089,CHESILHURST,NJ,425,305,-120,0.4178082191780822
08089,WATERFORD WKS,NJ,11,22,11,0.6666666666666666
08089,WATERFORD WORKS,NJ,766,794,28,0.5089743589743589
08090,WENONAH,NJ,1801,2033,232,0.5302556077203965
08091,BERLIN TOWNSHIP,NJ,224,278,54,0.5537848605577689
08091,WEST BERLIN,NJ,1584,1901,317,0.545480631276901
08092,WEST CREEK,NJ,1109,1271,162,0.5340336134453781
08093,WEST DEPTFORD,NJ,51,72,21,0.5853658536585366
08093,WESTVILLE,NJ,3500,3273,-227,0.4832422855455485
08094,WILLIAMSTOWN,NJ,11583,12226,643,0.5135032970725356
08095,WINSLOW,NJ,14,11,-3,0.44
08096,DEPTFORD,NJ,2857,2846,-11,0.4990355953007189
08096,WEST DEPTFORD,NJ,896,925,29,0.5079626578802856
08096,WOODBURY,NJ,8006,8149,143,0.5044258743423089
08097,DEPTFORD,NJ,13,12,-1,0.48
08097,WOODBURY HEIGHTS,NJ,655,708,53,0.5194424064563463
08097,WOODBURY HTS,NJ,0,15,15,1
08098,PILESGROVE,NJ,982,1057,75,0.5183913683178029
08098,WOODSTOWN,NJ,1510,1618,108,0.5172634271099744
08099,BELLMAWR,NJ,23,70,47,0.7526881720430108
08101,CAMDEN,NJ,730,4403,3673,0.8577829729203195
08102,CAMDEN,NJ,2741,2449,-292,0.47186897880539497
08103,CAMDEN,NJ,4142,3518,-624,0.45926892950391646
08104,CAMDEN,NJ,7675,6524,-1151,0.4594689766884992
08105,CAMDEN,NJ,7570,6209,-1361,0.45061325205022135
08106,AUDUBON,NJ,2753,2791,38,0.5034271284271284
08107,COLLINGSWOOD,NJ,686,633,-53,0.4799090219863533
08107,HADDON TOWNSHIP,NJ,493,446,-47,0.4749733759318424
08107,OAKLYN,NJ,3759,3322,-437,0.4691427764440051
08107,WEST COLLINGSWOOD,NJ,106,86,-20,0.4479166666666667
08107,WOODLYNNE,NJ,123,141,18,0.5340909090909091
08108,COLLINGSWOOD,NJ,5790,5413,-377,0.48317414978130857
08108,HADDON TOWNSHIP,NJ,1131,1042,-89,0.4795213989875748
08109,MERCHANTVILLE,NJ,2482,2549,67,0.5066587159610415
08109,PENNSAUKEN,NJ,4076,4042,-34,0.4979058881497906
08110,PENNSAUKEN,NJ,5537,5916,379,0.5165458831747141
08201,ABSECON,NJ,4387,4518,131,0.5073554183043234
08201,EGG HARBOR,NJ,93,114,21,0.5507246376811594
08202,AVALON,NJ,2771,3145,374,0.5316091954022989
08203,BRIGANTINE,NJ,5614,5307,-307,0.48594451057595456
08204,CAPE MAY,NJ,7969,7609,-360,0.4884452432918218
08204,NORTH CAPE MAY,NJ,421,621,200,0.5959692898272553
08204,WEST CAPE MAY,NJ,148,386,238,0.7228464419475655
08205,GALLOWAY,NJ,8996,8855,-141,0.4960506414206487
08210,CAPE MAY COURT HOUSE,NJ,5682,6160,478,0.5201824016213478
08212,CAPE MAY POINT,NJ,238,184,-54,0.43601895734597157
08214,DENNISVILLE,NJ,22,13,-9,0.37142857142857144
08215,EGG HARBOR CITY,NJ,3771,4085,314,0.5199847250509165
08215,EGG HARBOR CY,NJ,59,79,20,0.572463768115942
08215,EGG HBR CITY,NJ,395,445,50,0.5297619047619048
08219,GREEN CREEK,NJ,11,0,-11,0
08221,LINWOOD,NJ,2231,2536,305,0.5319907698762324
08223,MARMORA,NJ,1330,1564,234,0.5404284727021423
08224,NEW GRETNA,NJ,27,0,-27,0
08225,NORTHFIELD,NJ,2355,2789,434,0.5421850699844479
08226,OCEAN CITY,NJ,9386,10170,784,0.520044998977296
08230,OCEAN VIEW,NJ,1746,2182,436,0.5554989816700611
08232,PLEASANTVILLE,NJ,7362,6847,-515,0.4818776831585615
08234,EGG HARBOR TOWNSHIP,NJ,11853,13207,1354,0.5270151636073424
08234,EGG HARBOR TWP,NJ,248,293,45,0.5415896487985212
08240,POMONA,NJ,66,24,-42,0.26666666666666666
08241,PORT REPUBLIC,NJ,62,28,-34,0.3111111111111111
08242,RIO GRANDE,NJ,1736,1935,199,0.5271043312448924
08243,SEA ISLE CITY,NJ,2126,2687,561,0.5582796592561812
08244,SOMERS POINT,NJ,5208,4815,-393,0.48039509129003294
08246,S SEAVILLE,NJ,0,11,11,1
08246,SOUTH SEAVILLE,NJ,77,119,42,0.6071428571428571
08247,STONE HARBOR,NJ,1408,1665,257,0.5418158151643345
08248,STRATHMERE,NJ,82,61,-21,0.42657342657342656
08250,TUCKAHOE,NJ,11,0,-11,0
08251,DEL HAVEN,NJ,284,277,-7,0.49376114081996436
08251,VILLAS,NJ,3746,3411,-335,0.47659633924828837
08260,N WILDWOOD,NJ,147,96,-51,0.3950617283950617
08260,NORTH WILDWOOD,NJ,882,1046,164,0.5425311203319502
08260,WILDWOOD,NJ,6594,5745,-849,0.4655968879163628
08260,WILDWOOD CREST,NJ,2122,3057,935,0.5902683915813863
08270,CORBIN CITY,NJ,107,99,-8,0.48058252427184467
08270,DENNIS TWP,NJ,30,52,22,0.6341463414634146
08270,WOODBINE,NJ,1937,1954,17,0.5021845283988692
08302,BRIDGETON,NJ,10540,9347,-1193,0.47000553125157135
08310,BUENA,NJ,444,527,83,0.5427394438722966
08311,CEDARVILLE,NJ,428,347,-81,0.447741935483871
08312,CLAYTON,NJ,2355,2532,177,0.518109269490485
08316,DORCHESTER,NJ,0,23,23,1
08317,DOROTHY,NJ,38,38,0,0.5
08318,ELMER,NJ,3000,2884,-116,0.49014276002719237
08318,PITTSGROVE,NJ,357,351,-6,0.4957627118644068
08319,ESTELL MANOR,NJ,66,90,24,0.5769230769230769
08321,FORTESCUE,NJ,14,0,-14,0
08322,FRANKLINVILLE,NJ,2353,2456,103,0.5107090871283011
08324,HEISLERVILLE,NJ,0,12,12,1
08326,LANDISVILLE,NJ,260,315,55,0.5478260869565217
08327,LEESBURG,NJ,51,24,-27,0.32
08328,MALAGA,NJ,252,191,-61,0.43115124153498874
08330,MAYS LANDING,NJ,10536,11394,858,0.5195622435020519
08332,MILLVILLE,NJ,12895,12234,-661,0.4868478650165148
08340,MILMAY,NJ,0,13,13,1
08341,MINOTOLA,NJ,642,559,-83,0.46544546211490423
08343,MONROEVILLE,NJ,949,1020,71,0.5180294565769427
08344,NEWARK,NJ,153,129,-24,0.4574468085106383
08344,NEWFIELD,NJ,1361,1461,100,0.5177179305457122
08345,NEWPORT,NJ,68,25,-43,0.26881720430107525
08346,NEWTONVILLE,NJ,43,13,-30,0.23214285714285715
08349,PORT NORRIS,NJ,294,340,46,0.5362776025236593
08350,RICHLAND,NJ,27,23,-4,0.46
08353,SHILOH,NJ,12,11,-1,0.4782608695652174
08360,VINELAND,NJ,13248,12182,-1066,0.47904050334250886
08361,S VINELAND,NJ,64,102,38,0.6144578313253012
08361,VINELAND,NJ,4443,4717,274,0.5149563318777293
08362,VINELAND,NJ,1122,842,-280,0.4287169042769857
08401,ATLANTIC CITY,NJ,15897,13862,-2035,0.46580866292550155
08402,MARGATE CITY,NJ,4846,5376,530,0.525924476619057
08403,LONGPORT,NJ,1109,1158,49,0.5108072342302603
08404,ATLANTIC CITY,NJ,347,765,418,0.6879496402877698
08404,CAMDEN,NJ,0,17,17,1
08406,VENTNOR CITY,NJ,5701,5692,-9,0.4996050206267006
08501,ALLENTOWN,NJ,1383,1539,156,0.526694045174538
08502,BELLE MEAD,NJ,2849,3443,594,0.5472027972027972
08505,BORDENTOWN,NJ,5320,5479,159,0.5073617927585887
08510,CLARKSBURG,NJ,45,41,-4,0.47674418604651164
08510,MILLSTONE TOWNSHIP,NJ,790,1064,274,0.5738942826321467
08510,MILLSTONE TWP,NJ,101,147,46,0.592741935483871
08511,COOKSTOWN,NJ,71,83,12,0.538961038961039
08512,CRANBURY,NJ,1987,2053,66,0.5081683168316832
08512,EAST WINDSOR,NJ,1760,1857,97,0.5134089024053082
08514,CREAM RIDGE,NJ,1127,1361,234,0.5470257234726688
08515,CHESTERFIELD,NJ,942,1221,279,0.5644937586685159
08515,CROSSWICKS,NJ,274,355,81,0.5643879173290938
08518,FLORENCE,NJ,1795,1902,107,0.5144711928590749
08520,EAST WINDSOR,NJ,4371,4139,-232,0.4863689776733255
08520,HIGHTSTOWN,NJ,3276,3181,-95,0.49264364255846366
08525,HOPEWELL,NJ,1343,1496,153,0.5269461077844312
08527,JACKSON,NJ,17774,16941,-833,0.4880023044793317
08528,KINGSTON,NJ,82,0,-82,0
08530,LAMBERTVILLE,NJ,2540,2495,-45,0.4955312810327706
08533,NEW EGYPT,NJ,1624,1870,246,0.5352032054951346
08534,PENNINGTON,NJ,3558,4097,539,0.5352057478772044
08535,MILLSTONE TOWNSHIP,NJ,860,1120,260,0.5656565656565656
08535,MILLSTONE TWP,NJ,65,115,50,0.6388888888888888
08535,PERRINEVILLE,NJ,98,142,44,0.5916666666666667
08536,PLAINSBORO,NJ,11864,10008,-1856,0.45757132406730067
08540,PRINCETON,NJ,20418,19841,-577,0.4928339004942994
08542,PRINCETON,NJ,2535,2051,-484,0.4472307021369385
08543,PRINCETON,NJ,179,174,-5,0.49291784702549574
08544,PRINCETON,NJ,0,13,13,1
08550,PRINCETON JCT,NJ,968,1059,91,0.5224469659595461
08550,PRINCETON JUNCTION,NJ,3106,3308,202,0.5157468038665419
08550,WEST WINDSOR,NJ,1702,1907,205,0.5284012191742865
08551,RINGOES,NJ,1339,1547,208,0.536036036036036
08553,ROCKY HILL,NJ,249,157,-92,0.3866995073891626
08554,ROEBLING,NJ,1114,1080,-34,0.49225159525979945
08555,ROOSEVELT,NJ,60,27,-33,0.3103448275862069
08558,SKILLMAN,NJ,1938,2623,685,0.575093181319886
08559,STOCKTON,NJ,1175,1391,216,0.5420888542478566
08560,EWING,NJ,39,73,34,0.6517857142857143
08560,TITUSVILLE,NJ,735,743,8,0.5027063599458728
08561,WINDSOR,NJ,12,0,-12,0
08562,WRIGHTSTOWN,NJ,1503,1433,-70,0.4880790190735695
08602,TRENTON,NJ,0,53,53,1
08605,TRENTON,NJ,0,12,12,1
08607,TRENTON,NJ,16,145,129,0.9006211180124224
08608,TRENTON,NJ,858,373,-485,0.30300568643379366
08609,HAMILTON,NJ,349,256,-93,0.4231404958677686
08609,TRENTON,NJ,4041,3163,-878,0.43906163242642976
08610,HAMILTON,NJ,1723,1597,-126,0.48102409638554217
08610,HAMLTON,NJ,186,119,-67,0.3901639344262295
08610,TRENTON,NJ,7017,6122,-895,0.4659410914072608
08611,TRENTON,NJ,7660,5305,-2355,0.4091785576552256
08618,EWING,NJ,1578,1363,-215,0.4634478068684121
08618,TRENTON,NJ,9368,8158,-1210,0.46547985849594886
08619,HAMILTON,NJ,3328,3248,-80,0.49391727493917276
08619,MERCERVILLE,NJ,165,174,9,0.5132743362831859
08619,TRENTON,NJ,4008,4000,-8,0.4995004995004995
08620,HAMILTON,NJ,831,981,150,0.5413907284768212
08620,TRENTON,NJ,1683,1710,27,0.5039787798408488
08625,TRENTON,NJ,0,233,233,1
08628,EWING,NJ,3747,4113,366,0.5232824427480917
08628,TRENTON,NJ,267,339,72,0.5594059405940595
08629,HAMILTON,NJ,258,216,-42,0.45569620253164556
08629,TRENTON,NJ,3845,3033,-812,0.4409712125617912
08638,EWING,NJ,4290,4046,-244,0.4853646833013436
08638,TRENTON,NJ,2198,2161,-37,0.49575590731819225
08640,FORT DIX,NJ,312,285,-27,0.47738693467336685
08640,JB MDL,NJ,408,375,-33,0.4789272030651341
08640,JOINT BASE MDL,NJ,1159,963,-196,0.4538171536286522
08641,JB MDL,NJ,352,303,-49,0.46259541984732827
08641,JOINT BASE MDL,NJ,2747,2083,-664,0.4312629399585921
08641,MC GUIRE AFB,NJ,129,96,-33,0.4266666666666667
08648,LAWRENCE,NJ,736,636,-100,0.46355685131195334
08648,LAWRENCE TOWNSHIP,NJ,8038,7608,-430,0.4862584686181772
08648,LAWRENCE TWP,NJ,398,416,18,0.5110565110565111
08648,LAWRENCEVILLE,NJ,2069,1853,-216,0.47246302906680265
08650,HAMILTON,NJ,12,80,68,0.8695652173913043
08650,TRENTON,NJ,71,540,469,0.88379705400982
08690,HAMILTON,NJ,1272,1437,165,0.530454042081949
08690,HAMILTON SQ,NJ,300,294,-6,0.494949494949495
08690,HAMILTON SQUARE,NJ,248,246,-2,0.4979757085020243
08690,TRENTON,NJ,2842,3021,179,0.5152652225822958
08691,HAMILTON,NJ,894,1002,108,0.5284810126582279
08691,ROBBINSVILLE,NJ,2868,3267,399,0.532518337408313
08691,TRENTON,NJ,376,497,121,0.5693012600229095
08701,LAKEWOOD,NJ,21053,17873,-3180,0.45915326516980937
08720,ALLENWOOD,NJ,89,198,109,0.6898954703832753
08721,BAYVILLE,NJ,6361,6868,507,0.5191624461410538
08722,BEACHWOOD,NJ,2748,2900,152,0.5134560906515581
08723,BRICK,NJ,11052,11520,468,0.5103668261562998
08724,BRICK,NJ,12077,12361,284,0.5058106228005566
08724,WALL TOWNSHIP,NJ,246,282,36,0.5340909090909091
08730,BRIELLE,NJ,1802,2098,296,0.5379487179487179
08731,FORKED RIVER,NJ,7061,7649,588,0.5199864038069341
08732,ISLAND HEIGHTS,NJ,587,553,-34,0.4850877192982456
08733,JOINT BASE MDL,NJ,106,115,9,0.5203619909502263
08733,LAKEHURST,NJ,1048,1128,80,0.5183823529411765
08734,LANOKA HARBOR,NJ,1977,2278,301,0.5353701527614572
08735,LAVALLETTE,NJ,2823,3193,370,0.530751329787234
08736,MANASQUAN,NJ,4797,5465,668,0.5325472617423505
08738,MANTOLOKING,NJ,985,1300,315,0.5689277899343544
08739,NORMANDY BEACH,NJ,285,278,-7,0.4937833037300178
08740,OCEAN GATE,NJ,1133,797,-336,0.4129533678756477
08741,PINE BEACH,NJ,819,909,90,0.5260416666666666
08742,BAY HEAD,NJ,780,836,56,0.5173267326732673
08742,POINT PLEASANT BEACH,NJ,2155,2369,214,0.5236516357206012
08742,POINT PLEASANT BORO,NJ,4952,5174,222,0.5109618803081177
08742,PT PLEASANT BEACH,NJ,1058,1076,18,0.5042174320524836
08750,SEA GIRT,NJ,2005,2161,156,0.5187229956793087
08751,SEASIDE HEIGHTS,NJ,2735,2856,121,0.5108209622607762
08751,SEASIDE HGTS,NJ,119,125,6,0.5122950819672131
08752,SEASIDE PARK,NJ,1724,1864,140,0.5195094760312151
08753,TOMS RIVER,NJ,19533,20063,530,0.5066925952116376
08754,TOMS RIVER,NJ,541,843,302,0.6091040462427746
08755,TOMS RIVER,NJ,8638,9024,386,0.5109274147888121
08757,TOMS RIVER,NJ,11820,13182,1362,0.527237820974322
08758,WARETOWN,NJ,3337,3627,290,0.5208213670304422
08759,MANCHESTER,NJ,4072,4867,795,0.5444680613043965
08759,WHITING,NJ,10397,11397,1000,0.5229420941543544
08801,ANNANDALE,NJ,2594,2794,200,0.5185597624350409
08802,ASBURY,NJ,1015,1084,69,0.5164363982848976
08804,BLOOMSBURY,NJ,713,753,40,0.5136425648021828
08805,BOUND BROOK,NJ,4499,3781,-718,0.45664251207729467
08807,BRIDGEWATER,NJ,9868,10859,991,0.5239060163072321
08808,BROADWAY,NJ,13,0,-13,0
08809,CLINTON,NJ,2016,1822,-194,0.4747264200104221
08810,DAYTON,NJ,2084,2196,112,0.5130841121495328
08812,DUNELLEN,NJ,3287,3028,-259,0.47949326999208236
08812,GREEN BROOK,NJ,566,514,-52,0.4759259259259259
08816,EAST BRUNSWICK,NJ,13019,13127,108,0.5020653254799969
08817,EDISON,NJ,18175,15181,-2994,0.4551205180477275
08818,EDISON,NJ,476,795,319,0.6254917387883556
08820,EDISON,NJ,9276,8976,-300,0.4917817225509533
08820,FLEMINGTON,NJ,235,247,12,0.5124481327800829
08821,FLAGTOWN,NJ,20,0,-20,0
08822,FLEMINGTON,NJ,7985,9105,1120,0.5327677004095962
08823,FRANKLIN PARK,NJ,3954,3302,-652,0.45507166482910694
08824,KENDALL PARK,NJ,2621,2935,314,0.5282577393808495
08825,FRENCHTOWN,NJ,1254,1481,227,0.5414990859232176
08826,GLEN GARDNER,NJ,1470,1534,64,0.5106524633821571
08827,HAMPTON,NJ,1181,1234,53,0.5109730848861284
08828,HELMETTA,NJ,940,812,-128,0.4634703196347032
08829,HIGH BRIDGE,NJ,1049,1004,-45,0.48904042864101316
08830,ISELIN,NJ,7102,6570,-532,0.4805441778818022
08831,JAMESBURG,NJ,4740,5624,884,0.5426476263990737
08831,MONROE,NJ,220,474,254,0.6829971181556196
08831,MONROE TOWNSHIP,NJ,10236,11867,1631,0.5368954440573678
08831,MONROE TWP,NJ,1139,1730,591,0.6029975601254792
08832,KEASBEY,NJ,1356,1102,-254,0.4483319772172498
08833,LEBANON,NJ,2733,2996,263,0.5229533950078548
08835,MANVILLE,NJ,3783,3164,-619,0.45544839499064343
08836,MARTINSVILLE,NJ,1032,1023,-9,0.4978102189781022
08837,EDISON,NJ,6779,5652,-1127,0.4546697771699783
08840,METUCHEN,NJ,5327,5352,25,0.501170521584418
08844,HILLSBOROUGH,NJ,10349,12006,1657,0.537061060165511
08846,MIDDLESEX,NJ,3878,3841,-37,0.49760331649177353
08848,MILFORD,NJ,2035,2138,103,0.5123412413132039
08850,MILLTOWN,NJ,1969,1998,29,0.5036551550289892
08852,MONMOUTH JCT,NJ,635,598,-37,0.48499594484995945
08852,MONMOUTH JUNCTION,NJ,5715,5596,-119,0.49473963398461673
08853,BRANCHBURG,NJ,801,873,72,0.521505376344086
08853,NESHANIC STA,NJ,39,35,-4,0.47297297297297297
08853,NESHANIC STATION,NJ,245,325,80,0.5701754385964912
08854,PISCATAWAY,NJ,17127,15700,-1427,0.4782648429646328
08855,PISCATAWAY,NJ,80,484,404,0.8581560283687943
08857,OLD BRIDGE,NJ,10641,11027,386,0.508907144175743
08858,OLDWICK,NJ,89,123,34,0.5801886792452831
08859,PARLIN,NJ,7654,6740,-914,0.46825065999722104
08861,HOPELAWN,NJ,302,240,-62,0.44280442804428044
08861,PERTH AMBOY,NJ,17682,14633,-3049,0.4528237660529166
08862,PERTH AMBOY,NJ,350,691,341,0.6637848222862632
08863,FORDS,NJ,4661,3659,-1002,0.43978365384615387
08865,PHILLIPSBURG,NJ,10348,10564,216,0.5051644988523336
08867,PITTSTOWN,NJ,1195,1304,109,0.5218087234893958
08869,RARITAN,NJ,3232,2889,-343,0.47198170233621956
08872,SAYREVILLE,NJ,5929,5380,-549,0.47572729684322224
08873,SOMERSET,NJ,20462,18947,-1515,0.4807785023725545
08875,E MILLSTONE,NJ,0,54,54,1
08875,EAST MILLSTONE,NJ,11,38,27,0.7755102040816326
08875,SOMERSET,NJ,263,663,400,0.7159827213822895
08876,BRAA,NJ,151,168,17,0.5266457680250783
08876,BRANCHBURG,NJ,1657,1712,55,0.5081626595428911
08876,SOMERVILLE,NJ,5853,5923,70,0.5029721467391305
08879,LAURENCE HARBOR,NJ,110,147,37,0.5719844357976653
08879,LAURENCE HBR,NJ,451,426,-25,0.48574686431014824
08879,SOUTH AMBOY,NJ,6739,6468,-271,0.48974028924055424
08880,SOUTH BOUND BROOK,NJ,2092,1502,-590,0.41791875347801893
08882,SOUTH RIVER,NJ,4619,3966,-653,0.4619685497961561
08884,SPOTSWOOD,NJ,2050,2062,12,0.5014591439688716
08886,STEWARTSVILLE,NJ,1595,1739,144,0.5215956808638272
08887,OLD BRIDGE,NJ,15,11,-4,0.4230769230769231
08887,THREE BRIDGES,NJ,339,218,-121,0.39138240574506283
08889,WHITE HSE STA,NJ,167,277,110,0.6238738738738738
08889,WHITEHOUSE STATION,NJ,2384,2931,547,0.5514581373471308
08901,NEW BRUNSWICK,NJ,15702,11124,-4578,0.41467233281145155
08902,NEW BRUNSWICK,NJ,379,402,23,0.5147247119078106
08902,NORTH BRUNSWICK,NJ,14472,13159,-1313,0.4762404545619051
08903,NEW BRUNSWICK,NJ,362,717,355,0.6645041705282669
08904,HIGHLAND PARK,NJ,6924,6027,-897,0.46536946953903174
08906,NEW BRUNSWICK,NJ,0,16,16,1
10001,NEW YORK,NY,30033,21848,-8185,0.42111755748732677
10002,NEW YORK,NY,28711,20060,-8651,0.41130999979496013
10003,NEW YORK,NY,37827,24106,-13721,0.389227067960538
10004,BOWLING GREEN,NY,53,45,-8,0.45918367346938777
10004,NEW YORK,NY,5743,3874,-1869,0.40282832484142667
10005,NEW YORK,NY,12880,10176,-2704,0.44136016655100624
10006,NEW YORK,NY,5391,3545,-1846,0.39670993733213966
10007,NEW YORK,NY,6829,6188,-641,0.47537835138664825
10008,NEW YORK,NY,407,498,91,0.5502762430939226
10009,NEW YORK,NY,34915,21830,-13085,0.38470349810556
10010,NEW YORK,NY,26140,16390,-9750,0.3853750293910181
10011,NEW YORK,NY,40267,25721,-14546,0.3897829908468206
10012,NEW YORK,NY,19877,11428,-8449,0.36505350582973967
10013,CANAL STREET,NY,1725,1069,-656,0.38260558339298495
10013,NEW YORK,NY,18549,12756,-5793,0.4074748442740776
10014,NEW YORK,NY,27132,16949,-10183,0.38449672194369455
10016,NEW YORK,NY,50806,30919,-19887,0.37832976445396144
10017,NEW YORK,NY,19560,13534,-6026,0.4089563062790838
10018,NEW YORK,NY,18143,11856,-6287,0.39521317377245907
10019,NEW YORK,NY,41050,30498,-10552,0.42625929445966343
10020,NEW YORK,NY,803,1207,404,0.6004975124378109
10021,NEW YORK,NY,27688,21076,-6612,0.4322040849807235
10022,NEW YORK,NY,30916,22286,-8630,0.4188940265403556
10023,NEW YORK,NY,44667,33050,-11617,0.42526088243241505
10023,SECHEDATY,NY,817,797,-20,0.49380421313506817
10024,NEW YORK,NY,35352,25279,-10073,0.41693193250977223
10025,NEW YORK,NY,47359,32621,-14738,0.40786446611652916
10026,NEW YORK,NY,14118,10571,-3547,0.42816638989023453
10027,NEW YORK,NY,23739,16337,-7402,0.40765046411817546
10028,NEW YORK,NY,31293,22594,-8699,0.4192847996733906
10029,NEW YORK,NY,23331,17058,-6273,0.42234271707643173
10030,NEW YORK,NY,10037,7053,-2984,0.4126974839087186
10031,NEW YORK,NY,21351,14069,-7282,0.3972049689440994
10032,NEW YORK,NY,20496,12980,-7516,0.38774047078504004
10033,NEW YORK,NY,17006,11403,-5603,0.4013868844380302
10034,NEW YORK,NY,12275,8553,-3722,0.4106491261763011
10035,NEW YORK,NY,11015,8842,-2173,0.44528377901999294
10036,NEW YORK,NY,28165,20330,-7835,0.41921847613155994
10037,NEW YORK,NY,7078,5219,-1859,0.42441245832316826
10038,NEW YORK,NY,16677,11726,-4951,0.4128437136922156
10039,NEW YORK,NY,7154,5137,-2017,0.4179480920999105
10040,NEW YORK,NY,12519,8353,-4166,0.40020122652357226
10040,NYC,NY,320,226,-94,0.4139194139194139
10044,NEW YORK,NY,4771,4247,-524,0.4709469948990907
10044,ROOSEVELT ISL,NY,525,369,-156,0.412751677852349
10044,ROOSEVELT ISLAND,NY,530,576,46,0.5207956600361664
10065,NEW YORK,NY,20648,15688,-4960,0.43174812857771905
10069,NEW YORK,NY,5182,4488,-694,0.4641158221302999
10075,NEW YORK,NY,15870,11551,-4319,0.4212464899164874
10101,NEW YORK,NY,436,563,127,0.5635635635635635
10105,NEW YORK,NY,242,473,231,0.6615384615384615
10106,NEW YORK,NY,244,97,-147,0.2844574780058651
10107,NEW YORK,NY,26,18,-8,0.4090909090909091
10108,NEW YORK,NY,289,197,-92,0.4053497942386831
10110,NEW YORK,NY,132,242,110,0.6470588235294118
10111,NEW YORK,NY,143,90,-53,0.38626609442060084
10113,NEW YORK,NY,174,341,167,0.6621359223300971
10115,NEW YORK,NY,26,23,-3,0.46938775510204084
10116,NEW YORK,NY,831,1107,276,0.5712074303405573
10118,NEW YORK,NY,66,24,-42,0.26666666666666666
10119,NEW YORK,NY,270,63,-207,0.1891891891891892
10121,NEW YORK,NY,0,50,50,1
10122,NEW YORK,NY,93,119,26,0.5613207547169812
10123,NEW YORK,NY,68,115,47,0.6284153005464481
10128,NEW YORK,NY,39914,29919,-9995,0.42843641258430826
10138,NEW YORK,NY,0,32,32,1
10150,NEW YORK,NY,974,1067,93,0.5227829495345419
10151,NEW YORK,NY,48,40,-8,0.45454545454545453
10152,NEW YORK,NY,69,756,687,0.9163636363636364
10155,NEW YORK,NY,87,55,-32,0.3873239436619718
10156,NEW YORK,NY,240,68,-172,0.22077922077922077
10159,NEW YORK,NY,340,234,-106,0.4076655052264808
10162,NEW YORK,NY,973,749,-224,0.4349593495934959
10163,NEW YORK,NY,1902,1549,-353,0.4488554042306578
10165,NEW YORK,NY,478,372,-106,0.4376470588235294
10166,NEW YORK,NY,170,185,15,0.5211267605633803
10167,NEW YORK,NY,15,0,-15,0
10168,NEW YORK,NY,274,49,-225,0.15170278637770898
10169,NEW YORK,NY,86,121,35,0.5845410628019324
10170,NEW YORK,NY,275,228,-47,0.4532803180914513
10171,NEW YORK,NY,0,23,23,1
10172,NEW YORK,NY,119,0,-119,0
10173,NEW YORK,NY,11,0,-11,0
10174,NEW YORK,NY,110,144,34,0.5669291338582677
10175,NEW YORK,NY,48,0,-48,0
10176,NEW YORK,NY,13,0,-13,0
10177,NEW YORK,NY,16,11,-5,0.4074074074074074
10178,NEW YORK,NY,44,0,-44,0
10185,NEW YORK,NY,457,346,-111,0.43088418430884184
10271,NEW YORK,NY,35,27,-8,0.43548387096774194
10272,NEW YORK,NY,75,76,1,0.5033112582781457
10276,NEW YORK,NY,318,444,126,0.5826771653543307
10279,NEW YORK,NY,125,11,-114,0.08088235294117647
10280,NEW YORK,NY,5682,4405,-1277,0.4367007038762764
10281,NEW YORK,NY,33,57,24,0.6333333333333333
10282,NEW YORK,NY,3861,2827,-1034,0.42269736842105265
10301,STATEN ISLAND,NY,11452,9770,-1682,0.4603713127886156
10302,STATEN ISLAND,NY,4556,4028,-528,0.46924510717614165
10303,STATEN ISLAND,NY,6860,5942,-918,0.4641462271520075
10304,STATEN ISLAND,NY,10547,9415,-1132,0.4716461276425208
10305,STATEN ISLAND,NY,10028,8913,-1115,0.4705664959611425
10306,STATEN ISLAND,NY,12850,12561,-289,0.4943134862854669
10307,STATEN ISLAND,NY,3048,3268,220,0.5174160861304623
10308,STATEN ISLAND,NY,6032,5953,-79,0.49670421360033373
10309,STATEN ISLAND,NY,7373,7583,210,0.5070205937416421
10310,STATEN ISLAND,NY,6160,5301,-859,0.46252508507111073
10312,STATEN ISLAND,NY,12386,12406,20,0.500403355921265
10313,STATEN ISLAND,NY,0,12,12,1
10314,STATEN ISLAND,NY,20899,18337,-2562,0.46735141196860025
10451,BRONX,NY,10483,10158,-325,0.4921273194128191
10452,BRONX,NY,15137,11510,-3627,0.43194355837430104
10453,BRONX,NY,16541,11949,-4592,0.4194103194103194
10454,BRONX,NY,7883,6162,-1721,0.4387326450694197
10455,BRONX,NY,8483,7005,-1478,0.4522856404958678
10456,BRONX,NY,18746,12742,-6004,0.40466209349593496
10457,BRONX,NY,17328,13052,-4276,0.4296247531270573
10458,BRONX,NY,19260,13492,-5768,0.41194430874450416
10459,BRONX,NY,9838,8154,-1684,0.453201422854602
10460,BRONX,NY,13623,11281,-2342,0.452979441053646
10461,BRONX,NY,16244,12831,-3413,0.4413069647463457
10462,BRONX,NY,23296,17166,-6130,0.4242499134990856
10463,BRONX,NY,19768,16329,-3439,0.4523644624206998
10464,BRONX,NY,1342,1408,66,0.512
10465,BRONX,NY,10939,9966,-973,0.47672805548911745
10466,BRONX,NY,17340,13182,-4158,0.431885197562414
10467,BRONX,NY,25818,19213,-6605,0.42666163309719973
10468,BRONX,NY,16135,11515,-4620,0.41645569620253164
10469,BRONX,NY,17060,13744,-3316,0.44617582132190625
10470,BRONX,NY,5010,4142,-868,0.45257867132867136
10471,BRONX,NY,6497,6086,-411,0.4836684415481205
10472,BRONX,NY,14433,10293,-4140,0.41628245571463235
10473,BRONX,NY,12181,10777,-1404,0.4694224235560589
10474,BRONX,NY,2855,2121,-734,0.4262459807073955
10475,BRONX,NY,6882,6901,19,0.500689254879199
10501,AMAWALK,NY,48,105,57,0.6862745098039216
10502,ARDSLEY,NY,1513,1639,126,0.5199873096446701
10504,ARMONK,NY,2397,2640,243,0.5241215008933889
10504,NORTH CASTLE,NY,36,47,11,0.5662650602409639
10505,BALDWIN PLACE,NY,545,626,81,0.5345858240819812
10506,BEDFORD,NY,1664,1890,226,0.5317951603826674
10507,BEDFORD HILLS,NY,1732,1628,-104,0.4845238095238095
10509,BREWSTER,NY,4738,5194,456,0.5229561014901329
10510,BRIARCLIFF,NY,80,118,38,0.5959595959595959
10510,BRIARCLIFF MANOR,NY,2235,2926,691,0.5669443906219724
10510,SCARBOROUGH,NY,34,32,-2,0.48484848484848486
10511,BUCHANAN,NY,571,529,-42,0.4809090909090909
10512,CARMEL,NY,6712,7346,634,0.5225494380423958
10514,CHAPPAQUA,NY,2970,3681,711,0.5534506089309879
10516,COLD SPRING,NY,1823,2040,217,0.5280869790318405
10516,NELSONVILLE,NY,38,46,8,0.5476190476190477
10517,CROMPOND,NY,76,41,-35,0.3504273504273504
10518,CROSS RIVER,NY,360,263,-97,0.42215088282504015
10519,CROTON FALLS,NY,0,12,12,1
10520,CROTON HDSN,NY,477,498,21,0.5107692307692308
10520,CROTON ON HUDSON,NY,3222,3582,360,0.5264550264550265
10522,DOBBS FERRY,NY,3689,3685,-4,0.49972877678329264
10523,ELMSFORD,NY,4643,4240,-403,0.4773162219970731
10524,GARRISON,NY,1307,1379,72,0.5134028294862248
10526,GOLDENS BRG,NY,66,93,27,0.5849056603773585
10526,GOLDENS BRIDGE,NY,407,445,38,0.5223004694835681
10527,GRANITE SPGS,NY,0,24,24,1
10527,GRANITE SPRINGS,NY,0,15,15,1
10528,HARRISON,NY,4008,4099,91,0.5056124336992722
10530,HARTSDALE,NY,4208,4184,-24,0.49857006673021925
10532,HAWTHORNE,NY,1070,1173,103,0.5229603209986625
10533,IRVINGTON,NY,2289,2585,296,0.5303652031185885
10535,JEFFERSON VALLEY,NY,130,69,-61,0.34673366834170855
10535,JEFFERSON VLY,NY,22,11,-11,0.3333333333333333
10536,KATONAH,NY,2589,3125,536,0.5469023451172559
10537,LAKE PEEKSKILL,NY,593,534,-59,0.4738243123336291
10537,LK PEEKSKILL,NY,20,14,-6,0.4117647058823529
10538,LARCHMONT,NY,5198,5693,495,0.5227251859333395
10540,LINCOLNDALE,NY,12,12,0,0.5
10541,MAHOPAC,NY,5414,5896,482,0.5213085764809903
10543,MAMARONECK,NY,6477,6300,-177,0.49307349142991314
10546,MILLWOOD,NY,262,246,-16,0.484251968503937
10547,MOHEGAN LAKE,NY,2111,2254,143,0.5163802978235968
10548,MONTROSE,NY,758,879,121,0.5369578497251069
10549,BEDFORD CORNERS,NY,469,483,14,0.5073529411764706
10549,MOUNT KISCO,NY,3956,3959,3,0.5001895135818067
10550,MOUNT VERNON,NY,12094,9563,-2531,0.441566237244309
10551,MOUNT VERNON,NY,0,325,325,1
10552,FLEETWOOD,NY,502,469,-33,0.48300720906282185
10552,MOUNT VERNON,NY,5297,4707,-590,0.47051179528188725
10553,MOUNT VERNON,NY,3336,2911,-425,0.4659836721626381
10560,NORTH SALEM,NY,1239,1358,119,0.522911051212938
10562,OSSINING,NY,8857,8011,-846,0.47492293099359734
10566,PEEKSKILL,NY,7847,7173,-674,0.47756324900133157
10567,CORTLANDT MANOR,NY,3588,4182,594,0.5382239382239382
10567,CORTLANDT MNR,NY,277,309,32,0.5273037542662116
10570,PLEASANTVILLE,NY,3078,3285,207,0.5162659123055162
10573,PORT CHESTER,NY,6953,6621,-332,0.48777073817592453
10573,RYE BROOK,NY,2648,2462,-186,0.4818003913894325
10576,POUND RIDGE,NY,1516,1862,346,0.5512137359384252
10577,PURCHASE,NY,976,1531,555,0.6106900678101316
10578,PURDYS,NY,11,49,38,0.8166666666666667
10579,PUTNAM VALLEY,NY,2214,2403,189,0.52046783625731
10580,RYE,NY,5523,6172,649,0.5277469003847798
10583,HEATHCOTE,NY,430,526,96,0.5502092050209205
10583,SCARSDALE,NY,9919,10889,970,0.5233083429450212
10588,SHRUB OAK,NY,659,460,-199,0.4110813226094727
10589,SOMERS,NY,3119,3476,357,0.5270659590598938
10590,SOUTH SALEM,NY,1608,1982,374,0.5520891364902507
10591,N TARRYTOWN,NY,284,260,-24,0.47794117647058826
10591,SLEEPY HOLLOW,NY,2360,2208,-152,0.48336252189141854
10591,TARRYTOWN,NY,5401,5226,-175,0.491766255763621
10594,THORNWOOD,NY,1012,1097,85,0.5201517306780464
10595,VALHALLA,NY,1695,1512,-183,0.4714686623012161
10596,VERPLANCK,NY,165,132,-33,0.4444444444444444
10597,WACCABUC,NY,241,271,30,0.529296875
10598,YORKTOWN HEIGHTS,NY,4892,5578,686,0.5327602674307546
10598,YORKTOWN HTS,NY,636,666,30,0.511520737327189
10601,WHITE PLAINS,NY,6930,5941,-989,0.46158029679123613
10602,WHITE PLAINS,NY,239,581,342,0.7085365853658536
10603,N WHITE PLAINS,NY,276,218,-58,0.44129554655870445
10603,WHITE PLAINS,NY,5584,4628,-956,0.4531923227575401
10604,W HARRISON,NY,259,227,-32,0.4670781893004115
10604,WEST HARRISON,NY,1915,2195,280,0.5340632603406326
10604,WHITE PLAINS,NY,1274,1274,0,0.5
10605,WHITE PLAINS,NY,5971,6035,64,0.5026653339996668
10606,WHITE PLAINS,NY,6040,5036,-1004,0.4546767786204406
10607,WHITE PLAINS,NY,1712,1868,156,0.5217877094972067
10701,YONKERS,NY,23639,19799,-3840,0.4557990699387633
10702,YONKERS,NY,365,1123,758,0.7547043010752689
10703,YONKERS,NY,6139,5453,-686,0.47041062801932365
10704,YONKERS,NY,9703,8927,-776,0.47917337627482554
10705,YONKERS,NY,11441,8994,-2447,0.44012723268901394
10706,HASTINGS HDSN,NY,322,303,-19,0.4848
10706,HASTINGS ON HUDSON,NY,2363,2334,-29,0.49691292314243135
10707,TUCKAHOE,NY,2990,2869,-121,0.48967400580303805
10707,YONKERS,NY,327,355,28,0.5205278592375366
10708,BRONXVILLE,NY,7272,6701,-571,0.4795677377800043
10708,YONKERS,NY,180,155,-25,0.4626865671641791
10709,EASTCHESTER,NY,2260,2372,112,0.5120898100172712
10710,YONKERS,NY,6560,6265,-295,0.4884990253411306
10801,NEW ROCHELLE,NY,12237,11287,-950,0.47980785580683555
10802,NEW ROCHELLE,NY,58,154,96,0.7264150943396226
10803,PELHAM,NY,3440,3478,38,0.5027464585140214
10804,NEW ROCHELLE,NY,2882,3794,912,0.5683043738765728
10804,WYKAGYL,NY,170,210,40,0.5526315789473685
10805,NEW ROCHELLE,NY,5569,4729,-840,0.4592153816275005
10901,SUFFERN,NY,7785,7203,-582,0.48058446757405926
10913,BLAUVELT,NY,1071,1113,42,0.5096153846153846
10914,BLOOMING GROVE,NY,53,0,-53,0
10915,BULLVILLE,NY,11,0,-11,0
10916,CAMPBELL HALL,NY,1147,1161,14,0.5030329289428076
10917,CENTRAL VALLEY,NY,674,623,-51,0.48033924441017734
10918,CHESTER,NY,3394,3301,-93,0.49305451829723673
10919,CIRCLEVILLE,NY,90,162,72,0.6428571428571429
10920,CONGERS,NY,2177,2077,-100,0.48824635637047487
10921,FLORIDA,NY,1127,1119,-8,0.4982190560997329
10922,FORT MONTGOMERY,NY,411,345,-66,0.45634920634920634
10923,GARNERVILLE,NY,3216,2607,-609,0.4477073673364245
10924,GOSHEN,NY,3779,4088,309,0.5196389983475277
10925,GREENWOOD LAKE,NY,1756,1492,-264,0.45935960591133007
10925,GREENWOOD LK,NY,33,38,5,0.5352112676056338
10926,HARRIMAN,NY,1825,1404,-421,0.43480953855682875
10927,HAVERSTRAW,NY,4818,3823,-995,0.44242564517995603
10928,HIGHLAND FALLS,NY,1761,1612,-149,0.4779128372368811
10928,HIGHLAND FLS,NY,165,134,-31,0.44816053511705684
10930,HIGHLAND MILLS,NY,2493,2277,-216,0.47735849056603774
10931,HILLBURN,NY,42,36,-6,0.46153846153846156
10940,MIDDLETOWN,NY,17995,16785,-1210,0.4826049453709028
10941,MIDDLETOWN,NY,5100,4947,-153,0.49238578680203043
10949,MONROE,NY,161,157,-4,0.4937106918238994
10950,MONROE,NY,8906,7977,-929,0.47248711721850384
10952,AIRMONT,NY,2537,1895,-642,0.427572202166065
10952,MONSEY,NY,3471,2645,-826,0.43247220405493786
10954,BARDONIA,NY,378,371,-7,0.4953271028037383
10954,NANUET,NY,6864,6564,-300,0.48882931188561213
10956,NEW CITY,NY,8041,8264,223,0.5068383931309415
10958,NEW HAMPTON,NY,916,822,-94,0.47295742232451093
10960,NYACK,NY,6215,5723,-492,0.4793935332551516
10962,ORANGEBURG,NY,1159,1319,160,0.5322841000807103
10963,BRONX,NY,15,20,5,0.5714285714285714
10963,OTISVILLE,NY,852,909,57,0.5161839863713799
10964,PALISADES,NY,77,142,65,0.6484018264840182
10965,PEARL RIVER,NY,3784,3671,-113,0.49242119382964455
10968,PIERMONT,NY,1323,1130,-193,0.4606604158173665
10969,PINE ISLAND,NY,154,234,80,0.6030927835051546
10970,POMONA,NY,3636,3214,-422,0.4691970802919708
10973,SLATE HILL,NY,532,471,-61,0.4695912263210369
10974,SLOATSBURG,NY,1052,1219,167,0.5367679436371643
10975,SOUTHFIELDS,NY,40,14,-26,0.25925925925925924
10976,SPARKILL,NY,234,306,72,0.5666666666666667
10977,CHESTNUT RIDGE,NY,742,506,-236,0.40544871794871795
10977,SPRING VALLEY,NY,11417,8638,-2779,0.4307155322862129
10980,STONY POINT,NY,3481,3462,-19,0.4986317153968025
10981,SUGAR LOAF,NY,41,0,-41,0
10982,TALLMAN,NY,91,45,-46,0.33088235294117646
10983,TAPPAN,NY,1132,1341,209,0.5422563687828549
10984,THIELLS,NY,510,517,7,0.5034079844206426
10986,TOMKINS COVE,NY,443,480,37,0.5200433369447454
10987,TUXEDO PARK,NY,1554,1526,-28,0.4954545454545455
10988,UNIONVILLE,NY,51,0,-51,0
10989,VALLEY COTTAGE,NY,2527,2507,-20,0.4980135081446166
10989,VLY COTTAGE,NY,112,134,22,0.5447154471544715
10990,WARWICK,NY,5466,5950,484,0.521198318149965
10992,WASHINGTONVILLE,NY,2391,2561,170,0.5171647819063004
10992,WASHINGTONVLE,NY,41,41,0,0.5
10993,W HAVERSTRAW,NY,61,68,7,0.5271317829457365
10993,WEST HAVERSTRAW,NY,1428,1329,-99,0.4820457018498368
10994,WEST NYACK,NY,1748,1868,120,0.5165929203539823
10996,WEST POINT,NY,1576,1575,-1,0.4998413202158045
10997,WEST POINT,NY,6436,129,-6307,0.01964965727341965
10998,WESTTOWN,NY,690,899,209,0.565764631843927
11001,BELLEROSE VILLAGE,NY,193,238,45,0.5522041763341067
11001,FLORAL PARK,NY,5648,5064,-584,0.4727408513816281
11001,SOUTH FLORAL PARK,NY,132,135,3,0.5056179775280899
11002,FLORAL PARK,NY,45,61,16,0.5754716981132075
11003,ELMONT,NY,10709,9146,-1563,0.4606396373709393
11004,FLORAL PARK,NY,476,379,-97,0.4432748538011696
11004,GLEN OAKS,NY,3056,2677,-379,0.46694575266003835
11005,FLORAL PARK,NY,1997,1872,-125,0.4838459550271388
11010,FRANKLIN SQ,NY,301,289,-12,0.48983050847457626
11010,FRANKLIN SQUARE,NY,4625,4791,166,0.5088147833474936
11020,GREAT NECK,NY,1422,1486,64,0.5110041265474553
11020,LAKE SUCCESS,NY,19,28,9,0.5957446808510638
11021,GREAT NCK PLZ,NY,224,166,-58,0.42564102564102563
11021,GREAT NECK,NY,7462,7111,-351,0.487957181088314
11021,GREAT NECK PLAZA,NY,100,160,60,0.6153846153846154
11022,GREAT NECK,NY,61,127,66,0.675531914893617
11023,GREAT NECK,NY,2499,2725,226,0.5216309341500766
11024,GREAT NECK,NY,1409,1447,38,0.5066526610644257
11024,KINGS POINT,NY,252,323,71,0.5617391304347826
11030,MANHASSET,NY,4140,5114,974,0.5526258915063756
11030,PLANDOME,NY,255,244,-11,0.48897795591182364
11040,GARDEN CITY PARK,NY,408,377,-31,0.4802547770700637
11040,N NEW HYDE PK,NY,161,237,76,0.5954773869346733
11040,NEW HYDE PARK,NY,7414,7793,379,0.512461366475965
11042,N NEW HYDE PK,NY,28,44,16,0.6111111111111112
11042,NEW HYDE PARK,NY,404,217,-187,0.3494363929146538
11042,NORTH NEW HYDE PARK,NY,0,11,11,1
11050,PORT WASHINGTON,NY,9257,9055,-202,0.49448449104412406
11096,INWOOD,NY,2207,1755,-452,0.44295810196870267
11101,ASTORIA,NY,487,471,-16,0.49164926931106473
11101,LONG IS CITY,NY,3948,3726,-222,0.48553557466770914
11101,LONG ISLAND CITY,NY,26903,24190,-2713,0.47345037480672497
11102,ASTORIA,NY,16204,12396,-3808,0.4334265734265734
11102,LONG ISLAND CITY,NY,1085,908,-177,0.45559458103361766
11103,ASTORIA,NY,17553,12522,-5031,0.41635910224438905
11103,LONG ISLAND CITY,NY,495,330,-165,0.4
11104,ASTORIA,NY,393,193,-200,0.3293515358361775
11104,LONG IS CITY,NY,236,178,-58,0.42995169082125606
11104,LONG ISLAND CITY,NY,1202,961,-241,0.444290337494221
11104,SUNNYSIDE,NY,9903,7424,-2479,0.42846424655162463
11105,ASTORIA,NY,15546,12318,-3228,0.4420757967269595
11105,LONG ISLAND CITY,NY,230,193,-37,0.4562647754137116
11106,ASTORIA,NY,15688,11776,-3912,0.42877949315467523
11106,LONG IS CITY,NY,955,655,-300,0.40683229813664595
11106,LONG ISLAND CITY,NY,1708,1369,-339,0.4449138771530712
11109,LONG IS CITY,NY,1259,1010,-249,0.44513001322168355
11109,LONG ISLAND CITY,NY,5485,4347,-1138,0.44212774613506917
11201,BROOKLYN,NY,46337,37419,-8918,0.4467620230192464
11202,BROOKLYN,NY,700,1057,357,0.601593625498008
11203,BROOKLYN,NY,15850,12409,-3441,0.43911674156905767
11204,BROOKLYN,NY,15948,11731,-4217,0.4238231149969291
11205,BROOKLYN,NY,15778,12094,-3684,0.4339121699196326
11206,BROOKLYN,NY,29160,22047,-7113,0.4305466049563536
11207,BROOKLYN,NY,23639,18065,-5574,0.4331718779973144
11208,BROOKLYN,NY,21889,16128,-5761,0.42423126496041247
11209,BROOKLYN,NY,22239,18431,-3808,0.453184165232358
11210,BROOKLYN,NY,12621,10754,-1867,0.46006417112299464
11211,BROOKLYN,NY,32922,25313,-7609,0.43466987207006097
11212,BROOKLYN,NY,17005,13509,-3496,0.4427148194271482
11213,BROOKLYN,NY,18546,13374,-5172,0.418984962406015
11214,BROOKLYN,NY,21257,15877,-5380,0.4275596488393386
11215,BROOKLYN,NY,36224,29101,-7123,0.44548029085342516
11216,BROOKLYN,NY,29594,22711,-6883,0.43420323104865693
11217,BROOKLYN,NY,24292,20087,-4205,0.45262398882354266
11218,BROOKLYN,NY,20331,15561,-4770,0.4335506519558676
11219,BROOKLYN,NY,15303,9954,-5349,0.39410856396246585
11220,BROOKLYN,NY,22851,15892,-6959,0.410190227912139
11221,BROOKLYN,NY,36298,27707,-8591,0.43288805562065463
11222,BROOKLYN,NY,25410,21548,-3862,0.45887814642872354
11223,BROOKLYN,NY,17377,12820,-4557,0.4245454846507931
11224,BROOKLYN,NY,8950,9215,265,0.5072942471786402
11225,BROOKLYN,NY,21198,16031,-5167,0.4306051733863386
11226,BROOKLYN,NY,32414,25401,-7013,0.4393496497448759
11228,BROOKLYN,NY,9177,7655,-1522,0.4547884980988593
11229,BROOKLYN,NY,17882,15083,-2799,0.45754588199605645
11230,BROOKLYN,NY,20905,16728,-4177,0.44450349427364283
11231,BROOKLYN,NY,17198,14004,-3194,0.4488173835010576
11232,BROOKLYN,NY,8280,6071,-2209,0.42303672217963906
11233,BROOKLYN,NY,22091,17010,-5081,0.43502723715506
11234,BROOKLYN,NY,16791,15480,-1311,0.47968764525425306
11235,BROOKLYN,NY,22144,18931,-3213,0.46088861838101036
11236,BROOKLYN,NY,19106,15042,-4064,0.4404943188473703
11237,BROOKLYN,NY,20717,14437,-6280,0.41067872788302895
11238,BROOKLYN,NY,34111,26875,-7236,0.44067490899550715
11239,BROOKLYN,NY,2527,3904,1377,0.6070595552791168
11241,BROOKLYN,NY,97,0,-97,0
11242,BROOKLYN,NY,210,22,-188,0.09482758620689655
11243,BROOKLYN,NY,62,24,-38,0.27906976744186046
11247,BROOKLYN,NY,0,78,78,1
11249,BROOKLYN,NY,17706,15417,-2289,0.4654469703831175
11352,FLUSHING,NY,146,465,319,0.7610474631751227
11354,FLUSHING,NY,17258,14483,-2775,0.4562868214612016
11355,FLUSHING,NY,23686,18306,-5380,0.43594017908172983
11356,COLLEGE POINT,NY,7743,5604,-2139,0.4198696336255338
11357,BEECHHURST,NY,536,442,-94,0.45194274028629855
11357,FLUSHING,NY,188,209,21,0.5264483627204031
11357,WHITESTONE,NY,8863,8322,-541,0.484259528658714
11358,AUBURNDALE,NY,349,371,22,0.5152777777777777
11358,FLUSHING,NY,10054,9065,-989,0.4741356765521209
11360,BAYSIDE,NY,5939,5916,-23,0.499029945170814
11361,BAYSIDE,NY,7901,7399,-502,0.4835947712418301
11361,FLUSHING,NY,190,184,-6,0.4919786096256685
11362,DOUGLASTON,NY,1436,1413,-23,0.495963495963496
11362,FLUSHING,NY,59,91,32,0.6066666666666667
11362,LITTLE NECK,NY,2968,2790,-178,0.4845432441820076
11363,DOUGLASTON,NY,529,600,71,0.5314437555358724
11363,FLUSHING,NY,38,28,-10,0.42424242424242425
11363,LITTLE NECK,NY,1195,1267,72,0.5146222583265637
11364,BAYSIDE,NY,2908,2728,-180,0.48403122782114977
11364,BAYSIDE HILLS,NY,691,616,-75,0.47130833970925784
11364,OAKLAND GARDENS,NY,5200,4929,-271,0.48662256886168426
11365,FLUSHING,NY,997,874,-123,0.467129877071085
11365,FRESH MEADOWS,NY,10712,9276,-1436,0.4640784470682409
11366,FLUSHING,NY,557,505,-52,0.4755178907721281
11366,FRESH MEADOWS,NY,2759,2638,-121,0.4887900685566055
11367,FLUSHING,NY,9277,7445,-1832,0.4452218634134673
11367,KEW GARDENS HILLS,NY,611,484,-127,0.4420091324200913
11368,CORONA,NY,18247,11689,-6558,0.39046632816675575
11369,EAST ELMHURST,NY,7466,5588,-1878,0.428068025126398
11369,FLUSHING,NY,182,146,-36,0.4451219512195122
11370,EAST ELMHURST,NY,6337,5111,-1226,0.4464535290006988
11370,FLUSHING,NY,304,260,-44,0.46099290780141844
11372,FLUSHING,NY,696,495,-201,0.4156171284634761
11372,JACKSON HEIGHTS,NY,16502,11903,-4599,0.4190459426157367
11373,ELMHURST,NY,25576,17957,-7619,0.41249167298371353
11374,REGO PARK,NY,14888,11759,-3129,0.441287949863024
11375,FLUSHING,NY,496,344,-152,0.4095238095238095
11375,FOREST HILLS,NY,23571,19389,-4182,0.4513268156424581
11377,FLUSHING,NY,782,496,-286,0.38810641627543035
11377,WOODSIDE,NY,25719,18460,-7259,0.41784558274293215
11378,MASPETH,NY,8442,7172,-1270,0.45933136928397594
11379,FLUSHING,NY,143,124,-19,0.46441947565543074
11379,MIDDLE VILLAGE,NY,7832,6841,-991,0.4662304913787228
11379,MIDDLE VLG,NY,151,140,-11,0.48109965635738833
11380,ELMHURST,NY,13,12,-1,0.48
11385,FLUSHING,NY,2661,1836,-825,0.4082721814543029
11385,GLENDALE,NY,5043,3782,-1261,0.4285552407932011
11385,RIDGEWOOD,NY,21848,16784,-5064,0.43445848001656656
11386,RIDGEWOOD,NY,22,263,241,0.9228070175438596
11411,CAMBRIA HEIGHTS,NY,4156,3914,-242,0.48500619578686494
11411,JAMAICA,NY,99,73,-26,0.42441860465116277
11412,JAMAICA,NY,149,138,-11,0.4808362369337979
11412,SAINT ALBANS,NY,8717,7528,-1189,0.46340412434595263
11413,LAURELTON,NY,3926,3462,-464,0.46859772604223066
11413,SPRINGFIELD GARDENS,NY,4962,4352,-610,0.4672535967360962
11413,SPRNGFLD GDNS,NY,402,346,-56,0.4625668449197861
11414,HOWARD BEACH,NY,6403,6276,-127,0.4949917185897941
11415,KEW GARDENS,NY,6903,5083,-1820,0.4240780911062907
11416,JAMAICA,NY,144,131,-13,0.4763636363636364
11416,OZONE PARK,NY,6623,4719,-1904,0.41606418621054486
11417,JAMAICA,NY,426,325,-101,0.43275632490013316
11417,OZONE PARK,NY,6864,5675,-1189,0.45258792567190365
11418,JAMAICA,NY,801,594,-207,0.4258064516129032
11418,KEW GARDENS,NY,457,335,-122,0.42297979797979796
11418,RICHMOND HILL,NY,8093,5914,-2179,0.4222174626972228
11419,JAMAICA,NY,933,691,-242,0.42549261083743845
11419,S RICHMOND HL,NY,2011,1298,-713,0.3922635237231792
11419,SOUTH RICHMOND HILL,NY,8384,5800,-2584,0.40891144952058656
11420,JAMAICA,NY,725,541,-184,0.4273301737756714
11420,S OZONE PARK,NY,1479,1290,-189,0.4658721560130011
11420,SOUTH OZONE PARK,NY,8249,6930,-1319,0.45655181500757624
11421,JAMAICA,NY,183,157,-26,0.46176470588235297
11421,WOODHAVEN,NY,9668,7426,-2242,0.43442143442143444
11422,JAMAICA,NY,142,129,-13,0.47601476014760147
11422,ROSEDALE,NY,7447,6181,-1266,0.4535515115937775
11423,HOLLIS,NY,7140,5755,-1385,0.446297014346646
11423,NEW YORK CITY,NY,141,120,-21,0.45977011494252873
11426,BELLEROSE,NY,4818,4479,-339,0.48176831235882545
11427,BELLEROSE MANOR,NY,215,254,39,0.5415778251599147
11427,JAMAICA,NY,537,392,-145,0.4219590958019376
11427,QUEENS VILLAGE,NY,4029,3404,-625,0.4579577559531818
11427,QUEENS VLG,NY,505,376,-129,0.4267877412031782
11428,QUEENS VILLAGE,NY,4426,4108,-318,0.4813686430747598
11428,QUEENS VLG,NY,90,118,28,0.5673076923076923
11429,JAMAICA,NY,98,64,-34,0.3950617283950617
11429,QUEENS VILLAGE,NY,5611,4225,-1386,0.4295445302968686
11429,QUEENS VLG,NY,148,117,-31,0.44150943396226416
11430,JAMAICA,NY,11,67,56,0.8589743589743589
11431,JAMAICA,NY,326,865,539,0.7262804366078925
11432,JAMAICA,NY,16286,12347,-3939,0.431215730101631
11433,CALVERTON,NY,210,206,-4,0.4951923076923077
11433,JAMAICA,NY,7855,6575,-1280,0.4556479556479556
11434,JAMAICA,NY,14525,12871,-1654,0.46981311140312454
11435,BRIARWOOD,NY,3718,3187,-531,0.46154960173787113
11435,JAMAICA,NY,10508,9339,-1169,0.4705497052451252
11436,JAMAICA,NY,4299,3393,-906,0.4411076443057722
11436,SOUTH OZONE PARK,NY,107,95,-12,0.47029702970297027
11501,MINEOLA,NY,7667,6718,-949,0.4670142509558568
11507,ALBERTSON,NY,1732,1686,-46,0.49327091866588646
11509,ATLANTIC BCH,NY,177,166,-11,0.4839650145772595
11509,ATLANTIC BEACH,NY,897,1071,174,0.5442073170731707
11510,BALDWIN,NY,3725,3570,-155,0.4893762851267992
11510,NORTH BALDWIN,NY,4536,4395,-141,0.4921061471279812
11514,CARLE PLACE,NY,1550,1426,-124,0.4791666666666667
11516,CEDARHURST,NY,2683,2480,-203,0.48034088708115436
11518,EAST ROCKAWAY,NY,2804,2913,109,0.5095329718383768
11520,FREEPORT,NY,13571,12202,-1369,0.473441198153106
11530,GARDEN CITY,NY,7248,8230,982,0.531722444760305
11530,GARDEN CITY SOUTH,NY,502,519,17,0.5083251714005876
11542,GLEN COVE,NY,8790,8768,-22,0.49937350495500626
11545,GLEN HEAD,NY,2873,3367,494,0.5395833333333333
11547,GLENWOOD LANDING,NY,52,139,87,0.7277486910994765
11548,GREENVALE,NY,369,477,108,0.5638297872340425
11550,HEMPSTEAD,NY,14013,10576,-3437,0.4301110252551954
11550,SOUTH HEMPSTEAD,NY,1576,1182,-394,0.42857142857142855
11551,HEMPSTEAD,NY,294,1011,717,0.774712643678161
11552,W HEMPSTEAD,NY,627,613,-14,0.49435483870967745
11552,WEST HEMPSTEAD,NY,5608,5349,-259,0.4881810714611664
11553,UNIONDALE,NY,8169,6588,-1581,0.4464322016670055
11554,EAST MEADOW,NY,9613,9153,-460,0.48774379196419054
11556,UNIONDALE,NY,687,49,-638,0.06657608695652174
11557,HEWLETT,NY,2656,2732,76,0.5070527097253155
11558,ISLAND PARK,NY,2600,2664,64,0.506079027355623
11558,UNIONDALE,NY,43,120,77,0.7361963190184049
11559,LAWRENCE,NY,2376,2308,-68,0.4927412467976089
11560,LOCUST VALLEY,NY,2061,2233,172,0.5200279459711225
11561,E ATLANTC BCH,NY,367,351,-16,0.48885793871866295
11561,E ATLANTIC BEACH,NY,336,401,65,0.5440976933514247
11561,EAST ATLANTIC BEACH,NY,301,234,-67,0.4373831775700935
11561,LIDO BEACH,NY,1081,796,-285,0.42408098028769314
11561,LONG BEACH,NY,13945,12594,-1351,0.4745468932514413
11563,LYNBROOK,NY,5802,5545,-257,0.48867542081607473
11565,MALVERNE,NY,1869,1925,56,0.507380073800738
11566,MERRICK,NY,6681,7014,333,0.51215772179627606
11566,N MERRICK,NY,613,679,66,0.5255417956656346
11566,NORTH MERRICK,NY,116,174,58,0.6
11566,UNIONDALE,NY,168,127,-41,0.43050847457627117
11568,OLD WESTBURY,NY,840,1066,226,0.559286463798531
11569,POINT LOOKOUT,NY,720,678,-42,0.48497854077253216
11570,ROCKVILLE CENTRE,NY,7114,6919,-195,0.4930520914986104
11570,ROCKVILLE CTR,NY,612,632,20,0.5080385852090032
11571,ROCKVILLE CENTRE,NY,12,125,113,0.9124087591240876
11572,OCEANSIDE,NY,7465,7687,222,0.5073257655755016
11575,ROOSEVELT,NY,5702,5016,-686,0.4679977607762642
11576,ROSLYN,NY,3507,4027,520,0.5345102203344837
11577,ROSLYN HEIGHTS,NY,3134,3292,158,0.5122938064114535
11577,ROSLYN HTS,NY,69,44,-25,0.3893805309734513
11579,SEA CLIFF,NY,1502,1586,84,0.5136010362694301
11580,VALLEY STREAM,NY,9606,8404,-1202,0.4666296501943365
11581,VALLEY STREAM,NY,4942,4678,-264,0.4862785862785863
11582,VALLEY STREAM,NY,339,956,617,0.7382239382239382
11590,WESTBURY,NY,14636,12678,-1958,0.46415757487003
11596,EAST WILLISTON,NY,488,460,-28,0.48523206751054854
11596,WILLISTON PARK,NY,1596,1559,-37,0.49413629160063394
11596,WILLISTON PK,NY,40,37,-3,0.4805194805194805
11598,WOODMERE,NY,3493,3605,112,0.5078895463510849
11690,FAR ROCKAWAY,NY,14,249,235,0.9467680608365019
11691,FAR ROCKAWAY,NY,12405,9946,-2459,0.44499127555814055
11692,ARVERNE,NY,4871,4337,-534,0.47100347523892266
11692,FAR ROCKAWAY,NY,210,196,-14,0.4827586206896552
11693,BROAD CHANNEL,NY,99,93,-6,0.484375
11693,FAR ROCKAWAY,NY,238,240,2,0.502092050209205
11693,ROCKAWAY BEACH,NY,2244,2215,-29,0.4967481498093743
11694,BELLE HARBOR,NY,883,909,26,0.5072544642857143
11694,FAR ROCKAWAY,NY,534,467,-67,0.46653346653346656
11694,NEPONSIT,NY,388,409,21,0.5131744040150564
11694,ROCKAWAY PARK,NY,2853,2903,50,0.5043432939541348
11697,BREEZY POINT,NY,917,1260,343,0.5787781350482315
11697,ROCKAWAY POINT,NY,163,379,216,0.6992619926199262
11701,AMITYVILLE,NY,9587,8371,-1216,0.46614322307606637
11702,BABYLON,NY,4388,4386,-2,0.49988602689765216
11702,OAK BEACH,NY,82,111,29,0.5751295336787565
11702,WEST GILGO BEACH,NY,85,131,46,0.6064814814814815
11703,BABYLON,NY,112,92,-20,0.45098039215686275
11703,NORTH BABYLON,NY,4542,4467,-75,0.4958374958374958
11704,WEST BABYLON,NY,11743,10861,-882,0.4804901787294284
11705,BAYPORT,NY,2682,2706,24,0.5022271714922049
11706,BAY SHORE,NY,20649,17762,-2887,0.46241961937986514
11709,BAYVILLE,NY,1995,1906,-89,0.48859266854652655
11710,BELLMORE,NY,2790,2731,-59,0.4946567650787901
11710,NORTH BELLMORE,NY,5118,4919,-199,0.49008667928663946
11713,BELLPORT,NY,5170,4667,-503,0.47443326217342685
11714,BETHPAGE,NY,5884,5790,-94,0.4959739592256296
11715,BLUE POINT,NY,1255,1260,5,0.5009940357852882
11716,BOHEMIA,NY,4410,3894,-516,0.4689306358381503
11717,BRENTWOOD,NY,17376,13636,-3740,0.43970076099574357
11718,BRIGHTWATERS,NY,1478,1053,-425,0.4160410904780719
11719,BROOKHAVEN,NY,1082,1153,71,0.5158836689038031
11720,CENTEREACH,NY,5960,5666,-294,0.487355926371925
11720,SOUTH SETAUKET,NY,1715,1441,-274,0.45659062103929027
11721,CENTERPORT,NY,2000,1952,-48,0.4939271255060729
11722,CENTRAL ISLIP,NY,12256,10900,-1356,0.47072033166349975
11724,COLD SPG HBR,NY,39,38,-1,0.4935064935064935
11724,COLD SPRING HARBOR,NY,901,1014,113,0.5295039164490861
11725,COMMACK,NY,6883,7482,599,0.5208492864601462
11726,COPIAGUE,NY,6752,5817,-935,0.4628053146630599
11727,CORAM,NY,12427,11091,-1336,0.4715962241687218
11729,DEER PARK,NY,8244,7970,-274,0.49155051190329346
11730,EAST ISLIP,NY,3738,3680,-58,0.4960905904556484
11730,SUNRISE HWY,NY,87,97,10,0.5271739130434783
11731,E NORTHPORT,NY,521,667,146,0.5614478114478114
11731,EAST NORTHPORT,NY,5810,6526,716,0.5290207522697795
11732,EAST NORWICH,NY,1324,1160,-164,0.4669887278582931
11733,EAST SETAUKET,NY,2165,2089,-76,0.4910672308415609
11733,SETAUKET,NY,3100,3666,566,0.5418267809636418
11735,FARMINGDALE,NY,9766,8237,-1529,0.45753485530189414
11738,FARMINGVILLE,NY,4925,4745,-180,0.4906928645294726
11739,GREAT RIVER,NY,102,149,47,0.5936254980079682
11740,GREENLAWN,NY,2109,2357,248,0.5277653381101657
11741,HOLBROOK,NY,8580,7961,-619,0.4812889184450759
11742,HOLTSVILLE,NY,3672,3414,-258,0.48179508890770534
11743,HALESITE,NY,1218,1254,36,0.5072815533980582
11743,HUNTINGTON,NY,10993,11678,685,0.5151074059371002
11743,LLOYD HARBOR,NY,287,323,36,0.5295081967213114
11746,DIX HILLS,NY,3207,3344,137,0.5104564188673485
11746,HUNTINGTN STA,NY,408,445,37,0.5216881594372802
11746,HUNTINGTON STATION,NY,12948,12626,-322,0.49370454367717215
11747,MELVILLE,NY,8726,9355,629,0.5173939494496986
11749,CENTRAL ISLIP,NY,22,23,1,0.5111111111111111
11749,ISLANDIA,NY,1293,1136,-157,0.4676821737340469
11751,ISLIP,NY,4260,4012,-248,0.48500967117988397
11752,ISLIP TERRACE,NY,2772,2412,-360,0.4652777777777778
11753,JERICHO,NY,4621,5849,1228,0.5586437440305635
11754,KINGS PARK,NY,4559,4412,-147,0.491806933452235
11755,LAKE GROVE,NY,4180,3805,-375,0.4765184721352536
11756,LEVITTOWN,NY,9773,8999,-774,0.47938418921798426
11757,LINDENHURST,NY,12366,11480,-886,0.4814224607900696
11758,MASSAPEQUA,NY,12338,12052,-286,0.4941369413694137
11762,MASSAPEQUA PARK,NY,4000,4205,205,0.5124923826934796
11762,MASSAPEQUA PK,NY,69,69,0,0.5
11763,MEDFORD,NY,8820,8496,-324,0.49064449064449067
11764,MILLER PLACE,NY,3313,3362,49,0.5036704119850187
11765,MILL NECK,NY,52,83,31,0.6148148148148148
11766,MOUNT SINAI,NY,3495,4072,577,0.5381260737412449
11767,NESCONSET,NY,3497,3514,17,0.5012123805448581
11768,NORTHPORT,NY,5783,6473,690,0.5281494778067886
11769,OAKDALE,NY,3432,2936,-496,0.4610552763819096
11770,OCEAN BEACH,NY,510,538,28,0.5133587786259542
11771,OYSTER BAY,NY,3065,3120,55,0.5044462409054163
11772,EAST PATCHOGUE,NY,7553,7298,-255,0.4914147195475052
11772,PATCHOGUE,NY,8037,7162,-875,0.47121521152707413
11776,PORT JEFF STA,NY,611,563,-48,0.479557069846678
11776,PORT JEFFERSON STATION,NY,7181,6890,-291,0.48965958354061545
11777,PORT JEFFERSON,NY,4099,3781,-318,0.4798223350253807
11778,ROCKY POINT,NY,3987,3788,-199,0.4872025723472669
11779,RONKONKOMA,NY,13029,11732,-1297,0.4738096199668834
11780,SAINT JAMES,NY,4334,4599,265,0.5148326430090675
11782,CHERRY GROVE,NY,648,435,-213,0.40166204986149584
11782,FIRE IS PINES,NY,107,70,-37,0.3954802259887006
11782,SAYVILLE,NY,4844,4565,-279,0.48517376979487725
11783,SEAFORD,NY,4125,4247,122,0.5072861920688008
11784,SELDEN,NY,7718,7169,-549,0.4815610935715725
11786,SHOREHAM,NY,1814,1675,-139,0.4800802522212668
11787,SMITHTOWN,NY,9052,9227,175,0.5047869139449642
11788,HAUPPAUGE,NY,6552,6280,-272,0.48940149625935164
11788,SMITHTOWN,NY,121,135,14,0.52734375
11789,SOUND BEACH,NY,2456,2362,-94,0.49024491490244915
11790,STONY BROOK,NY,4317,4255,-62,0.49638357442837144
11791,SYOSSET,NY,6504,7026,522,0.519290465631929
11792,WADING RIVER,NY,2364,2370,6,0.5006337135614702
11793,WANTAGH,NY,6214,6568,354,0.5138475981849476
11795,WEST ISLIP,NY,5244,5221,-23,0.4989010989010989
11796,WEST SAYVILLE,NY,919,841,-78,0.4778409090909091
11797,WOODBURY,NY,3708,3990,282,0.5183164458300857
11798,MASSAPEQUA,NY,125,106,-19,0.4588744588744589
11798,WHEATLEY HEIGHTS,NY,1743,1535,-208,0.4682733374008542
11798,WHEATLEY HTS,NY,105,85,-20,0.4473684210526316
11798,WYANDANCH,NY,3431,2995,-436,0.46607531901649546
11801,HICKSVILLE,NY,12149,10583,-1566,0.46555516452577866
11802,HICKSVILLE,NY,950,1039,89,0.5223730517848165
11803,PLAINVIEW,NY,7590,8603,1013,0.5312789476934477
11804,OLD BETHPAGE,NY,1047,1171,124,0.5279531109107304
11901,RIVERHEAD,NY,9041,8035,-1006,0.4705434527992504
11930,AMAGANSETT,NY,1694,1759,65,0.5094121054155807
11931,AQUEBOGUE,NY,763,222,-541,0.22538071065989848
11931,RIVERHEAD,NY,14,19,5,0.5757575757575758
11932,BRIDGEHAMPTON,NY,1767,1262,-505,0.4166391548365797
11933,BAITING HOLLOW,NY,178,204,26,0.5340314136125655
11933,CALVERTON,NY,2304,2279,-25,0.49727252891119356
11934,CENTER MORICHES,NY,2411,2465,54,0.5055373256767842
11934,CTR MORICHES,NY,88,66,-22,0.42857142857142855
11935,CUTCHOGUE,NY,1603,1881,278,0.5398966704936854
11937,EAST HAMPTON,NY,8875,11623,2748,0.5670309298468144
11939,EAST MARION,NY,442,509,67,0.5352260778128286
11940,EAST MORICHES,NY,1927,1952,25,0.5032224800206239
11941,EASTPORT,NY,1186,935,-251,0.4408297972654408
11942,EAST QUOGUE,NY,2427,2391,-36,0.4962640099626401
11944,GREENPORT,NY,1904,2047,143,0.5180966843837004
11946,HAMPTON BAYS,NY,7355,5886,-1469,0.4445283588852806
11947,JAMAICA,NY,19,15,-4,0.4411764705882353
11947,JAMESPORT,NY,211,257,46,0.5491452991452992
11948,LAUREL,NY,530,438,-92,0.4524793388429752
11949,MANORVILLE,NY,4427,4157,-270,0.4842730661696179
11950,MASTIC,NY,5223,4672,-551,0.47215765538150584
11951,MASTIC BEACH,NY,6102,5044,-1058,0.4525390274537951
11952,MATTITUCK,NY,1809,1971,162,0.5214285714285715
11953,MIDDLE ISLAND,NY,5745,4831,-914,0.4567889561270802
11954,MONTAUK,NY,2868,2985,117,0.5099948744233727
11955,MORICHES,NY,2386,1986,-400,0.45425434583714547
11956,NEW SUFFOLK,NY,34,15,-19,0.30612244897959184
11957,ORIENT,NY,386,642,256,0.6245136186770428
11958,PECONIC,NY,173,216,43,0.5552699228791774
11959,QUOGUE,NY,2179,1547,-632,0.4151905528717123
11960,REMSENBURG,NY,905,959,54,0.5144849785407726
11961,RIDGE,NY,5117,5100,-17,0.49916805324459235
11962,SAGAPONACK,NY,506,396,-110,0.43902439024390244
11963,SAG HARBOR,NY,4917,5632,715,0.5338894681960376
11964,SHELTER IS,NY,236,167,-69,0.4143920595533499
11964,SHELTER ISLAND,NY,685,793,108,0.5365358592692828
11965,SHELTER IS HT,NY,86,129,43,0.6
11965,SHELTER ISLAND HEIGHTS,NY,1026,907,-119,0.4692188308329022
11967,SHIRLEY,NY,8096,8030,-66,0.4979536152796726
11967,SMITH POINT,NY,309,366,57,0.5422222222222223
11968,SOUTHAMPTON,NY,6776,7574,798,0.5278048780487805
11969,SOUTHAMPTON,NY,1387,1284,-103,0.4807188318981655
11970,S JAMESPORT,NY,0,20,20,1
11970,SOUTH JAMESPORT,NY,56,63,7,0.5294117647058824
11971,SOUTHOLD,NY,2604,2881,277,0.5252506836827712
11972,SPEONK,NY,93,176,83,0.654275092936803
11973,UPTON,NY,11,0,-11,0
11975,WAINSCOTT,NY,684,798,114,0.5384615384615384
11976,WATER MILL,NY,1835,2211,376,0.546465645081562
11977,WESTHAMPTON,NY,2032,1997,-35,0.49565649044427895
11978,WESTHAMPTON BEACH,NY,3527,3203,-324,0.47592867756315005
11980,YAPHANK,NY,2048,2646,598,0.5636983383042181
12009,ALTAMONT,NY,2684,2857,173,0.5156109005594658
12010,AMSTERDAM,NY,12917,11966,-951,0.48089056785757345
12015,ATHENS,NY,1401,1521,120,0.5205338809034907
12017,AUSTERLITZ,NY,51,41,-10,0.44565217391304346
12018,AVERILL PARK,NY,2509,2461,-48,0.49517102615694164
12019,BALLSTON LAKE,NY,4910,5334,424,0.5206950409996095
12020,BALLSTON SPA,NY,14560,14290,-270,0.4953206239168111
12020,MALTA,NY,1291,1352,61,0.5115399167612561
12022,BERLIN,NY,151,33,-118,0.1793478260869565
12023,BERNE,NY,314,484,170,0.606516290726817
12025,BROADALBIN,NY,2400,2242,-158,0.4829814735028005
12027,BURNT HILLS,NY,1009,1186,177,0.5403189066059225
12028,BUSKIRK,NY,101,53,-48,0.34415584415584416
12029,CANAAN,NY,390,567,177,0.5924764890282131
12031,CARLISLE,NY,12,0,-12,0
12032,CAROGA LAKE,NY,951,873,-78,0.4786184210526316
12033,CASTLETON,NY,226,241,15,0.5160599571734475
12033,CASTLETON ON HUDSON,NY,2151,2274,123,0.5138983050847458
12035,CENTRAL BRG,NY,12,0,-12,0
12035,CENTRAL BRIDGE,NY,211,89,-122,0.2966666666666667
12037,CHATHAM,NY,1505,1557,52,0.508491182233834
12043,COBLESKILL,NY,3093,3130,37,0.5029728426803792
12045,COEYMANS,NY,23,47,24,0.6714285714285714
12046,COEYMANS HOLLOW,NY,0,11,11,1
12047,COHOES,NY,12273,11661,-612,0.48721484081223365
12051,COXSACKIE,NY,1553,1351,-202,0.4652203856749311
12052,CROPSEYVILLE,NY,338,305,-33,0.47433903576982894
12053,DELANSON,NY,1224,1338,114,0.522248243559719
12054,DELMAR,NY,6359,6285,-74,0.4970737108509965
12056,DUANESBURG,NY,730,647,-83,0.4698620188816267
12057,EAGLE BRIDGE,NY,121,235,114,0.6601123595505618
12058,EARLTON,NY,508,421,-87,0.45317545748116256
12059,EAST BERNE,NY,484,511,27,0.5135678391959799
12060,EAST CHATHAM,NY,347,516,169,0.5979142526071842
12061,E GREENBUSH,NY,317,331,14,0.5108024691358025
12061,EAST GREENBUSH,NY,3307,3221,-86,0.4934129901960784
12062,EAST NASSAU,NY,336,328,-8,0.4939759036144578
12063,EAST SCHODACK,NY,12,25,13,0.6756756756756757
12065,CLIFTON PARK,NY,13943,13225,-718,0.4867859246171967
12065,HALFMOON,NY,5687,5383,-304,0.48626919602529356
12066,ESPERANCE,NY,361,503,142,0.5821759259259259
12067,FEURA BUSH,NY,161,150,-11,0.48231511254019294
12068,FONDA,NY,1014,952,-62,0.4842319430315361
12069,FORT HUNTER,NY,12,0,-12,0
12070,FORT JOHNSON,NY,234,204,-30,0.4657534246575342
12072,FULTONVILLE,NY,915,780,-135,0.46017699115044247
12074,GALWAY,NY,1058,1168,110,0.5247079964061097
12075,GHENT,NY,903,1280,377,0.5863490609253321
12076,GILBOA,NY,441,265,-176,0.37535410764872523
12077,GLENMONT,NY,2320,2500,180,0.5186721991701245
12078,GLOVERSVILLE,NY,12576,11654,-922,0.48097399917457695
12083,GREENVILLE,NY,1322,1191,-131,0.47393553521687226
12084,GUILDERLAND,NY,4125,2709,-1416,0.39640035118525024
12085,GUILDERLAND CENTER,NY,34,34,0,0.5
12086,HAGAMAN,NY,394,383,-11,0.4929214929214929
12087,HANNACROIX,NY,62,93,31,0.6
12090,HOOSICK FALLS,NY,2041,1986,-55,0.4931710951080209
12092,HOWES CAVE,NY,176,213,37,0.5475578406169666
12093,JEFFERSON,NY,711,637,-74,0.4725519287833828
12094,JOHNSONVILLE,NY,447,309,-138,0.4087301587301587
12095,JOHNSTOWN,NY,5337,4779,-558,0.4724199288256228
12106,KINDERHOOK,NY,722,693,-29,0.48975265017667846
12108,LAKE PLEASANT,NY,305,231,-74,0.43097014925373134
12110,LATHAM,NY,7855,8182,327,0.5101951736609092
12116,MARYLAND,NY,583,595,12,0.5050933786078099
12117,MAYFIELD,NY,1490,1288,-202,0.4636429085673146
12118,MECHANICVILLE,NY,6938,7237,299,0.5105467372134039
12120,MEDUSA,NY,11,15,4,0.5769230769230769
12121,MELROSE,NY,296,239,-57,0.44672897196261685
12122,MIDDLEBURGH,NY,1525,1435,-90,0.4847972972972973
12123,NASSAU,NY,1727,1794,67,0.5095143425163305
12124,NEW BALTIMORE,NY,12,0,-12,0
12125,LEBANON SPG,NY,14,0,-14,0
12125,LEBANON SPRINGS,NY,11,12,1,0.5217391304347826
12125,NEW LEBANON,NY,316,468,152,0.5969387755102041
12128,NEWTONVILLE,NY,17,0,-17,0
12130,NIVERVILLE,NY,113,97,-16,0.46190476190476193
12134,NORTHVILLE,NY,1994,1939,-55,0.49300788202390033
12136,OLD CHATHAM,NY,69,248,179,0.7823343848580442
12137,PATTERSONVILLE,NY,319,336,17,0.5129770992366413
12137,PATTERSONVLE,NY,0,24,24,1
12138,PETERSBURG,NY,761,660,-101,0.4644616467276566
12138,PETERSBURGH,NY,153,193,40,0.5578034682080925
12139,PISECO,NY,205,175,-30,0.4605263157894737
12140,POESTENKILL,NY,230,195,-35,0.4588235294117647
12143,RAVENA,NY,1829,1704,-125,0.4823096518539485
12144,RENSSELAER,NY,9821,9178,-643,0.4830780567398284
12147,RENSSELAERVILLE,NY,48,39,-9,0.4482758620689655
12148,REXFORD,NY,1432,1576,144,0.523936170212766
12149,RICHMONDVILLE,NY,1074,1004,-70,0.48315688161693937
12150,ROTTERDAM JCT,NY,39,0,-39,0
12150,ROTTERDAM JUNCTION,NY,125,147,22,0.5404411764705882
12151,ROUND LAKE,NY,149,220,71,0.5962059620596206
12153,SAND LAKE,NY,47,53,6,0.53
12154,SCHAGHTICOKE,NY,773,791,18,0.5057544757033248
12155,SCHENECTADY,NY,16,37,21,0.6981132075471698
12155,SCHENEVUS,NY,487,354,-133,0.42092746730083236
12157,SCHOHARIE,NY,1353,1294,-59,0.488855307895731
12158,SELKIRK,NY,2254,2412,158,0.5169309901414488
12159,SLINGERLANDS,NY,3057,3471,414,0.5317095588235294
12160,SLOANSVILLE,NY,11,47,36,0.8103448275862069
12164,SPECULATOR,NY,398,302,-96,0.43142857142857144
12165,SPENCERTOWN,NY,15,150,135,0.9090909090909091
12166,SPRAKERS,NY,344,240,-104,0.410958904109589
12167,STAMFORD,NY,1388,1242,-146,0.47224334600760454
12168,STEPHENTOWN,NY,562,614,52,0.5221088435374149
12170,STILLWATER,NY,1703,1596,-107,0.4837829645347075
12172,STOTTVILLE,NY,23,34,11,0.5964912280701754
12173,STUYVESANT,NY,353,385,32,0.521680216802168
12175,SUMMIT,NY,227,170,-57,0.4282115869017632
12177,TRIBES HILL,NY,0,12,12,1
12180,TROY,NY,28845,23107,-5738,0.44477594702802586
12181,TROY,NY,565,473,-92,0.4556840077071291
12182,TROY,NY,7703,6120,-1583,0.4427403602691167
12183,GREEN ISLAND,NY,738,652,-86,0.46906474820143884
12183,TROY,NY,1095,994,-101,0.475825753949258
12184,VALATIE,NY,2075,2280,205,0.5235361653272101
12185,VALLEY FALLS,NY,386,339,-47,0.4675862068965517
12186,VOORHEESVILLE,NY,1903,2003,100,0.5128008192524321
12187,WARNERVILLE,NY,116,57,-59,0.32947976878612717
12188,WATERFORD,NY,4466,3981,-485,0.47129158281046524
12189,WATERVLIET,NY,10686,8244,-2442,0.4354992076069731
12190,WELLS,NY,153,148,-5,0.49169435215946844
12192,W COXSACKIE,NY,26,44,18,0.6285714285714286
12192,WEST COXSACKIE,NY,304,309,5,0.5040783034257749
12193,WESTERLO,NY,414,360,-54,0.46511627906976744
12196,W SAND LAKE,NY,21,16,-5,0.43243243243243246
12196,WEST SAND LAKE,NY,798,752,-46,0.48516129032258065
12197,WORCESTER,NY,879,686,-193,0.4383386581469649
12198,WYNANTSKILL,NY,2084,2095,11,0.5013161043311797
12201,ALBANY,NY,557,1169,612,0.6772885283893395
12202,ALBANY,NY,5476,4167,-1309,0.43212693145286735
12203,ALBANY,NY,13524,11892,-1632,0.4678942398489141
12204,ALBANY,NY,2459,2260,-199,0.47891502436956984
12204,MENANDS,NY,2100,1893,-207,0.4740796393688956
12205,ALBANY,NY,9925,9423,-502,0.4870270829026256
12205,COLONIE,NY,852,838,-14,0.4958579881656805
12206,ALBANY,NY,10465,8428,-2037,0.4460911448684698
12207,ALBANY,NY,2124,1985,-139,0.4830859089802872
12208,ALBANY,NY,12186,10086,-2100,0.45285560344827586
12209,ALBANY,NY,4530,3879,-651,0.4612914734213343
12210,ALBANY,NY,7866,5830,-2036,0.4256717289719626
12211,ALBANY,NY,2019,2215,196,0.5231459612659424
12211,LOUDONVILLE,NY,1332,1476,144,0.5256410256410257
12212,ALBANY,NY,233,415,182,0.6404320987654321
12220,ALBANY,NY,11,0,-11,0
12224,ALBANY,NY,0,12,12,1
12301,SCHENECTADY,NY,220,573,353,0.7225725094577553
12302,GLENVILLE,NY,1754,1729,-25,0.49641113982199253
12302,SCHENECTADY,NY,5749,6042,293,0.5124247307268256
12302,SCOTIA,NY,1598,1629,31,0.5048032228075612
12303,SCHENECTADY,NY,10927,10015,-912,0.4782255753987203
12304,SCHENECTADY,NY,8646,7665,-981,0.4699282692661394
12305,SCHENECTADY,NY,4240,3987,-253,0.4846237996839674
12306,ROTTERDAM,NY,779,820,41,0.5128205128205128
12306,SCHENECTADY,NY,9398,9102,-296,0.492
12307,SCHENECTADY,NY,3937,3173,-764,0.44627285513361464
12308,SCHENECTADY,NY,7249,6259,-990,0.46335504885993484
12309,NISKAYUNA,NY,1437,1523,86,0.514527027027027
12309,SCHENECTADY,NY,9179,9428,249,0.50669103025743
12325,GLENVILLE,NY,13,0,-13,0
12325,SCHENECTADY,NY,0,28,28,1
12401,KINGSTON,NY,14651,13662,-989,0.4825345247766044
12402,KINGSTON,NY,1337,1188,-149,0.47049504950495047
12404,ACCORD,NY,1378,1696,318,0.5517241379310345
12405,ACRA,NY,73,35,-38,0.32407407407407407
12406,ARKVILLE,NY,247,161,-86,0.3946078431372549
12409,BEARSVILLE,NY,455,469,14,0.5075757575757576
12410,BIG INDIAN,NY,0,62,62,1
12411,BLOOMINGTON,NY,24,41,17,0.6307692307692307
12412,BOICEVILLE,NY,136,100,-36,0.423728813559322
12413,CAIRO,NY,1482,1412,-70,0.4879060124395301
12414,CATSKILL,NY,4424,4242,-182,0.4894991922455573
12416,CHICHESTER,NY,26,51,25,0.6623376623376623
12417,CONNELLY,NY,12,38,26,0.76
12418,CORNWALLVILLE,NY,12,27,15,0.6923076923076923
12419,COTTEKILL,NY,11,0,-11,0
12420,CRAGSMOOR,NY,0,12,12,1
12421,DENVER,NY,166,191,25,0.5350140056022409
12421,EAST KINGSTON,NY,0,12,12,1
12423,EAST DURHAM,NY,459,479,20,0.5106609808102346
12424,EAST JEWETT,NY,0,11,11,1
12427,ELKA PARK,NY,0,11,11,1
12428,ELLENVILLE,NY,3345,2892,-453,0.4636844636844637
12429,ESOPUS,NY,0,12,12,1
12430,FLEISCHMANNS,NY,397,321,-76,0.44707520891364905
12430,HALCOTT CENTER,NY,25,0,-25,0
12431,FREEHOLD,NY,474,423,-51,0.47157190635451507
12432,GLASCO,NY,148,11,-137,0.06918238993710692
12433,GLENFORD,NY,0,23,23,1
12434,GRAND GORGE,NY,61,46,-15,0.42990654205607476
12435,GREENFIELD PARK,NY,16,0,-16,0
12436,HAINES FALLS,NY,126,97,-29,0.4349775784753363
12439,HENSONVILLE,NY,35,23,-12,0.39655172413793105
12440,HIGH FALLS,NY,712,791,79,0.5262807717897539
12441,HIGHMOUNT,NY,0,16,16,1
12442,HUNTER,NY,673,356,-317,0.3459669582118562
12443,HURLEY,NY,1063,1288,225,0.5478519778817524
12444,JEWETT,NY,58,79,21,0.5766423357664233
12446,KERHONKSON,NY,1926,2091,165,0.520537714712472
12448,LAKE HILL,NY,0,13,13,1
12449,LAKE KATRINE,NY,1030,1004,-26,0.4936086529006883
12451,LEEDS,NY,509,532,23,0.5110470701248799
12453,MALDEN ON HUDSON,NY,15,0,-15,0
12454,MAPLECREST,NY,11,13,2,0.5416666666666666
12455,MARGARETVILLE,NY,1106,835,-271,0.43019062339000513
12456,MOUNT MARION,NY,11,12,1,0.5217391304347826
12457,MOUNT TREMPER,NY,138,217,79,0.6112676056338028
12458,NAPANOCH,NY,1019,881,-138,0.4636842105263158
12459,NEW KINGSTON,NY,11,16,5,0.5925925925925926
12461,OLIVEBRIDGE,NY,517,714,197,0.5800162469536961
12463,PALENVILLE,NY,621,405,-216,0.39473684210526316
12464,PHOENICIA,NY,450,479,29,0.5156081808396125
12465,PINE HILL,NY,12,0,-12,0
12466,PORT EWEN,NY,1122,1126,4,0.5008896797153025
12468,PRATTSVILLE,NY,359,353,-6,0.4957865168539326
12469,PRESTON HOLLOW,NY,196,71,-125,0.26591760299625467
12469,PRESTON HOLW,NY,97,17,-80,0.14912280701754385
12470,PURLING,NY,39,60,21,0.6060606060606061
12472,ROSENDALE,NY,576,565,-11,0.49517966695880805
12473,ROUND TOP,NY,210,206,-4,0.4951923076923077
12474,ROXBURY,NY,244,294,50,0.5464684014869888
12477,SAUGERTIES,NY,6873,6420,-453,0.48296095689460616
12480,SHANDAKEN,NY,87,62,-25,0.4161073825503356
12481,SHOKAN,NY,348,415,67,0.5439056356487549
12482,SOUTH CAIRO,NY,49,65,16,0.5701754385964912
12484,STONE RIDGE,NY,978,1215,237,0.5540355677154583
12485,TANNERSVILLE,NY,772,408,-364,0.34576271186440677
12486,TILLSON,NY,229,303,74,0.5695488721804511
12487,ULSTER PARK,NY,635,807,172,0.5596393897364771
12491,WEST HURLEY,NY,594,765,171,0.5629139072847682
12492,WEST KILL,NY,40,0,-40,0
12493,WEST PARK,NY,11,12,1,0.5217391304347826
12494,WEST SHOKAN,NY,91,191,100,0.6773049645390071
12495,WILLOW,NY,11,51,40,0.8225806451612904
12496,WINDHAM,NY,939,749,-190,0.4437203791469194
12498,WOODSTOCK,NY,2627,3178,551,0.5474590869939707
12501,AMENIA,NY,717,775,58,0.5194369973190348
12502,ANCRAM,NY,157,388,231,0.7119266055045872
12503,ANCRAMDALE,NY,23,255,232,0.9172661870503597
12508,BEACON,NY,7779,7466,-313,0.4897343391275828
12513,CLAVERACK,NY,315,311,-4,0.4968051118210863
12514,CLINTON CORNERS,NY,819,1007,188,0.5514786418400877
12515,CLINTONDALE,NY,385,309,-76,0.4452449567723343
12516,COPAKE,NY,948,907,-41,0.4889487870619946
12517,COPAKE FALLS,NY,36,126,90,0.7777777777777778
12518,CORNWALL,NY,2226,2216,-10,0.4988743809095002
12520,CORNWALL HDSN,NY,114,131,17,0.5346938775510204
12520,CORNWALL ON HUDSON,NY,1064,1039,-25,0.4940561103185925
12521,CRARYVILLE,NY,665,665,0,0.5
12522,DOVER PLAINS,NY,1386,1419,33,0.5058823529411764
12523,ELIZAVILLE,NY,498,573,75,0.5350140056022409
12524,FISHKILL,NY,5640,5848,208,0.5090529247910863
12525,GARDINER,NY,1237,1318,81,0.5158512720156556
12526,GERMANTOWN,NY,1223,1420,197,0.5372682557699584
12528,HIGHLAND,NY,5030,4927,-103,0.4948277593652707
12529,HILLSDALE,NY,1264,1583,319,0.5560238847910081
12531,HOLMES,NY,799,892,93,0.527498521584861
12533,HOPEWELL JCT,NY,977,948,-29,0.49246753246753244
12533,HOPEWELL JUNCTION,NY,5343,5886,543,0.5241784664707454
12534,HUDSON,NY,7231,7168,-63,0.49781234807972774
12538,HYDE PARK,NY,4533,4759,226,0.5121609987085665
12540,LA GRANGE,NY,48,28,-20,0.3684210526315789
12540,LAGRANGEVILLE,NY,1896,2082,186,0.5233785822021116
12542,MARLBORO,NY,1959,2074,115,0.5142573766426978
12543,MAYBROOK,NY,1238,1107,-131,0.4720682302771855
12545,MILLBROOK,NY,1680,1864,184,0.5259593679458239
12546,MILLERTON,NY,1048,1263,215,0.5465166594547815
12547,MILTON,NY,871,890,19,0.5053946621237932
12548,MODENA,NY,372,314,-58,0.4577259475218659
12549,MONTGOMERY,NY,3043,3133,90,0.5072862694300518
12550,NEWBURGH,NY,20199,18666,-1533,0.4802778849864917
12551,NEWBURGH,NY,249,818,569,0.7666354264292409
12552,NEWBURGH,NY,25,14,-11,0.358974358974359
12553,NEW WINDSOR,NY,9368,9145,-223,0.4939772052071517
12561,NEW PALTZ,NY,6178,5888,-290,0.4879827614785347
12563,PATTERSON,NY,1645,1818,173,0.5249783424776205
12564,PAWLING,NY,2071,2278,207,0.5237985743849161
12565,PHILMONT,NY,583,641,58,0.5236928104575164
12566,PINE BUSH,NY,3072,3358,286,0.5222395023328149
12567,PINE PLAINS,NY,877,1031,154,0.540356394129979
12568,PLATTEKILL,NY,63,44,-19,0.411214953271028
12569,PLEASANT VALLEY,NY,3759,3475,-284,0.48037047276748684
12570,POUGHQUAG,NY,1672,1778,106,0.5153623188405797
12571,RED HOOK,NY,3175,3284,109,0.5084378386747175
12572,RHINEBECK,NY,3690,4355,665,0.5413300186451212
12575,ROCK TAVERN,NY,426,531,105,0.554858934169279
12577,SALISBURY MILLS,NY,296,490,194,0.6234096692111959
12577,SALISBURY MLS,NY,23,40,17,0.6349206349206349
12578,SALT POINT,NY,429,615,186,0.5890804597701149
12580,STAATSBURG,NY,1277,1353,76,0.5144486692015209
12581,STANFORDVILLE,NY,694,831,137,0.5449180327868852
12582,STORMVILLE,NY,968,1088,120,0.5291828793774319
12583,TIVOLI,NY,992,802,-190,0.44704570791527315
12584,VAILS GATE,NY,39,22,-17,0.36065573770491804
12585,VERBANK,NY,39,107,68,0.7328767123287672
12586,WALDEN,NY,4154,4182,28,0.5016794625719769
12589,WALLKILL,NY,3940,4233,293,0.5179248745870549
12590,WAPENGERS FALLS,NY,275,263,-12,0.4888475836431227
12590,WAPPINGERS FALLS,NY,11368,11521,153,0.5033422167853554
12592,WASSAIC,NY,238,224,-14,0.48484848484848486
12594,WINGDALE,NY,1104,1111,7,0.5015801354401805
12601,POUGHKEEPSIE,NY,18058,16247,-1811,0.4736044308409853
12602,POUGHKEEPSIE,NY,254,615,361,0.7077100115074798
12603,POUGHKEEPSIE,NY,13177,13845,668,0.5123602990156169
12701,MONTICELLO,NY,6579,5873,-706,0.4716511403790556
12719,BARRYVILLE,NY,434,337,-97,0.437094682230869
12721,BLOOMINGBURG,NY,2288,2249,-39,0.49570200573065903
12722,BURLINGHAM,NY,11,0,-11,0
12723,CALLICOON,NY,692,727,35,0.5123326286116984
12724,CALLICOON CENTER,NY,0,28,28,1
12725,CLARYVILLE,NY,23,46,23,0.6666666666666666
12726,COCHECTON,NY,244,234,-10,0.4895397489539749
12729,CUDDEBACKVILLE,NY,486,368,-118,0.4309133489461358
12729,GODEFFROY,NY,33,38,5,0.5352112676056338
12732,ELDRED,NY,160,191,31,0.5441595441595442
12733,FALLSBURG,NY,81,43,-38,0.3467741935483871
12734,FERNDALE,NY,464,200,-264,0.30120481927710846
12737,GLEN SPEY,NY,691,612,-79,0.4696853415195702
12738,GLEN WILD,NY,47,0,-47,0
12740,GRAHAMSVILLE,NY,531,601,70,0.5309187279151943
12740,SUNDOWN,NY,12,13,1,0.52
12743,HIGHLAND LAKE,NY,80,63,-17,0.4405594405594406
12746,HUGUENOT,NY,103,185,82,0.6423611111111112
12747,HURLEYVILLE,NY,475,354,-121,0.4270205066344994
12748,JEFFERSONVILLE,NY,553,673,120,0.5489396411092985
12748,JEFFERSONVLLE,NY,25,14,-11,0.358974358974359
12749,KAUNEONGA LAKE,NY,328,152,-176,0.31666666666666665
12749,KAUNEONGA LK,NY,13,0,-13,0
12751,KIAMESHA LAKE,NY,193,155,-38,0.4454022988505747
12752,LAKE HUNTINGTON,NY,12,0,-12,0
12754,LIBERTY,NY,3066,2566,-500,0.45561079545454547
12758,LIVINGSTN MNR,NY,280,267,-13,0.48811700182815354
12758,LIVINGSTON MANOR,NY,1371,1370,-1,0.49981758482305727
12759,LOCH SHELDRAKE,NY,664,521,-143,0.43966244725738396
12759,LOCH SHELDRKE,NY,26,19,-7,0.4222222222222222
12760,LONG EDDY,NY,14,51,37,0.7846153846153846
12762,MONGAUP VALLEY,NY,50,0,-50,0
12763,MOUNTAIN DALE,NY,112,109,-3,0.49321266968325794
12764,NARROWSBURG,NY,668,853,185,0.5608152531229454
12765,NEVERSINK,NY,59,43,-16,0.4215686274509804
12766,NORTH BRANCH,NY,12,58,46,0.8285714285714286
12768,PARKSVILLE,NY,341,311,-30,0.47699386503067487
12771,PORT JERVIS,NY,6069,5480,-589,0.4744999567062083
12775,ROCK HILL,NY,1687,1412,-275,0.45563084866085835
12776,ROSCOE,NY,1135,852,-283,0.4287871162556618
12777,FORESTBURGH,NY,58,175,117,0.7510729613733905
12777,MONTICELLO,NY,12,0,-12,0
12778,SMALLWOOD,NY,764,527,-237,0.40821068938807126
12779,S FALLSBURG,NY,73,11,-62,0.13095238095238096
12779,SOUTH FALLSBURG,NY,557,389,-168,0.41120507399577166
12780,SPARROW BUSH,NY,801,525,-276,0.39592760180995473
12780,SPARROWBUSH,NY,159,102,-57,0.39080459770114945
12783,SWAN LAKE,NY,567,570,3,0.5013192612137203
12785,WESTBROOKVILLE,NY,35,45,10,0.5625
12786,WHITE LAKE,NY,379,306,-73,0.4467153284671533
12788,WOODBOURNE,NY,843,903,60,0.5171821305841925
12789,WOODRIDGE,NY,1170,773,-397,0.397838394235718
12790,WURTSBORO,NY,2042,1988,-54,0.49330024813895784
12791,YOUNGSVILLE,NY,35,36,1,0.5070422535211268
12792,YULAN,NY,28,18,-10,0.391304347826087
12801,GLENS FALLS,NY,8915,8122,-793,0.4767271233198333
12803,S GLENS FALLS,NY,277,277,0,0.5
12803,SOUTH GLENS FALLS,NY,3069,3279,210,0.5165406427221172
12804,QUEENSBURY,NY,10509,10731,222,0.505225988700565
12808,ADIRONDACK,NY,478,373,-105,0.4383078730904818
12809,ARGYLE,NY,1158,1179,21,0.5044929396662388
12810,ATHOL,NY,11,12,1,0.5217391304347826
12812,BLUE MOUNTAIN LAKE,NY,14,28,14,0.6666666666666666
12812,BLUE MTN LAKE,NY,14,0,-14,0
12814,BOLTON LANDING,NY,1608,1315,-293,0.4498802600068423
12814,BOLTON LNDG,NY,54,19,-35,0.2602739726027397
12815,BRANT LAKE,NY,625,559,-66,0.4721283783783784
12816,CAMBRIDGE,NY,1865,1856,-9,0.4987906476753561
12817,CHESTERTOWN,NY,1891,1460,-431,0.43569083855565505
12820,CLEVERDALE,NY,59,37,-22,0.3854166666666667
12821,COMSTOCK,NY,0,11,11,1
12822,CORINTH,NY,2296,2455,159,0.5167333193011997
12823,COSSAYUNA,NY,14,43,29,0.7543859649122807
12824,DIAMOND POINT,NY,517,574,57,0.5261228230980751
12827,FORT ANN,NY,1419,1289,-130,0.4759970457902511
12828,FORT EDWARD,NY,3855,3592,-263,0.4823418826373036
12831,GANSEVOORT,NY,6240,6178,-62,0.49750362377194396
12832,GRANVILLE,NY,2647,2680,33,0.5030974281959827
12833,GREENFIELD CENTER,NY,1513,1499,-14,0.49767596281540505
12833,GREENFLD CTR,NY,29,42,13,0.5915492957746479
12834,GREENWICH,NY,2252,2227,-25,0.49720919848180395
12835,HADLEY,NY,1531,1462,-69,0.4884731039091213
12836,HAGUE,NY,796,637,-159,0.44452198185624564
12837,HAMPTON,NY,0,29,29,1
12838,HARTFORD,NY,111,38,-73,0.2550335570469799
12839,HUDSON FALLS,NY,6017,5711,-306,0.4869542974079127
12841,HULETTS LANDING,NY,163,152,-11,0.48253968253968255
12842,INDIAN LAKE,NY,641,614,-27,0.4892430278884462
12843,JOHNSBURG,NY,37,12,-25,0.24489795918367346
12844,KATTSKILL BAY,NY,106,133,27,0.5564853556485355
12844,PILOT KNOB,NY,0,42,42,1
12845,LAKE GEORGE,NY,3298,3134,-164,0.4872512437810945
12846,LAKE LUZERNE,NY,1691,1640,-51,0.4923446412488742
12847,LONG LAKE,NY,666,589,-77,0.4693227091633466
12849,MIDDLE GRANVILLE,NY,51,14,-37,0.2153846153846154
12850,MIDDLE GROVE,NY,943,954,11,0.5028993147074328
12851,MINERVA,NY,47,30,-17,0.38961038961038963
12852,NEWCOMB,NY,103,45,-58,0.30405405405405406
12853,NORTH CREEK,NY,563,524,-39,0.48206071757129715
12856,NORTH RIVER,NY,13,39,26,0.75
12857,OLMSTEDVILLE,NY,44,24,-20,0.35294117647058826
12859,PORTER CORNERS,NY,574,551,-23,0.48977777777777776
12860,POTTERSVILLE,NY,246,195,-51,0.4421768707482993
12861,PUTNAM STA,NY,27,27,0,0.5
12861,PUTNAM STATION,NY,119,270,151,0.6940874035989717
12863,ROCK CITY FALLS,NY,0,14,14,1
12864,SABAEL,NY,25,11,-14,0.3055555555555556
12865,SALEM,NY,1285,1302,17,0.5032856590645536
12866,SARATOGA SPRINGS,NY,22152,21483,-669,0.49233413544173255
12870,SCHROON LAKE,NY,1253,1129,-124,0.4739714525608732
12871,SCHUYLERVILLE,NY,1387,1434,47,0.5083303792981212
12872,SEVERANCE,NY,12,11,-1,0.4782608695652174
12873,SHUSHAN,NY,12,52,40,0.8125
12874,SCHUYLERVILLE,NY,0,39,39,1
12874,SILVER BAY,NY,241,295,54,0.5503731343283582
12878,STONY CREEK,NY,67,46,-21,0.40707964601769914
12883,TICONDEROGA,NY,2530,2370,-160,0.48367346938775513
12884,VICTORY MILLS,NY,23,25,2,0.5208333333333334
12885,THURMAN,NY,47,32,-15,0.4050632911392405
12885,WARRENSBURG,NY,1906,1858,-48,0.49362380446333687
12887,WHITEHALL,NY,2338,2025,-313,0.46413018565207426
12901,PLATTSBURGH,NY,18880,15757,-3123,0.4549181511100846
12903,PLATTSBURGH,NY,1344,1388,44,0.5080527086383602
12910,ALTONA,NY,507,378,-129,0.4271186440677966
12912,AU SABLE FORKS,NY,1346,1201,-145,0.47153513937966235
12912,AU SABLE FRKS,NY,41,0,-41,0
12913,BLOOMINGDALE,NY,164,149,-15,0.476038338658147
12914,BOMBAY,NY,96,100,4,0.5102040816326531
12916,BRUSHTON,NY,1078,930,-148,0.4631474103585657
12917,BURKE,NY,262,204,-58,0.43776824034334766
12918,CADYVILLE,NY,561,632,71,0.5297569153394803
12919,CHAMPLAIN,NY,2410,1655,-755,0.4071340713407134
12920,CHATEAUGAY,NY,1215,917,-298,0.4301125703564728
12921,CHAZY,NY,1074,779,-295,0.42039935240151105
12923,CHURUBUSCO,NY,0,13,13,1
12926,CONSTABLE,NY,777,769,-8,0.4974126778783959
12927,CRANBERRY LAKE,NY,119,122,3,0.5062240663900415
12928,CROWN POINT,NY,900,756,-144,0.45652173913043476
12929,DANNEMORA,NY,485,216,-269,0.30813124108416545
12930,DICKINSON CENTER,NY,33,15,-18,0.3125
12932,ELIZABETHTOWN,NY,609,481,-128,0.44128440366972477
12934,ELLENBURG CENTER,NY,156,102,-54,0.3953488372093023
12935,ELLENBURG DEPOT,NY,599,467,-132,0.43808630393996245
12936,ESSEX,NY,574,381,-193,0.39895287958115183
12937,FORT COVINGTON,NY,401,309,-92,0.4352112676056338
12939,GABRIELS,NY,12,18,6,0.6
12941,JAY,NY,463,440,-23,0.48726467331118495
12942,KEENE,NY,408,368,-40,0.4742268041237113
12943,KEENE VALLEY,NY,173,248,75,0.5890736342042755
12944,KEESEVILLE,NY,1993,1925,-68,0.49132210311383356
12945,LAKE CLEAR,NY,172,247,75,0.5894988066825776
12946,LAKE PLACID,NY,3372,3172,-200,0.484718826405868
12950,LEWIS,NY,112,75,-37,0.40106951871657753
12952,LYON MOUNTAIN,NY,110,103,-7,0.4835680751173709
12953,MALONE,NY,5547,5327,-220,0.4898841272760714
12955,LYON MOUNTAIN,NY,42,98,56,0.7
12956,MINEVILLE,NY,118,147,29,0.5547169811320755
12956,TUPPER LAKE,NY,12,12,0,0.5
12957,MOIRA,NY,760,765,5,0.5016393442622951
12958,MOOERS,NY,501,635,134,0.5589788732394366
12959,MOOERS FORKS,NY,186,138,-48,0.42592592592592593
12960,MORIAH,NY,38,88,50,0.6984126984126984
12962,MORRISONVILLE,NY,1983,1859,-124,0.4838625715773035
12965,NICHOLVILLE,NY,13,13,0,0.5
12966,NORTH BANGOR,NY,893,894,1,0.5002797985450476
12966,WEST BANGOR,NY,27,21,-6,0.4375
12967,N LAWRENCE,NY,11,20,9,0.6451612903225806
12967,NORTH LAWRENCE,NY,175,122,-53,0.4107744107744108
12969,OWLS HEAD,NY,96,173,77,0.6431226765799256
12972,PERU,NY,2343,2198,-145,0.48403435366659325
12973,PIERCEFIELD,NY,35,0,-35,0
12974,PORT HENRY,NY,581,528,-53,0.47610459873760147
12975,PORT KENT,NY,81,15,-66,0.15625
12976,RAINBOW LAKE,NY,70,13,-57,0.1566265060240964
12977,RAY BROOK,NY,11,0,-11,0
12979,ROUSES POINT,NY,1532,1149,-383,0.42857142857142855
12980,SAINT REGIS FALLS,NY,482,431,-51,0.4720700985761227
12980,ST REGIS FLS,NY,83,39,-44,0.319672131147541
12981,SARANAC,NY,649,605,-44,0.4824561403508772
12983,SARANAC LAKE,NY,4093,3829,-264,0.4833375410249937
12985,SCHUYLER FALLS,NY,93,102,9,0.5230769230769231
12986,TUPPER LAKE,NY,3282,2838,-444,0.46372549019607845
12987,UPPER JAY,NY,28,0,-28,0
12989,LOON LAKE,NY,41,58,17,0.5858585858585859
12989,ONCHIOTA,NY,35,14,-21,0.2857142857142857
12989,VERMONTVILLE,NY,111,170,59,0.604982206405694
12992,WEST CHAZY,NY,1790,1693,-97,0.48607522250933105
12993,WADHAMS,NY,14,14,0,0.5
12993,WESTPORT,NY,741,790,49,0.5160026126714565
12996,WILLSBORO,NY,1315,1135,-180,0.463265306122449
12997,WILMINGTON,NY,598,584,-14,0.494077834179357
12998,WITHERBEE,NY,11,49,38,0.8166666666666667
13021,AUBURN,NY,19296,16804,-2492,0.4654847645429363
13026,AURORA,NY,429,255,-174,0.37280701754385964
13027,BALDWINSVILLE,NY,13920,13228,-692,0.48725504641225875
13028,BERNHARDS BAY,NY,432,382,-50,0.4692874692874693
13029,BREWERTON,NY,2901,2690,-211,0.48113038812377035
13030,BRIDGEPORT,NY,1807,1361,-446,0.42960858585858586
13031,CAMILLUS,NY,6333,6035,-298,0.48795278137128073
13032,CANASTOTA,NY,4860,4555,-305,0.4838024429102496
13033,CATO,NY,1230,1047,-183,0.4598155467720685
13034,CAYUGA,NY,543,527,-16,0.49252336448598133
13035,CAZENOVIA,NY,2852,3076,224,0.5188933873144399
13036,CENTRAL SQUARE,NY,3755,3519,-236,0.4837778388781963
13037,CHITTENANGO,NY,3117,3060,-57,0.4953861097620204
13039,CICERO,NY,5976,5882,-94,0.4960364311013662
13040,CINCINNATUS,NY,910,875,-35,0.49019607843137253
13040,STANTEN ISLAND,NY,26,22,-4,0.4583333333333333
13041,CLAY,NY,3435,3364,-71,0.4947786439182233
13042,CLEVELAND,NY,1122,884,-238,0.4406779661016949
13044,CONSTANTIA,NY,897,881,-16,0.4955005624296963
13045,CORTLAND,NY,13054,12128,-926,0.4816138511635295
13052,DE RUYTER,NY,666,478,-188,0.4178321678321678
13053,DRYDEN,NY,2051,1763,-288,0.46224436287362347
13054,DURHAMVILLE,NY,323,217,-106,0.40185185185185185
13057,EAST SYRACUSE,NY,6051,5978,-73,0.49696566630642613
13060,ELBRIDGE,NY,987,966,-21,0.4946236559139785
13061,ERIEVILLE,NY,255,245,-10,0.49
13062,ETNA,NY,11,12,1,0.5217391304347826
13063,FABIUS,NY,311,289,-22,0.4816666666666667
13064,FAIR HAVEN,NY,206,232,26,0.5296803652968036
13066,FAYETTEVILLE,NY,5417,5219,-198,0.4906919894697255
13068,FREEVILLE,NY,2401,2212,-189,0.4795144157814871
13069,FULTON,NY,12535,10887,-1648,0.4648194005635727
13071,GENOA,NY,78,50,-28,0.390625
13072,GEORGETOWN,NY,136,56,-80,0.2916666666666667
13073,GROTON,NY,2362,2132,-230,0.4744103248776146
13074,HANNIBAL,NY,1687,1537,-150,0.47673697270471466
13076,HASTINGS,NY,773,703,-70,0.47628726287262874
13077,HOMER,NY,2564,2506,-58,0.4942800788954635
13078,JAMESVILLE,NY,2994,3208,214,0.5172524991938084
13080,JORDAN,NY,1238,1180,-58,0.4880066170388751
13081,KING FERRY,NY,254,179,-75,0.4133949191685912
13082,KIRKVILLE,NY,1340,1364,24,0.5044378698224852
13083,LACONA,NY,955,721,-234,0.4301909307875895
13084,LA FAYETTE,NY,1420,1547,127,0.521402089652848
13087,LITTLE YORK,NY,11,0,-11,0
13088,LIVERPOOL,NY,11167,9972,-1195,0.47173470835895737
13089,LIVERPOOL,NY,44,45,1,0.5056179775280899
13090,LIVERPOOL,NY,13667,12664,-1003,0.480954008583039
13092,LOCKE,NY,727,663,-64,0.47697841726618706
13101,MC GRAW,NY,1067,921,-146,0.46327967806841047
13102,MC LEAN,NY,26,0,-26,0
13103,MALLORY,NY,23,0,-23,0
13104,MANLIUS,NY,5540,5738,198,0.5087781521546374
13108,MARCELLUS,NY,2071,2092,21,0.5025222195532069
13110,MARIETTA,NY,910,825,-85,0.4755043227665706
13111,MARTVILLE,NY,386,296,-90,0.4340175953079179
13112,MEMPHIS,NY,403,452,49,0.5286549707602339
13114,MEXICO,NY,2896,2555,-341,0.46872133553476425
13115,MINETTO,NY,15,0,-15,0
13116,MINOA,NY,1176,1022,-154,0.46496815286624205
13118,MORAVIA,NY,2225,2169,-56,0.4936276741010469
13120,NEDROW,NY,545,492,-53,0.47444551591128253
13122,NEW WOODSTOCK,NY,199,139,-60,0.41124260355029585
13123,NORTH BAY,NY,11,76,65,0.8735632183908046
13126,OSWEGO,NY,16638,14718,-1920,0.4693838499808649
13131,PARISH,NY,1615,1476,-139,0.4775153671950825
13132,PENNELLVILLE,NY,1409,1337,-72,0.4868900218499636
13135,PHOENIX,NY,2505,2465,-40,0.4959758551307847
13136,PITCHER,NY,0,12,12,1
13138,POMPEY,NY,14,0,-14,0
13140,PORT BYRON,NY,1570,1475,-95,0.48440065681444994
13141,PREBLE,NY,63,66,3,0.5116279069767442
13142,PULASKI,NY,3502,3439,-63,0.49546174902751766
13143,RED CREEK,NY,1084,1102,18,0.5041171088746569
13144,RICHLAND,NY,473,380,-93,0.4454865181711606
13145,SANDY CREEK,NY,1184,933,-251,0.4407179971658007
13146,SAVANNAH,NY,811,786,-25,0.49217282404508456
13147,SCIPIO CENTER,NY,70,45,-25,0.391304347826087
13148,SENECA FALLS,NY,4845,4427,-418,0.4774590163934426
13152,SKANEATELES,NY,4135,3912,-223,0.48614390456070583
13155,SOUTH OTSELIC,NY,39,11,-28,0.22
13156,STERLING,NY,846,807,-39,0.4882032667876588
13157,SYLVAN BEACH,NY,776,454,-322,0.36910569105691055
13158,CUYLER,NY,24,15,-9,0.38461538461538464
13158,TRUXTON,NY,246,194,-52,0.4409090909090909
13159,TULLY,NY,1963,1807,-156,0.4793103448275862
13160,UNION SPRINGS,NY,755,689,-66,0.47714681440443213
13162,VERONA BEACH,NY,121,86,-35,0.41545893719806765
13163,WAMPSVILLE,NY,0,12,12,1
13164,WARNERS,NY,531,530,-1,0.49952874646559847
13165,WATERLOO,NY,4271,3882,-389,0.476143750766589
13166,WEEDSPORT,NY,1916,1795,-121,0.48369711668014015
13167,WEST MONROE,NY,1235,1095,-140,0.4699570815450644
13201,SYRACUSE,NY,57,162,105,0.7397260273972602
13202,SYRACUSE,NY,6032,4609,-1423,0.4331359834602011
13203,SYRACUSE,NY,11447,9008,-2439,0.4403813248594476
13204,SYRACUSE,NY,14716,11430,-3286,0.4371605599326857
13205,SYRACUSE,NY,9444,8245,-1199,0.46610888122562044
13206,SYRACUSE,NY,9416,8718,-698,0.48075438402999887
13207,SYRACUSE,NY,6185,5374,-811,0.4649191106497102
13208,SYRACUSE,NY,14074,11784,-2290,0.4557196998994508
13209,SOLVAY,NY,633,659,26,0.510061919504644
13209,SYRACUSE,NY,4923,4579,-344,0.48189854767417384
13210,SYRACUSE,NY,11717,8218,-3499,0.4122397792826687
13211,MATTYDALE,NY,302,293,-9,0.492436974789916
13211,SYRACUSE,NY,2901,2711,-190,0.483071988595866
13212,NORTH SYRACUSE,NY,471,465,-6,0.4967948717948718
13212,SYRACUSE,NY,7493,6877,-616,0.47856645789839947
13214,DE WITT,NY,115,136,21,0.5418326693227091
13214,SYRACUSE,NY,3180,2712,-468,0.46028513238289204
13215,SYRACUSE,NY,4762,4638,-124,0.49340425531914894
13217,SYRACUSE,NY,492,64,-428,0.11510791366906475
13218,SYRACUSE,NY,88,196,108,0.6901408450704225
13219,SYRACUSE,NY,4719,4670,-49,0.4973905634252849
13220,SYRACUSE,NY,580,230,-350,0.2839506172839506
13224,SYRACUSE,NY,4261,3762,-499,0.4689019070173252
13244,SYRACUSE,NY,13,0,-13,0
13302,ALTMAR,NY,1100,845,-255,0.43444730077120824
13303,AVA,NY,94,100,6,0.5154639175257731
13304,BARNEVELD,NY,377,341,-36,0.47493036211699163
13308,BLOSSVALE,NY,1434,1324,-110,0.48005801305293694
13309,BOONVILLE,NY,2308,1977,-331,0.46137689614935823
13310,BOUCKVILLE,NY,74,12,-62,0.13953488372093023
13312,BRANTINGHAM,NY,156,172,16,0.524390243902439
13313,BRIDGEWATER,NY,22,29,7,0.5686274509803921
13314,BROOKFIELD,NY,0,11,11,1
13315,BURLINGTON FLATS,NY,203,153,-50,0.4297752808988764
13316,CAMDEN,NY,2394,2248,-146,0.4842740198190435
13317,CANAJOHARIE,NY,1601,1371,-230,0.46130551816958276
13318,CASSVILLE,NY,81,62,-19,0.43356643356643354
13319,CHADWICKS,NY,152,80,-72,0.3448275862068966
13320,CHERRY VALLEY,NY,879,604,-275,0.40728253540121373
13321,CLARK MILLS,NY,437,243,-194,0.3573529411764706
13322,CLAYVILLE,NY,207,241,34,0.5379464285714286
13323,CLINTON,NY,3947,3842,-105,0.4932597252535627
13324,COLD BROOK,NY,678,650,-28,0.4894578313253012
13325,CONSTABLEVILLE,NY,58,11,-47,0.15942028985507245
13326,COOPERSTOWN,NY,2853,2727,-126,0.48870967741935484
13327,CROGHAN,NY,592,475,-117,0.4451733833177132
13328,DEANSBORO,NY,99,111,12,0.5285714285714286
13329,DOLGEVILLE,NY,1520,1245,-275,0.45027124773960214
13331,EAGLE BAY,NY,262,287,25,0.5227686703096539
13332,EARLVILLE,NY,1024,910,-114,0.4705274043433299
13334,EATON,NY,438,411,-27,0.4840989399293286
13335,EDMESTON,NY,333,220,-113,0.39783001808318263
13337,FLY CREEK,NY,163,118,-45,0.4199288256227758
13338,FORESTPORT,NY,463,457,-6,0.4967391304347826
13339,FORT PLAIN,NY,2406,2249,-157,0.4831364124597207
13340,FRANKFORT,NY,2360,2319,-41,0.4956187219491344
13343,GLENFIELD,NY,511,614,103,0.5457777777777778
13346,HAMILTON,NY,2026,1887,-139,0.4822386915410171
13348,HARTWICK,NY,264,198,-66,0.42857142857142855
13350,HERKIMER,NY,4819,4488,-331,0.48221768561297945
13354,HOLLAND PATENT,NY,826,834,8,0.5024096385542168
13355,HUBBARDSVILLE,NY,93,15,-78,0.1388888888888889
13357,ILION,NY,4346,4063,-283,0.4831727910572006
13360,INLET,NY,463,493,30,0.5156903765690377
13361,JORDANVILLE,NY,52,13,-39,0.2
13363,LEE CENTER,NY,683,586,-97,0.46178092986603625
13365,LITTLE FALLS,NY,3316,3149,-167,0.4870843000773395
13367,LOWVILLE,NY,3124,3201,77,0.5060869565217392
13368,LYONS FALLS,NY,204,129,-75,0.38738738738738737
13402,MADISON,NY,324,197,-127,0.3781190019193858
13403,MARCY,NY,1529,1383,-146,0.47493131868131866
13406,MIDDLEVILLE,NY,12,11,-1,0.4782608695652174
13407,MOHAWK,NY,1776,1548,-228,0.4657039711191336
13408,MORRISVILLE,NY,1034,843,-191,0.4491209376664891
13409,MUNNSVILLE,NY,916,680,-236,0.42606516290726815
13410,NELLISTON,NY,11,0,-11,0
13411,NEW BERLIN,NY,1381,1285,-96,0.48199549887471865
13413,NEW HARTFORD,NY,5820,5623,-197,0.4913921174517172
13416,NEWPORT,NY,428,462,34,0.5191011235955056
13417,NEW YORK,NY,411,331,-80,0.44609164420485176
13417,NEW YORK MILLS,NY,1102,974,-128,0.46917148362235067
13417,NEW YORK MLS,NY,159,139,-20,0.4664429530201342
13417,NY,NY,31,23,-8,0.42592592592592593
13420,OLD FORGE,NY,1283,958,-325,0.427487728692548
13421,ONEIDA,NY,6226,5771,-455,0.4810369258981412
13424,ORISKANY,NY,715,610,-105,0.46037735849056605
13425,ORISKANY FALLS,NY,717,419,-298,0.36883802816901406
13425,ORISKANY FLS,NY,85,72,-13,0.4585987261146497
13428,PALATINE BRG,NY,12,20,8,0.625
13428,PALATINE BRIDGE,NY,332,410,78,0.5525606469002695
13431,POLAND,NY,442,353,-89,0.4440251572327044
13433,PORT LEYDEN,NY,686,496,-190,0.4196277495769882
13436,RAQUETTE LAKE,NY,79,157,78,0.6652542372881356
13437,REDFIELD,NY,34,25,-9,0.423728813559322
13438,BOONVILLE RAD,NY,47,16,-31,0.25396825396825395
13438,REMSEN,NY,1201,1149,-52,0.488936170212766
13439,RICHFIELD SPRINGS,NY,1419,1370,-49,0.4912154894227322
13440,ROME,NY,17767,16232,-1535,0.4774258066413718
13441,ROME,NY,50,158,108,0.7596153846153846
13442,ROME,NY,647,670,23,0.5087319665907365
13452,SAINT JOHNSVILLE,NY,1684,1565,-119,0.4816866728224069
13452,ST JOHNSVILLE,NY,87,66,-21,0.43137254901960786
13454,SALISBURY CENTER,NY,62,46,-16,0.42592592592592593
13456,SAUQUOIT,NY,1068,1058,-10,0.49764816556914393
13459,SHARON SPGS,NY,37,33,-4,0.4714285714285714
13459,SHARON SPRINGS,NY,925,781,-144,0.4577960140679953
13460,SHERBURNE,NY,1734,1645,-89,0.4868304232021308
13461,SHERRILL,NY,1123,979,-144,0.46574690770694577
13464,SMYRNA,NY,168,111,-57,0.3978494623655914
13468,SPRINGFIELD CENTER,NY,46,101,55,0.6870748299319728
13470,STRATFORD,NY,109,75,-34,0.4076086956521739
13471,TABERG,NY,903,871,-32,0.49098083427282974
13472,THENDARA,NY,0,11,11,1
13473,TURIN,NY,46,15,-31,0.2459016393442623
13476,VERNON,NY,1332,1248,-84,0.48372093023255813
13477,VERNON CENTER,NY,140,135,-5,0.4909090909090909
13478,VERONA,NY,877,814,-63,0.48137196924896514
13480,WATERTOWN,NY,32,29,-3,0.47540983606557374
13480,WATERVILLE,NY,1122,1103,-19,0.49573033707865166
13485,WEST EDMESTON,NY,107,68,-39,0.38857142857142857
13486,WESTERNVILLE,NY,65,13,-52,0.16666666666666666
13489,WEST LEYDEN,NY,18,15,-3,0.45454545454545453
13490,WESTMORELAND,NY,260,290,30,0.5272727272727272
13491,WEST WINFIELD,NY,1158,1056,-102,0.47696476964769646
13492,WHITESBORO,NY,3552,3455,-97,0.4930783502212074
13493,WILLIAMSTOWN,NY,798,654,-144,0.45041322314049587
13494,WOODGATE,NY,96,151,55,0.611336032388664
13495,YORKVILLE,NY,835,719,-116,0.4626769626769627
13501,UTICA,NY,19651,16616,-3035,0.458157553698955
13502,DEERFIELD,NY,318,326,8,0.5062111801242236
13502,UTICA,NY,14354,13277,-1077,0.4805110202309001
13503,UTICA,NY,309,316,7,0.5056
13504,UTICA,NY,13,139,126,0.9144736842105263
13505,UTICA,NY,30,83,53,0.7345132743362832
13601,WATERTOWN,NY,28036,21819,-6217,0.43764918262962593
13602,FORT DRUM,NY,3841,672,-3169,0.14890316862397518
13603,FORT DRUM,NY,4438,3727,-711,0.45646050214329453
13603,WATERTOWN,NY,3996,3161,-835,0.4416655023054352
13605,ADAMS,NY,2033,1699,-334,0.4552518756698821
13606,ADAMS CENTER,NY,1092,901,-191,0.4520822880080281
13607,ALEX BAY,NY,80,36,-44,0.3103448275862069
13607,ALEXANDRIA BAY,NY,2119,1682,-437,0.44251512759800055
13608,ANTWERP,NY,401,531,130,0.5697424892703863
13611,BELLEVILLE,NY,0,24,24,1
13612,BLACK RIVER,NY,1395,1356,-39,0.49291166848418755
13613,BRASHER FALLS,NY,1081,918,-163,0.4592296148074037
13615,BROWNVILLE,NY,366,188,-178,0.33935018050541516
13616,CALCIUM,NY,1898,1235,-663,0.3941908713692946
13617,CANTON,NY,4996,3790,-1206,0.4313680855907125
13618,CAPE VINCENT,NY,2191,1746,-445,0.44348488696977395
13619,CARTHAGE,NY,5844,5201,-643,0.47089180624717064
13620,CASTORLAND,NY,508,461,-47,0.4757481940144479
13621,CHASE MILLS,NY,86,28,-58,0.24561403508771928
13622,CHAUMONT,NY,1146,1161,15,0.5032509752925878
13623,CHIPPEWA BAY,NY,70,113,43,0.6174863387978142
13624,CLAYTON,NY,3530,3307,-223,0.4836916776363902
13624,FRONTENAC,NY,43,128,85,0.7485380116959064
13625,COLTON,NY,801,873,72,0.521505376344086
13626,COPENHAGEN,NY,859,639,-220,0.4265687583444593
13628,DEFERIET,NY,37,0,-37,0
13630,DE KALB JCT,NY,0,19,19,1
13630,DE KALB JUNCTION,NY,209,259,50,0.5534188034188035
13632,DEPAUVILLE,NY,12,0,-12,0
13634,DEXTER,NY,1927,1718,-209,0.47133058984910836
13635,EDWARDS,NY,410,238,-172,0.36728395061728397
13637,EVANS MILLS,NY,4703,3154,-1549,0.40142548046328114
13638,FELTS MILLS,NY,61,23,-38,0.27380952380952384
13639,FINE,NY,0,11,11,1
13640,FINEVIEW,NY,0,102,102,1
13640,WELLESLEY IS,NY,36,11,-25,0.23404255319148937
13640,WELLESLEY ISLAND,NY,991,822,-169,0.453392167677882
13641,FISHERS LANDING,NY,214,173,-41,0.4470284237726098
13642,GOUVERNEUR,NY,5039,4215,-824,0.455478711908364
13643,GREAT BEND,NY,197,0,-197,0
13646,HAMMOND,NY,1556,1357,-199,0.46584277377274286
13647,HANNAWA FALLS,NY,64,70,6,0.5223880597014925
13648,HARRISVILLE,NY,1311,978,-333,0.4272608125819135
13650,HENDERSON,NY,806,742,-64,0.479328165374677
13651,HENDERSON HARBOR,NY,107,145,38,0.5753968253968254
13651,HENDERSON HBR,NY,30,56,26,0.6511627906976745
13652,HERMON,NY,801,614,-187,0.43392226148409896
13654,HEUVELTON,NY,628,518,-110,0.45200698080279234
13655,AKWESASNE,NY,56,55,-1,0.4954954954954955
13655,HOGANSBURG,NY,762,732,-30,0.4899598393574297
13656,LA FARGEVILLE,NY,827,848,21,0.506268656716418
13658,LISBON,NY,615,526,-89,0.4609991235758107
13659,LORRAINE,NY,23,34,11,0.5964912280701754
13660,MADRID,NY,559,489,-70,0.4666030534351145
13661,MANNSVILLE,NY,488,302,-186,0.3822784810126582
13662,MASSENA,NY,8800,7745,-1055,0.46811725596857057
13664,MORRISTOWN,NY,296,312,16,0.5131578947368421
13665,NATURAL BRIDGE,NY,147,133,-14,0.475
13666,NEWTON FALLS,NY,27,0,-27,0
13667,NORFOLK,NY,1296,1283,-13,0.49747964327258626
13668,NORWOOD,NY,1152,1122,-30,0.49340369393139843
13669,OGDENSBURG,NY,8788,6721,-2067,0.4333612740989103
13672,PARISHVILLE,NY,238,106,-132,0.3081395348837209
13673,PHILADELPHIA,NY,1560,1222,-338,0.4392523364485981
13676,POTSDAM,NY,6255,5232,-1023,0.45547140245494905
13679,REDWOOD,NY,1201,1095,-106,0.4769163763066202
13680,RENSSELAER FALLS,NY,210,77,-133,0.2682926829268293
13681,RICHVILLE,NY,151,69,-82,0.31363636363636366
13682,RODMAN,NY,36,34,-2,0.4857142857142857
13684,RUSSELL,NY,172,159,-13,0.48036253776435045
13685,SACKETS HARBOR,NY,2142,1773,-369,0.4528735632183908
13687,SOUTH COLTON,NY,113,114,1,0.5022026431718062
13690,STAR LAKE,NY,416,289,-127,0.4099290780141844
13691,THERESA,NY,1493,1205,-288,0.44662713120830244
13692,THOUSAND ISLAND PARK,NY,128,72,-56,0.36
13693,THREE MILE BAY,NY,518,486,-32,0.48406374501992033
13693,THREE MLE BAY,NY,0,46,46,1
13694,WADDINGTON,NY,958,752,-206,0.439766081871345
13695,WANAKENA,NY,39,0,-39,0
13697,WINTHROP,NY,739,738,-1,0.4996614759647935
13730,AFTON,NY,1156,1105,-51,0.48872180451127817
13731,ANDES,NY,623,560,-63,0.47337278106508873
13732,APALACHIN,NY,2122,2053,-69,0.4917365269461078
13733,BAINBRIDGE,NY,1934,1836,-98,0.4870026525198939
13734,BARTON,NY,733,598,-135,0.4492862509391435
13736,7185 WEST CREEK ROAD,NY,15,0,-15,0
13736,BERKSHIRE,NY,915,735,-180,0.44545454545454544
13737,BIBLE SCHOOL PARK,NY,12,0,-12,0
13739,BLOOMVILLE,NY,93,92,-1,0.4972972972972973
13740,BOVINA CENTER,NY,24,79,55,0.7669902912621359
13743,CANDOR,NY,1370,1222,-148,0.4714506172839506
13744,CASTLE CREEK,NY,68,63,-5,0.48091603053435117
13746,CHENANGO FKS,NY,66,25,-41,0.27472527472527475
13746,CHENANGO FORKS,NY,622,655,33,0.5129209083790133
13748,CONKLIN,NY,1457,1207,-250,0.4530780780780781
13750,DAVENPORT,NY,299,221,-78,0.425
13751,DAVENPORT CENTER,NY,16,0,-16,0
13752,APALACHIN,NY,0,28,28,1
13752,DELANCEY,NY,68,99,31,0.592814371257485
13753,DELHI,NY,1768,1842,74,0.5102493074792244
13754,DEPOSIT,NY,1541,1354,-187,0.4677029360967185
13755,DOWNSVILLE,NY,255,141,-114,0.3560606060606061
13755,SHINHOPPLE,NY,17,0,-17,0
13756,EAST BRANCH,NY,64,65,1,0.5038759689922481
13757,EAST MEREDITH,NY,151,231,80,0.6047120418848168
13760,ENDICOTT,NY,17853,17059,-794,0.48862855178735104
13760,ENDWELL,NY,907,706,-201,0.43769373837569747
13761,ENDICOTT,NY,68,135,67,0.6650246305418719
13774,FISHS EDDY,NY,11,0,-11,0
13775,FRANKLIN,NY,565,481,-84,0.4598470363288719
13776,GILBERTSVILLE,NY,199,102,-97,0.3388704318936877
13777,GLEN AUBREY,NY,63,59,-4,0.48360655737704916
13778,GREENE,NY,2232,2009,-223,0.4737090308889413
13780,GUILFORD,NY,214,136,-78,0.38857142857142857
13782,HAMDEN,NY,153,161,8,0.5127388535031847
13783,HANCOCK,NY,1248,1125,-123,0.4740834386852086
13786,HARPERSFIELD,NY,12,0,-12,0
13787,HARPURSVILLE,NY,1368,1254,-114,0.4782608695652174
13788,HOBART,NY,320,318,-2,0.49843260188087773
13790,JOHNSON CITY,NY,9301,7979,-1322,0.46174768518518516
13795,KIRKWOOD,NY,1494,1327,-167,0.4704005671747607
13796,LAURENS,NY,218,271,53,0.5541922290388548
13797,LISLE,NY,424,636,212,0.6
13801,MC DONOUGH,NY,539,298,-241,0.35603345280764637
13802,MAINE,NY,120,77,-43,0.39086294416243655
13803,MARATHON,NY,1833,1635,-198,0.47145328719723184
13804,MASONVILLE,NY,17,0,-17,0
13807,MILFORD,NY,544,341,-203,0.38531073446327685
13808,MORRIS,NY,515,587,72,0.5326678765880217
13809,MOUNT UPTON,NY,494,294,-200,0.3730964467005076
13810,MOUNT VISION,NY,98,72,-26,0.4235294117647059
13810,MT VERNON,NY,14,14,0,0.5
13811,NEWARK VALLEY,NY,1340,1293,-47,0.4910748195974174
13812,NICHOLS,NY,831,687,-144,0.4525691699604743
13813,NINEVEH,NY,91,98,7,0.5185185185185185
13815,NORWICH,NY,6612,6216,-396,0.4845650140318054
13820,ONEONTA,NY,8518,7592,-926,0.471260086902545
13825,OTEGO,NY,1168,1053,-115,0.4741107609185052
13827,OWEGO,NY,5087,4571,-516,0.4732863946986954
13830,OXFORD,NY,1900,1770,-130,0.4822888283378747
13832,PLYMOUTH,NY,35,11,-24,0.2391304347826087
13833,PORT CRANE,NY,1726,1581,-145,0.4780768067735107
13835,RICHFORD,NY,343,247,-96,0.4186440677966102
13838,SIDNEY,NY,2620,2119,-501,0.4471407469930365
13839,SIDNEY CENTER,NY,298,210,-88,0.41338582677165353
13841,SMITHVILLE FLATS,NY,48,37,-11,0.43529411764705883
13842,SOUTH KORTRIGHT,NY,22,25,3,0.5319148936170213
13843,S NEW BERLIN,NY,0,12,12,1
13843,SOUTH NEW BERLIN,NY,495,492,-3,0.49848024316109424
13844,SO PLYMOUTH,NY,0,11,11,1
13844,SOUTH PLYMOUTH,NY,40,36,-4,0.47368421052631576
13846,TREADWELL,NY,23,11,-12,0.3235294117647059
13849,UNADILLA,NY,1850,1564,-286,0.45811364967779733
13850,VESTAL,NY,7377,7016,-361,0.48745918154658513
13851,VESTAL,NY,22,51,29,0.6986301369863014
13856,WALTON,NY,2821,2690,-131,0.4881146797314462
13861,WEST ONEONTA,NY,0,12,12,1
13862,WHITNEY POINT,NY,1394,1298,-96,0.4821693907875186
13863,WILLET,NY,15,0,-15,0
13864,WILLSEYVILLE,NY,577,135,-442,0.1896067415730337
13865,WINDSOR,NY,2096,1851,-245,0.4689637699518622
13901,BINGHAMTON,NY,9318,8352,-966,0.4726655348047538
13902,BINGHAMTON,NY,813,1020,207,0.5564648117839607
13903,BINGHAMTON,NY,8306,6894,-1412,0.4535526315789474
13904,BINGHAMTON,NY,3567,3239,-328,0.4759036144578313
13905,BINGHAMTON,NY,14638,11433,-3205,0.4385332361627862
14001,AKRON,NY,3423,3522,99,0.5071274298056155
14004,ALDEN,NY,2883,2803,-80,0.49296517762926484
14005,ALEXANDER,NY,460,397,-63,0.4632438739789965
14006,ANGOLA,NY,3237,3116,-121,0.4904769400283331
14008,APPLETON,NY,97,155,58,0.6150793650793651
14009,ARCADE,NY,2070,1860,-210,0.4732824427480916
14011,ATTICA,NY,1902,1707,-195,0.47298420615128844
14012,BARKER,NY,891,807,-84,0.4752650176678445
14013,BASOM,NY,191,107,-84,0.35906040268456374
14020,BATAVIA,NY,10439,8995,-1444,0.4628486158279304
14021,BATAVIA,NY,178,37,-141,0.17209302325581396
14024,BLISS,NY,535,467,-68,0.4660678642714571
14025,BOSTON,NY,770,713,-57,0.480782198246797
14025,MASSACHUTESS,NY,19,17,-2,0.4722222222222222
14026,BOWMANSVILLE,NY,124,101,-23,0.4488888888888889
14028,BURT,NY,88,112,24,0.56
14030,CHAFFEE,NY,157,242,85,0.606516290726817
14031,CLARENCE,NY,3376,3609,233,0.5166785969935577
14032,CLARENCE CENTER,NY,2374,2635,261,0.5260531044120583
14032,CLARENCE CTR,NY,29,71,42,0.71
14033,COLDEN,NY,471,570,99,0.547550432276657
14034,COLLINS,NY,351,320,-31,0.47690014903129657
14036,CORFU,NY,1279,1210,-69,0.48613901165126555
14037,COWLESVILLE,NY,42,78,36,0.65
14040,DARIEN CENTER,NY,476,453,-23,0.4876210979547901
14042,DELEVAN,NY,1710,1560,-150,0.47706422018348627
14043,DEPEW,NY,8482,7505,-977,0.46944392318758993
14047,DERBY,NY,2116,1897,-219,0.4727136805382507
14048,DUNKIRK,NY,7921,7275,-646,0.47874440642274285
14051,EAST AMHERST,NY,7033,7379,346,0.5120038856508465
14052,EAST AURORA,NY,4940,5480,540,0.525911708253359
14054,EAST BETHANY,NY,173,97,-76,0.3592592592592593
14055,EAST CONCORD,NY,234,160,-74,0.40609137055837563
14056,EAST PEMBROKE,NY,12,22,10,0.6470588235294118
14057,EDEN,NY,1970,1928,-42,0.49461262185736277
14058,ELBA,NY,437,370,-67,0.45848822800495664
14059,ELMA,NY,2666,2619,-47,0.49555345316934724
14060,FARMERSVILLE STATION,NY,11,0,-11,0
14062,FORESTVILLE,NY,1055,856,-199,0.4479330193615908
14063,FREDONIA,NY,5134,4761,-373,0.4811520970186963
14065,FREEDOM,NY,504,374,-130,0.42596810933940776
14065,GETZVILLE,NY,21,12,-9,0.36363636363636365
14066,GAINESVILLE,NY,117,124,7,0.5145228215767634
14067,GASPORT,NY,1472,1457,-15,0.49743939911232504
14068,GETZVILLE,NY,3092,2566,-526,0.45351714386709086
14069,GLENWOOD,NY,64,51,-13,0.4434782608695652
14070,GOWANDA,NY,2021,1809,-212,0.47232375979112273
14072,GRAND ISLAND,NY,6907,7346,439,0.5154002666105382
14075,HAMBURG,NY,15301,15160,-141,0.4976855651488789
14080,HOLLAND,NY,1393,1209,-184,0.46464258262874714
14081,IRVING,NY,1078,923,-155,0.4612693653173413
14082,JAVA CENTER,NY,23,11,-12,0.3235294117647059
14085,LAKE VIEW,NY,1663,1847,184,0.5262108262108263
14086,LANCASTER,NY,8955,9406,451,0.512281466151081
14091,LAWTONS,NY,44,35,-9,0.4430379746835443
14092,LEWISTON,NY,4002,4024,22,0.5013705457263893
14094,LOCKPORT,NY,19084,18626,-458,0.49392734022805623
14095,LOCKPORT,NY,188,274,86,0.5930735930735931
14098,DUNKIRK,NY,12,21,9,0.6363636363636364
14098,LYNDONVILLE,NY,1052,930,-122,0.4692230070635722
14101,MACHIAS,NY,801,687,-114,0.46169354838709675
14102,MARILLA,NY,11,11,0,0.5
14103,MEDINA,NY,3869,3811,-58,0.4962239583333333
14105,MIDDLEPORT,NY,1205,1195,-10,0.4979166666666667
14108,NEWFANE,NY,1795,1659,-136,0.48031268094962365
14109,NIAGARA UNIVERSITY,NY,180,0,-180,0
14111,NORTH COLLINS,NY,881,806,-75,0.47777119146413755
14113,NORTH JAVA,NY,0,11,11,1
14120,NORTH TONAWANDA,NY,14121,13444,-677,0.48771993469980046
14125,OAKFIELD,NY,1160,1046,-114,0.4741613780598368
14126,OLCOTT,NY,366,99,-267,0.2129032258064516
14127,ORCHARD PARK,NY,10168,10367,199,0.504845385926467
14129,PERRYSBURG,NY,320,140,-180,0.30434782608695654
14130,PIKE,NY,25,0,-25,0
14131,RANSOMVILLE,NY,1409,1393,-16,0.4971448965024982
14132,SANBORN,NY,1387,1478,91,0.5158813263525306
14136,QUEENS,NY,55,39,-16,0.4148936170212766
14136,SILVER CREEK,NY,1779,1676,-103,0.4850940665701881
14138,SOUTH DAYTON,NY,600,402,-198,0.40119760479041916
14139,SOUTH WALES,NY,453,407,-46,0.47325581395348837
14141,SPRINGVILLE,NY,2568,2653,85,0.5081402030262402
14143,STAFFORD,NY,141,176,35,0.555205047318612
14145,STRYKERSVILLE,NY,112,86,-26,0.43434343434343436
14150,TONAWANDA,NY,14646,13141,-1505,0.4729189908950229
14151,TONAWANDA,NY,13,12,-1,0.48
14166,VAN BUREN POINT,NY,0,40,40,1
14167,VARYSBURG,NY,59,105,46,0.6402439024390244
14170,WEST FALLS,NY,578,629,51,0.5211267605633803
14171,WEST VALLEY,NY,435,322,-113,0.42536327608982827
14172,WILSON,NY,1118,1141,23,0.5050907481186365
14173,YORKSHIRE,NY,47,12,-35,0.2033898305084746
14174,YOUNGSTOWN,NY,1721,1732,11,0.5015928178395598
14201,BUFFALO,NY,7779,6534,-1245,0.45650806958708867
14202,BUFFALO,NY,3234,2570,-664,0.4427980702963473
14203,BUFFALO,NY,2151,2166,15,0.501737317581654
14204,BUFFALO,NY,4116,3924,-192,0.4880597014925373
14205,BUFFALO,NY,36,118,82,0.7662337662337663
14206,BUFFALO,NY,8755,7705,-1050,0.4681044957472661
14207,BUFFALO,NY,12846,11370,-1476,0.4695242814667988
14208,BUFFALO,NY,5763,4518,-1245,0.43945141523198133
14209,BUFFALO,NY,4902,4129,-773,0.45720296755619533
14210,BUFFALO,NY,6527,5631,-896,0.46315183418325384
14211,BUFFALO,NY,11379,9893,-1486,0.46507145543437384
14212,BUFFALO,NY,5660,4897,-763,0.4638628398219191
14212,SLOAN,NY,365,323,-42,0.4694767441860465
14213,BUFFALO,NY,14640,11861,-2779,0.44756801630127163
14214,BUFFALO,NY,8802,7247,-1555,0.4515546139946414
14215,BUFFALO,NY,18746,16918,-1828,0.4743719156572454
14216,BUFFALO,NY,10880,8787,-2093,0.4467890374739411
14217,BUFFALO,NY,5020,4427,-593,0.46861437493384145
14217,KENMORE,NY,3360,3020,-340,0.47335423197492166
14218,BUFFALO,NY,3353,3160,-193,0.48518347919545524
14218,LACKAWANNA,NY,3933,3510,-423,0.47158403869407495
14219,BLASDELL,NY,1394,1488,94,0.5163081193615545
14219,BUFFALO,NY,2434,2103,-331,0.4635221512012343
14220,BUFFALO,NY,8614,7676,-938,0.47120933087783917
14221,BUFFALO,NY,11817,11307,-510,0.4889724961079398
14221,WILLIAMSVILLE,NY,8491,9069,578,0.5164578587699317
14222,BUFFALO,NY,8017,6503,-1514,0.4478650137741047
14223,BUFFALO,NY,6002,5830,-172,0.4927315753887762
14223,KENMORE,NY,150,140,-10,0.4827586206896552
14223,TONAWANDA,NY,669,586,-83,0.46693227091633466
14223,TOWN OF TONAWANDA,NY,311,262,-49,0.4572425828970332
14224,BUFFALO,NY,7373,7065,-308,0.4893337027289098
14224,WEST SENECA,NY,4663,4840,177,0.5093128485741345
14225,BUFFALO,NY,9167,8615,-552,0.4844786863120009
14225,CHEEKTOWAGA,NY,2786,2580,-206,0.48080506895266495
14226,AMHERST,NY,4878,4651,-227,0.4880889914996327
14226,BUFFALO,NY,6069,5432,-637,0.4723067559342666
14227,BUFFALO,NY,5055,4779,-276,0.485967053081147
14227,CHEEKTOWAGA,NY,3442,3056,-386,0.4702985534010465
14228,AMHERST,NY,3222,2723,-499,0.45803195962994114
14228,BUFFALO,NY,6865,6111,-754,0.47094636251541305
14231,BUFFALO,NY,105,175,70,0.625
14231,WILLIAMSVILLE,NY,72,185,113,0.7198443579766537
14240,BUFFALO,NY,364,1120,756,0.7547169811320755
14261,BUFFALO,NY,0,29,29,1
14301,NIAGARA FALLS,NY,7666,6326,-1340,0.4521154945683248
14302,NIAGARA FALLS,NY,248,619,371,0.7139561707035755
14303,NIAGARA FALLS,NY,3391,2961,-430,0.46615239294710326
14304,NIAGARA FALLS,NY,10114,10095,-19,0.4995299124152605
14305,NIAGARA FALLS,NY,7402,6547,-855,0.4693526417664349
14411,ALBION,NY,4764,4207,-557,0.4689555233530264
14414,AVON,NY,2391,2358,-33,0.4965255843335439
14416,BERGEN,NY,1152,1126,-26,0.4942932396839333
14418,BRANCHPORT,NY,303,328,25,0.5198098256735341
14420,BROCKPORT,NY,8969,7412,-1557,0.4524754288504975
14422,BYRON,NY,748,595,-153,0.4430379746835443
14423,CALEDONIA,NY,1486,1425,-61,0.4895225008588114
14424,CANANDAIGUA,NY,14536,14487,-49,0.49915584191847845
14425,FARMINGTON,NY,6312,6195,-117,0.4953226193331734
14427,CASTILE,NY,943,800,-143,0.4589787722317843
14428,CHURCHVILLE,NY,2594,2610,16,0.5015372790161414
14430,CLARKSON,NY,0,12,12,1
14432,CLIFTON SPGS,NY,49,46,-3,0.4842105263157895
14432,CLIFTON SPRINGS,NY,1946,1923,-23,0.4970276557249935
14433,CLYDE,NY,1622,1495,-127,0.47962784728906
14435,CONESUS,NY,1187,1025,-162,0.46338155515370705
14437,DANSVILLE,NY,3994,3768,-226,0.48544189641844887
14441,DRESDEN,NY,45,0,-45,0
14445,E ROCHESTER,NY,648,496,-152,0.43356643356643354
14445,EAST ROCHESTER,NY,3024,2665,-359,0.46844788187730707
14450,FAIRPORT,NY,14723,14871,148,0.5025005068594985
14454,GENESEO,NY,3166,3000,-166,0.4865390853065196
14456,GENEVA,NY,9609,8635,-974,0.47330629247971934
14462,GROVELAND,NY,13,0,-13,0
14464,HAMLIN,NY,2341,2283,-58,0.4937283737024221
14466,HEMLOCK,NY,386,346,-40,0.4726775956284153
14467,HENRIETTA,NY,4195,3738,-457,0.47119626875078785
14468,HILTON,NY,5553,5777,224,0.5098852603706973
14469,BLOOMFIELD,NY,1971,1972,1,0.5001268069997464
14470,HOLLEY,NY,2711,2646,-65,0.4939331715512414
14471,HONEOYE,NY,1655,1365,-290,0.4519867549668874
14472,HONEOYE FALLS,NY,2859,2940,81,0.5069839627521987
14476,KENDALL,NY,551,386,-165,0.4119530416221985
14477,KENT,NY,350,337,-13,0.49053857350800584
14478,BLUFF POINT,NY,68,31,-37,0.31313131313131315
14478,KEUKA PARK,NY,648,205,-443,0.2403282532239156
14480,LAKEVILLE,NY,513,474,-39,0.48024316109422494
14481,LEICESTER,NY,593,431,-162,0.4208984375
14482,LE ROY,NY,3123,2960,-163,0.48660200558934735
14485,LIMA,NY,1316,1397,81,0.5149281238481386
14487,LIVONIA,NY,2301,2183,-118,0.4868421052631579
14489,LYONS,NY,3285,3057,-228,0.48202459791863767
14502,MACEDON,NY,3499,3375,-124,0.49098050625545536
14504,MANCHESTER,NY,661,688,27,0.5100074128984433
14505,MARION,NY,1680,1564,-116,0.48212083847102344
14506,MENDON,NY,177,242,65,0.5775656324582339
14507,MIDDLESEX,NY,528,392,-136,0.4260869565217391
14510,MOUNT MORRIS,NY,2522,2219,-303,0.4680447163045771
14511,MUMFORD,NY,55,30,-25,0.35294117647058826
14512,NAPLES,NY,2086,1840,-246,0.4686704024452369
14513,NEWARK,NY,6795,6215,-580,0.4777094542659493
14514,NORTH CHILI,NY,2800,2670,-130,0.48811700182815354
14516,NORTH ROSE,NY,858,821,-37,0.4889815366289458
14517,NUNDA,NY,1272,987,-285,0.43691899070385126
14518,OAKS CORNERS,NY,14,13,-1,0.48148148148148145
14519,ONTARIO,NY,3767,4004,237,0.515249002702355
14521,OVID,NY,1395,1200,-195,0.4624277456647399
14522,PALMYRA,NY,4202,3498,-704,0.4542857142857143
14525,PAVILION,NY,582,588,6,0.5025641025641026
14526,PENFIELD,NY,6293,6769,476,0.5182207931404073
14527,PENN YAN,NY,5843,5372,-471,0.4790013374944271
14530,PERRY,NY,2524,2175,-349,0.462864439242392
14532,PHELPS,NY,1548,1534,-14,0.49772874756651525
14533,PIFFARD,NY,201,250,49,0.5543237250554324
14534,PITTSFORD,NY,10772,11303,531,0.5120271800679501
14536,PORTAGEVILLE,NY,11,25,14,0.6944444444444444
14541,ROME,NY,18,16,-2,0.47058823529411764
14541,ROMULUS,NY,1136,880,-256,0.4365079365079365
14543,RUSH,NY,792,859,67,0.5202907328891581
14544,RUSHVILLE,NY,745,659,-86,0.46937321937321935
14546,SCOTTSVILLE,NY,2047,1900,-147,0.4813782619711173
14548,SHORTSVILLE,NY,1211,1204,-7,0.4985507246376812
14549,SILVER LAKE,NY,91,33,-58,0.2661290322580645
14550,SILVER SPRINGS,NY,618,442,-176,0.4169811320754717
14551,SODUS,NY,2103,2068,-35,0.4958043634619995
14555,SODUS POINT,NY,687,579,-108,0.45734597156398105
14559,SPENCERPORT,NY,6234,5734,-500,0.47911096256684493
14560,SPRINGWATER,NY,678,707,29,0.5104693140794224
14561,STANLEY,NY,572,593,21,0.5090128755364807
14564,VICTOR,NY,6265,6530,265,0.5103556076592419
14568,WALWORTH,NY,1582,1584,2,0.5003158559696779
14569,WARSAW,NY,2775,2775,0,0.5
14571,WATERPORT,NY,341,340,-1,0.49926578560939794
14572,WAYLAND,NY,2065,1905,-160,0.47984886649874053
14580,WEBSTER,NY,20973,21296,323,0.5038207669923584
14586,WEST HENRIETTA,NY,4665,4797,132,0.5069752694990488
14589,WILLIAMSON,NY,2457,2584,127,0.5125967070025789
14590,WOLCOTT,NY,2614,2404,-210,0.47907532881626147
14591,WYOMING,NY,146,274,128,0.6523809523809524
14603,ROCHESTER,NY,387,780,393,0.6683804627249358
14604,ROCHESTER,NY,3537,3361,-176,0.48724267903740215
14605,ROCHESTER,NY,7120,6037,-1083,0.45884320133769096
14606,ROCHESTER,NY,12501,11364,-1137,0.47617850408548085
14607,ROCHESTER,NY,14184,10904,-3280,0.4346301020408163
14608,ROCHESTER,NY,8401,7050,-1351,0.45628114685133647
14609,ROCHESTER,NY,20936,18541,-2395,0.46966588139929577
14610,ROCHESTER,NY,7533,6697,-836,0.47062543921293043
14611,ROCHESTER,NY,10443,8601,-1842,0.45163831127914306
14612,GREECE,NY,228,280,52,0.5511811023622047
14612,ROCHESTER,NY,13027,12627,-400,0.4922039448039292
14613,ROCHESTER,NY,9661,7599,-2062,0.4402665121668598
14614,ROCHESTER,NY,841,843,2,0.50059382422802845
14615,GREECE,NY,157,136,-21,0.4641638225255973
14615,ROCHESTER,NY,8997,8219,-778,0.4774047397769517
14616,ROCHESTER,NY,12112,11299,-813,0.4826363675195421
14617,IRONDEQUOIT,NY,448,516,68,0.5352697095435685
14617,ROCHESTER,NY,7250,7018,-232,0.491869918699187
14618,ROCHESTER,NY,8809,8712,-97,0.4972318931567833
14619,ROCHESTER,NY,6829,5786,-1043,0.45866032500990883
14620,BRIGHTON,NY,242,222,-20,0.47844827586206895
14620,ROCHESTER,NY,15454,12311,-3143,0.4433999639834324
14621,ROCHESTER,NY,18948,15600,-3348,0.45154567558179926
14622,IRONDEQUOIT,NY,235,272,37,0.5364891518737672
14622,ROCHESTER,NY,4182,4069,-113,0.4931523451702824
14623,ROCHESTER,NY,11446,9814,-1632,0.461618062088429
14624,GATES,NY,224,195,-29,0.46539379474940334
14624,ROCHESTER,NY,13269,13394,125,0.5023440723099426
14625,ROCHESTER,NY,4286,4293,7,0.5004079729572212
14626,ROCHESTER,NY,12209,12062,-147,0.4969716946149726
14692,ROCHESTER,NY,675,878,203,0.5653573728267869
14701,JAMESTOWN,NY,19583,18443,-1140,0.48501025614053545
14702,JAMESTOWN,NY,417,754,337,0.6438941076003416
14706,ALLEGANY,NY,2127,2009,-118,0.4857350096711799
14707,ALLENTOWN,NY,0,11,11,1
14709,ANGELICA,NY,587,412,-175,0.4124124124124124
14710,ASHVILLE,NY,1290,1087,-203,0.4572991165334455
14711,BELFAST,NY,688,629,-59,0.4776006074411541
14712,BEMUS POINT,NY,1748,1634,-114,0.48314606741573035
14715,BOLIVAR,NY,1443,1275,-168,0.46909492273730685
14716,BROCTON,NY,1000,921,-79,0.47943779281624155
14717,CANEADEA,NY,295,268,-27,0.47602131438721135
14718,CASSADAGA,NY,676,615,-61,0.4763749031758327
14719,CATTARAUGUS,NY,1084,988,-96,0.4768339768339768
14720,CELORON,NY,148,83,-65,0.3593073593073593
14722,CHAUTAUQUA,NY,2559,1950,-609,0.4324683965402528
14723,CHERRY CREEK,NY,285,175,-110,0.3804347826086957
14724,CLYMER,NY,831,616,-215,0.4257083621285418
14726,CONEWANGO VALLEY,NY,131,50,-81,0.27624309392265195
14727,CUBA,NY,2288,2071,-217,0.4751089699472356
14728,DEWITTVILLE,NY,566,435,-131,0.43456543456543456
14729,EAST OTTO,NY,82,175,93,0.6809338521400778
14731,ELLICOTTVILLE,NY,949,870,-79,0.4782847718526663
14733,FALCONER,NY,1671,1671,0,0.5
14735,FILLMORE,NY,1029,799,-230,0.43708971553610504
14736,FINDLEY LAKE,NY,59,52,-7,0.46846846846846846
14737,FRANKLINVILLE,NY,1592,1434,-158,0.47389292795769994
14738,FREWSBURG,NY,1284,1227,-57,0.4886499402628435
14739,FRIENDSHIP,NY,1530,1407,-123,0.4790602655771195
14740,GERRY,NY,150,222,72,0.5967741935483871
14741,GREAT VALLEY,NY,451,518,67,0.5345717234262126
14743,HINSDALE,NY,474,494,20,0.5103305785123967
14743,ISCHUA,NY,53,52,-1,0.49523809523809526
14744,HOUGHTON,NY,145,161,16,0.5261437908496732
14747,KENNEDY,NY,684,378,-306,0.3559322033898305
14748,KILL BUCK,NY,0,11,11,1
14750,LAKEWOOD,NY,2484,2159,-325,0.46500107688994186
14752,LILY DALE,NY,118,45,-73,0.27607361963190186
14753,LIMESTONE,NY,113,86,-27,0.4321608040201005
14754,LITTLE GENESEE,NY,27,12,-15,0.3076923076923077
14755,LITTLE VALLEY,NY,1079,1036,-43,0.48983451536643025
14757,MAYVILLE,NY,1889,1908,19,0.5025019752436134
14760,OLEAN,NY,8774,7884,-890,0.4732861087765638
14767,PANAMA,NY,372,322,-50,0.46397694524495675
14769,PORTLAND,NY,111,114,3,0.5066666666666667
14770,PORTVILLE,NY,1013,966,-47,0.4881253158160687
14772,RANDOLPH,NY,1311,1238,-73,0.4856806590819929
14775,RIPLEY,NY,858,824,-34,0.48989298454221164
14777,RUSHFORD,NY,297,233,-64,0.439622641509434
14778,SAINT BONAVENTURE,NY,16,0,-16,0
14778,ST BONAS,NY,12,0,-12,0
14779,SALAMANCA,NY,3278,2883,-395,0.4679435156630417
14781,SHERMAN,NY,765,574,-191,0.42867811799850636
14782,SINCLAIRVILLE,NY,527,591,64,0.5286225402504472
14783,STEAMBURG,NY,16,0,-16,0
14784,STOCKTON,NY,213,89,-124,0.2947019867549669
14785,STOW,NY,12,51,39,0.8095238095238095
14787,WESTFIELD,NY,2287,2237,-50,0.49447391688771
14788,WESTONS MILLS,NY,12,0,-12,0
14801,ADDISON,NY,2147,1940,-207,0.4746758013212625
14802,ALFRED,NY,643,267,-376,0.2934065934065934
14803,ALFRED STA,NY,16,0,-16,0
14803,ALFRED STATION,NY,355,277,-78,0.43829113924050633
14804,ALMOND,NY,260,269,9,0.5085066162570888
14805,ALPINE,NY,192,201,9,0.5114503816793893
14806,ANDOVER,NY,690,619,-71,0.47288006111535524
14807,ARKPORT,NY,1051,964,-87,0.4784119106699752
14808,ATLANTA,NY,122,69,-53,0.3612565445026178
14809,AVOCA,NY,1052,1016,-36,0.4912959381044487
14810,BATH,NY,6257,5970,-287,0.4882636787437638
14812,BEAVER DAMS,NY,1398,1005,-393,0.418227215980025
14813,BELMONT,NY,980,967,-13,0.49666153055983564
14814,BIG FLATS,NY,670,580,-90,0.464
14815,BRADFORD,NY,305,269,-36,0.4686411149825784
14817,BROOKLYN,NY,140,149,9,0.5155709342560554
14817,BROOKTONDALE,NY,1171,1082,-89,0.480248557478917
14818,BURDETT,NY,796,716,-80,0.47354497354497355
14819,CAMERON,NY,97,85,-12,0.46703296703296704
14820,CAMERON MILLS,NY,23,0,-23,0
14821,CAMPBELL,NY,1256,1148,-108,0.47753743760399336
14822,CANASERAGA,NY,113,127,14,0.5291666666666667
14823,CANISTEO,NY,1575,1288,-287,0.44987775061124696
14824,CAYUTA,NY,29,84,55,0.7433628318584071
14825,CHEMUNG,NY,101,50,-51,0.33112582781456956
14826,COHOCTON,NY,515,494,-21,0.489593657086224
14830,CORNING,NY,9567,8553,-1014,0.47201986754966885
14836,DALTON,NY,115,33,-82,0.22297297297297297
14837,DUNDEE,NY,2285,2079,-206,0.47639780018331807
14838,ERIN,NY,386,342,-44,0.4697802197802198
14839,GREENWOOD,NY,0,24,24,1
14840,HAMMONDSPORT,NY,2191,2062,-129,0.48483423465788855
14841,HECTOR,NY,170,212,42,0.5549738219895288
14842,HIMROD,NY,180,187,7,0.5095367847411444
14843,HORNELL,NY,7285,5823,-1462,0.4442325297528227
14845,HORSEHEADS,NY,8325,7808,-517,0.4839769416723486
14846,HUNT,NY,24,16,-8,0.4
14847,INTERLAKEN,NY,1043,846,-197,0.44785600847009
14850,ITHACA,NY,33043,26246,-6797,0.44267908043650595
14851,ITHACA,NY,436,372,-64,0.4603960396039604
14852,ITHACA,NY,606,292,-314,0.32516703786191536
14853,ITHACA,NY,0,22,22,1
14855,JASPER,NY,127,85,-42,0.4009433962264151
14858,LINDLEY,NY,364,356,-8,0.49444444444444446
14859,LOCKWOOD,NY,223,134,-89,0.3753501400560224
14860,LODI,NY,410,323,-87,0.4406548431105048
14861,LOWMAN,NY,382,403,21,0.513375796178344
14864,MILLPORT,NY,385,236,-149,0.38003220611916266
14865,MONTOUR FALLS,NY,1300,1162,-138,0.4719740048740861
14867,NEWFIELD,NY,3126,2309,-817,0.42483900643974243
14869,ODESSA,NY,294,243,-51,0.45251396648044695
14870,PAINTED POST,NY,4449,4180,-269,0.48441302584308726
14871,PINE CITY,NY,1443,1186,-257,0.45112209965766453
14872,PINE VALLEY,NY,84,67,-17,0.44370860927152317
14873,PRATTSBURGH,NY,1106,969,-137,0.4669879518072289
14877,REXVILLE,NY,11,12,1,0.5217391304347826
14878,ROCK STREAM,NY,123,121,-2,0.4959016393442623
14879,SAVONA,NY,889,703,-186,0.4415829145728643
14880,SCIO,NY,607,608,1,0.5004115226337449
14881,SLATERVILLE SPRINGS,NY,0,11,11,1
14882,ITHACA,NY,33,37,4,0.5285714285714286
14882,LANSING,NY,1592,1629,37,0.5057435579012729
14883,SPENCER,NY,1497,1359,-138,0.47584033613445376
14884,SWAIN,NY,13,15,2,0.5357142857142857
14885,TROUPSBURG,NY,110,57,-53,0.3413173652694611
14886,TRUMANSBURG,NY,2717,2742,25,0.502289796666056
14889,VAN ETTEN,NY,318,304,-14,0.4887459807073955
14891,WATKINS GLEN,NY,2010,1908,-102,0.4869831546707504
14892,WAVERLY,NY,4352,3322,-1030,0.4328902788636956
14894,WELLSBURG,NY,472,329,-143,0.4107365792759051
14895,WELLSVILLE,NY,4131,3841,-290,0.4818113396889112
14897,WHITESVILLE,NY,89,62,-27,0.4105960264900662
14898,WOODHULL,NY,388,215,-173,0.35655058043117743
14901,ELMIRA,NY,8535,7274,-1261,0.46011765450060094
14902,ELMIRA,NY,11,13,2,0.5416666666666666
14903,ELMIRA,NY,2536,2355,-181,0.4814966264567573
14903,ELMIRA HEIGHTS,NY,357,378,21,0.5142857142857142
14903,ELMIRA HTS,NY,75,43,-32,0.3644067796610169
14904,ELMIRA,NY,7709,7222,-487,0.4836916482486103
14905,ELMIRA,NY,3963,3799,-164,0.4894357124452461
15001,ALIQUIPPA,PA,10320,9692,-628,0.4843094143513892
15003,AMBRIDGE,PA,6050,4457,-1593,0.42419339487960406
15005,BADEN,PA,2526,2615,89,0.5086559035207158
15009,BEAVER,PA,4958,5063,105,0.5052389981039817
15010,BEAVER FALLS,PA,10018,8964,-1054,0.47223685596881254
15012,BELLE VERNON,PA,2849,2766,-83,0.4926090828138914
15012,ROSTRAVER TOWNSHIP,PA,1917,1913,-4,0.4994778067885117
15012,ROSTRAVER TWP,PA,119,134,15,0.5296442687747036
15014,BRACKENRIDGE,PA,1122,1000,-122,0.471253534401508
15015,BRADFORDWOODS,PA,127,162,35,0.5605536332179931
15017,BRIDGEVILLE,PA,5828,5832,4,0.5001715265866209
15018,BUENA VISTA,PA,45,22,-23,0.3283582089552239
15019,BULGER,PA,129,136,7,0.5132075471698113
15021,ALIQUIPPA,PA,22,30,8,0.5769230769230769
15021,BURGETTSTOWN,PA,1791,1701,-90,0.48711340206185566
15022,CHARLEROI,PA,3861,3494,-367,0.4750509857239973
15022,NORTH CHARLEROI,PA,95,73,-22,0.43452380952380953
15024,CHESWICK,PA,2420,2475,55,0.5056179775280899
15025,CLAIRTON,PA,6063,5027,-1036,0.45329125338142473
15025,JEFFERSON HILLS,PA,343,324,-19,0.48575712143928035
15026,CLINTON,PA,1274,1261,-13,0.49743589743589745
15027,CONWAY,PA,522,457,-65,0.466802860061287
15030,CREIGHTON,PA,116,122,6,0.5126050420168067
15031,CUDDY,PA,116,37,-79,0.24183006535947713
15033,DONORA,PA,2102,1868,-234,0.47052896725440807
15034,DRAVOSBURG,PA,560,413,-147,0.4244604316546763
15035,E MCKEESPORT,PA,22,16,-6,0.42105263157894735
15035,EAST MC KEESPORT,PA,848,626,-222,0.42469470827679784
15037,ELIZABETH,PA,2539,2298,-241,0.47508786437874717
15042,FREEDOM,PA,2322,2175,-147,0.4836557705136758
15043,GEORGETOWN,PA,230,174,-56,0.4306930693069307
15044,GIBSONIA,PA,6398,7331,933,0.5339791681841358
15045,GLASSPORT,PA,2184,1825,-359,0.4552257420803193
15046,CRESCENT,PA,614,549,-65,0.472055030094583
15047,GREENOCK,PA,0,16,16,1
15049,HARWICK,PA,40,57,17,0.5876288659793815
15050,HOOKSTOWN,PA,315,289,-26,0.478476821192053
15051,INDIANOLA,PA,69,14,-55,0.1686746987951807
15052,INDUSTRY,PA,736,696,-40,0.4860335195530726
15054,LANGELOTH,PA,63,24,-39,0.27586206896551724
15055,LAWRENCE,PA,425,275,-150,0.39285714285714285
15056,LEETSDALE,PA,299,142,-157,0.3219954648526077
15057,MC DONALD,PA,3919,4563,644,0.5379627446356992
15059,MIDLAND,PA,1406,1186,-220,0.4575617283950617
15060,MIDWAY,PA,55,0,-55,0
15061,MONACA,PA,4749,4460,-289,0.4843088283201216
15062,MONESSEN,PA,2966,2597,-369,0.4668344418479238
15063,MONONGAHELA,PA,3103,2995,-108,0.4911446375860938
15064,MORGAN,PA,39,0,-39,0
15065,NATRONA HEIGHTS,PA,3663,3309,-354,0.47461273666092946
15065,NATRONA HTS,PA,72,86,14,0.5443037974683544
15066,NEW BRIGHTON,PA,4780,3886,-894,0.44841910916224326
15067,NEW EAGLE,PA,630,620,-10,0.496
15068,ARNOLD,PA,525,511,-14,0.49324324324324326
15068,LOWER BURRELL,PA,1054,1086,32,0.5074766355140187
15068,NEW KENSINGTON,PA,10103,10215,112,0.502756176789054
15071,OAKDALE,PA,4842,4686,-156,0.49181360201511337
15074,ROCHESTER,PA,3414,3021,-393,0.4694638694638695
15076,RUSSELLTON,PA,101,26,-75,0.2047244094488189
15078,SLOVAN,PA,54,0,-54,0
15081,SOUTH HEIGHTS,PA,13,0,-13,0
15082,STURGEON,PA,13,0,-13,0
15083,SUTERSVILLE,PA,61,11,-50,0.1527777777777778
15084,TARENTUM,PA,3232,2822,-410,0.46613809051866534
15085,CLAIRTON,PA,43,68,25,0.6126126126126126
15085,TRAFFORD,PA,2188,2269,81,0.5090868297060803
15086,WARRENDALE,PA,55,221,166,0.8007246376811594
15087,WEBSTER,PA,12,0,-12,0
15088,W ELIZABETH,PA,0,11,11,1
15088,WEST ELIZABETH,PA,25,0,-25,0
15089,WEST NEWTON,PA,1683,1738,55,0.5080385852090032
15090,WEXFORD,PA,8364,8494,130,0.5038557361490094
15101,ALLISON PARK,PA,6290,6695,405,0.5155949172121679
15102,BETHEL PARK,PA,8074,8454,380,0.5114956437560504
15104,BRADDOCK,PA,4005,2565,-1440,0.3904109589041096
15104,RANKIN,PA,99,58,-41,0.36942675159235666
15106,CARNEGIE,PA,6672,6513,-159,0.4939704209328783
15106,HEIDELBERG,PA,147,129,-18,0.4673913043478261
15108,CORAOPOLIS,PA,14154,13303,-851,0.48450304111884035
15108,MOON TOWNSHIP,PA,570,529,-41,0.4813466787989081
15110,DUQUESNE,PA,2251,1896,-355,0.4571979744393537
15112,EAST PITTSBURGH,PA,2112,1206,-906,0.36347197106690776
15116,GLENSHAW,PA,3044,3139,95,0.5076823548439269
15120,HOMESTEAD,PA,5112,4581,-531,0.4726090993500464
15120,MUNHALL,PA,1640,1652,12,0.5018226002430134
15122,WEST MIFFLIN,PA,5222,4964,-258,0.48733555860985667
15126,IMPERIAL,PA,2458,2531,73,0.5073160954099017
15129,SOUTH PARK,PA,3645,3710,65,0.504418762746431
15131,MCKEESPORT,PA,75,59,-16,0.44029850746268656
15131,WHITE OAK,PA,2486,2635,149,0.514547939855497
15132,MCKEESPORT,PA,8547,6906,-1641,0.44690351388079985
15133,MCKEESPORT,PA,1674,1598,-76,0.4883863080684597
15134,MCKEESPORT,PA,183,120,-63,0.39603960396039606
15135,MCKEESPORT,PA,1406,1349,-57,0.4896551724137931
15136,MC KEES ROCKS,PA,8700,7600,-1100,0.4662576687116564
15137,N VERSAILLES,PA,107,62,-45,0.3668639053254438
15137,NORTH VERSAILLES,PA,3949,3228,-721,0.4497700989271283
15139,OAKMONT,PA,3010,2951,-59,0.4950511659117598
15140,PITCAIRN,PA,1354,1213,-141,0.4725360342812622
15142,PRESTO,PA,1323,1209,-114,0.4774881516587678
15143,SEWICKLEY,PA,6620,7201,581,0.5210187395991607
15144,SPRINGDALE,PA,1179,1144,-35,0.49246663796814466
15145,TURTLE CREEK,PA,3302,2456,-846,0.42653699201111495
15146,MONROEVILLE,PA,11548,11015,-533,0.4881886273988388
15147,VERONA,PA,6435,5337,-1098,0.4533639143730887
15148,WALL,PA,512,375,-137,0.4227733934611049
15148,WILMERDING,PA,958,666,-292,0.4100985221674877
15201,PITTSBURGH,PA,9140,7350,-1790,0.44572468162522744
15202,AVALON,PA,995,800,-195,0.4456824512534819
15202,BELLEVUE,PA,1494,1271,-223,0.4596745027124774
15202,BELLVUE,PA,180,177,-3,0.4957983193277311
15202,BEN AVON,PA,385,321,-64,0.4546742209631728
15202,EMSWORTH,PA,328,264,-64,0.44594594594594594
15202,PITTSBURGH,PA,5513,4482,-1031,0.44842421210605304
15203,CARSON,PA,129,89,-40,0.40825688073394495
15203,PITTSBURGH,PA,8650,5947,-2703,0.40741248201685276
15204,PITTSBURGH,PA,2653,2296,-357,0.4639321074964639
15205,CRAFTON,PA,753,645,-108,0.4613733905579399
15205,PITTSBURGH,PA,10568,9265,-1303,0.46715070841526746
15206,EAST LIBERTY,PA,1059,868,-191,0.4504411001556824
15206,PITTSBURGH,PA,16461,13250,-3211,0.44596277472989804
15207,HAZELWOOD,PA,70,83,13,0.5424836601307189
15207,PITTSBURGH,PA,3858,3491,-367,0.47503061641039596
15208,HOMEWOOD,PA,76,69,-7,0.47586206896551725
15208,PITTSBURGH,PA,4294,3695,-599,0.4625109525597697
15209,MILLVALE,PA,317,210,-107,0.3984819734345351
15209,PITTSBURGH,PA,3336,2998,-338,0.47331859804231136
15210,PITTSBURGH,PA,10901,8871,-2030,0.44866477847461056
15211,MOUNT WASHINGTON,PA,1810,1394,-416,0.43508114856429464
15211,MT WASHINGTON,PA,385,318,-67,0.4523470839260313
15211,PITTSBURGH,PA,4829,3884,-945,0.4457706874784804
15212,PITTSBURGH,PA,13722,11403,-2319,0.45385074626865674
15213,OAKLAND,PA,298,139,-159,0.3180778032036613
15213,PITTSBURGH,PA,11743,6487,-5256,0.35584201865057596
15214,OBSERVATORY,PA,150,120,-30,0.4444444444444444
15214,PITTSBURGH,PA,5066,3999,-1067,0.4411472697186983
15215,ASPINWALL,PA,837,872,35,0.5102399063779989
15215,PITTSBURGH,PA,3110,2964,-146,0.48798156075074084
15215,SHARPSBURG,PA,224,218,-6,0.49321266968325794
15216,PITTSBURGH,PA,9039,7684,-1355,0.45948693416253067
15216,SOUTH HILLS,PA,288,231,-57,0.44508670520231214
15217,PITTSBURGH,PA,13476,10544,-2932,0.4389675270607827
15217,SQUIRREL HILL,PA,434,339,-95,0.4385510996119017
15218,PITTSBURGH,PA,6101,5430,-671,0.47090451825513835
15218,SWISSVALE,PA,225,226,1,0.5011086474501109
15219,PITTSBURGH,PA,7395,6609,-786,0.47193658954584405
15220,PITTSBURGH,PA,8925,7449,-1476,0.454928545254672
15221,PITTSBURGH,PA,12284,10552,-1732,0.4620774216149939
15221,WILKINSBURG,PA,1328,1119,-209,0.4572946465059256
15222,PITTSBURGH,PA,7628,6530,-1098,0.46122333662946746
15223,ETNA,PA,672,544,-128,0.4473684210526316
15223,PITTSBURGH,PA,1863,1538,-325,0.4522199353131432
15224,BLOOMFIELD,PA,590,426,-164,0.41929133858267714
15224,PITTSBURGH,PA,6408,5025,-1383,0.43951718709000265
15225,PITTSBURGH,PA,348,188,-160,0.35074626865671643
15226,BROOKLINE,PA,291,277,-14,0.4876760563380282
15226,PITTSBURGH,PA,4915,4216,-699,0.4617237980505969
15227,BRENTWOOD,PA,506,509,3,0.5014778325123153
15227,PITTSBURGH,PA,9130,8016,-1114,0.46751428904700804
15228,MT LEBANON,PA,548,554,6,0.5027223230490018
15228,PISSTBURGH,PA,98,95,-3,0.49222797927461137
15228,PITTSBURGH,PA,4923,4667,-256,0.48665276329509904
15229,PITTSBURGH,PA,4372,3989,-383,0.4770960411434039
15229,WEST VIEW,PA,441,390,-51,0.4693140794223827
15230,PITTSBURGH,PA,32,27,-5,0.4576271186440678
15232,PITTSBURGH,PA,9810,6068,-3742,0.3821640005038418
15232,SHADYSIDE,PA,128,108,-20,0.4576271186440678
15233,KILBUCK,PA,28,43,15,0.6056338028169014
15233,PITTSBURGH,PA,1699,1546,-153,0.4764252696456086
15234,CASTLE SHANNON,PA,210,245,35,0.5384615384615384
15234,PITTSBURGH,PA,4987,4832,-155,0.4921071392198798
15235,PENN HILLS,PA,885,868,-17,0.49515116942384485
15235,PITTSBURGH,PA,10592,10138,-454,0.48904968644476604
15236,PITTSBURGH,PA,9096,9213,117,0.5031951499262658
15236,PLEASANT HILLS,PA,408,382,-26,0.4835443037974684
15236,PLEASANT HLS,PA,235,251,16,0.5164609053497943
15237,MC KNIGHT,PA,305,282,-23,0.4804088586030664
15237,PITTSBURGH,PA,13551,13570,19,0.5003502820692453
15238,BLAWNOX,PA,398,472,74,0.542528735632184
15238,PITTSBURGH,PA,4197,4712,515,0.5289033561566955
15239,PITTSBURGH,PA,4972,4984,12,0.5006026516673363
15239,PLUM,PA,665,656,-9,0.49659348978046935
15241,PITTSBURGH,PA,5368,5850,482,0.5214833303619183
15241,UPPER SAINT CLAIR,PA,377,447,70,0.5424757281553398
15241,UPPER ST CLAIR,PA,396,430,34,0.5205811138014528
15243,CEDARHURST,PA,90,110,20,0.55
15243,PITTSBURGH,PA,3202,3709,507,0.5366806540298076
15244,PITTSBURGH,PA,0,114,114,1
15275,PITTSBURGH,PA,0,12,12,1
15301,WASHINGTON,PA,19637,17044,-2593,0.4646547258798833
15311,AMITY,PA,23,25,2,0.5208333333333334
15312,AVELLA,PA,686,708,22,0.5078909612625538
15314,BENTLEYVILLE,PA,1177,1093,-84,0.4814977973568282
15315,BOBTOWN,PA,26,0,-26,0
15317,CANONSBURG,PA,13229,14418,1189,0.5215032372409303
15317,MCMURRAY,PA,888,978,90,0.5241157556270096
15320,CARMICHAELS,PA,1760,1678,-82,0.48807446189645143
15321,CECIL,PA,361,313,-48,0.46439169139465875
15322,CLARKSVILLE,PA,470,530,60,0.53
15323,CLAYSVILLE,PA,1409,1166,-243,0.45281553398058255
15324,COKEBURG,PA,72,36,-36,0.3333333333333333
15325,CRUCIBLE,PA,24,0,-24,0
15327,DILLINER,PA,85,80,-5,0.48484848484848486
15329,PROSPERITY,PA,51,26,-25,0.33766233766233766
15330,EIGHTY FOUR,PA,1197,1547,350,0.5637755102040817
15331,ELLSWORTH,PA,40,48,8,0.5454545454545454
15332,FINLEYVILLE,PA,1849,1909,60,0.5079829696647152
15333,FREDERICKTOWN,PA,345,256,-89,0.4259567387687188
15337,GRAYSVILLE,PA,22,0,-22,0
15338,GREENSBORO,PA,238,190,-48,0.4439252336448598
15340,HICKORY,PA,84,98,14,0.5384615384615384
15341,HOLBROOK,PA,23,13,-10,0.3611111111111111
15342,HOUSTON,PA,1491,1628,137,0.5219621673613337
15344,JEFFERSON,PA,139,182,43,0.5669781931464174
15345,MARIANNA,PA,124,133,9,0.5175097276264592
15346,MATHER,PA,12,0,-12,0
15347,MEADOW LANDS,PA,141,52,-89,0.2694300518134715
15349,MOUNT MORRIS,PA,518,246,-272,0.3219895287958115
15349,MT MORRIS,PA,42,14,-28,0.25
15350,MUSE,PA,55,0,-55,0
15351,NEMACOLIN,PA,166,98,-68,0.3712121212121212
15352,NEW FREEPORT,PA,75,38,-37,0.336283185840708
15357,RICES LANDING,PA,167,120,-47,0.4181184668989547
15358,RICHEYVILLE,PA,103,12,-91,0.10434782608695652
15360,SCENERY HILL,PA,164,144,-20,0.4675324675324675
15362,SPRAGGS,PA,34,26,-8,0.43333333333333335
15363,STRABANE,PA,90,0,-90,0
15364,SYCAMORE,PA,13,0,-13,0
15367,VENETIA,PA,1822,2315,493,0.5595842397872854
15370,WAYNESBURG,PA,5312,4665,-647,0.46757542347399017
15376,W ALEXANDER,PA,27,0,-27,0
15376,WEST ALEXANDER,PA,212,240,28,0.5309734513274337
15377,WEST FINLEY,PA,12,13,1,0.52
15380,WIND RIDGE,PA,12,0,-12,0
15401,UNIONTOWN,PA,12654,11907,-747,0.48479296445584463
15410,ADAH,PA,17,12,-5,0.41379310344827586
15411,ADDISON,PA,109,24,-85,0.18045112781954886
15412,ALLENPORT,PA,0,12,12,1
15413,ALLISON,PA,15,11,-4,0.4230769230769231
15417,BROWNSVILLE,PA,2386,2359,-27,0.4971548998946259
15419,CALIFORNIA,PA,1596,1416,-180,0.4701195219123506
15421,CHALK HILL,PA,11,0,-11,0
15423,COAL CENTER,PA,202,149,-53,0.42450142450142453
15423,PERRYOPOLIS,PA,0,14,14,1
15424,CONFLUENCE,PA,983,804,-179,0.44991606043648574
15425,CONNELLSVILLE,PA,6584,5711,-873,0.46449776331842213
15427,DAISYTOWN,PA,0,22,22,1
15428,DAWSON,PA,206,142,-64,0.40804597701149425
15430,DICKERSON RUN,PA,12,0,-12,0
15431,DUNBAR,PA,1136,1048,-88,0.47985347985347987
15432,DUNLEVY,PA,0,25,25,1
15436,FAIRCHANCE,PA,975,884,-91,0.4755244755244755
15437,FARMINGTON,PA,619,537,-82,0.46453287197231835
15438,FAYETTE CITY,PA,400,290,-110,0.42028985507246375
15442,GRINDSTONE,PA,283,278,-5,0.49554367201426025
15443,HIBBS,PA,11,0,-11,0
15444,HILLER,PA,13,0,-13,0
15445,HOPWOOD,PA,906,774,-132,0.4607142857142857
15446,INDIAN HEAD,PA,26,0,-26,0
15450,LA BELLE,PA,0,11,11,1
15451,LAKE LYNN,PA,13,0,-13,0
15455,LEISENRING,PA,12,0,-12,0
15456,LEMONT FRNC,PA,0,11,11,1
15456,LEMONT FURNACE,PA,767,687,-80,0.47248968363136173
15458,MC CLELLANDTOWN,PA,644,470,-174,0.42190305206463197
15458,MCCLELLANDTWN,PA,17,34,17,0.6666666666666666
15459,MARKLEYSBURG,PA,199,200,1,0.5012531328320802
15460,MARTIN,PA,11,0,-11,0
15461,MASONTOWN,PA,1348,1367,19,0.503499079189687
15464,MILL RUN,PA,101,47,-54,0.31756756756756754
15466,NEWELL,PA,14,0,-14,0
15468,NEW SALEM,PA,855,554,-301,0.39318665720369056
15469,NORMALVILLE,PA,578,271,-307,0.31919905771495877
15470,OHIOPYLE,PA,11,13,2,0.5416666666666666
15473,PERRYOPOLIS,PA,907,910,3,0.5008255365987893
15474,POINT MARION,PA,665,648,-17,0.49352627570449353
15475,REPUBLIC,PA,262,147,-115,0.3594132029339853
15476,RONCO,PA,31,0,-31,0
15477,ROSCOE,PA,96,25,-71,0.2066115702479339
15478,SMITHFIELD,PA,1972,1655,-317,0.45629997242900466
15479,SMITHTON,PA,372,315,-57,0.4585152838427948
15480,SMOCK,PA,281,172,-109,0.37969094922737306
15482,STAR JUNCTION,PA,39,0,-39,0
15484,ULEDI,PA,11,0,-11,0
15486,VANDERBILT,PA,386,412,26,0.5162907268170426
15489,WEST LEISENRING,PA,23,0,-23,0
15501,SOMERSET,PA,5485,5657,172,0.5077185424519834
15502,HIDDEN VALLEY,PA,11,12,1,0.5217391304347826
15521,ALUM BANK,PA,108,159,51,0.5955056179775281
15522,BEDFORD,PA,4482,3988,-494,0.4708382526564345
15530,BERLIN,PA,1240,1180,-60,0.48760330578512395
15531,BOSWELL,PA,1004,943,-61,0.4843348741653826
15533,BREEZEWOOD,PA,315,221,-94,0.4123134328358209
15534,BUFFALO MILLS,PA,27,41,14,0.6029411764705882
15535,CLEARVILLE,PA,298,182,-116,0.37916666666666665
15537,EVERETT,PA,2858,2606,-252,0.4769399707174231
15539,FISHERTOWN,PA,13,37,24,0.74
15541,FRIEDENS,PA,925,882,-43,0.48810182623132264
15542,GARRETT,PA,118,38,-80,0.24358974358974358
15545,HYNDMAN,PA,663,576,-87,0.4648910411622276
15546,JENNERS,PA,12,0,-12,0
15550,MANNS CHOICE,PA,465,310,-155,0.4
15552,MEYERSDALE,PA,1555,1427,-128,0.4785378940308518
15554,NEW PARIS,PA,677,493,-184,0.42136752136752137
15557,ROCKWOOD,PA,1177,1047,-130,0.47077338129496404
15558,SALISBURY,PA,245,221,-24,0.4742489270386266
15559,SCHELLSBURG,PA,535,507,-28,0.4865642994241843
15563,STOYSTOWN,PA,878,658,-220,0.4283854166666667
15601,GREENSBURG,PA,19569,18715,-854,0.4888465155156201
15610,ACME,PA,651,602,-49,0.48044692737430167
15611,ADAMSBURG,PA,0,11,11,1
15613,APOLLO,PA,3811,3838,27,0.5017649365930187
15618,AVONMORE,PA,644,505,-139,0.4395126196692776
15618,EDMON,PA,17,12,-5,0.41379310344827586
15620,BRADENVILLE,PA,86,87,1,0.5028901734104047
15622,CHAMPION,PA,277,285,8,0.5071174377224199
15623,CLARIDGE,PA,12,97,85,0.8899082568807339
15624,CRABTREE,PA,18,0,-18,0
15626,DELMONT,PA,1572,1713,141,0.5214611872146119
15627,DERRY,PA,2182,1998,-184,0.4779904306220096
15628,DONEGAL,PA,39,26,-13,0.4
15629,EAST VANDERGRIFT,PA,120,28,-92,0.1891891891891892
15631,EVERSON,PA,147,61,-86,0.2932692307692308
15632,EXPORT,PA,2555,2635,80,0.5077071290944123
15632,MURRYSVILLE,PA,57,46,-11,0.44660194174757284
15634,GRAPEVILLE,PA,25,49,24,0.6621621621621622
15636,HARRISON CITY,PA,766,824,58,0.5182389937106918
15637,HERMINIE,PA,314,326,12,0.509375
15638,HOSTETTER,PA,12,0,-12,0
15639,HUNKER,PA,400,399,-1,0.49937421777221525
15641,HYDE PARK,PA,0,11,11,1
15642,IRWIN,PA,10407,10987,580,0.5135552023931943
15642,NORTH HUNTINGDON,PA,216,246,30,0.5324675324675324
15644,JEANNETTE,PA,5927,6064,137,0.5057126177966809
15647,LARIMER,PA,13,0,-13,0
15650,LATROBE,PA,8031,7576,-455,0.4854232075350804
15655,LAUGHLINTOWN,PA,14,39,25,0.7358490566037735
15656,LEECHBURG,PA,2707,2664,-43,0.4959970210389127
15656,WEST LEECHBURG,PA,56,52,-4,0.48148148148148145
15658,LIGONIER,PA,2694,2804,110,0.5100036376864314
15661,LOYALHANNA,PA,11,0,-11,0
15662,LUXOR,PA,11,0,-11,0
15665,MANOR,PA,331,234,-97,0.41415929203539825
15666,MOUNT PLEASANT,PA,4501,4357,-144,0.49187175434635355
15666,MT PLEASANT,PA,78,79,1,0.5031847133757962
15668,MURRYSVILLE,PA,3884,3664,-220,0.4854266030736619
15670,NEW ALEXANDRI,PA,32,25,-7,0.43859649122807015
15670,NEW ALEXANDRIA,PA,1107,945,-162,0.4605263157894737
15671,NEW DERRY,PA,24,0,-24,0
15672,NEW STANTON,PA,1276,1113,-163,0.4658853076601088
15673,NORTH APOLLO,PA,471,195,-276,0.2927927927927928
15675,PA,PA,11,0,-11,0
15675,PENN,PA,88,99,11,0.5294117647058824
15676,PLEASANT UNITY,PA,13,0,-13,0
15678,RILLTON,PA,11,12,1,0.5217391304347826
15679,RUFFS DALE,PA,752,669,-83,0.4707952146375792
15681,SALTSBURG,PA,1596,1398,-198,0.46693386773547096
15683,SCOTTDALE,PA,2538,2339,-199,0.4795981135944228
15684,SLICKVILLE,PA,37,15,-22,0.28846153846153844
15686,SPRING CHURCH,PA,13,24,11,0.6486486486486487
15687,STAHLSTOWN,PA,62,96,34,0.6075949367088608
15688,TARRS,PA,11,22,11,0.6666666666666666
15690,VANDERGRIFT,PA,3677,3166,-511,0.4626625748940523
15691,WENDEL,PA,19,0,-19,0
15692,WESTMORELAND CITY,PA,15,12,-3,0.4444444444444444
15696,YOUNGSTOWN,PA,30,11,-19,0.2682926829268293
15697,YOUNGWOOD,PA,1279,1129,-150,0.4688538205980066
15698,YUKON,PA,75,72,-3,0.4897959183673469
15701,INDIANA,PA,11752,11316,-436,0.49054967920929426
15711,ANITA,PA,12,11,-1,0.4782608695652174
15714,N CAMBRIA,PA,100,66,-34,0.39759036144578314
15714,NORTHERN CAMBRIA,PA,1814,1650,-164,0.47632794457274824
15715,BIG RUN,PA,199,101,-98,0.33666666666666667
15716,BLACK LICK,PA,67,36,-31,0.34951456310679613
15717,BLAIRSVILLE,PA,3252,3140,-112,0.49123904881101377
15722,CARROLLTOWN,PA,316,329,13,0.5100775193798449
15724,CHERRY TREE,PA,584,501,-83,0.46175115207373274
15725,CLARKSBURG,PA,61,11,-50,0.1527777777777778
15728,CLYMER,PA,1221,1026,-195,0.45660881174899864
15729,COMMODORE,PA,207,90,-117,0.30303030303030304
15732,CREEKSIDE,PA,179,248,69,0.5807962529274004
15736,ELDERTON,PA,30,0,-30,0
15737,ELMORA,PA,13,11,-2,0.4583333333333333
15739,ERNEST,PA,14,0,-14,0
15742,GLEN CAMPBELL,PA,85,103,18,0.5478723404255319
15745,HEILWOOD,PA,13,11,-2,0.4583333333333333
15747,HOME,PA,159,142,-17,0.4717607973421927
15748,GRACETON,PA,163,154,-9,0.48580441640378547
15748,HOMER CITY,PA,1911,1762,-149,0.47971685270895725
15754,LUCERNEMINES,PA,0,11,11,1
15757,MAHAFFEY,PA,269,161,-108,0.3744186046511628
15759,MARION CENTER,PA,488,534,46,0.5225048923679061
15765,PENN RUN,PA,111,152,41,0.5779467680608364
15767,PUNXSUTAWNEY,PA,4907,4679,-228,0.48810765699979136
15771,ROCHESTER MILLS,PA,0,12,12,1
15772,ROSSITER,PA,237,268,31,0.5306930693069307
15774,SHELOCTA,PA,822,779,-43,0.48657089319175517
15777,STARFORD,PA,0,11,11,1
15801,DU BOIS,PA,7696,6998,-698,0.47624880903770245
15823,BROCKPORT,PA,131,120,-11,0.47808764940239046
15824,BROCKWAY,PA,1632,1608,-24,0.4962962962962963
15825,BROOKVILLE,PA,2980,2761,-219,0.48092666782790455
15827,BYRNEDALE,PA,11,0,-11,0
15828,CLARINGTON,PA,25,11,-14,0.3055555555555556
15829,CORSICA,PA,250,329,79,0.5682210708117443
15834,EMPORIUM,PA,1752,1487,-265,0.45909231244211174
15840,FALLS CREEK,PA,662,501,-161,0.4307824591573517
15845,JOHNSONBURG,PA,1578,1169,-409,0.4255551510738988
15846,KERSEY,PA,832,709,-123,0.4600908500973394
15847,KNOX DALE,PA,11,0,-11,0
15848,LUTHERSBURG,PA,22,0,-22,0
15849,PENFIELD,PA,280,274,-6,0.49458483754512633
15851,REYNOLDSVILLE,PA,2255,2033,-222,0.47411380597014924
15853,RIDGWAY,PA,2326,2174,-152,0.4831111111111111
15856,ROCKTON,PA,49,11,-38,0.18333333333333332
15857,SAINT MARYS,PA,3871,3700,-171,0.48870690793818516
15860,SIGEL,PA,127,123,-4,0.492
15864,SUMMERVILLE,PA,189,207,18,0.5227272727272727
15865,SYKESVILLE,PA,397,368,-29,0.48104575163398694
15868,WEEDVILLE,PA,252,132,-120,0.34375
15870,WILCOX,PA,160,120,-40,0.42857142857142855
15901,JOHNSTOWN,PA,2283,2059,-224,0.4742054352832796
15902,JOHNSTOWN,PA,4673,4287,-386,0.4784598214285714
15904,JOHNSTOWN,PA,4702,4654,-48,0.49743480119709277
15905,JOHNSTOWN,PA,6204,6149,-55,0.4977738201246661
15906,JOHNSTOWN,PA,4069,3644,-425,0.47244911188901856
15907,JOHNSTOWN,PA,19,40,21,0.6779661016949152
15909,CONEMAUGH,PA,423,487,64,0.5351648351648352
15909,JOHNSTOWN,PA,805,781,-24,0.49243379571248425
15920,ARMAGH,PA,75,60,-15,0.4444444444444444
15921,BEAVERDALE,PA,46,11,-35,0.19298245614035087
15923,BOLIVAR,PA,166,132,-34,0.4429530201342282
15924,CAIRNBROOK,PA,81,51,-30,0.38636363636363635
15926,CENTRAL CITY,PA,909,700,-209,0.435052827843381
15927,COLVER,PA,144,49,-95,0.2538860103626943
15928,DAVIDSVILLE,PA,201,347,146,0.6332116788321168
15931,EBENSBURG,PA,2473,2367,-106,0.4890495867768595
15935,HOLLSOPPLE,PA,395,320,-75,0.44755244755244755
15936,HOOVERSVILLE,PA,173,156,-17,0.47416413373860183
15937,JEROME,PA,35,11,-24,0.2391304347826087
15938,LILLY,PA,356,272,-84,0.43312101910828027
15940,LORETTO,PA,163,47,-116,0.22380952380952382
15942,MINERAL POINT,PA,92,101,9,0.5233160621761658
15943,NANTY GLO,PA,1130,1052,-78,0.4821264894592117
15944,NEW FLORENCE,PA,739,642,-97,0.46488052136133234
15946,PORTAGE,PA,1615,1561,-54,0.49149874055415615
15949,ROBINSON,PA,0,12,12,1
15951,SAINT MICHAEL,PA,74,23,-51,0.23711340206185566
15952,SALIX,PA,127,149,22,0.5398550724637681
15954,SEWARD,PA,527,460,-67,0.46605876393110435
15955,SIDMAN,PA,117,81,-36,0.4090909090909091
15956,SOUTH FORK,PA,518,500,-18,0.4911591355599214
15958,SUMMERHILL,PA,259,159,-100,0.3803827751196172
15960,TWIN ROCKS,PA,0,11,11,1
15961,VINTONDALE,PA,14,46,32,0.7666666666666667
15962,WILMORE,PA,13,0,-13,0
15963,WINDBER,PA,3420,3228,-192,0.4855595667870036
16001,BUTLER,PA,16169,14838,-1331,0.4785371045247847
16002,BUTLER,PA,3398,3396,-2,0.49985281130409187
16003,BUTLER,PA,43,39,-4,0.47560975609756095
16020,BOYERS,PA,76,58,-18,0.43283582089552236
16022,BRUIN,PA,12,11,-1,0.4782608695652174
16023,CABOT,PA,964,1033,69,0.5172759138708062
16025,CHICORA,PA,1278,1184,-94,0.4809098294069862
16028,EAST BRADY,PA,637,614,-23,0.4908073541167066
16029,EAST BUTLER,PA,37,0,-37,0
16033,EVANS CITY,PA,1680,2019,339,0.545823195458232
16034,FENELTON,PA,167,176,9,0.5131195335276968
16037,HARMONY,PA,1228,1589,361,0.5640752573659922
16037,ZELIENOPLE,PA,27,46,19,0.6301369863013698
16038,HARRISVILLE,PA,913,794,-119,0.4651435266549502
16040,HILLIARDS,PA,73,39,-34,0.3482142857142857
16041,KARNS CITY,PA,356,238,-118,0.4006734006734007
16045,LYNDORA,PA,480,445,-35,0.4810810810810811
16046,MARS,PA,5568,6532,964,0.5398347107438016
16046,SEVEN FIELDS,PA,403,523,120,0.5647948164146869
16049,PARKER,PA,941,926,-15,0.4959828602035351
16050,PETROLIA,PA,170,118,-52,0.4097222222222222
16051,PORTERSVILLE,PA,845,714,-131,0.4579858883899936
16052,PROSPECT,PA,636,578,-58,0.47611202635914335
16053,RENFREW,PA,1109,1089,-20,0.49545040946314833
16054,SAINT PETERSBURG,PA,25,0,-25,0
16055,SARVER,PA,1870,2157,287,0.5356344673454184
16056,SAXONBURG,PA,1306,1363,57,0.5106781566129637
16057,SLIPPERY ROCK,PA,4920,3691,-1229,0.42863778887469517
16059,VALENCIA,PA,2252,2725,473,0.547518585493269
16061,WEST SUNBURY,PA,654,560,-94,0.4612850082372323
16063,ZELIENOPLE,PA,2951,3510,559,0.5432595573440644
16066,CRANBERRY TOWNSHIP,PA,11752,12519,767,0.5158007498660954
16066,CRANBERRY TWP,PA,945,1013,68,0.517364657814096
16101,NEW CASTLE,PA,11493,10565,-928,0.4789645480097924
16102,NEW CASTLE,PA,1643,1561,-82,0.48720349563046195
16103,NEW CASTLE,PA,196,40,-156,0.1694915254237288
16105,NEW CASTLE,PA,4740,5005,265,0.5135967162647511
16107,NEW CASTLE,PA,0,27,27,1
16111,ATLANTIC,PA,12,0,-12,0
16112,BESSEMER,PA,198,156,-42,0.4406779661016949
16114,CLARKS MILLS,PA,12,11,-1,0.4782608695652174
16115,DARLINGTON,PA,748,623,-125,0.45441283734500365
16116,EDINBURG,PA,645,643,-2,0.49922360248447206
16117,ELLWOOD CITY,PA,4974,4937,-37,0.4981333871455958
16120,ENON VALLEY,PA,254,200,-54,0.44052863436123346
16121,FARRELL,PA,2337,1818,-519,0.4375451263537906
16123,FOMBELL,PA,174,178,4,0.5056818181818182
16124,FREDONIA,PA,420,394,-26,0.48402948402948404
16125,GREENVILLE,PA,7721,6030,-1691,0.4385135626499891
16127,GROVE CITY,PA,4967,4453,-514,0.4727176220806794
16130,HADLEY,PA,583,402,-181,0.40812182741116754
16131,HARTSTOWN,PA,33,11,-22,0.25
16132,HILLSVILLE,PA,16,22,6,0.5789473684210527
16133,JACKSON CENTER,PA,167,162,-5,0.49240121580547114
16134,JAMESTOWN,PA,1378,1248,-130,0.4752475247524752
16134,WESTFORD,PA,25,19,-6,0.4318181818181818
16136,KOPPEL,PA,270,207,-63,0.4339622641509434
16137,MERCER,PA,4149,4064,-85,0.4948252769998782
16141,NEW GALILEE,PA,233,147,-86,0.3868421052631579
16142,NEW WILMINGTON,PA,1424,1349,-75,0.4864767399927876
16142,NEW WILMNGTN,PA,23,30,7,0.5660377358490566
16143,PULASKI,PA,636,532,-104,0.4554794520547945
16145,SANDY LAKE,PA,988,840,-148,0.45951859956236324
16146,SHARON,PA,8164,6429,-1735,0.4405536901254026
16148,HERMITAGE,PA,6536,6314,-222,0.49136186770428014
16150,SHARPSVILLE,PA,2822,2234,-588,0.44185126582278483
16153,STONEBORO,PA,930,848,-82,0.4769403824521935
16154,TRANSFER,PA,661,601,-60,0.4762282091917591
16156,VOLANT,PA,758,607,-151,0.44468864468864466
16157,KOPPEL,PA,18,16,-2,0.47058823529411764
16157,WAMPUM,PA,748,759,11,0.5036496350364964
16159,WEST MIDDLESEX,PA,1460,1229,-231,0.4570472294533284
16160,WEST PITTSBURG,PA,98,25,-73,0.2032520325203252
16161,WHEATLAND,PA,240,159,-81,0.39849624060150374
16201,KITTANNING,PA,5282,5157,-125,0.4940128364785899
16210,ADRIAN,PA,74,55,-19,0.4263565891472868
16212,CADOGAN,PA,40,0,-40,0
16214,CLARION,PA,3971,3760,-211,0.48635364118484026
16218,COWANSVILLE,PA,23,58,35,0.7160493827160493
16222,DAYTON,PA,563,527,-36,0.4834862385321101
16224,FAIRMOUNT CITY,PA,116,124,8,0.5166666666666667
16226,FORD CITY,PA,2479,2391,-88,0.49096509240246405
16229,FREEPORT,PA,1496,1228,-268,0.45080763582966227
16230,HAWTHORN,PA,34,0,-34,0
16232,KNOX,PA,1447,1194,-253,0.45210147671336615
16233,LEEPER,PA,120,75,-45,0.38461538461538464
16235,LUCINDA,PA,51,23,-28,0.3108108108108108
16238,MANORVILLE,PA,11,0,-11,0
16239,MARIENVILLE,PA,702,488,-214,0.41008403361344536
16240,MAYPORT,PA,160,168,8,0.5121951219512195
16242,NEW BETHLEHEM,PA,1348,1270,-78,0.4851031321619557
16244,NU MINE,PA,23,0,-23,0
16246,PLUMVILLE,PA,25,0,-25,0
16248,RIMERSBURG,PA,978,856,-122,0.46673936750272627
16249,RURAL VALLEY,PA,591,426,-165,0.41887905604719766
16254,SHIPPENVILLE,PA,1070,1044,-26,0.4938505203405866
16255,SLIGO,PA,408,374,-34,0.4782608695652174
16256,SMICKSBURG,PA,213,117,-96,0.35454545454545455
16258,FISHER,PA,13,26,13,0.6666666666666666
16258,STRATTANVILLE,PA,654,554,-100,0.4586092715231788
16259,TEMPLETON,PA,252,180,-72,0.4166666666666667
16262,WORTHINGTON,PA,675,571,-104,0.4582664526484751
16263,YATESBORO,PA,58,12,-46,0.17142857142857143
16301,OIL CITY,PA,6269,6013,-256,0.48957824458557236
16311,CARLTON,PA,12,14,2,0.5384615384615384
16313,CLARENDON,PA,718,577,-141,0.44555984555984557
16314,COCHRANTON,PA,1743,1609,-134,0.48001193317422436
16316,CONNEAUT LAKE,PA,2763,2370,-393,0.46171829339567505
16317,COOPERSTOWN,PA,138,132,-6,0.4888888888888889
16319,CRANBERRY,PA,61,28,-33,0.3146067415730337
16323,FRANKLIN,PA,5996,5866,-130,0.49452031697858706
16327,GUYS MILLS,PA,521,456,-65,0.46673490276356194
16329,IRVINE,PA,17,15,-2,0.46875
16335,MEADVILLE,PA,12634,11329,-1305,0.4727705212202145
16340,PITTSBURGH,PA,12,12,0,0.5
16340,PITTSFIELD,PA,409,337,-72,0.4517426273458445
16341,PLEASANTVILLE,PA,532,431,-101,0.4475597092419522
16342,POLK,PA,294,394,100,0.5726744186046512
16343,RENO,PA,65,0,-65,0
16344,ROUSEVILLE,PA,37,0,-37,0
16345,RUSSELL,PA,957,980,23,0.5059370160041301
16346,SENECA,PA,1169,1099,-70,0.4845679012345679
16347,SHEFFIELD,PA,614,464,-150,0.43042671614100186
16350,SUGAR GROVE,PA,638,501,-137,0.43985952589991223
16351,TIDIOUTE,PA,807,646,-161,0.44459738472126636
16353,TIONESTA,PA,952,956,4,0.5010482180293501
16354,TITUSVILLE,PA,4614,3987,-627,0.4635507499128008
16360,TOWNVILLE,PA,201,129,-72,0.39090909090909093
16362,UTICA,PA,91,39,-52,0.3
16364,VENUS,PA,76,23,-53,0.23232323232323232
16365,WARREN,PA,7635,7143,-492,0.48335363377994317
16371,YOUNGSVILLE,PA,1485,1243,-242,0.45564516129032256
16372,CLINTONVILLE,PA,126,23,-103,0.15436241610738255
16373,EMLENTON,PA,992,935,-57,0.4852101712506487
16374,KENNERDELL,PA,320,367,47,0.5342066957787481
16401,ALBION,PA,1330,1222,-108,0.4788401253918495
16403,CAMBRIDG SPGS,PA,29,21,-8,0.42
16403,CAMBRIDGE SPRINGS,PA,1817,1547,-270,0.4598692033293698
16404,CENTERVILLE,PA,958,823,-135,0.46209994385176867
16405,COLUMBUS,PA,22,13,-9,0.37142857142857144
16406,CONNEAUTVILLE,PA,904,938,34,0.509229098805646
16407,CORRY,PA,4420,4024,-396,0.4765513974419706
16410,CRANESVILLE,PA,231,175,-56,0.43103448275862066
16411,E SPRINGFIELD,PA,28,11,-17,0.28205128205128205
16411,EAST SPRINGFIELD,PA,292,234,-58,0.4448669201520912
16412,EDINBORO,PA,4018,3611,-407,0.4733254686066326
16415,FAIRVIEW,PA,2708,3035,327,0.5284694410586801
16417,GIRARD,PA,2987,2843,-144,0.48765008576329333
16420,GRAND VALLEY,PA,14,0,-14,0
16421,HARBORCREEK,PA,690,628,-62,0.4764795144157815
16423,LAKE CITY,PA,1343,1300,-43,0.49186530457813094
16424,ESPYVILLE,PA,140,144,4,0.5070422535211268
16424,LINESVILLE,PA,1834,1508,-326,0.4512268102932376
16426,MC KEAN,PA,1631,1335,-296,0.45010114632501685
16427,MILL VILLAGE,PA,0,24,24,1
16428,NORTH EAST,PA,4715,4213,-502,0.4718862007168459
16433,SAEGERTOWN,PA,1642,1493,-149,0.4762360446570973
16434,SPARTANSBURG,PA,693,533,-160,0.43474714518760194
16435,SPRINGBORO,PA,552,506,-46,0.4782608695652174
16436,SPRING CREEK,PA,13,0,-13,0
16438,UNION CITY,PA,3088,2646,-442,0.461457970003488
16440,VENANGO,PA,39,12,-27,0.23529411764705882
16441,WATERFORD,PA,3124,2997,-127,0.4896258781244895
16442,WATTSBURG,PA,748,540,-208,0.4192546583850932
16443,WEST SPRINGFIELD,PA,328,280,-48,0.4605263157894737
16501,ERIE,PA,1332,1604,272,0.5463215258855586
16502,ERIE,PA,9000,6985,-2015,0.43697216140131373
16503,ERIE,PA,8655,6804,-1851,0.44013196196390453
16504,ERIE,PA,6057,5514,-543,0.47653616800622245
16505,ERIE,PA,7074,6623,-451,0.48353654084836095
16506,ERIE,PA,9103,8502,-601,0.4829309855154786
16507,ERIE,PA,4635,3906,-729,0.45732349841938885
16508,ERIE,PA,6697,5830,-867,0.4653947473457332
16509,ERIE,PA,11734,9972,-1762,0.45941214410762
16510,ERIE,PA,7930,7203,-727,0.47597964712879137
16511,ERIE,PA,4047,3478,-569,0.46219269102990035
16512,ERIE,PA,338,420,82,0.554089709762533
16514,ERIE,PA,153,169,16,0.5248447204968945
16565,ERIE,PA,15,0,-15,0
16601,ALTOONA,PA,10540,9953,-587,0.4856780364026741
16601,STATE COLLEGE,PA,164,196,32,0.5444444444444444
16602,ALTOONA,PA,11346,10551,-795,0.4818468283326483
16603,ALTOONA,PA,474,252,-222,0.34710743801652894
16611,ALEXANDRIA,PA,583,425,-158,0.42162698412698413
16613,ASHVILLE,PA,25,23,-2,0.4791666666666667
16617,BELLWOOD,PA,719,659,-60,0.4782293178519594
16619,BLANDBURG,PA,13,0,-13,0
16620,BRISBIN,PA,14,0,-14,0
16623,CASSVILLE,PA,12,0,-12,0
16625,CLAYSBURG,PA,1475,1312,-163,0.4707570864729099
16627,COALPORT,PA,354,311,-43,0.46766917293233085
16630,CRESSON,PA,1814,1432,-382,0.44115834873690696
16635,DUNCANSVILLE,PA,3596,3334,-262,0.4810966810966811
16636,DYSART,PA,11,0,-11,0
16637,EAST FREEDOM,PA,812,645,-167,0.4426904598490048
16639,FALLENTIMBER,PA,14,59,45,0.8082191780821918
16640,FLINTON,PA,321,316,-5,0.49607535321821034
16641,GALLITZIN,PA,706,624,-82,0.4691729323308271
16644,GLASGOW,PA,23,0,-23,0
16646,HASTINGS,PA,395,243,-152,0.38087774294670845
16647,HESSTON,PA,0,24,24,1
16648,HOLLIDAYSBURG,PA,5391,5044,-347,0.48337326305701966
16650,HOPEWELL,PA,363,365,2,0.5013736263736264
16651,HOUTZDALE,PA,824,809,-15,0.49540722596448256
16652,HUNTINGDON,PA,5173,4919,-254,0.4874157748711851
16655,IMLER,PA,75,110,35,0.5945945945945946
16656,IRVONA,PA,34,27,-7,0.4426229508196721
16657,JAMES CREEK,PA,145,105,-40,0.42
16661,MADERA,PA,25,22,-3,0.46808510638297873
16662,ALTOONA,PA,38,28,-10,0.42424242424242425
16662,MARTINSBURG,PA,1419,1336,-83,0.4849364791288566
16664,NEW ENTERPRISE,PA,153,128,-25,0.4555160142348754
16665,NEWRY,PA,34,0,-34,0
16666,OSCEOLA MILLS,PA,764,795,31,0.5099422706863374
16667,OSTERBURG,PA,85,121,36,0.587378640776699
16668,PATTON,PA,899,890,-9,0.4974846282839575
16669,PETERSBURG,PA,474,357,-117,0.4296028880866426
16671,RAMEY,PA,11,0,-11,0
16673,ROARING SPG,PA,107,80,-27,0.42780748663101603
16673,ROARING SPRING,PA,1426,1356,-70,0.4874191229331416
16674,ROBERTSDALE,PA,15,12,-3,0.4444444444444444
16677,SANDY RIDGE,PA,11,13,2,0.5416666666666666
16678,SAXTON,PA,958,945,-13,0.49658434051497635
16679,SIX MILE RUN,PA,12,12,0,0.5
16680,SMITHMILL,PA,15,0,-15,0
16686,TYRONE,PA,4387,3844,-543,0.46701494350625683
16692,WESTOVER,PA,22,0,-22,0
16693,WILLIAMSBURG,PA,1014,1079,65,0.515527950310559
16695,WOODBURY,PA,94,52,-42,0.3561643835616438
16701,BRADFORD,PA,7135,6565,-570,0.4791970802919708
16720,AUSTIN,PA,386,298,-88,0.43567251461988304
16725,CUSTER CITY,PA,0,26,26,1
16726,CYCLONE,PA,11,0,-11,0
16729,DUKE CENTER,PA,97,93,-4,0.48947368421052634
16731,ELDRED,PA,1091,994,-97,0.4767386091127098
16733,HAZEL HURST,PA,14,0,-14,0
16735,KANE,PA,2638,2498,-140,0.4863707165109034
16735,LEWIS RUN,PA,59,54,-5,0.4778761061946903
16738,LEWIS RUN,PA,377,250,-127,0.39872408293460926
16740,MOUNT JEWETT,PA,666,233,-433,0.25917686318131256
16743,PORT ALLEGANY,PA,1940,1669,-271,0.4624549736769188
16745,RIXFORD,PA,37,0,-37,0
16746,ROULETTE,PA,392,337,-55,0.46227709190672156
16748,SHINGLEHOUSE,PA,1052,861,-191,0.4500784108729744
16749,SMETHPORT,PA,1465,1441,-24,0.49587061252580866
16750,TURTLEPOINT,PA,21,36,15,0.631578947368421
16801,STATE COLLEGE,PA,17151,12950,-4201,0.4302182651739145
16802,STATE COLLEGE,PA,0,13,13,1
16802,UNIVERSITY PARK,PA,12,105,93,0.8974358974358975
16803,STATE COLLEGE,PA,13668,10082,-3586,0.4245052631578947
16804,STATE COLLEGE,PA,177,164,-13,0.4809384164222874
16820,AARONSBURG,PA,67,13,-54,0.1625
16820,CENTRE HALL,PA,0,16,16,1
16822,BEECH CREEK,PA,659,480,-179,0.42142230026338895
16823,BELLEFONTE,PA,6742,6714,-28,0.49895957193816887
16823,PLEASANT GAP,PA,1547,1474,-73,0.4879179079774909
16826,BLANCHARD,PA,11,0,-11,0
16827,BOALSBURG,PA,2050,2214,164,0.5192307692307693
16828,CENTRE HALL,PA,1485,1342,-143,0.47470817120622566
16829,CLARENCE,PA,11,0,-11,0
16830,CLEARFIELD,PA,5274,4987,-287,0.486015008283793
16832,COBURN,PA,0,13,13,1
16833,CURWENSVILLE,PA,1573,1441,-132,0.4781021897810219
16836,FRENCHVILLE,PA,83,50,-33,0.37593984962406013
16838,GRAMPIAN,PA,198,218,20,0.5240384615384616
16839,GRASSFLAT,PA,0,12,12,1
16840,HAWK RUN,PA,11,0,-11,0
16841,HOWARD,PA,1215,1123,-92,0.4803250641573995
16843,HYDE,PA,97,63,-34,0.39375
16844,JULIAN,PA,442,544,102,0.5517241379310345
16845,KARTHAUS,PA,12,0,-12,0
16848,LAMAR,PA,17,0,-17,0
16851,LEMONT,PA,286,276,-10,0.49110320284697506
16853,MILESBURG,PA,185,102,-83,0.3554006968641115
16854,MILLHEIM,PA,235,59,-176,0.20068027210884354
16858,MORRISDALE,PA,816,827,11,0.5033475349969568
16861,NEW MILLPORT,PA,0,11,11,1
16863,OLANTA,PA,11,0,-11,0
16865,PA FURNACE,PA,28,25,-3,0.4716981132075472
16865,PENNSYLVANIA FURNACE,PA,93,101,8,0.520618556701031
16866,PHILIPSBURG,PA,3025,2733,-292,0.4746439736019451
16868,PINE GROVE MILLS,PA,168,75,-93,0.30864197530864196
16870,PORT MATILDA,PA,1801,1950,149,0.519861370301253
16872,REBERSBURG,PA,162,91,-71,0.35968379446640314
16874,SNOW SHOE,PA,28,68,40,0.7083333333333334
16875,SPRING MILLS,PA,888,959,71,0.5192203573362209
16877,WARRIORS MARK,PA,135,141,6,0.5108695652173914
16878,WEST DECATUR,PA,226,191,-35,0.4580335731414868
16879,WINBURNE,PA,22,0,-22,0
16881,WOODLAND,PA,401,375,-26,0.4832474226804124
16901,WELLSBORO,PA,4138,3905,-233,0.4855153549670521
16912,BLOSSBURG,PA,1132,964,-168,0.4599236641221374
16914,COLUMBIA CROSS ROADS,PA,684,616,-68,0.47384615384615386
16915,COUDERSPORT,PA,2714,2526,-188,0.4820610687022901
16917,COVINGTON,PA,637,265,-372,0.29379157427937913
16920,ELKLAND,PA,1053,818,-235,0.43719935863174775
16921,GAINES,PA,0,41,41,1
16922,GALETON,PA,956,827,-129,0.4638250140213124
16923,GENESEE,PA,325,271,-54,0.4546979865771812
16925,GILLETT,PA,1123,1038,-85,0.4803331790837575
16926,GRANVILLE SUMMIT,PA,11,24,13,0.6857142857142857
16927,HARRISON VALLEY,PA,0,18,18,1
16928,KNOXVILLE,PA,535,334,-201,0.38434982738780205
16929,LAWRENCEVILLE,PA,914,849,-65,0.4815655133295519
16930,LIBERTY,PA,176,126,-50,0.41721854304635764
16932,MAINESBURG,PA,47,33,-14,0.4125
16933,MANSFIELD,PA,4102,2931,-1171,0.4167496089862079
16935,MIDDLEBRY CTR,PA,0,11,11,1
16935,MIDDLEBURY CENTER,PA,212,137,-75,0.39255014326647564
16936,MILLERTON,PA,602,626,24,0.509771986970684
16938,MORRIS,PA,35,0,-35,0
16942,OSCEOLA,PA,129,85,-44,0.397196261682243
16943,SABINSVILLE,PA,38,35,-3,0.4794520547945205
16946,TIOGA,PA,1273,1127,-146,0.46958333333333335
16947,TROY,PA,2007,1771,-236,0.46876654314452093
16948,ULYSSES,PA,474,406,-68,0.46136363636363636
16950,WESTFIELD,PA,1458,1251,-207,0.46179401993355484
17001,CAMP HILL,PA,49,105,56,0.6818181818181818
17003,ANNVILLE,PA,3241,3489,248,0.5184249628528975
17004,BELLEVILLE,PA,1226,1134,-92,0.48050847457627116
17006,BLAIN,PA,94,41,-53,0.3037037037037037
17007,BOILING SPGS,PA,113,121,8,0.5170940170940171
17007,BOILING SPRINGS,PA,1377,1534,157,0.5269666781174854
17009,BURNHAM,PA,890,813,-77,0.4773928361714621
17011,CAMP HILL,PA,13363,12273,-1090,0.47874083320330785
17011,CAMPHL,PA,245,243,-2,0.4979508196721312
17011,SHIREMANSTOWN,PA,245,266,21,0.5205479452054794
17013,CARLISLE,PA,16686,16044,-642,0.49019248395967
17015,CARLISLE,PA,6358,7202,844,0.5311209439528024
17016,CORNWALL,PA,0,11,11,1
17017,DALMATIA,PA,162,131,-31,0.447098976109215
17018,DAUPHIN,PA,1219,1103,-116,0.47502153316106804
17019,DILLSBURG,PA,5353,5530,177,0.5081319489111458
17020,DUNCANNON,PA,2708,2776,68,0.5061998541210795
17021,EAST WATERFORD,PA,40,35,-5,0.4666666666666667
17022,ELIZABETHTOWN,PA,9796,10054,258,0.5064987405541562
17023,ELIZABETHVILLE,PA,1139,1382,243,0.5481951606505355
17023,ELIZABETHVLE,PA,11,24,13,0.6857142857142857
17024,ELLIOTTSBURG,PA,303,241,-62,0.4430147058823529
17025,E PENNSBORO,PA,113,125,12,0.5252100840336135
17025,EAST PENNSBORO,PA,387,449,62,0.5370813397129187
17025,ENOLA,PA,5893,6465,572,0.5231429033824243
17026,FREDERICKSBRG,PA,58,95,37,0.6209150326797386
17026,FREDERICKSBURG,PA,836,857,21,0.5062020082693444
17028,GRANTVILLE,PA,986,1102,116,0.5277777777777778
17029,GRANVILLE,PA,0,11,11,1
17030,GRATZ,PA,137,87,-50,0.38839285714285715
17032,HALIFAX,PA,2065,2147,82,0.5097340930674265
17033,HERSHEY,PA,8494,7031,-1463,0.45288244766505636
17034,HIGHSPIRE,PA,1450,1394,-56,0.490154711673699
17035,HONEY GROVE,PA,34,12,-22,0.2608695652173913
17036,HUMMELSTOWN,PA,8783,8525,-258,0.4925467991680148
17037,ICKESBURG,PA,34,42,8,0.5526315789473685
17038,JONESTOWN,PA,2613,2624,11,0.5010502195913691
17040,LANDISBURG,PA,709,624,-85,0.46811702925731435
17042,LEBANON,PA,15601,16101,500,0.5078859377957227
17043,LEMOYNE,PA,3677,3303,-374,0.47320916905444127
17043,WORMLEYSBURG,PA,149,137,-12,0.479020979020979
17044,LEWISTOWN,PA,10012,9716,-296,0.4924979724249797
17045,LIVERPOOL,PA,1014,951,-63,0.48396946564885496
17046,LEBANON,PA,13504,11935,-1569,0.46916152364479735
17047,LOYSVILLE,PA,665,490,-175,0.42424242424242425
17048,LYKENS,PA,1417,1490,73,0.5125558995528036
17049,MC ALISTERVILLE,PA,840,818,-22,0.49336550060313633
17049,MC ALISTERVLE,PA,15,14,-1,0.4827586206896552
17050,HAMPDEN TOWNSHIP,PA,309,371,62,0.5455882352941176
17050,MECHANICSBURG,PA,14261,15710,1449,0.5241733675886691
17051,MC VEYTOWN,PA,1131,1002,-129,0.469760900140647
17052,MAPLETON DEPOT,PA,263,224,-39,0.459958932238193
17053,MARYSVILLE,PA,1536,1745,209,0.531850045717769
17055,MECHANICSBURG,PA,16713,17701,988,0.5143546231184983
17057,MIDDLETOWN,PA,9436,8823,-613,0.48321375759899227
17058,MIFFLIN,PA,706,603,-103,0.46065699006875477
17059,MIFFLINTOWN,PA,2350,2124,-226,0.4747429593205186
17060,MILL CREEK,PA,73,62,-11,0.45925925925925926
17061,MILLERSBURG,PA,2539,2425,-114,0.48851732473811443
17062,MILLERSTOWN,PA,958,932,-26,0.49312169312169313
17063,LANCASTER,PA,18,20,2,0.5263157894736842
17063,MILROY,PA,965,831,-134,0.4626948775055679
17064,MOUNT GRETNA,PA,229,191,-38,0.45476190476190476
17064,MT GRETNA,PA,14,28,14,0.6666666666666666
17065,MOUNT HOLLY SPRINGS,PA,1379,1423,44,0.5078515346181299
17065,MT HOLLY SPGS,PA,51,60,9,0.5405405405405406
17066,MOUNT UNION,PA,2158,2124,-34,0.4960298925735638
17067,MYERSTOWN,PA,4240,4228,-12,0.4992914501653283
17068,NEW BLOOMFIELD,PA,1311,1322,11,0.5020888720091151
17070,NEW CUMBERLAND,PA,6503,6491,-12,0.4995382484223488
17072,NEW KINGSTOWN,PA,210,11,-199,0.049773755656108594
17073,NEWMANSTOWN,PA,1253,1332,79,0.5152804642166344
17074,NEWPORT,PA,2762,2366,-396,0.46138845553822155
17077,ONO,PA,41,0,-41,0
17078,PALMYRA,PA,7867,7648,-219,0.4929423138897841
17080,PILLOW,PA,12,0,-12,0
17082,PORT ROYAL,PA,1007,791,-216,0.43993325917686316
17084,REEDSVILLE,PA,921,1056,135,0.5341426403641881
17086,RICHFIELD,PA,429,367,-62,0.4610552763819096
17087,RICHLAND,PA,638,489,-149,0.4338952972493345
17088,SCHAEFFERSTOWN,PA,11,0,-11,0
17090,SHERMANS DALE,PA,1652,1544,-108,0.4831038798498123
17093,SUMMERDALE,PA,250,0,-250,0
17094,THOMPSONTOWN,PA,775,659,-116,0.4595536959553696
17097,WICONISCO,PA,80,0,-80,0
17098,WILLIAMSTOWN,PA,959,960,1,0.5002605523710266
17099,YEAGERTOWN,PA,502,289,-213,0.36536030341340076
17101,HARRISBURG,PA,2648,2445,-203,0.48007068525427055
17102,HARRISBURG,PA,6107,5050,-1057,0.45263063547548626
17103,HARRISBURG,PA,7116,5888,-1228,0.4527837588434328
17104,HARRISBURG,PA,10129,8134,-1995,0.44538137217324647
17105,HARRISBURG,PA,36,0,-36,0
17106,HARRISBURG,PA,252,590,338,0.7007125890736342
17108,HARRISBURG,PA,259,63,-196,0.1956521739130435
17109,HARRISBURG,PA,13387,12112,-1275,0.4749990195693949
17110,HARRISBURG,PA,14292,14525,233,0.5040427525419023
17111,HARRISBURG,PA,15144,15688,544,0.5088220031136481
17112,HARRISBURG,PA,11802,13259,1457,0.5290690714656239
17113,HARRISBURG,PA,1092,1043,-49,0.4885245901639344
17113,OBERLIN,PA,424,397,-27,0.4835566382460414
17113,STEELTON,PA,3432,3386,-46,0.49662657670871224
17201,CHAMBERSBURG,PA,14119,12412,-1707,0.467830085560288
17202,CHAMBERSBURG,PA,9135,9101,-34,0.49906777802149593
17212,BIG COVE TANNERY,PA,0,29,29,1
17213,BLAIRS MILLS,PA,0,12,12,1
17214,BLUE RIDGE SUMMIT,PA,172,217,45,0.5578406169665809
17221,FANNETTSBURG,PA,54,29,-25,0.3493975903614458
17222,FAYETTEVILLE,PA,3888,4120,232,0.5144855144855145
17224,FORT LOUDON,PA,468,409,-59,0.4663625997719498
17224,FT LOUDON,PA,0,18,18,1
17225,GREENCASTLE,PA,5620,5698,78,0.5034458384873652
17228,HARRISONVILLE,PA,49,71,22,0.5916666666666667
17229,HUSTONTOWN,PA,110,134,24,0.5491803278688525
17233,MC CONNELLSBG,PA,112,111,-1,0.4977578475336323
17233,MC CONNELLSBURG,PA,1639,1541,-98,0.48459119496855346
17233,MCCONNELLSBURG,PA,40,37,-3,0.4805194805194805
17235,MARION,PA,0,11,11,1
17236,MERCERSBURG,PA,2360,2201,-159,0.48256961192720893
17237,MONT ALTO,PA,595,485,-110,0.44907407407407407
17238,NEEDMORE,PA,209,264,55,0.5581395348837209
17240,NEWBURG,PA,752,615,-137,0.4498902706656913
17241,NEWVILLE,PA,3675,3331,-344,0.4754496146160434
17243,ORBISONIA,PA,262,346,84,0.569078947368421
17244,ORRSTOWN,PA,569,521,-48,0.4779816513761468
17249,ROCKHILL FURNACE,PA,11,0,-11,0
17250,ROUZERVILLE,PA,0,26,26,1
17252,SAINT THOMAS,PA,1421,1281,-140,0.4740932642487047
17254,SCOTLAND,PA,24,12,-12,0.3333333333333333
17255,SHADE GAP,PA,72,25,-47,0.25773195876288657
17257,SHIPPENSBURG,PA,11029,10241,-788,0.48147625763986834
17260,SHIRLEYSBURG,PA,26,42,16,0.6176470588235294
17262,SPRING RUN,PA,45,27,-18,0.375
17263,STATE LINE,PA,24,0,-24,0
17264,THREE SPRINGS,PA,395,388,-7,0.4955300127713921
17267,WARFORDSBURG,PA,790,714,-76,0.4747340425531915
17268,WAYNESBORO,PA,10313,10026,-287,0.49294458921284234
17301,ABBOTTSTOWN,PA,1290,1406,116,0.521513353115727
17302,AIRVILLE,PA,678,670,-8,0.4970326409495549
17303,ARENDTSVILLE,PA,26,0,-26,0
17304,ASPERS,PA,717,675,-42,0.4849137931034483
17306,BENDERSVILLE,PA,43,14,-29,0.24561403508771928
17307,BIGLERVILLE,PA,1591,1500,-91,0.4852798447104497
17309,BROGUE,PA,414,308,-106,0.4265927977839335
17309,DALLAS 75252,TX,13,0,-13,0
17313,DALLASTOWN,PA,3935,3128,-807,0.44287130114682144
17313,YOE,PA,998,820,-178,0.45104510451045104
17314,DELTA,PA,1539,1569,30,0.5048262548262549
17315,DOVER,PA,7636,8538,902,0.5278842586867812
17316,EAST BERLIN,PA,2557,2325,-232,0.47623924621056946
17317,EAST PROSPECT,PA,18,0,-18,0
17318,EMIGSVILLE,PA,172,36,-136,0.17307692307692307
17319,ETTERS,PA,3446,3109,-337,0.47429443173150265
17320,FAIRFIELD,PA,2042,2075,33,0.5040077726499879
17321,FAWN GROVE,PA,272,330,58,0.5481727574750831
17322,FELTON,PA,1494,1386,-108,0.48125
17323,FRANKLINTOWN,PA,14,12,-2,0.46153846153846156
17324,GARDNERS,PA,900,1034,134,0.5346432264736298
17325,GETTYSBURG,PA,9382,9649,267,0.507014870474489
17327,GLEN ROCK,PA,2266,2270,4,0.5004409171075838
17329,GLENVILLE,PA,367,465,98,0.5588942307692307
17331,HANOVER,PA,20925,21094,169,0.5020109950260596
17339,LEWISBERRY,PA,2018,2145,127,0.5152534230122507
17340,LITTLESTOWN,PA,3839,3584,-255,0.4828236562036912
17342,LOGANVILLE,PA,24,0,-24,0
17344,MC SHERRYSTOWN,PA,1304,1002,-302,0.43451864700780574
17344,MCSHERRYSTOWN,PA,479,366,-113,0.4331360946745562
17345,MANCHESTER,PA,3481,3016,-465,0.46421425273203015
17347,MOUNT WOLF,PA,2028,1817,-211,0.47256176853055915
17349,NEW FREEDOM,PA,2108,2368,260,0.5290437890974083
17350,NEW OXFORD,PA,4421,4183,-238,0.4861692236169224
17352,NEW PARK,PA,87,39,-48,0.30952380952380953
17353,ORRTANNA,PA,597,729,132,0.5497737556561086
17356,RED LION,PA,9442,8566,-876,0.4756774766770324
17360,SEVEN VALLEYS,PA,1624,1570,-54,0.4915466499686913
17361,SHREWSBURY,PA,1756,1973,217,0.5290962724591043
17362,SPRING GROVE,PA,4181,3891,-290,0.4820366699702676
17363,STEWARTSTOWN,PA,2456,2782,326,0.531118747613593
17364,THOMASVILLE,PA,1383,1200,-183,0.4645760743321719
17365,WELLSVILLE,PA,669,678,9,0.5033407572383074
17366,WINDSOR,PA,2053,1894,-159,0.47985812009120854
17368,WRIGHTSVILLE,PA,2904,2818,-86,0.49248514505417684
17370,YORK HAVEN,PA,2086,2034,-52,0.4936893203883495
17371,YORK NEW SALEM,PA,51,0,-51,0
17372,YORK SPRINGS,PA,1205,1084,-121,0.47356924421144603
17401,YORK,PA,13428,11091,-2337,0.4523430808760553
17402,YORK,PA,14327,13897,-430,0.4923823696145125
17403,YORK,PA,18486,16794,-1692,0.4760204081632653
17404,WEST YORK,PA,274,277,3,0.5027223230490018
17404,YORK,PA,15322,15050,-272,0.4955221914921638
17405,HARRISBURG,PA,11,36,25,0.7659574468085106
17405,YORK,PA,455,1210,755,0.7267267267267268
17406,HALLAM,PA,469,479,10,0.5052742616033755
17406,HELLAM,PA,742,767,25,0.508283631544069
17406,YORK,PA,7381,7147,-234,0.4919465859030837
17407,JACOBUS,PA,263,255,-8,0.4922779922779923
17407,YORK,PA,50,51,1,0.504950495049505
17408,YORK,PA,8036,8534,498,0.5150271575135787
17501,AKRON,PA,1866,1557,-309,0.4548641542506573
17502,BAINBRIDGE,PA,651,633,-18,0.4929906542056075
17504,BAUSMAN,PA,11,0,-11,0
17505,BIRD IN HAND,PA,103,96,-7,0.4824120603015075
17506,BLUE BALL,PA,11,0,-11,0
17507,BOWMANSVILLE,PA,40,13,-27,0.24528301886792453
17508,BROWNSTOWN,PA,166,22,-144,0.11702127659574468
17509,CHRISTIANA,PA,1024,841,-183,0.4509383378016086
17512,COLUMBIA,PA,8274,7185,-1089,0.4647777993401902
17516,CONESTOGA,PA,1187,1095,-92,0.47984224364592465
17517,DENVER,PA,4214,4272,58,0.5034173933537591
17518,DRUMORE,PA,105,50,-55,0.3225806451612903
17519,EAST EARL,PA,1200,1155,-45,0.49044585987261147
17519,TERRE HILL,PA,19,31,12,0.62
17520,E PETERSBURG,PA,52,74,22,0.5873015873015873
17520,EAST PETERSBURG,PA,1635,1664,29,0.5043952712943316
17522,EPHRATA,PA,11950,10823,-1127,0.47525578535985596
17527,GAP,PA,1630,1382,-248,0.4588313413014608
17529,GORDONVILLE,PA,863,782,-81,0.47537993920972643
17532,HOLTWOOD,PA,962,998,36,0.5091836734693878
17535,KINZERS,PA,531,433,-98,0.4491701244813278
17536,KIRKWOOD,PA,603,524,-79,0.4649511978704525
17538,LANDISVILLE,PA,1584,1631,47,0.5073094867807154
17538,SALUNGA,PA,250,287,37,0.5344506517690876
17540,LEOLA,PA,3415,3157,-258,0.4803712720632988
17543,LITITZ,PA,13085,13483,398,0.5074902137910268
17545,MANHEIM,PA,6320,6220,-100,0.4960127591706539
17547,MARIETTA,PA,3495,3409,-86,0.49377172653534185
17550,MAYTOWN,PA,79,77,-2,0.4935897435897436
17551,MILLERSVILLE,PA,3972,3331,-641,0.4561139257839244
17552,MOUNT JOY,PA,6897,6921,24,0.5008684324793747
17554,MOUNTVILLE,PA,3073,2871,-202,0.48300807537012114
17555,NARVON,PA,1358,1345,-13,0.4975952645209027
17557,NEW HOLLAND,PA,4160,4071,-89,0.4945936095249666
17560,NEW PROVIDENCE,PA,1252,1251,-1,0.49980023971234516
17560,PROVIDENCE NEW,PA,24,26,2,0.52
17562,PARADISE,PA,997,894,-103,0.4727657324167107
17563,PEACH BOTTOM,PA,999,799,-200,0.44438264738598443
17565,PEQUEA,PA,647,559,-88,0.4635157545605307
17566,QUARRYVILLE,PA,3090,3058,-32,0.4973975276512687
17569,REINHOLDS,PA,1486,1435,-51,0.49127011297500855
17572,RONKS,PA,860,788,-72,0.47815533980582525
17578,STEVENS,PA,1324,1477,153,0.5273116744019993
17579,STRASBURG,PA,1565,1603,38,0.5059974747474747
17581,TERRE HILL,PA,67,72,5,0.5179856115107914
17582,MOUNT JOY,PA,0,13,13,1
17582,WASH BORO,PA,15,0,-15,0
17582,WASHINGTON BORO,PA,269,406,137,0.6014814814814815
17584,WILLOW STREET,PA,2948,3553,605,0.5465313028764806
17601,LANCASTER,PA,19392,19678,286,0.5036600972613259
17602,LANCASTER,PA,23819,19845,-3974,0.45449340417735434
17603,LANCASTER,PA,32291,28497,-3794,0.4687931828650391
17604,LANCASTER,PA,1280,1081,-199,0.4578568403218975
17605,LANCASTER,PA,355,25,-330,0.06578947368421052
17606,LANCASTER,PA,0,11,11,1
17607,LANCASTER,PA,64,15,-49,0.189873417721519
17608,LANCASTER,PA,1263,1326,63,0.5121668597914253
17701,WILLIAMSPORT,PA,20668,19059,-1609,0.47974928889672014
17702,S WILLIAMSPOR,PA,181,170,-11,0.4843304843304843
17702,S WILLIAMSPORT,PA,102,82,-20,0.44565217391304346
17702,SOUTH WILLIAMSPORT,PA,165,156,-9,0.48598130841121495
17702,WILLIAMSPORT,PA,3407,3096,-311,0.4760879594033523
17703,WILLIAMSPORT,PA,22,643,621,0.9669172932330827
17721,AVIS,PA,435,144,-291,0.24870466321243523
17724,CANTON,PA,2360,1984,-376,0.4567219152854512
17724,TOWADA,PA,51,31,-20,0.3780487804878049
17728,COGAN STATION,PA,1271,1331,60,0.5115295926210607
17731,EAGLES MERE,PA,175,197,22,0.5295698924731183
17737,HUGHESVILLE,PA,2139,2256,117,0.5133105802047782
17740,JERSEY SHORE,PA,4599,4245,-354,0.4799864314789688
17742,LAIRDSVILLE,PA,11,0,-11,0
17744,LINDEN,PA,994,947,-47,0.487892838742916
17745,LOCK HAVEN,PA,8139,7263,-876,0.47156213478768993
17747,LOGANTON,PA,541,500,-41,0.4803073967339097
17751,MILL HALL,PA,2144,2093,-51,0.4939815907481709
17752,MONTGOMERY,PA,1593,1589,-4,0.49937146448774355
17754,MONTOURSVILLE,PA,4025,3722,-303,0.48044404285529885
17756,MUNCY,PA,3681,3618,-63,0.4956843403205919
17756,PENNSDALE,PA,94,87,-7,0.48066298342541436
17758,MUNCY VALLEY,PA,102,145,43,0.5870445344129555
17760,NORTH BEND,PA,11,11,0,0.5
17763,RALSTON,PA,24,11,-13,0.3142857142857143
17764,RENOVO,PA,896,817,-79,0.47694103911266783
17765,ROARING BRANCH,PA,196,84,-112,0.3
17771,TROUT RUN,PA,688,741,53,0.5185444366689993
17772,TURBOTVILLE,PA,656,557,-99,0.45919208573784004
17774,UNITYVILLE,PA,33,36,3,0.5217391304347826
17776,WATERVILLE,PA,13,0,-13,0
17777,WATSONTOWN,PA,2161,2035,-126,0.4849857006673022
17801,SUNBURY,PA,6800,6348,-452,0.48281107392759354
17810,ALLENWOOD,PA,307,186,-121,0.3772819472616633
17812,BEAVER SPRGS,PA,12,16,4,0.5714285714285714
17812,BEAVER SPRINGS,PA,374,298,-76,0.44345238095238093
17813,BEAVERTOWN,PA,433,368,-65,0.45942571785268416
17813,BROOKSBURG,PA,16,11,-5,0.4074074074074074
17814,BENTON,PA,1541,1451,-90,0.48495989304812837
17814,ORANGEVILLE,PA,36,18,-18,0.3333333333333333
17815,BLOOMSBURG,PA,9517,9412,-105,0.4972264778910666
17820,CATAWISSA,PA,1585,1588,3,0.5004727387330602
17821,DANVILLE,PA,6859,6516,-343,0.48717757009345797
17823,DORNSIFE,PA,11,64,53,0.8533333333333334
17824,ELYSBURG,PA,1056,1074,18,0.504225352112676
17827,FREEBURG,PA,51,54,3,0.5142857142857142
17830,HERNDON,PA,319,281,-38,0.4683333333333333
17832,MARION HEIGHTS,PA,74,22,-52,0.22916666666666666
17834,KULPMONT,PA,964,981,17,0.5043701799485861
17837,LEWISBURG,PA,6444,5703,-741,0.46949864163991106
17841,MC CLURE,PA,1157,1084,-73,0.4837126282909415
17841,MCCLURE,PA,21,35,14,0.625
17842,MIDDLEBURG,PA,2429,2251,-178,0.480982905982906
17844,MIFFLINBURG,PA,2914,2833,-81,0.4929528449625892
17845,MILLMONT,PA,528,486,-42,0.47928994082840237
17846,MILLVILLE,PA,1019,989,-30,0.49252988047808766
17847,MILTON,PA,5001,4069,-932,0.4486218302094818
17850,MONROEVILLE,PA,12,0,-12,0
17850,MONTANDON,PA,301,68,-233,0.1842818428184282
17851,MOUNT CARMEL,PA,3810,3525,-285,0.48057259713701433
17853,MOUNT PLEASANT MILLS,PA,485,368,-117,0.43141852286049237
17853,MT PLEASANT M,PA,17,16,-1,0.48484848484848486
17853,MT PLEASANT MILLS,PA,196,181,-15,0.48010610079575594
17855,NEW BERLIN,PA,237,109,-128,0.31502890173410403
17856,NEW COLUMBIA,PA,987,871,-116,0.468783638320775
17857,NORTHUMBERLAND,PA,2839,2583,-256,0.47639247510143856
17859,ORANGEVILLE,PA,944,849,-95,0.4735080870050195
17860,PAXINOS,PA,103,291,188,0.7385786802030457
17864,PORT TREVORTN,PA,12,28,16,0.7
17864,PORT TREVORTON,PA,328,325,-3,0.49770290964777947
17866,COAL TOWNSHIP,PA,2197,2309,112,0.51242787394585
17866,RANSHAW,PA,100,110,10,0.5238095238095238
17868,RIVERSIDE,PA,11,0,-11,0
17870,SELINSGROVE,PA,4685,4459,-226,0.4876421697287839
17872,SHAMOKIN,PA,4627,4428,-199,0.4890115958034235
17876,SHAMOKIN DAM,PA,478,449,-29,0.4843581445523193
17878,STILLWATER,PA,164,131,-33,0.4440677966101695
17880,SWENGEL,PA,16,0,-16,0
17881,TREVORTON,PA,319,269,-50,0.4574829931972789
17886,WEST MILTON,PA,285,192,-93,0.4025157232704403
17887,WHITE DEER,PA,14,0,-14,0
17889,WINFIELD,PA,494,670,176,0.5756013745704467
17901,POTTSVILLE,PA,10053,9664,-389,0.49013541613835776
17921,ASHLAND,PA,2404,2504,100,0.5101874490627547
17922,AUBURN,PA,1192,1401,209,0.5403008098727343
17929,CRESSONA,PA,432,341,-91,0.4411384217335058
17930,CUMBOLA,PA,38,0,-38,0
17931,FRACKVILLE,PA,1938,2006,68,0.5086206896551724
17933,FRIEDENSBURG,PA,11,0,-11,0
17935,GIRARDVILLE,PA,831,505,-326,0.37799401197604793
17936,GORDON,PA,29,0,-29,0
17938,HEGINS,PA,423,499,76,0.5412147505422994
17945,LOCUSTDALE,PA,13,0,-13,0
17948,MAHANOY CITY,PA,2091,2000,-91,0.48887802493277926
17948,NEW BOSTON,PA,64,73,9,0.5328467153284672
17953,MIDDLEPORT,PA,22,0,-22,0
17954,MINERSVILLE,PA,2347,2379,32,0.5033855268726195
17959,KASKA,PA,15,19,4,0.5588235294117647
17959,NEW PHILADELPHIA,PA,378,359,-19,0.4871099050203528
17960,NEW RINGGOLD,PA,1100,1002,-98,0.47668886774500474
17961,ORWIGSBURG,PA,2474,2364,-110,0.4886316659776767
17963,PINE GROVE,PA,2798,2704,-94,0.4914576517629953
17964,PITMAN,PA,11,0,-11,0
17965,PORT CARBON,PA,723,618,-105,0.4608501118568233
17967,RINGTOWN,PA,571,621,50,0.5209731543624161
17968,SACRAMENTO,PA,0,11,11,1
17970,SAINT CLAIR,PA,1412,1303,-109,0.479926335174954
17972,SCHUYKL HAVN,PA,68,70,2,0.5072463768115942
17972,SCHUYLKILL HAVEN,PA,3780,3851,71,0.5046520770541213
17976,SHENANDOAH,PA,4378,3251,-1127,0.4261371084021497
17980,TOWER CITY,PA,1067,955,-112,0.4723046488625124
17981,DONALDSON,PA,29,28,-1,0.49122807017543857
17981,TREMONT,PA,1129,842,-287,0.4271943176052765
17983,VALLEY VIEW,PA,324,334,10,0.5075987841945289
17985,ZION GROVE,PA,50,93,43,0.6503496503496503
18002,LEHIGH VALLEY,PA,360,90,-270,0.2
18011,ALBURTIS,PA,1732,1572,-160,0.47578692493946734
18013,BANGOR,PA,4410,4478,68,0.5038253825382538
18013,ROSETO,PA,937,973,36,0.5094240837696336
18014,BATH,PA,3753,3860,107,0.5070274530408512
18015,BETHLEHEM,PA,12890,11404,-1486,0.4694163167860377
18015,FOUNTAIN HILL,PA,1106,1012,-94,0.47780925401322
18016,BETHLEHEM,PA,1097,1029,-68,0.48400752587017876
18017,BETHLEHEM,PA,12798,12777,-21,0.49958944281524925
18017,FREEMANSBURG,PA,583,523,-60,0.472875226039783
18018,BETHLEHEM,PA,15028,13588,-1440,0.4748392507688007
18020,BETHLEHEM,PA,5723,5886,163,0.5070204151951072
18030,BOWMANSTOWN,PA,11,0,-11,0
18031,BREINIGSVILLE,PA,4037,4123,86,0.5052696078431372
18032,CATASAUQUA,PA,3499,3462,-37,0.49734233587128285
18034,CENTER VALLEY,PA,2029,2392,363,0.541054060167383
18035,CHERRYVILLE,PA,0,15,15,1
18036,COOPERSBURG,PA,3477,4117,640,0.5421385304187516
18037,COPLAY,PA,2100,2034,-66,0.49201741654571846
18038,DANIELSVILLE,PA,550,656,106,0.5439469320066335
18040,EASTON,PA,3831,4480,649,0.5390446396342197
18040,FORKS TOWNSHIP,PA,249,289,40,0.5371747211895911
18040,FORKS TWP,PA,98,102,4,0.51
18041,EAST GREENVILLE,PA,1614,1576,-38,0.49404388714733544
18042,EASTON,PA,18584,15786,-2798,0.4592958975851033
18043,EASTON,PA,139,303,164,0.6855203619909502
18044,EASTON,PA,673,817,144,0.5483221476510067
18045,EASTON,PA,9012,9785,773,0.5205617917752833
18045,PALMER TOWNSHIP,PA,175,200,25,0.5333333333333333
18049,EMMAUS,PA,6212,6614,402,0.5156712926867301
18051,FOGELSVILLE,PA,975,1307,332,0.5727432077125328
18052,WHITEHALL,PA,10520,9858,-662,0.48375699283541074
18053,GERMANSVILLE,PA,299,451,152,0.6013333333333334
18053,TANNERSVILLE,PA,0,16,16,1
18054,GREEN LANE,PA,1275,1171,-104,0.47874080130825836
18055,HELLERTOWN,PA,3624,3631,7,0.5004824259131634
18056,HEREFORD,PA,442,407,-35,0.4793875147232038
18058,KUNKLETOWN,PA,2589,2854,265,0.5243431930920448
18059,LAURYS STATION,PA,106,298,192,0.7376237623762376
18062,MACUNGIE,PA,8126,8011,-115,0.4964367602404412
18064,NAZARETH,PA,6197,6981,784,0.5297465472757626
18065,NEFFS,PA,11,0,-11,0
18066,NEW TRIPOLI,PA,1320,1442,122,0.5220854453294714
18067,NORTHAMPTON,PA,6148,6352,204,0.50816
18069,OREFIELD,PA,1998,2218,220,0.5260910815939279
18070,PALM,PA,0,11,11,1
18071,PALMERTON,PA,3688,3755,67,0.5045008733037754
18072,PEN ARGYL,PA,2268,2186,-82,0.49079479119892233
18073,PENNSBURG,PA,2665,3136,471,0.5405964488881227
18074,PERKIOMENVILLE,PA,1108,1297,189,0.5392931392931393
18076,RED HILL,PA,870,853,-17,0.4950667440510737
18077,RIEGELSVILLE,PA,777,659,-118,0.45891364902506965
18078,SCHNECKSVILLE,PA,1828,1932,104,0.5138297872340426
18079,SLATEDALE,PA,50,12,-38,0.1935483870967742
18080,SLATINGTON,PA,3849,3944,95,0.5060952136532786
18083,STOCKERTOWN,PA,72,11,-61,0.13253012048192772
18085,TATAMY,PA,60,57,-3,0.48717948717948717
18087,TREXLERTOWN,PA,537,364,-173,0.4039955604883463
18088,WALNUTPORT,PA,2349,2564,215,0.5218807246081824
18091,WIND GAP,PA,1956,2188,232,0.527992277992278
18092,WIND GAP,PA,0,13,13,1
18092,ZIONSVILLE,PA,465,639,174,0.5788043478260869
18101,ALLENTOWN,PA,3950,3756,-194,0.48741240591746693
18102,ALLENTOWN,PA,28445,22503,-5942,0.44168564026065793
18103,ALLENTOWN,PA,19639,17298,-2341,0.4683109077618648
18104,ALLENTOWN,PA,16581,17390,809,0.5119072149774808
18105,ALLENTOWN,PA,1232,2420,1188,0.6626506024096386
18105,BETHLEHEM,PA,24,38,14,0.6129032258064516
18105,WILKES BARRE,PA,34,69,35,0.6699029126213593
18106,ALLENTOWN,PA,2557,2508,-49,0.4951628825271471
18106,WESCOSVILLE,PA,46,56,10,0.5490196078431373
18109,ALLENTOWN,PA,8508,7506,-1002,0.4687148744848258
18195,ALLENTOWN,PA,15,0,-15,0
18201,HAZLETON,PA,18707,15411,-3296,0.451697051409813
18202,HAZLE TOWNSHIP,PA,2175,2095,-80,0.49063231850117095
18202,HAZLETON,PA,422,404,-18,0.4891041162227603
18202,WEST HAZLETON,PA,3482,3372,-110,0.49197548876568425
18210,ALBRIGHTSVILLE,PA,3362,2920,-442,0.46482012098057945
18210,ALBRIGHTSVLLE,PA,159,160,1,0.5015673981191222
18211,ANDREAS,PA,80,100,20,0.5555555555555556
18214,BARNESVILLE,PA,254,446,192,0.6371428571428571
18216,BEAVER MDWS,PA,14,13,-1,0.48148148148148145
18216,BEAVER MEADOWS,PA,476,304,-172,0.38974358974358975
18218,COALDALE,PA,1137,1019,-118,0.47263450834879406
18219,CONYNGHAM,PA,330,288,-42,0.46601941747572817
18222,DRUMS,PA,2532,3130,598,0.5528081949841046
18224,FREELAND,PA,2777,2757,-20,0.4981929887965305
18229,JIM THORPE,PA,2678,2745,67,0.5061773925871289
18231,KELAYRES,PA,34,24,-10,0.41379310344827586
18232,LANSFORD,PA,3609,2697,-912,0.42768791627021885
18235,LEHIGHTON,PA,6352,6260,-92,0.4963526799873137
18237,KLINE TOWNSHIP,PA,35,34,-1,0.4927536231884058
18237,MCADOO,PA,1579,1668,89,0.5137049584231599
18240,NESQUEHONING,PA,1838,1601,-237,0.4655423088107008
18241,NUREMBERG,PA,11,0,-11,0
18248,SHEPPTON,PA,30,45,15,0.6
18249,SUGARLOAF,PA,720,1126,406,0.609967497291441
18250,SUMMIT HILL,PA,1386,1139,-247,0.4510891089108911
18252,TAMAQUA,PA,4348,4533,185,0.5104154937507037
18254,TRESCKOW,PA,321,0,-321,0
18255,WEATHERLY,PA,1189,1230,41,0.5084745762711864
18301,EAST STROUDSBURG,PA,10262,8900,-1362,0.4644609122221062
18302,E STROUDSBURG,PA,219,210,-9,0.48951048951048953
18302,EAST STROUDSBURG,PA,5255,4979,-276,0.486515536447137
18321,BARTONSVILLE,PA,660,667,7,0.5026375282592314
18322,BRODHEADSVILLE,PA,1018,930,-88,0.47741273100616016
18322,EASTON,PA,27,29,2,0.5178571428571429
18323,BUCK HILL FALLS,PA,148,245,97,0.6234096692111959
18323,BUCK HILL FLS,PA,52,36,-16,0.4090909090909091
18324,BUSHKILL,PA,3943,3672,-271,0.4822061720288903
18325,CANADENSIS,PA,889,850,-39,0.48878665899942497
18326,CRESCO,PA,1765,1664,-101,0.4852726742490522
18327,DELAWARE WATER GAP,PA,284,46,-238,0.1393939393939394
18328,DINGMANS FERRY,PA,2643,2819,176,0.5161113145367997
18328,DINGMANS FRY,PA,110,123,13,0.5278969957081545
18330,EFFORT,PA,2314,2403,89,0.5094339622641509
18331,GILBERT,PA,127,43,-84,0.2529411764705882
18332,HENRYVILLE,PA,1053,1177,124,0.5278026905829596
18333,KRESGEVILLE,PA,216,28,-188,0.11475409836065574
18334,LONG POND,PA,2356,1044,-1312,0.3070588235294118
18335,MARSHALLS CREEK,PA,534,85,-449,0.13731825525040386
18335,MARSHALLS CRK,PA,144,24,-120,0.14285714285714285
18336,MATAMORAS,PA,1305,1600,295,0.5507745266781411
18337,MILFORD,PA,5485,5584,99,0.5044719486855181
18343,MOUNT BETHEL,PA,1362,1317,-45,0.4916013437849944
18344,MOUNT POCONO,PA,1879,1971,92,0.5119480519480519
18346,POCONO SUMMIT,PA,1521,1107,-414,0.4212328767123288
18347,POCONO LAKE,PA,1561,1428,-133,0.477751756440281
18350,POCONO PINES,PA,1648,1455,-193,0.4689010634869481
18351,PORTLAND,PA,11,11,0,0.5
18352,REEDERS,PA,88,0,-88,0
18353,SAYLORSBURG,PA,3137,3148,11,0.5008750994431186
18354,SCIOTA,PA,243,225,-18,0.4807692307692308
18355,SCOTRUN,PA,311,344,33,0.5251908396946565
18356,SHAWNEE ON DELAWARE,PA,0,15,15,1
18360,STROUDSBURG,PA,9339,9504,165,0.5043782837127846
18370,SWIFTWATER,PA,618,356,-262,0.3655030800821355
18371,TAMIMENT,PA,79,13,-66,0.14130434782608695
18372,TANNERSVILLE,PA,1342,1138,-204,0.4588709677419355
18403,ARCHBALD,PA,1419,1453,34,0.5059192200557103
18403,EYNON,PA,527,533,6,0.5028301886792453
18405,BEACH LAKE,PA,1017,856,-161,0.4570208222103577
18407,CARBONDALE,PA,5521,4919,-602,0.47116858237547893
18407,SIMPSON,PA,502,483,-19,0.4903553299492386
18411,CLARKS SUMMIT,PA,3462,4048,586,0.5390146471371504
18411,RANSOM TOWNSHIP,PA,413,417,4,0.5024096385542168
18411,SCOTT TOWNSHIP,PA,225,274,49,0.5490981963927856
18411,SCOTT TWP,PA,123,123,0,0.5
18411,SOUTH ABINGTON TOWNSHIP,PA,1745,1760,15,0.5021398002853067
18414,DALTON,PA,1264,1381,117,0.522117202268431
18414,NORTH ABINGTON TOWNSHIP,PA,62,69,7,0.5267175572519084
18414,WAVERLY TOWNSHIP,PA,74,88,14,0.5432098765432098
18414,WEST ABINGTON TOWNSHIP,PA,42,67,25,0.6146788990825688
18415,DAMASCUS,PA,341,380,39,0.5270457697642164
18417,EQUINUNK,PA,371,301,-70,0.4479166666666667
18419,FACTORYVILLE,PA,1311,1275,-36,0.49303944315545245
18421,CLIFFORD TOWNSHIP,PA,98,109,11,0.5265700483091788
18421,CLIFFORD TWP,PA,34,44,10,0.5641025641025641
18421,FOREST CITY,PA,1039,972,-67,0.4833416210840378
18421,VANDLING,PA,412,348,-64,0.45789473684210524
18424,CLIFTON TOWNSHIP,PA,289,288,-1,0.49913344887348354
18424,COVINGTON TOWNSHIP,PA,99,116,17,0.5395348837209303
18424,COVINGTON TWP,PA,75,55,-20,0.4230769230769231
18424,GOULDSBORO,PA,1879,1607,-272,0.4609868043602983
18424,THORNHURST,PA,218,236,18,0.5198237885462555
18425,GREELEY,PA,257,301,44,0.5394265232974911
18425,LORDS VALLEY,PA,15,0,-15,0
18426,GREENTOWN,PA,2479,2142,-337,0.46353603116208614
18427,HAMLIN,PA,161,16,-145,0.0903954802259887
18428,HAWLEY,PA,5810,5604,-206,0.4909759943928509
18428,LORDS VALLEY,PA,329,323,-6,0.495398773006135
18431,HONESDALE,PA,4636,4552,-84,0.4954288202002612
18433,JERMYN,PA,1099,1104,5,0.5011348161597822
18433,MAYFIELD,PA,365,329,-36,0.47406340057636887
18433,SCOTT TOWNSHIP,PA,284,309,25,0.521079258010118
18434,JESSUP,PA,1123,1124,1,0.5002225189141077
18435,LACKAWAXEN,PA,381,597,216,0.6104294478527608
18436,JEFFERSON TOWNSHIP,PA,204,210,6,0.5072463768115942
18436,JEFFERSON TWP,PA,116,155,39,0.5719557195571956
18436,LAKE ARIEL,PA,5584,5145,-439,0.4795414297697828
18437,LAKE COMO,PA,0,11,11,1
18438,HAWLEY,PA,13,0,-13,0
18438,LAKEVILLE,PA,526,475,-51,0.4745254745254745
18439,LAKEWOOD,PA,58,116,58,0.6666666666666666
18443,MILANVILLE,PA,54,70,16,0.5645161290322581
18444,COVINGTON TOWNSHIP,PA,374,450,76,0.5461165048543689
18444,ELMHURST TOWNSHIP,PA,71,70,-1,0.49645390070921985
18444,MADISON TOWNSHIP,PA,51,43,-8,0.4574468085106383
18444,MADISON TWP,PA,68,65,-3,0.48872180451127817
18444,MOSCOW,PA,2569,2671,102,0.5097328244274809
18444,ROARING BROOK TWP,PA,47,55,8,0.5392156862745098
18444,SPRING BROOK TOWNSHIP,PA,482,425,-57,0.4685777287761852
18444,SPRNG BRK TWP,PA,66,72,6,0.5217391304347826
18445,NEWFOUNDLAND,PA,993,775,-218,0.43834841628959276
18446,CLIFFORD TOWNSHIP,PA,28,20,-8,0.4166666666666667
18446,NICHOLSON,PA,959,866,-93,0.4745205479452055
18447,BLAKELY,PA,444,513,69,0.5360501567398119
18447,DICKSON CTY,PA,242,309,67,0.5607985480943739
18447,OLYPHANT,PA,2152,2224,72,0.5082266910420475
18447,SCOTT TOWNSHIP,PA,216,187,-29,0.4640198511166253
18447,SCOTT TWP,PA,68,56,-12,0.45161290322580644
18451,PAUPACK,PA,71,87,16,0.5506329113924051
18452,PECKVILLE,PA,1227,1321,94,0.5184458398744113
18453,PLEASANT MOUNT,PA,68,47,-21,0.40869565217391307
18453,PLEASANT MT,PA,12,23,11,0.6571428571428571
18455,PRESTON PARK,PA,11,13,2,0.5416666666666666
18458,SHOHOLA,PA,1498,1502,4,0.5006666666666667
18460,SOUTH STERLING,PA,12,0,-12,0
18461,STARLIGHT,PA,0,11,11,1
18462,STARRUCCA,PA,0,51,51,1
18464,TAFTON,PA,534,637,103,0.5439795046968403
18465,THOMPSON,PA,389,502,113,0.5634118967452301
18466,TOBYHANNA,PA,7285,5935,-1350,0.4489409984871407
18470,CLIFFORD TOWNSHIP,PA,151,127,-24,0.4568345323741007
18470,UNION DALE,PA,450,491,41,0.5217853347502657
18471,WAVERLY,PA,13,38,25,0.7450980392156863
18472,WAYMART,PA,1485,1505,20,0.5033444816053512
18473,WHITE MILLS,PA,11,11,0,0.5
18501,SCRANTON,PA,0,23,23,1
18502,SCRANTON,PA,11,100,89,0.9009009009009009
18503,SCRANTON,PA,1160,1105,-55,0.4878587196467991
18504,GLEN LYON,PA,163,140,-23,0.46204620462046203
18504,RANSOM TOWNSHIP,PA,209,181,-28,0.4641025641025641
18504,SCRANTON,PA,8049,7429,-620,0.4799715725545936
18505,SCRANTON,PA,9467,8782,-685,0.4812318483204559
18507,MOOSIC,PA,1455,1510,55,0.5092748735244519
18508,SCRANTON,PA,5172,4371,-801,0.4580320653882427
18509,DUNMORE,PA,128,100,-28,0.43859649122807015
18509,SCRANTON,PA,5668,4340,-1328,0.4336530775379696
18510,SCRANTON,PA,5729,4604,-1125,0.4455627600890351
18512,DUNMORE,PA,3262,2938,-324,0.4738709677419355
18512,THROOP,PA,908,830,-78,0.47756041426927504
18517,TAYLOR,PA,1837,1955,118,0.5155590717299579
18518,OLD FORGE,PA,2789,2669,-120,0.4890069622572371
18519,DICKSON CITY,PA,698,698,0,0.5
18519,SCRANTON,PA,949,845,-104,0.47101449275362317
18603,BERWICK,PA,8833,7506,-1327,0.4593916396352286
18610,BLAKESLEE,PA,1755,1819,64,0.5089535534415222
18612,DALLAS,PA,4105,4482,377,0.5219517875858857
18614,DUSHORE,PA,795,838,43,0.51316595223515
18615,FALLS,PA,208,137,-71,0.39710144927536234
18616,FORKSVILLE,PA,68,28,-40,0.2916666666666667
18617,GLEN LYON,PA,870,602,-268,0.40896739130434784
18618,HARVEYS LAKE,PA,1504,1320,-184,0.46742209631728043
18618,MONROE TOWNSHIP,PA,31,23,-8,0.42592592592592593
18621,HUNLOCK CREEK,PA,1173,1052,-121,0.4728089887640449
18623,LACEYVILLE,PA,758,749,-9,0.49701393497013935
18624,LAKE HARMONY,PA,380,172,-208,0.3115942028985507
18625,LAKE WINOLA,PA,124,83,-41,0.40096618357487923
18626,LAPORTE,PA,59,45,-14,0.4326923076923077
18629,FORKSTON TOWNSHIP,PA,45,39,-6,0.4642857142857143
18629,FORKSTON TWP,PA,15,11,-4,0.4230769230769231
18629,MEHOOPANY,PA,483,336,-147,0.41025641025641024
18630,MESHOPPEN,PA,1080,880,-200,0.4489795918367347
18631,MIFFLINVILLE,PA,147,50,-97,0.25380710659898476
18632,MILDRED,PA,11,0,-11,0
18634,NANTICOKE,PA,6000,5544,-456,0.4802494802494803
18635,NESCOPECK,PA,1371,1300,-71,0.4867090977162112
18636,MONROE TOWNSHIP,PA,28,0,-28,0
18636,NOXEN,PA,125,87,-38,0.41037735849056606
18640,HUGHESTOWN,PA,464,512,48,0.5245901639344263
18640,JENKINS TOWNSHIP,PA,385,395,10,0.5064102564102564
18640,PITTSTON,PA,4996,5061,65,0.503231579994034
18640,YATESVILLE,PA,128,121,-7,0.4859437751004016
18641,AVOCA,PA,1200,1267,67,0.5135792460478313
18641,DUPONT,PA,593,583,-10,0.4957482993197279
18641,PITTSTON,PA,28,31,3,0.5254237288135594
18642,DURYEA,PA,1183,1221,38,0.5079034941763727
18642,PITTSTON,PA,35,14,-21,0.2857142857142857
18643,EXETER,PA,1555,1540,-15,0.4975767366720517
18643,HARDING,PA,802,689,-113,0.46210596914822266
18643,PITTSTON,PA,153,168,15,0.5233644859813084
18643,WEST PITTSTON,PA,1175,1143,-32,0.4930974978429681
18644,WEST WYOMING,PA,255,233,-22,0.4774590163934426
18644,WYOMING,PA,1665,1825,160,0.5229226361031518
18651,PLYMOUTH,PA,4101,3595,-506,0.4671257796257796
18655,MOCANAQUA,PA,193,242,49,0.5563218390804597
18655,SHICKSHINNY,PA,1584,1495,-89,0.4855472556024683
18656,SWEET VALLEY,PA,452,509,57,0.5296566077003122
18657,TUNKHANNOCK,PA,4175,3668,-507,0.46767818436822645
18660,WAPWALLOPEN,PA,553,684,131,0.5529506871463218
18661,WHITE HAVEN,PA,1663,1725,62,0.5091499409681228
18701,WILKES BARRE,PA,1553,1470,-83,0.48627191531591135
18702,WILKES BARRE,PA,17846,15119,-2727,0.4586379493402093
18703,WILKES BARRE,PA,895,1006,111,0.5291951604418726
18704,COURTDALE,PA,248,281,33,0.5311909262759924
18704,EDWARDSVILLE,PA,474,458,-16,0.49141630901287553
18704,KINGSTON,PA,10655,9783,-872,0.4786671885703102
18704,LARKSVILLE,PA,522,494,-28,0.4862204724409449
18704,SWOYERSVILLE,PA,198,207,9,0.5111111111111111
18705,HUDSON,PA,89,93,4,0.510989010989011
18705,MINERS MILL,PA,162,173,11,0.5164179104477612
18705,PLAINS,PA,1444,1307,-137,0.47509996364958196
18705,WILKES BARRE,PA,3504,3229,-275,0.47957819694044257
18706,ASHLEY,PA,1350,1291,-59,0.4888299886406664
18706,HANOVER TOWNSHIP,PA,3872,3828,-44,0.49714285714285716
18706,LAUREL RUN,PA,133,119,-14,0.4722222222222222
18706,WARRIOR RUN,PA,103,93,-10,0.4744897959183674
18706,WILKES BARRE,PA,321,307,-14,0.4888535031847134
18707,MOUNTAIN TOP,PA,3354,3793,439,0.5307121869315797
18707,NUANGOLA,PA,87,80,-7,0.47904191616766467
18708,SHAVERTOWN,PA,2019,2135,116,0.5139624458353395
18708,TRUCKSVILLE,PA,46,43,-3,0.48314606741573035
18709,LUZERNE,PA,1142,1044,-98,0.4775846294602013
18801,MONTROSE,PA,2955,2636,-319,0.47147200858522625
18810,ATHENS,PA,2454,2487,33,0.5033394049787493
18812,BRACKNEY,PA,529,492,-37,0.48188050930460335
18814,BURLINGTON,PA,13,0,-13,0
18818,FRIENDSVILLE,PA,239,197,-42,0.4518348623853211
18821,GREAT BEND,PA,192,238,46,0.5534883720930233
18822,HALLSTEAD,PA,1254,1195,-59,0.4879542670477746
18824,HOP BOTTOM,PA,162,81,-81,0.3333333333333333
18826,KINGSLEY,PA,463,336,-127,0.42052565707133915
18829,LE RAYSVILLE,PA,60,48,-12,0.4444444444444444
18830,LITTLE MEADOWS,PA,22,22,0,0.5
18831,MILAN,PA,98,177,79,0.6436363636363637
18832,MONROETON,PA,459,464,5,0.5027085590465872
18833,NEW ALBANY,PA,631,458,-173,0.42056932966023874
18834,NEW MILFORD,PA,1399,1210,-189,0.46377922575699504
18837,MILFORD,PA,23,22,-1,0.4888888888888889
18837,ROME,PA,913,823,-90,0.4740783410138249
18840,SAYRE,PA,4706,4303,-403,0.47763347763347763
18844,SPRINGVILLE,PA,267,166,-101,0.3833718244803695
18845,STEVENSVILLE,PA,11,0,-11,0
18846,SUGAR RUN,PA,12,0,-12,0
18847,SUSQUEHANNA,PA,1864,1752,-112,0.48451327433628316
18848,TOWANDA,PA,4246,3974,-272,0.4834549878345499
18850,ULSTER,PA,746,626,-120,0.45626822157434405
18851,WARREN CENTER,PA,25,43,18,0.6323529411764706
18853,WYALUSING,PA,1382,1332,-50,0.49078850405305824
18854,WYSOX,PA,955,656,-299,0.40720049658597146
18901,DOYLESTOWN,PA,9381,9205,-176,0.4952652534165501
18901,NEW BRITAIN,PA,195,225,30,0.5357142857142857
18902,DOYLESTOWN,PA,4651,5675,1024,0.5495835754406353
18912,BUCKINGHAM,PA,26,11,-15,0.2972972972972973
18913,CARVERSVILLE,PA,0,11,11,1
18914,CHALFONT,PA,4895,5478,583,0.528101802757158
18915,COLMAR,PA,337,689,352,0.6715399610136452
18916,DANBORO,PA,13,0,-13,0
18917,DUBLIN,PA,1034,896,-138,0.46424870466321244
18920,ERWINNA,PA,82,96,14,0.5393258426966292
18923,FOUNTAINVILLE,PA,91,166,75,0.6459143968871596
18925,FURLONG,PA,1477,1622,145,0.5233946434333656
18929,JAMISON,PA,1692,2005,313,0.542331620232621
18930,KINTNERSVILLE,PA,460,497,37,0.5193312434691745
18931,LAHASKA,PA,15,31,16,0.6739130434782609
18932,LINE LEXINGTON,PA,0,23,23,1
18936,MONTGOMERYVILLE,PA,392,120,-272,0.234375
18938,NEW HOPE,PA,4725,5641,916,0.5441829056530967
18940,NEWTOWN,PA,8851,9674,823,0.5222132253711201
18942,OTTSVILLE,PA,721,823,102,0.5330310880829016
18943,PENNS PARK,PA,0,11,11,1
18944,PERKASIE,PA,6396,6944,548,0.5205397301349325
18947,PIPERSVILLE,PA,1378,1513,135,0.5233483223797993
18949,PLUMSTEADVILLE,PA,52,0,-52,0
18950,POINT PLEASANT,PA,14,0,-14,0
18951,QUAKERTOWN,PA,9477,10111,634,0.5161833775781091
18954,RICHBORO,PA,1809,2151,342,0.5431818181818182
18955,RICHLANDTOWN,PA,436,439,3,0.5017142857142857
18960,SELLERSVILLE,PA,3297,3674,377,0.5270405967579974
18962,SILVERDALE,PA,40,0,-40,0
18963,SOLEBURY,PA,36,0,-36,0
18964,SOUDERTON,PA,4060,3902,-158,0.4900778698819392
18966,CHURCHVILLE,PA,516,484,-32,0.484
18966,HOLLAND,PA,2103,2104,1,0.5001188495364868
18966,SOUTHAMPTON,PA,6017,6155,138,0.5056687479461058
18969,TELFORD,PA,4493,3908,-585,0.46518271634329245
18970,TRUMBAUERSVILLE,PA,246,113,-133,0.3147632311977716
18972,UPPER BLACK EDDY,PA,869,912,43,0.5120718697361033
18972,UPPR BLCK EDY,PA,22,20,-2,0.47619047619047616
18974,IVYLAND,PA,256,266,10,0.5095785440613027
18974,WARMINSTER,PA,7879,8428,549,0.5168332617894156
18974,WARWICK,PA,3254,3208,-46,0.4964407304240173
18976,WARRINGTON,PA,5438,5343,-95,0.4955941007327706
18977,WASHINGTON CROSSING,PA,1444,1449,5,0.5008641548565503
18977,WSHNGTN XING,PA,23,29,6,0.5576923076923077
19001,ABINGTON,PA,3869,3567,-302,0.4796933835395374
19001,ROSLYN,PA,267,319,52,0.5443686006825939
19002,AMBLER,PA,8130,8841,711,0.520947498674209
19002,LOWER GWYNEDD,PA,192,234,42,0.5492957746478874
19002,MAPLE GLEN,PA,214,169,-45,0.4412532637075718
19003,ARDMORE,PA,5774,5191,-583,0.47341541267669857
19004,BALA CYNWYD,PA,5202,6028,826,0.5367764915405164
19006,HUNTINGDON VALLEY,PA,5532,5907,375,0.5163912929451875
19006,HUNTINGDON VY,PA,224,233,9,0.5098468271334792
19007,BRISTOL,PA,8011,7437,-574,0.4814215432418436
19008,BROOMALL,PA,4060,4477,417,0.5244230994494553
19009,BRYN ATHYN,PA,11,38,27,0.7755102040816326
19010,BRYN MAWR,PA,7149,7194,45,0.5015687094750052
19010,SECANE,PA,157,110,-47,0.41198501872659177
19012,CHELTENHAM,PA,1512,1680,168,0.5263157894736842
19013,CHESTER,PA,11283,9831,-1452,0.4656152315998863
19014,ASTON,PA,3861,3978,117,0.5074626865671642
19014,UPPER CHICHESTER,PA,718,699,-19,0.49329569513055754
19015,BROOKHAVEN,PA,4428,4203,-225,0.4869655891553702
19015,UPLAND,PA,102,96,-6,0.48484848484848486
19016,CHESTER,PA,116,121,5,0.510548523206751
19018,ALDAN,PA,1248,716,-532,0.3645621181262729
19018,CLIFTON HEIGHTS,PA,3801,2121,-1680,0.35815602836879434
19018,CLIFTON HTS,PA,358,195,-163,0.352622061482821
19018,SECANE,PA,7707,4734,-2973,0.3805160356884495
19020,BENSALEM,PA,19734,17700,-2034,0.4728321846449752
19021,CROYDON,PA,3166,3015,-151,0.4877851480342987
19022,CRUM LYNNE,PA,998,937,-61,0.4842377260981912
19022,EDDYSTONE,PA,341,280,-61,0.45088566827697263
19023,COLLINGDALE,PA,1592,1341,-251,0.4572110467098534
19023,DARBY,PA,5919,5112,-807,0.4634212673375034
19025,DRESHER,PA,1596,2469,873,0.607380073800738
19026,DREXEL HILL,PA,10161,9376,-785,0.479909914521165
19026,PILGRIM GDNS,PA,208,192,-16,0.48
19027,ELKINS PARK,PA,7436,6448,-988,0.46441947565543074
19027,MELROSE PARK,PA,356,343,-13,0.4907010014306152
19029,ESSINGTON,PA,1414,1198,-216,0.45865237366003064
19029,LESTER,PA,75,66,-9,0.46808510638297873
19030,FAIRLESS HILLS,PA,3197,3070,-127,0.48986756023615763
19031,FLOURTOWN,PA,1262,1637,375,0.5646774749913763
19032,FOLCROFT,PA,2499,2194,-305,0.46750479437460046
19033,FOLSOM,PA,1978,1838,-140,0.48165618448637315
19033,MILMONT PARK,PA,207,154,-53,0.4265927977839335
19034,FORT WASHINGTON,PA,1895,2387,492,0.5574497898178421
19034,FT WASHINGTON,PA,132,138,6,0.5111111111111111
19035,GLADWYNE,PA,1380,1645,265,0.543801652892562
19036,GLENOLDEN,PA,4965,4132,-833,0.4542156754974167
19038,ERDENHEIM,PA,228,225,-3,0.4966887417218543
19038,GLENSIDE,PA,6802,6873,71,0.5025959780621572
19038,WYNDMOOR,PA,292,337,45,0.5357710651828299
19040,HATBORO,PA,5796,5658,-138,0.4939759036144578
19040,UPPR MORELAND,PA,112,149,37,0.5708812260536399
19041,HAVERFORD,PA,2421,2631,210,0.5207838479809976
19043,HOLMES,PA,671,546,-125,0.4486442070665571
19044,HORSHAM,PA,5598,5801,203,0.5089042898499868
19046,FOXCROFT SQUARE,PA,2722,2780,58,0.5052708106143221
19046,JENKINTOWN,PA,2615,2870,255,0.5232452142206017
19046,MEADOWBROOK,PA,375,383,8,0.5052770448548812
19046,ROCKLEDGE,PA,116,119,3,0.5063829787234042
19046,RYDAL,PA,294,287,-7,0.4939759036144578
19047,LANGHORNE,PA,9006,8973,-33,0.49908226263974637
19047,PENNDEL,PA,1221,1274,53,0.51062124248497
19050,EAST LANSDOWNE,PA,193,191,-2,0.4973958333333333
19050,LANSDOWNE,PA,7667,7264,-403,0.48650458777041056
19050,YEADON,PA,1483,1400,-83,0.4856052722858134
19052,LENNI,PA,0,11,11,1
19053,FEASTERVILLE TREVOSE,PA,7495,7439,-56,0.49812508370162045
19054,FALLSINGTON,PA,280,263,-17,0.4843462246777164
19054,LEVITTOWN,PA,4386,4260,-126,0.49271339347675225
19055,LEVITTOWN,PA,3819,3666,-153,0.48977955911823645
19056,LEVITTOWN,PA,4542,4322,-220,0.4875902527075812
19057,LEVITTOWN,PA,5126,4699,-427,0.47826972010178115
19058,LEVITTOWN,PA,69,530,461,0.8848080133555927
19060,BOOTHWYN,PA,28,53,25,0.654320987654321
19060,GARNET VALLEY,PA,1933,2246,313,0.5374491505144772
19061,BOOTHWYN,PA,2057,1912,-145,0.4817334341143865
19061,LINWOOD,PA,3827,3577,-250,0.4831172339276067
19061,MARCUS HOOK,PA,939,969,30,0.5078616352201258
19061,UPPER CHICHESTER,PA,276,275,-1,0.49909255898366606
19063,MEDIA,PA,11609,12839,1230,0.5251554319371727
19064,SPRINGFIELD,PA,4370,4645,275,0.5152523571824736
19066,MERION STATION,PA,1248,1640,392,0.5678670360110804
19067,MORRISVILLE,PA,10205,9985,-220,0.49455175829618625
19067,YARDLEY,PA,6207,6369,162,0.5064408396946565
19070,MORTON,PA,1862,1732,-130,0.4819143016138008
19070,RUTLEDGE,PA,87,88,1,0.5028571428571429
19072,NARBERTH,PA,3154,3107,-47,0.4962466059734867
19072,PENN VALLEY,PA,453,457,4,0.5021978021978022
19073,NEWTOWN SQUARE,PA,7051,7546,495,0.5169555388093444
19074,NORWOOD,PA,1847,1664,-183,0.47393904870407294
19075,ORELAND,PA,1249,1422,173,0.5323848745788095
19076,PROSPECT PARK,PA,2653,2050,-603,0.4358919838401021
19078,RIDLEY PARK,PA,3217,3114,-103,0.4918654241036171
19079,SHARON HILL,PA,3114,2591,-523,0.45416301489921124
19081,SWARTHMORE,PA,2496,2647,151,0.514680147773673
19082,KIRKLYN,PA,338,284,-54,0.4565916398713826
19082,UPPER DARBY,PA,14176,10729,-3447,0.43079702870909453
19083,HAVERTOWN,PA,7240,7698,458,0.5153300307939483
19085,VILLANOVA,PA,1646,1927,281,0.5393226980128744
19086,ROSE VALLEY,PA,183,206,23,0.5295629820051414
19086,WALLINGFORD,PA,2475,2645,170,0.5166015625
19087,CHESTERBROOK,PA,472,445,-27,0.48527808069792805
19087,RADNOR,PA,737,781,44,0.5144927536231884
19087,SAINT DAVIDS,PA,1116,1178,62,0.5135135135135135
19087,STRAFFORD,PA,273,214,-59,0.4394250513347023
19087,WAYNE,PA,9537,9427,-110,0.4970997679814385
19090,WILLOW GROVE,PA,6322,6401,79,0.5031046136917394
19094,WOODLYN,PA,1271,1298,27,0.5052549630206306
19095,WYNCOTE,PA,2989,2737,-252,0.4779951100244499
19096,PENN WYNNE,PA,87,83,-4,0.48823529411764705
19096,WYNNEWOOD,PA,4761,4975,214,0.5109901396877568
19101,PHILA,PA,41,38,-3,0.4810126582278481
19101,PHILADELPHIA,PA,634,998,364,0.6115196078431373
19102,MID CITY EAST,PA,394,206,-188,0.3433333333333333
19102,MIDDLE CITY EAST,PA,162,130,-32,0.4452054794520548
19102,PHILA,PA,315,297,-18,0.4852941176470588
19102,PHILADELPHIA,PA,7774,5932,-1842,0.4328031519042755
19103,MIDDLE CITY WEST,PA,1304,990,-314,0.4315605928509154
19103,PHILA,PA,2250,1784,-466,0.4422409519087754
19103,PHILADELPHIA,PA,22325,17700,-4625,0.44222361024359774
19104,PHILADELPHIA,PA,23237,15946,-7291,0.40696220299619734
19105,PHILA,PA,0,14,14,1
19105,PHILADELPHIA,PA,12,76,64,0.8636363636363636
19106,PHILA,PA,222,177,-45,0.44360902255639095
19106,PHILADELPHIA,PA,10671,8977,-1694,0.45689128664495116
19107,PHILA,PA,176,339,163,0.658252427184466
19107,PHILADELPHIA,PA,13160,10360,-2800,0.44047619047619047
19109,PHILADELPHIA,PA,16,0,-16,0
19110,PHILA,PA,12,0,-12,0
19110,PHILADELPHIA,PA,75,141,66,0.6527777777777778
19111,PHILADELPHIA,PA,19144,15151,-3993,0.4417845166933955
19112,PHILADELPHIA,PA,0,11,11,1
19113,PHILADELPHIA,PA,30,0,-30,0
19114,PHILA,PA,386,340,-46,0.46831955922865015
19114,PHILADELPHIA,PA,9543,8726,-817,0.477639717554327
19115,PHILA,PA,467,473,6,0.5031914893617021
19115,PHILADELPHIA,PA,9140,8167,-973,0.4718899867105795
19116,PHILA,PA,201,163,-38,0.4478021978021978
19116,PHILADELPHIA,PA,8987,7524,-1463,0.45569620253164556
19118,PHILA,PA,97,85,-12,0.46703296703296704
19118,PHILADELPHIA,PA,4634,4644,10,0.5005389092476827
19119,PHILA,PA,338,316,-22,0.4831804281345566
19119,PHILADELPHIA,PA,8377,8288,-89,0.49732973297329736
19120,PHILADELPHIA,PA,17293,13854,-3439,0.44479404115966226
19121,PHILA,PA,540,468,-72,0.4642857142857143
19121,PHILADELPHIA,PA,13863,11881,-1982,0.461505593536358
19122,PHILA,PA,229,265,36,0.5364372469635628
19122,PHILADELPHIA,PA,9592,9178,-414,0.4889717634523175
19123,PHILADELPHIA,PA,12153,9892,-2261,0.44871853027897485
19124,PHILADELPHIA,PA,21051,16666,-4385,0.4418697139221041
19125,PHILADELPHIA,PA,13864,12591,-1273,0.47594027594027594
19126,PHILA,PA,200,156,-44,0.43820224719101125
19126,PHILADELPHIA,PA,3766,3395,-371,0.47409579667644186
19127,MANAYUNK,PA,1078,841,-237,0.43824908806670143
19127,PHILADELPHIA,PA,4267,3179,-1088,0.4269406392694064
19128,PHILADELPHIA,PA,17228,15493,-1735,0.4734879740839216
19129,PHILADELPHIA,PA,5115,4585,-530,0.472680412371134
19130,PHILA,PA,304,268,-36,0.46853146853146854
19130,PHILADELPHIA,PA,20859,17457,-3402,0.45560601315377386
19131,PHILADELPHIA,PA,15500,13272,-2228,0.461281801751703
19132,PHILA,PA,248,232,-16,0.48333333333333334
19132,PHILADELPHIA,PA,11608,10043,-1565,0.4638584822871923
19133,PHILADELPHIA,PA,7411,6000,-1411,0.44739393035567815
19134,PHILA,PA,824,641,-183,0.437542662116041
19134,PHILADELPHIA,PA,20026,15982,-4044,0.4438458120417685
19135,PHILA,PA,227,188,-39,0.4530120481927711
19135,PHILADELPHIA,PA,11162,9002,-2160,0.44643919857171194
19136,PHILA,PA,419,427,8,0.5047281323877069
19136,PHILADELPHIA,PA,10071,8309,-1762,0.4520674646354733
19137,PHILADELPHIA,PA,2148,1927,-221,0.4728834355828221
19138,PHILADELPHIA,PA,8068,7488,-580,0.48135767549498587
19139,PHILA,PA,668,598,-70,0.47235387045813587
19139,PHILADELPHIA,PA,15230,13107,-2123,0.46254014186399406
19140,PHILA,PA,316,225,-91,0.41589648798521256
19140,PHILADELPHIA,PA,16176,13170,-3006,0.4487834798609691
19141,PHILA,PA,196,188,-8,0.4895833333333333
19141,PHILADELPHIA,PA,8615,7488,-1127,0.46500652052412594
19142,PHILADELPHIA,PA,8552,7151,-1401,0.45539068967713175
19143,PHILADELPHIA,PA,24283,20146,-4137,0.4534425712935245
19144,PHILADELPHIA,PA,17540,15352,-2188,0.46673963273744373
19145,PHILA,PA,726,584,-142,0.44580152671755724
19145,PHILADELPHIA,PA,14195,12541,-1654,0.4690679233991622
19146,PHILA,PA,845,671,-174,0.4426121372031662
19146,PHILADELPHIA,PA,23091,19827,-3264,0.4619739969243674
19147,PHILA,PA,358,292,-66,0.4492307692307692
19147,PHILADELPHIA,PA,20783,17326,-3457,0.45464326012228085
19148,PHILADELPHIA,PA,16881,13702,-3179,0.4480266814897165
19149,PHILA,PA,1563,1021,-542,0.39512383900928794
19149,PHILADELPHIA,PA,15903,11272,-4631,0.4147930082796688
19150,PHILA,PA,97,86,-11,0.46994535519125685
19150,PHILADELPHIA,PA,5258,4749,-509,0.4745678025382232
19151,PHILA,PA,186,163,-23,0.4670487106017192
19151,PHILADELPHIA,PA,8260,7327,-933,0.47007121319047923
19152,PHILA,PA,621,536,-85,0.46326707000864303
19152,PHILADELPHIA,PA,9120,7671,-1449,0.4568518849383598
19153,PHILA,PA,67,83,16,0.5533333333333333
19153,PHILADELPHIA,PA,3467,2888,-579,0.4544453186467349
19154,NEWTOWN SQUARE,PA,162,139,-23,0.46179401993355484
19154,PHILA,PA,496,485,-11,0.4943934760448522
19154,PHILADELPHIA,PA,7420,6788,-632,0.47775900900900903
19160,PHILADELPHIA,PA,39,556,517,0.934453781512605
19301,PAOLI,PA,2847,2897,50,0.5043523676880223
19310,ATGLEN,PA,448,420,-28,0.4838709677419355
19311,AVONDALE,PA,1767,1921,154,0.52087852494577
19312,BERWYN,PA,3135,3560,425,0.5317401045556386
19312,TREDYFFRIN,PA,49,60,11,0.5504587155963303
19317,CHADDS FORD,PA,3427,3555,128,0.5091664279576052
19320,COATESVILLE,PA,18984,15676,-3308,0.4522792844777842
19330,COCHRANVILLE,PA,1242,1341,99,0.519163763066202
19333,DEVON,PA,3266,2993,-273,0.47819140437769614
19335,DOWNINGTOWN,PA,13623,15761,2138,0.5363803430438334
19341,EXTON,PA,9473,10551,1078,0.5269176987614862
19342,GLEN MILLS,PA,5971,6438,467,0.5188169876702393
19343,GLENMOORE,PA,2090,2191,101,0.5117963092735343
19344,HONEY BROOK,PA,3542,3417,-125,0.4910188245437563
19348,KENNETT SQ,PA,287,247,-40,0.46254681647940077
19348,KENNETT SQUARE,PA,6023,6907,884,0.534184068058778
19350,LANDENBERG,PA,2190,2471,281,0.5301437459772581
19352,LINCOLN UNIV,PA,22,25,3,0.5319148936170213
19352,LINCOLN UNIVERSITY,PA,1399,1688,289,0.5468091998704243
19355,MALVERN,PA,11049,12305,1256,0.5268904684422369
19358,MODENA,PA,40,0,-40,0
19362,NOTTINGHAM,PA,1487,1373,-114,0.4800699300699301
19363,OXFORD,PA,4173,4069,-104,0.49369085173501576
19365,PARKESBURG,PA,2167,2170,3,0.500345861194374
19369,SADSBURYVILLE,PA,11,22,11,0.6666666666666666
19372,THORNDALE,PA,1175,1170,-5,0.4989339019189765
19373,THORNTON,PA,397,431,34,0.5205314009661836
19374,TOUGHKENAMON,PA,13,25,12,0.6578947368421053
19375,UNIONVILLE,PA,57,26,-31,0.3132530120481928
19380,WEST BRADFORD,PA,309,319,10,0.5079617834394905
19380,WEST CHESTER,PA,16079,16337,258,0.5039795162882527
19381,WEST CHESTER,PA,11,136,125,0.9251700680272109
19382,WEST CHESTER,PA,16318,15254,-1064,0.4831496262511086
19390,WEST GROVE,PA,2837,3159,322,0.526851234156104
19395,WESTTOWN,PA,58,53,-5,0.4774774774774775
19399,SOUTHEASTERN,PA,45,186,141,0.8051948051948052
19401,EAST NORRITON,PA,2360,2160,-200,0.4778761061946903
19401,NORRISTOWN,PA,13699,11605,-2094,0.4586231425861524
19403,AUDUBON,PA,679,694,15,0.5054624908958485
19403,NORRISTOWN,PA,13577,13061,-516,0.49031458818229595
19403,WEST NORRITON,PA,523,512,-11,0.49468599033816424
19404,NORRISTOWN,PA,72,454,382,0.8631178707224335
19405,BRIDGEPORT,PA,2060,1892,-168,0.47874493927125505
19406,KING OF PRUSSIA,PA,16623,16101,-522,0.49202420242024203
19408,EAGLEVILLE,PA,0,26,26,1
19421,BIRCHRUNVILLE,PA,24,0,-24,0
19422,BLUE BELL,PA,7079,7957,878,0.5291965948390529
19422,PENLLYN,PA,171,134,-37,0.43934426229508194
19423,CEDARS,PA,11,0,-11,0
19425,CHESTER SPRGS,PA,882,1127,245,0.5609756097560976
19425,CHESTER SPRINGS,PA,2608,3544,936,0.576072821846554
19426,COLLEGEVILLE,PA,8396,9416,1020,0.528632382663373
19426,TRAPPE,PA,798,844,46,0.5140073081607796
19428,CONSHOHOCKEN,PA,10470,8733,-1737,0.45477269176691143
19428,GULPH MILLS,PA,188,161,-27,0.46131805157593125
19428,W CNSHOHOCKEN,PA,498,428,-70,0.46220302375809935
19436,GWYNEDD,PA,50,37,-13,0.42528735632183906
19437,GWYNEDD VALLEY,PA,63,44,-19,0.411214953271028
19438,HARLEYSVILLE,PA,6658,6574,-84,0.49682587666263606
19440,HATFIELD,PA,6300,5776,-524,0.4783040741967539
19442,KIMBERTON,PA,14,0,-14,0
19443,KULPSVILLE,PA,12,0,-12,0
19444,LAFAYETTE HILL,PA,2888,3048,160,0.5134770889487871
19444,LAFAYETTE HL,PA,108,122,14,0.5304347826086957
19446,LANSDALE,PA,19158,18982,-176,0.4976927110644992
19450,LEDERACH,PA,11,33,22,0.75
19453,MONT CLARE,PA,402,160,-242,0.2846975088967972
19453,PHOENIXVILLE,PA,16,15,-1,0.4838709677419355
19454,NORTH WALES,PA,9315,8462,-853,0.4760083253642347
19456,OAKS,PA,60,31,-29,0.34065934065934067
19457,PARKER FORD,PA,11,0,-11,0
19460,PHOENIXVILLE,PA,15131,15163,32,0.5005281573909025
19462,PLYMOUTH MEETING,PA,4975,5126,151,0.5074745074745075
19464,POTTSTOWN,PA,17632,18076,444,0.5062170942085807
19465,POTTSTOWN,PA,4687,4721,34,0.5018069727891157
19468,LIMERICK,PA,2546,2496,-50,0.4950416501388338
19468,LINFIELD,PA,173,171,-2,0.49709302325581395
19468,ROYERSFORD,PA,7538,6845,-693,0.47590905930612526
19473,SCHWENKSVILLE,PA,3350,3513,163,0.5118752732041382
19474,SKIPPACK,PA,157,80,-77,0.33755274261603374
19475,SPRING CITY,PA,3299,3387,88,0.5065809153454981
19477,SPRING HOUSE,PA,40,39,-1,0.4936708860759494
19490,WORCESTER,PA,48,0,-48,0
19492,ZIEGLERVILLE,PA,0,44,44,1
19501,ADAMSTOWN,PA,413,198,-215,0.32405891980360063
19503,BALLY,PA,226,205,-21,0.4756380510440835
19504,BARTO,PA,1145,1243,98,0.5205192629815746
19505,BECHTELSVILLE,PA,1002,1190,188,0.5428832116788321
19506,BERNVILLE,PA,1996,1903,-93,0.4880738650936137
19507,BETHEL,PA,1041,956,-85,0.4787180771156735
19508,BIRDSBORO,PA,4303,4240,-63,0.49631277068945334
19510,BLANDON,PA,2001,2026,25,0.5031040476781723
19512,BOYERTOWN,PA,5159,5045,-114,0.4944139553116425
19518,DOUGLASSVILLE,PA,3940,4535,595,0.5351032448377581
19520,ELVERSON,PA,1534,1638,104,0.5163934426229508
19522,FLEETWOOD,PA,3693,3826,133,0.5088442612049474
19525,GILBERTSVILLE,PA,3597,3946,349,0.5231340315524328
19526,HAMBURG,PA,3662,3616,-46,0.49683979115141524
19529,KEMPTON,PA,560,624,64,0.527027027027027
19530,KUTZTOWN,PA,3807,3943,136,0.508774193548387
19533,DAUBERVILLE,PA,61,80,19,0.5673758865248227
19533,LEESPORT,PA,1664,1879,215,0.5303415184871578
19534,LENHARTSVILLE,PA,384,364,-20,0.48663101604278075
19536,LYON STATION,PA,27,0,-27,0
19539,MERTZTOWN,PA,1139,1051,-88,0.47990867579908675
19540,MOHNTON,PA,3025,3261,236,0.518771874005727
19541,MOHRSVILLE,PA,926,998,72,0.5187110187110187
19543,MORGANTOWN,PA,1530,1486,-44,0.4927055702917772
19547,OLEY,PA,1275,1251,-24,0.49524940617577196
19550,REHRERSBURG,PA,16,0,-16,0
19551,ROBESONIA,PA,1313,1434,121,0.5220240262104113
19554,SHARTLESVILLE,PA,142,74,-68,0.3425925925925926
19555,SHOEMAKERSVILLE,PA,1108,1133,25,0.5055778670236502
19555,SHOEMAKERSVLE,PA,26,18,-8,0.4090909090909091
19560,TEMPLE,PA,3408,3449,41,0.502989645617617
19562,TOPTON,PA,1074,769,-305,0.4172544763971785
19565,WERNERSVILLE,PA,2499,2680,181,0.5174744159104074
19567,STOUCHSBURG,PA,30,35,5,0.5384615384615384
19567,WOMELSDORF,PA,1702,1715,13,0.5019022534386889
19601,READING,PA,17611,15154,-2457,0.46250572256981537
19602,READING,PA,11552,9706,-1846,0.45658105183930753
19603,READING,PA,261,669,408,0.7193548387096774
19604,READING,PA,12458,9971,-2487,0.4445583842346962
19605,LAURELDALE,PA,165,129,-36,0.4387755102040816
19605,READING,PA,8051,6291,-1760,0.43864175149909357
19606,READING,PA,11722,11258,-464,0.4899042645778938
19607,READING,PA,6193,5838,-355,0.4852464466794115
19607,SHILLINGTON,PA,2507,2361,-146,0.48500410846343467
19608,READING,PA,3109,3148,39,0.5031165095093495
19608,SINKING SPG,PA,396,458,62,0.5362997658079626
19608,SINKING SPRING,PA,3027,3325,298,0.5234571788413098
19609,READING,PA,2700,2593,-107,0.4898923105989042
19609,WEST LAWN,PA,871,787,-84,0.4746682750301568
19610,READING,PA,3864,4081,217,0.5136563876651983
19610,WYOMISSING,PA,2968,3144,176,0.5143979057591623
19611,READING,PA,3205,2827,-378,0.46866710875331563
19611,WEST READING,PA,1553,1403,-150,0.4746278755074425
19612,PHILA,PA,0,13,13,1
19612,READING,PA,275,964,689,0.778046811945117
19701,BEAR,DE,15028,14978,-50,0.49916683330000666
19702,CHRISTIANA,DE,449,389,-60,0.46420047732696895
19702,NEWARK,DE,21748,18274,-3474,0.45659887062115834
19703,CLAYMONT,DE,6843,7895,1052,0.5356900529244131
19706,DELAWARE CITY,DE,663,582,-81,0.4674698795180723
19707,HOCKESSIN,DE,4037,4773,736,0.5417707150964812
19709,MIDDLETOWN,DE,12498,17306,4808,0.5806603140518052
19710,MONTCHANIN,DE,0,61,61,1
19711,NEWARK,DE,16517,14402,-2115,0.4657977295514085
19713,NEWARK,DE,12097,10872,-1225,0.4733336235796073
19714,NEWARK,DE,1099,999,-100,0.47616777883698763
19720,HISTORIC NEW CASTLE,DE,904,835,-69,0.48016101207590567
19720,NEW CASTLE,DE,18632,17300,-1332,0.4814649894244684
19730,ODESSA,DE,27,0,-27,0
19732,ROCKLAND,DE,11,61,50,0.8472222222222222
19734,TOWNSEND,DE,2982,3740,758,0.5563820291579887
19801,WILMINGTON,DE,9053,8112,-941,0.4725895718030877
19802,WILMINGTON,DE,9528,8652,-876,0.4759075907590759
19803,TALLEYVILLE,DE,499,533,34,0.5164728682170543
19803,WILMINGTON,DE,6166,5961,-205,0.4915477859322174
19804,NEWPORT,DE,323,303,-20,0.4840255591054313
19804,WILMINGTON,DE,5203,5417,214,0.510075329566855
19805,WILMINGTON,DE,15201,14136,-1065,0.4818488598016157
19806,WILMINGTON,DE,5757,5588,-169,0.49255178492728074
19807,GREENVILLE,DE,437,524,87,0.5452653485952134
19807,WILMINGTON,DE,3420,3834,414,0.5285359801488834
19808,WILMINGTON,DE,11804,11609,-195,0.495835646862854
19809,WILMINGTON,DE,6019,6075,56,0.5023151976186538
19810,WILMINGTON,DE,7190,7400,210,0.5071967100753941
19850,WILMINGTON,DE,575,868,293,0.6015246015246015
19899,WILMINGTON,DE,268,779,511,0.7440305635148042
19901,DOVER,DE,15974,15590,-384,0.49391712077049804
19902,DOVER,DE,0,44,44,1
19902,DOVER AFB,DE,162,307,145,0.6545842217484008
19902,DOVER AIR FORCE BASE,DE,42,112,70,0.7272727272727273
19903,BRIDGEVILLE,DE,28,16,-12,0.36363636363636365
19903,DOVER,DE,732,1201,469,0.6213140196585618
19904,DOVER,DE,14510,14140,-370,0.49354275741710296
19930,BETHANY BEACH,DE,3333,3578,245,0.5177253653595717
19930,S BETHANY,DE,104,55,-49,0.34591194968553457
19933,BRIDGEVILLE,DE,3388,3183,-205,0.48440115659716937
19934,CAMDEN,DE,1449,1710,261,0.5413105413105413
19934,CAMDEN WYOMING,DE,2987,3245,258,0.5206996148908858
19934,WYOMING,DE,63,83,20,0.5684931506849316
19936,CHESWOLD,DE,55,220,165,0.8
19938,CLAYTON,DE,2427,3026,599,0.5549238951036127
19939,DAGSBORO,DE,2204,2834,630,0.5625248114331084
19940,DELMAR,DE,1972,2421,449,0.5511040291372639
19941,ELLENDALE,DE,910,1001,91,0.5238095238095238
19943,FELTON,DE,3857,4637,780,0.5459147633623734
19944,FENWICK ISLAND,DE,334,379,45,0.5315568022440392
19944,FENWICK ISLE,DE,18,0,-18,0
19945,FRANKFORD,DE,2456,3500,1044,0.587642713230356
19946,FREDERICA,DE,1906,2012,106,0.5135273098519653
19947,GEORGETOWN,DE,4987,5289,302,0.5146944336317634
19950,GREENWOOD,DE,1949,2248,299,0.5356206814391232
19951,HARBESON,DE,629,1149,520,0.6462317210348706
19952,HARRINGTON,DE,3792,3685,-107,0.4928447238197138
19953,HARTLY,DE,1170,1260,90,0.5185185185185185
19954,HOUSTON,DE,273,331,58,0.5480132450331126
19955,KENTON,DE,0,27,27,1
19956,LAUREL,DE,5117,4966,-151,0.4925121491619558
19958,LEWES,DE,13404,17337,3933,0.5639699424221724
19960,LINCOLN,DE,1780,1955,175,0.5234270414993306
19962,MAGNOLIA,DE,4182,4825,643,0.5356944598645498
19963,MILFORD,DE,7448,8500,1052,0.5329821921244043
19964,MARYDEL,DE,164,83,-81,0.3360323886639676
19966,MILLSBORO,DE,13028,15647,2619,0.5456669572798605
19967,MILLVILLE,DE,682,1369,687,0.6674792784007801
19968,MILTON,DE,4697,6794,2097,0.5912453224262466
19969,NASSAU,DE,239,265,26,0.5257936507936508
19970,OCEAN VIEW,DE,4820,5952,1132,0.5525436316375789
19971,DEWEY BEACH,DE,411,322,-89,0.4392905866302865
19971,REHOBOTH BCH,DE,502,541,39,0.5186960690316395
19971,REHOBOTH BEACH,DE,9004,10778,1774,0.5448387422909716
19973,SEAFORD,DE,8693,8691,-2,0.49994247583985274
19975,SELBYVILLE,DE,4134,5444,1310,0.5683858843182292
19977,SMYRNA,DE,8671,9581,910,0.5249287749287749
19979,VIOLA,DE,13,0,-13,0
20001,WASHINGTON,DC,41873,32476,-9397,0.43680479898855396
20002,WASHINGTON,DC,53086,46512,-6574,0.46699732926363985
20003,WASHINGTON,DC,31342,31438,96,0.5007645747053202
20004,WASHINGTON,DC,2338,1860,-478,0.44306812767984755
20005,WASHINGTON,DC,14780,10039,-4741,0.4044884967162255
20006,WASHINGTON,DC,2655,2219,-436,0.4552728764874846
20007,WASHINGTON,DC,16821,13114,-3707,0.4380825121095707
20008,WASHINGTON,DC,22851,18361,-4490,0.44552557507522084
20009,WASHINGTON,DC,48609,35226,-13383,0.42018250134192164
20010,WASHINGTON,DC,21938,15734,-6204,0.4176576767891272
20011,WASHINGTON,DC,28688,23651,-5037,0.4518810065152181
20012,WASHINGTON,DC,5747,5561,-186,0.49177573399363284
20013,WASHINGTON,DC,614,661,47,0.5184313725490196
20015,CHEVY CHASE,DC,337,343,6,0.5044117647058823
20015,WASHINGTON,DC,5626,6083,457,0.5195149030660176
20016,WASHINGTON,DC,13399,12213,-1186,0.47684679056692175
20017,WASHINGTON,DC,8800,8161,-639,0.4811626672955604
20018,WASHINGTON,DC,7785,7800,15,0.5004812319538018
20019,WASHINGTON,DC,20589,16898,-3691,0.4507696001280444
20020,WASHINGTON,DC,19134,15659,-3475,0.45006179403903085
20024,FORT LESLEY J MCNAIR,DC,295,299,4,0.5033670033670034
20024,WASHINGTON,DC,13519,12781,-738,0.4859695817490494
20026,WASHINGTON,DC,92,54,-38,0.3698630136986301
20027,WASHINGTON,DC,36,23,-13,0.3898305084745763
20029,WASHINGTON,DC,0,266,266,1
20030,WASHINGTON,DC,24,402,378,0.9436619718309859
20032,BOLLING AFB,DC,8292,6633,-1659,0.4444221105527638
20032,WASHINGTON,DC,7359,5985,-1374,0.4485161870503597
20033,WASHINGTON,DC,0,35,35,1
20035,WASHINGTON,DC,11,0,-11,0
20036,WASHINGTON,DC,8408,5750,-2658,0.4061308094363611
20037,WASHINGTON,DC,10521,7062,-3459,0.4016379457430473
20038,WASHINGTON,DC,141,0,-141,0
20039,WASHINGTON,DC,11,88,77,0.8888888888888888
20040,WASHINGTON,DC,23,303,280,0.9294478527607362
20041,WASHINGTON,DC,13,0,-13,0
20043,WASHINGTON,DC,0,16,16,1
20044,WASHINGTON,DC,13,37,24,0.74
20045,WASHINGTON,DC,0,18,18,1
20052,WASHINGTON,DC,0,24,24,1
20056,WASHINGTON,DC,0,11,11,1
20090,WASHINGTON,DC,729,1293,564,0.6394658753709199
20105,ALDIE,VA,7672,11323,3651,0.5961042379573572
20105,STONE RIDGE,VA,415,638,223,0.6058879392212726
20106,AMISSVILLE,VA,1322,1486,164,0.5292022792022792
20108,MANASSAS,VA,2060,1896,-164,0.4792719919110212
20109,MANASSAS,VA,22973,19907,-3066,0.46424906716417913
20110,MANASSAS,VA,19220,17493,-1727,0.4764797210797265
20111,MANASSAS,VA,4476,3870,-606,0.46369518332135157
20111,MANASSAS PARK,VA,10439,8945,-1494,0.46146306231943873
20112,MANASSAS,VA,7171,8609,1438,0.5455640050697085
20113,MANASSAS,VA,13,46,33,0.7796610169491526
20113,MANASSAS PARK,VA,0,11,11,1
20115,MARSHALL,VA,1900,2028,128,0.5162932790224033
20116,MARSHALL,VA,26,48,22,0.6486486486486487
20117,MIDDLEBURG,VA,1003,913,-90,0.47651356993736954
20118,MIDDLEBURG,VA,1052,471,-581,0.309258043335522
20119,CATLETT,VA,1100,1218,118,0.5254529767040552
20120,CENTREVILLE,VA,14887,14787,-100,0.4983150232526791
20121,CENTREVILLE,VA,12821,11077,-1744,0.4635115909281111
20122,CENTREVILLE,VA,534,799,265,0.5993998499624906
20124,CLIFTON,VA,3565,4128,563,0.5365917067463928
20129,PAEONIAN SPRINGS,VA,16,34,18,0.68
20132,HILLSBORO,VA,1120,1340,220,0.5447154471544715
20132,PURCELLVILLE,VA,3278,3915,637,0.544279160294731
20134,PURCELLVILLE,VA,93,122,29,0.5674418604651162
20135,BLUEMONT,VA,736,910,174,0.5528554070473876
20136,BRISTOW,VA,8217,8649,432,0.5128068303094984
20137,BROAD RUN,VA,373,506,133,0.5756541524459613
20141,ROUND HILL,VA,1796,2505,709,0.582422692397117
20142,ROUND HILL,VA,11,0,-11,0
20143,CATHARPIN,VA,135,275,140,0.6707317073170732
20144,DELAPLANE,VA,126,139,13,0.5245283018867924
20146,ASHBURN,VA,506,827,321,0.6204051012753188
20147,ASHBURN,VA,27504,28381,877,0.507846470430348
20148,ASHBURN,VA,7637,9035,1398,0.5419265834932822
20148,BRAMBLETON,VA,8822,10080,1258,0.5332769019151412
20148,BROADLANDS,VA,3648,4822,1174,0.5693034238488784
20151,CHANTILLY,VA,7254,8026,772,0.525261780104712
20152,CHANTILLY,VA,8433,9436,1003,0.528065364597907
20152,SOUTH RIDING,VA,1215,1439,224,0.5422004521477016
20153,CHANTILLY,VA,1365,659,-706,0.3255928853754941
20155,GAINESVILLE,VA,12122,12674,552,0.5111308275528311
20156,GAINESVILLE,VA,162,217,55,0.5725593667546174
20158,HAMILTON,VA,892,1193,301,0.5721822541966427
20164,STERLING,VA,15312,12215,-3097,0.44374614015330405
20165,POTOMAC FALLS,VA,1338,1401,63,0.511500547645126
20165,STERLING,VA,11189,10834,-355,0.4919402442900604
20166,DULLES,VA,210,221,11,0.5127610208816705
20166,STERLING,VA,9086,9384,298,0.5080671358960477
20167,STERLING,VA,198,527,329,0.7268965517241379
20168,HAYMARKET,VA,191,181,-10,0.48655913978494625
20169,HAYMARKET,VA,7547,9491,1944,0.5570489494072074
20170,HERNDON,VA,17623,15224,-2399,0.4634822053764423
20171,HERNDON,VA,28820,28283,-537,0.49529797033430817
20171,OAK HILL,VA,490,517,27,0.5134061569016882
20172,HERNDON,VA,683,617,-66,0.4746153846153846
20175,LEESBURG,VA,11448,12560,1112,0.5231589470176607
20176,LEESBURG,VA,17187,17131,-56,0.49918410163762456
20177,LEESBURG,VA,597,844,247,0.5857043719639139
20180,LOVETTSVILLE,VA,2114,2628,514,0.5541965415436525
20181,NOKESVILLE,VA,2242,2862,620,0.5607366771159875
20182,NOKESVILLE,VA,43,0,-43,0
20184,UPPERVILLE,VA,39,27,-12,0.4090909090909091
20185,UPPERVILLE,VA,0,12,12,1
20186,WARRENTON,VA,5759,5823,64,0.5027629079606286
20187,VINT HILL FARMS,VA,568,630,62,0.5258764607679466
20187,WARRENTON,VA,4219,4871,652,0.5358635863586358
20188,WARRENTON,VA,433,501,68,0.5364025695931478
20189,DULLES,VA,5215,5302,87,0.5041361605020444
20190,RESTON,VA,18264,17132,-1132,0.48400949259803366
20191,RESTON,VA,14433,13554,-879,0.4842962804159074
20194,RESTON,VA,7179,6587,-592,0.4784977480749673
20195,RESTON,VA,342,468,126,0.5777777777777777
20197,WATERFORD,VA,542,707,165,0.566052842273819
20198,THE PLAINS,VA,859,837,-22,0.49351415094339623
20601,WALDORF,MD,9488,9567,79,0.502072946733141
20602,SAINT CHARLES,MD,200,181,-19,0.47506561679790027
20602,WALDORF,MD,11102,9766,-1336,0.4679892658616063
20603,WALDORF,MD,11274,11868,594,0.51283380865958
20604,SAINT CHARLES,MD,21,61,40,0.7439024390243902
20604,WALDORF,MD,855,1563,708,0.6464019851116626
20607,ACCOKEEK,MD,3280,3919,639,0.5443811640505626
20608,AQUASCO,MD,24,42,18,0.6363636363636364
20609,AVENUE,MD,70,58,-12,0.453125
20611,BEL ALTON,MD,11,47,36,0.8103448275862069
20613,BRANDYWINE,MD,4450,6349,1899,0.587924807852579
20615,BROOMES ISLAND,MD,23,12,-11,0.34285714285714286
20616,BRYANS ROAD,MD,2441,2504,63,0.5063700707785642
20617,BRYANTOWN,MD,34,37,3,0.5211267605633803
20618,BUSHWOOD,MD,50,141,91,0.7382198952879581
20619,CALIFORNIA,MD,6805,7035,230,0.5083092485549133
20620,CALLAWAY,MD,368,399,31,0.5202086049543677
20621,CHAPTICO,MD,115,182,67,0.6127946127946128
20622,CHARLOTT HALL,MD,174,225,51,0.5639097744360902
20622,CHARLOTTE HALL,MD,955,1182,227,0.5531118390266729
20623,CHELTENHAM,MD,671,954,283,0.587076923076923
20624,CLEMENTS,MD,36,49,13,0.5764705882352941
20625,COBB ISLAND,MD,23,28,5,0.5490196078431373
20626,COLTONS POINT,MD,12,13,1,0.52
20628,DAMERON,MD,12,13,1,0.52
20629,DOWELL,MD,239,0,-239,0
20630,DRAYDEN,MD,12,23,11,0.6571428571428571
20632,FAULKNER,MD,0,12,12,1
20634,GREAT MILLS,MD,3293,2901,-392,0.4683564740071037
20636,HOLLYWOOD,MD,2809,3032,223,0.5190891970552988
20637,HUGHESVILLE,MD,1516,1949,433,0.5624819624819625
20639,HUNTINGTOWN,MD,3429,3873,444,0.5304026294165982
20640,INDIAN HEAD,MD,3122,3186,64,0.5050729232720355
20645,ISSUE,MD,12,0,-12,0
20645,SWAN POINT,MD,87,91,4,0.5112359550561798
20646,LA PLATA,MD,6193,7406,1213,0.5445988675637915
20650,LEONARDTOWN,MD,4094,4937,843,0.546672572251135
20653,LEXINGTON PARK,MD,12314,11037,-1277,0.4726564172840564
20657,LUSBY,MD,7050,6687,-363,0.486787508189561
20658,MARBURY,MD,63,144,81,0.6956521739130435
20659,MECHANICSVILLE,MD,5445,5459,14,0.5006419662509171
20659,MECHANICSVLLE,MD,189,184,-5,0.4932975871313673
20662,NANJEMOY,MD,486,462,-24,0.4873417721518987
20664,NEWBURG,MD,730,960,230,0.5680473372781065
20667,PARK HALL,MD,11,12,1,0.5217391304347826
20670,PATUXENT RIVER,MD,1118,698,-420,0.3843612334801762
20674,PINEY POINT,MD,157,190,33,0.547550432276657
20675,POMFRET,MD,308,413,105,0.5728155339805825
20676,PORT REPUBLIC,MD,864,953,89,0.5244909190974133
20677,PORT TOBACCO,MD,605,844,239,0.5824706694271912
20678,PRINCE FREDERICK,MD,3827,4486,659,0.539636713581138
20680,RIDGE,MD,47,25,-22,0.3472222222222222
20684,SAINT INIGOES,MD,183,196,13,0.5171503957783641
20685,SAINT LEONARD,MD,1940,2013,73,0.5092334935492031
20688,SOLOMONS,MD,1699,2038,339,0.5453572384265454
20689,SUNDERLAND,MD,175,211,36,0.5466321243523317
20690,TALL TIMBERS,MD,37,60,23,0.6185567010309279
20692,VALLEY LEE,MD,127,94,-33,0.4253393665158371
20693,WELCOME,MD,61,135,74,0.6887755102040817
20695,WHITE PLAINS,MD,4755,5789,1034,0.5490326251896813
20701,ANNAPOLIS JCT,MD,115,125,10,0.5208333333333334
20701,ANNAPOLIS JUNCTION,MD,1037,945,-92,0.47679112008072655
20703,LANHAM,MD,68,305,237,0.8176943699731903
20703,LANHAM SEABROOK,MD,15,64,49,0.810126582278481
20704,BELTSVILLE,MD,86,263,177,0.7535816618911175
20704,LAUREL,MD,0,11,11,1
20705,BELTSVILLE,MD,11746,10455,-1291,0.4709247331201297
20706,GLENARDEN,MD,656,555,-101,0.458298926507019
20706,LANHAM,MD,10103,9379,-724,0.4814187455086747
20706,LANHAM SEABROOK,MD,4840,4471,-369,0.48018472774138116
20706,SEABROOK,MD,722,669,-53,0.4809489575844716
20707,LAUREL,MD,18080,16171,-1909,0.47213220051969285
20708,LAUREL,MD,15552,13030,-2522,0.45588132391015324
20709,LAUREL,MD,22,141,119,0.8650306748466258
20710,BLADENSBURG,MD,4812,3663,-1149,0.43221238938053097
20711,LOTHIAN,MD,1907,2145,238,0.5293682132280355
20712,MOUNT RAINIER,MD,4353,3456,-897,0.44256626968882057
20714,HOLLAND POINT,MD,39,37,-2,0.4868421052631579
20714,NORTH BEACH,MD,2180,1995,-185,0.47784431137724553
20715,BOWIE,MD,6324,6946,622,0.5234363225320271
20715,LEESBURG,VA,147,132,-15,0.4731182795698925
20716,BOWIE,MD,8865,8170,-695,0.4796008218373936
20717,BOWIE,MD,0,133,133,1
20718,BOWIE,MD,228,571,343,0.7146433041301627
20720,BOWIE,MD,6196,6483,287,0.5113179272813313
20721,BOWIE,MD,5464,6263,799,0.5340666837213268
20721,MITCHELLVILLE,MD,1935,2180,245,0.5297691373025516
20722,BRENTWOOD,MD,1744,1549,-195,0.4703917400546614
20722,COLMAR MANOR,MD,124,103,-21,0.45374449339207046
20722,COTTAGE CITY,MD,74,63,-11,0.45985401459854014
20722,NORTH BRENTWOOD,MD,32,34,2,0.5151515151515151
20723,LAUREL,MD,11857,11585,-272,0.4941984472314649
20723,SCAGGSVILLE,MD,261,237,-24,0.4759036144578313
20724,LAUREL,MD,8348,7847,-501,0.4845322630441494
20724,MARYLAND CITY,MD,178,177,-1,0.49859154929577465
20724,MD CITY,MD,181,180,-1,0.4986149584487535
20725,LAUREL,MD,1475,915,-560,0.38284518828451886
20731,CAPITOL HEIGHTS,MD,0,100,100,1
20732,CHESAPEAK BCH,MD,61,64,3,0.512
20732,CHESAPEAKE BEACH,MD,4107,3751,-356,0.47734792568083484
20733,CHURCHTON,MD,884,863,-21,0.4939896966227819
20735,CLINTON,MD,9851,10988,1137,0.5272805796823264
20736,OWINGS,MD,1978,2296,318,0.5372016846045858
20737,RIVERDALE,MD,6772,5061,-1711,0.42770218879405053
20737,RIVERDALE PARK,MD,842,711,-131,0.4578235672891178
20738,RIVERDALE,MD,12,198,186,0.9428571428571428
20740,BERWYN HEIGHTS,MD,787,720,-67,0.47777040477770405
20740,BERWYN HTS,MD,403,288,-115,0.41678726483357453
20740,COLLEGE PARK,MD,13319,9706,-3613,0.4215418023887079
20740,HANGERTOWN,MD,208,159,-49,0.4332425068119891
20741,BRADBURY HEIGHTS,MD,0,27,27,1
20741,COLLEGE PARK,MD,12,101,89,0.8938053097345132
20743,CAPITOL HEIGHTS,MD,13241,12093,-1148,0.47734270150785507
20743,CAPITOL HGTS,MD,326,307,-19,0.4849921011058452
20743,FAIRMOUNT HEIGHTS,MD,283,269,-14,0.48731884057971014
20744,FORT WASHINGTON,MD,14637,14555,-82,0.49859550561797755
20744,FT WASHINGTON,MD,1418,1390,-28,0.495014245014245
20745,FOREST HEIGHTS,MD,273,270,-3,0.4972375690607735
20745,OXON HILL,MD,12490,11270,-1220,0.4743265993265993
20746,CAMP SPRINGS,MD,1367,1244,-123,0.4764458062045193
20746,HILLCREST HGTS,MD,341,363,22,0.515625
20746,MORNINGSIDE,MD,1062,827,-235,0.43779777660137636
20746,SUITLAND,MD,13400,11906,-1494,0.47048130878052635
20747,DISTRICT HEIGHTS,MD,13338,11208,-2130,0.4566120752872158
20747,DISTRICT HTS,MD,810,702,-108,0.4642857142857143
20747,FORESTVILLE,MD,2475,2174,-301,0.4676274467627447
20748,TEMPLE HILLS,MD,15092,13125,-1967,0.4651451252790871
20749,FORT WASHINGTON,MD,79,504,425,0.8644939965694682
20749,FT WASHINGTON,MD,0,48,48,1
20750,OXON HILL,MD,125,679,554,0.8445273631840796
20751,DEALE,MD,762,811,49,0.5155753337571519
20752,SUITLAND,MD,34,246,212,0.8785714285714286
20753,DISTRICT HEIGHTS,MD,145,636,491,0.8143405889884763
20754,DUNKIRK,MD,1685,2040,355,0.5476510067114094
20755,FORT GEORGE G MEADE,MD,5888,5003,-885,0.459370122119181
20755,FORT MEADE,MD,633,534,-99,0.45758354755784064
20757,TEMPLE HILLS,MD,211,565,354,0.7280927835051546
20758,FRIENDSHIP,MD,22,23,1,0.5111111111111111
20759,FULTON,MD,1817,2536,719,0.5825867218010568
20762,ANDREWS AIR FORCE BASE,MD,81,93,12,0.5344827586206896
20762,JB ANDREWS,MD,1759,1800,41,0.5057600449564484
20763,SAVAGE,MD,2075,1717,-358,0.45279535864978904
20764,SHADY SIDE,MD,1384,1525,141,0.5242351323478859
20765,GALESVILLE,MD,0,24,24,1
20768,GREENBELT,MD,252,838,586,0.7688073394495413
20769,GLENN DALE,MD,1763,2225,462,0.5579237713139418
20770,GREENBELT,MD,16467,13575,-2892,0.4518673856600759
20772,UPPER MARLBORO,MD,13711,16272,2561,0.5427075342694193
20772,UPPR MARLBORO,MD,540,594,54,0.5238095238095238
20773,UPPER MARLBORO,MD,223,580,357,0.7222914072229141
20773,UPPR MARLBORO,MD,0,12,12,1
20774,GLENARDEN,MD,388,377,-11,0.4928104575163399
20774,KETTERING,MD,356,397,41,0.5272244355909694
20774,LARGO,MD,2314,2422,108,0.511402027027027
20774,SPRINGDALE,MD,785,815,30,0.509375
20774,UPPER MARLBORO,MD,12443,13247,804,0.5156481121058778
20774,UPPR MARLBORO,MD,1029,1047,18,0.5043352601156069
20776,HARWOOD,MD,879,816,-63,0.4814159292035398
20777,HIGHLAND,MD,752,1046,294,0.5817575083426029
20778,WEST RIVER,MD,242,458,216,0.6542857142857142
20779,TRACYS LANDING,MD,200,188,-12,0.4845360824742268
20779,TRACYS LNDG,MD,44,0,-44,0
20781,HYATTSVILLE,MD,5060,4179,-881,0.45232167983548005
20782,CHILLUM,MD,850,659,-191,0.4367130550033135
20782,HYATTSVILLE,MD,13224,11340,-1884,0.4616511968734734
20782,UNIVERSITY PARK,MD,976,902,-74,0.4802981895633653
20782,WEST HYATTSVILLE,MD,377,330,-47,0.4667609618104668
20783,ADELPHI,MD,3092,2153,-939,0.41048617731172543
20783,HYATTSVILLE,MD,11430,7803,-3627,0.4057089377632195
20784,HYATTSVILLE,MD,5550,4708,-842,0.45895886137648667
20784,LANDOVER HILLS,MD,246,222,-24,0.47435897435897434
20784,NEW CARROLLTN,MD,746,649,-97,0.4652329749103943
20784,NEW CARROLLTON,MD,5568,4510,-1058,0.44750942647350667
20785,CHEVERLY,MD,3925,3341,-584,0.45981282686485
20785,HYATTSVILLE,MD,10237,9080,-1157,0.4700522855515867
20785,LANDOVER,MD,3790,3539,-251,0.4828762450538955
20787,HYATTSVILLE,MD,14,147,133,0.9130434782608695
20787,LANGLEY PARK,MD,0,35,35,1
20787,WARRENTON,VA,0,12,12,1
20791,CAPITOL HEIGHTS,MD,260,342,82,0.5681063122923588
20792,LARGO,MD,133,429,296,0.7633451957295374
20792,UPPER MARLBORO,MD,200,521,321,0.7226074895977809
20792,UPPR MARLBORO,MD,30,67,37,0.6907216494845361
20794,JESSUP,MD,4872,4810,-62,0.4967981821937616
20812,GLEN ECHO,MD,30,12,-18,0.2857142857142857
20813,BETHESDA,MD,14,0,-14,0
20814,BETHESDA,MD,19667,18864,-803,0.489579818847162
20815,BETHESDA,MD,606,613,7,0.5028712059064807
20815,CHEVY CHASE,MD,13541,12880,-661,0.4874910109382688
20816,BETHESDA,MD,4861,5283,422,0.5208004731861199
20817,BETHESDA,MD,10980,12737,1757,0.5370409410971033
20818,CABIN JOHN,MD,364,469,105,0.5630252100840336
20824,BETHESDA,MD,113,228,115,0.6686217008797654
20827,BETHESDA,MD,124,425,301,0.7741347905282332
20827,W BETHESDA,MD,0,12,12,1
20830,OLNEY,MD,586,55,-531,0.08580343213728549
20832,OLNEY,MD,5857,6102,245,0.5102433313822226
20833,BROOKEVILLE,MD,1535,1822,287,0.5427464998510575
20837,POOLESVILLE,MD,1464,1951,487,0.5713030746705711
20841,BOYDS,MD,1889,2212,323,0.5393806388685687
20842,DICKERSON,MD,344,401,57,0.538255033557047
20847,ROCKVILLE,MD,39,131,92,0.7705882352941177
20848,ROCKVILLE,MD,164,299,135,0.6457883369330454
20849,ROCKVILLE,MD,301,700,399,0.6993006993006993
20850,ROCKVILLE,MD,27952,27008,-944,0.49141193595342064
20851,ROCKVILLE,MD,6526,5339,-1187,0.44997892962494734
20852,N BETHESDA,MD,1052,979,-73,0.48202855736090594
20852,NORTH BETHESDA,MD,2168,1970,-198,0.47607539874335425
20852,ROCKVILLE,MD,27472,24664,-2808,0.4730704311799908
20853,ROCKVILLE,MD,7757,7525,-232,0.4924093705012433
20854,POTOMAC,MD,11937,14634,2697,0.5507508185615897
20854,ROCKVILLE,MD,469,597,128,0.5600375234521576
20855,DERWOOD,MD,4948,5238,290,0.5142352248183781
20855,ROCKVILLE,MD,1311,1310,-1,0.4998092331171309
20859,POTOMAC,MD,49,173,124,0.7792792792792793
20860,SANDY SPRING,MD,524,591,67,0.5300448430493273
20861,ASHTON,MD,594,964,370,0.6187419768934531
20866,BURTONSVILLE,MD,5394,4984,-410,0.4802466756600501
20868,SPENCERVILLE,MD,36,77,41,0.6814159292035398
20871,CLARKSBURG,MD,7694,10684,2990,0.581347263031886
20872,DAMASCUS,MD,3876,3892,16,0.5010298661174047
20874,GERMANTOWN,MD,28162,25959,-2203,0.47964745662497
20875,GERMANTOWN,MD,1203,931,-272,0.436269915651359
20876,GERMANTOWN,MD,10314,9173,-1141,0.4707240724585621
20877,GAITHERSBURG,MD,20159,16112,-4047,0.44421162912519646
20878,GAITHERSBURG,MD,22395,22382,-13,0.49985483618822163
20878,NORTH POTOMAC,MD,4881,4691,-190,0.4900752193898872
20879,GAITHERSBURG,MD,10570,9587,-983,0.47561641117229747
20880,WASHINGTON GROVE,MD,127,53,-74,0.29444444444444445
20882,GAITHERSBURG,MD,2763,3473,710,0.5569275176395125
20882,LAYTONSVILLE,MD,130,170,40,0.5666666666666667
20883,GAITHERSBURG,MD,95,80,-15,0.45714285714285713
20884,GAITHERSBURG,MD,105,136,31,0.5643153526970954
20885,GAITHERSBURG,MD,11,131,120,0.9225352112676056
20886,GAITHERSBURG,MD,1223,1022,-201,0.4552338530066815
20886,MONTGOMERY VILLAGE,MD,13310,12106,-1204,0.4763141328297136
20886,MONTGOMRY VLG,MD,365,325,-40,0.47101449275362317
20895,KENSINGTON,MD,5696,6255,559,0.5233871642540373
20896,GARRETT PARK,MD,26,30,4,0.5357142857142857
20898,GAITHERSBURG,MD,39,197,158,0.8347457627118644
20901,SILVER SPRING,MD,12230,11352,-878,0.4813841065219235
20902,SILVER SPRING,MD,17287,14688,-2599,0.45935887412040655
20902,WHEATON,MD,2945,2554,-391,0.46444808146935807
20903,SILVER SPRING,MD,8914,6579,-2335,0.42464338733621637
20904,COLESVILLE,MD,1057,925,-132,0.4667003027245207
20904,SILVER SPRING,MD,23501,20569,-2932,0.46673474018606764
20905,SILVER SPRING,MD,3943,4180,237,0.5145882063277114
20906,ASPEN HILL,MD,1535,1407,-128,0.47824609109449356
20906,SILVER SPRING,MD,26317,24198,-2119,0.47902603187172127
20907,SILVER SPRING,MD,44,368,324,0.8932038834951457
20910,SILVER SPRING,MD,31058,26413,-4645,0.4595883141062449
20912,TAKOMA PARK,MD,10164,8017,-2147,0.4409548429679336
20913,TAKOMA PARK,MD,0,11,11,1
20914,COLESVILLE,MD,47,72,25,0.6050420168067226
20914,SILVER SPRING,MD,124,487,363,0.7970540098199672
20915,SILVER SPRING,MD,18,142,124,0.8875
20915,WHEATON,MD,0,52,52,1
20916,ASPEN HILL,MD,0,34,34,1
20916,SILVER SPRING,MD,12,207,195,0.9452054794520548
20918,SILVER SPRING,MD,33,71,38,0.6826923076923077
21001,ABERDEEN,MD,10850,11810,960,0.5211827007943513
21005,ABER PROV GRD,MD,373,301,-72,0.4465875370919881
21005,ABERDEEN PROVING GROUND,MD,1486,1268,-218,0.46042120551924476
21009,ABINGDON,MD,11885,11110,-775,0.4831485105457708
21010,GUNPOWDER,MD,30,0,-30,0
21012,ARNOLD,MD,6928,7082,154,0.5054960742326909
21013,BALDWIN,MD,674,1095,421,0.6189937817976258
21014,BEL AIR,MD,11922,12508,586,0.5119934506753991
21015,BEL AIR,MD,8105,9141,1036,0.530035950365302
21017,BELCAMP,MD,3619,3051,-568,0.45742128935532234
21022,BROOKLANDVILLE,MD,28,38,10,0.5757575757575758
21028,CHURCHVILLE,MD,732,818,86,0.5277419354838709
21029,CLARKSVILLE,MD,2432,3440,1008,0.5858310626702997
21030,COCKEYSVILLE,MD,15383,12272,-3111,0.4437533899837281
21031,HUNT VALLEY,MD,105,372,267,0.779874213836478
21032,CROWNSVILLE,MD,2460,2996,536,0.5491202346041055
21034,DARLINGTON,MD,907,972,65,0.5172964342735498
21035,DAVIDSONVILLE,MD,1707,2149,442,0.5573132780082988
21036,DAYTON,MD,221,393,172,0.6400651465798045
21037,EDGEWATER,MD,6790,7312,522,0.5185080130477946
21040,EDGEWOOD,MD,10554,9613,-941,0.4766698071106263
21041,ELLICOTT CITY,MD,134,331,197,0.7118279569892473
21042,ELLICOTT CITY,MD,10312,12124,1812,0.5403815296844358
21043,ELLICOTT CITY,MD,17721,17908,187,0.5026242667489966
21044,COLUMBIA,MD,22658,20951,-1707,0.4804283519456993
21045,COLUMBIA,MD,15864,15373,-491,0.4921407305439063
21046,COLUMBIA,MD,7300,6668,-632,0.47737686139748
21047,FALLSTON,MD,2478,3039,561,0.5508428493746601
21048,FINKSBURG,MD,2243,2641,398,0.5407452907452908
21050,FOREST HILL,MD,4425,4643,218,0.5120202911336568
21052,FORT HOWARD,MD,12,0,-12,0
21053,FREELAND,MD,444,574,130,0.5638506876227898
21054,GAMBRILLS,MD,4203,5341,1138,0.5596186085498742
21056,GIBSON ISLAND,MD,30,34,4,0.53125
21057,GLEN ARM,MD,855,1068,213,0.5553822152886115
21060,GLEN BURNIE,MD,15921,15701,-220,0.4965214091455316
21061,FERNDALE,MD,569,392,-177,0.40790842872008326
21061,GLEN BURNIE,MD,25938,20948,-4990,0.4467858209273557
21061,GLENBURNIE,MD,545,405,-140,0.4263157894736842
21071,GLYNDON,MD,0,24,24,1
21074,HAMPSTEAD,MD,3642,3950,308,0.5202845100105374
21075,DELMAR,MD,413,324,-89,0.4396200814111262
21075,ELKRIDGE,MD,14702,14415,-287,0.49507160765188724
21076,HANOVER,MD,11766,13961,2195,0.5426594628211606
21078,HAVRE DE GRACE,MD,7992,7728,-264,0.4916030534351145
21082,HYDES,MD,14,23,9,0.6216216216216216
21084,JARRETTSVILLE,MD,1356,1655,299,0.5496512786449684
21085,JOPPA,MD,5685,5617,-68,0.49699168288798445
21087,KINGSVILLE,MD,982,1247,265,0.5594436967249888
21090,LINTHICUM,MD,375,339,-36,0.47478991596638653
21090,LINTHICUM HEIGHTS,MD,3663,3987,324,0.5211764705882352
21090,LINTHICUM HTS,MD,180,169,-11,0.48424068767908307
21093,LUTHERVILLE,MD,749,758,9,0.5029860650298607
21093,LUTHERVILLE TIMONIUM,MD,9984,10493,509,0.5124285784050397
21093,TIMONIUM,MD,1175,1085,-90,0.48008849557522126
21094,LUTHERVILLE,MD,0,63,63,1
21094,LUTHERVILLE TIMONIUM,MD,42,121,79,0.7423312883435583
21094,TIMONIUM,MD,0,25,25,1
21102,MANCHESTER,MD,2837,2948,111,0.5095937770095074
21104,MARRIOTTSVILLE,MD,1065,1472,407,0.5802128498226251
21108,MILLERSVILLE,MD,5324,6288,964,0.5415087840165346
21111,MONKTON,MD,1243,1311,68,0.5133124510571653
21113,ODENTON,MD,17640,18463,823,0.5113979447691328
21114,CROFTON,MD,9395,9170,-225,0.4939402100727175
21117,OWINGS MILLS,MD,29619,27952,-1667,0.4855222247312015
21120,PARKTON,MD,1291,1620,329,0.5565097904500171
21122,PASADENA,MD,17127,17693,566,0.5081275129236071
21122,RIVIERA BEACH,MD,342,340,-2,0.49853372434017595
21123,PASADENA,MD,56,41,-15,0.422680412371134
21128,PERRY HALL,MD,4054,4590,536,0.531004164738547
21131,PHOENIX,MD,1447,1962,515,0.5755353476092696
21132,PYLESVILLE,MD,376,586,210,0.6091476091476091
21133,RANDALLSTOWN,MD,10741,10325,-416,0.49012626981866514
21136,REISTERSTOWN,MD,11734,11541,-193,0.49585392051557464
21139,RIDERWOOD,MD,0,15,15,1
21140,RIVA,MD,992,1032,40,0.5098814229249012
21144,SEVERN,MD,12171,12474,303,0.5061472915398662
21146,SEVERNA PARK,MD,6714,7846,1132,0.5388736263736263
21150,SIMPSONVILLE,MD,12,0,-12,0
21152,GLENCOE,MD,28,51,23,0.6455696202531646
21152,SPARKS,MD,248,288,40,0.5373134328358209
21152,SPARKS GLENCO,MD,39,42,3,0.5185185185185185
21152,SPARKS GLENCOE,MD,1812,1789,-23,0.4968064426548181
21153,STEVENSON,MD,43,122,79,0.7393939393939394
21154,STREET,MD,1320,1368,48,0.5089285714285714
21155,UPPERCO,MD,372,586,214,0.6116910229645094
21157,WESTMINSTER,MD,10685,11158,473,0.5108272673167605
21158,WESTMINSTER,MD,5931,6230,299,0.512293396924595
21160,WHITEFORD,MD,616,625,9,0.5036261079774376
21161,WHITE HALL,MD,1071,1194,123,0.5271523178807948
21162,WHITE MARSH,MD,1108,1359,251,0.550871503850831
21163,WOODSTOCK,MD,1929,2232,303,0.5364095169430425
21201,BALTIMORE,MD,15209,11725,-3484,0.43532338308457713
21202,BALTIMORE,MD,16596,14901,-1695,0.47309267549290407
21203,BALTIMORE,MD,1146,1717,571,0.5997205728257073
21204,BALTIMORE,MD,2217,2074,-143,0.48333721743183405
21204,TOWSON,MD,8428,8007,-421,0.4871919683602069
21205,BALTIMORE,MD,6356,5436,-920,0.46099050203527814
21206,BALTIMORE,MD,18781,17425,-1356,0.48127382201845
21207,BALTIMORE,MD,2693,2517,-176,0.48310940499040306
21207,GWYNN OAK,MD,15081,14420,-661,0.48879698993254467
21208,BALTIMORE,MD,1579,1495,-84,0.4863370201691607
21208,PIKESVILLE,MD,11382,11748,366,0.5079118028534371
21209,BALTIMORE,MD,10034,9359,-675,0.4825968132831434
21209,MOUNT WASHINGTON,MD,893,899,6,0.5016741071428571
21209,MT WASHINGTON,MD,186,169,-17,0.476056338028169
21210,BALTIMOR,MD,90,95,5,0.5135135135135135
21210,BALTIMORE,MD,5884,4996,-888,0.4591911764705882
21211,BALTIMORE,MD,10432,9380,-1052,0.47345043408035536
21212,BALTIMORE,MD,10870,10221,-649,0.4846142904556446
21212,GOVANS,MD,165,145,-20,0.46774193548387094
21213,BALTIMORE,MD,11525,10454,-1071,0.47563583420537786
21214,BALTIMORE,MD,6368,6357,-11,0.4995677799607073
21215,BALTIMORE,MD,20694,18451,-2243,0.4713501085706987
21216,BALTIMORE,MD,11913,10486,-1427,0.4681458993705076
21217,BALTIMORE,MD,15180,12616,-2564,0.4538782558641531
21218,BALTIMORE,MD,20470,17714,-2756,0.46391158600460924
21219,BALTIMORE,MD,361,450,89,0.5548705302096177
21219,EDGEMERE,MD,126,192,66,0.6037735849056604
21219,SPARROWS POINT,MD,1892,2039,147,0.518697532434495
21220,BALTIMORE,MD,3752,3449,-303,0.47896125538119705
21220,MIDDLE RIVER,MD,15960,15437,-523,0.4916711787750422
21221,ESSEX,MD,18031,16937,-1094,0.4843571265156715
21222,BALTIMORE,MD,2376,2337,-39,0.4958625079567155
21222,DUNDALK,MD,19368,18357,-1011,0.4866003976143141
21223,BALTIMORE,MD,10005,8727,-1278,0.4658872517616912
21224,BALTIMORE,MD,29283,23800,-5483,0.44835446376429366
21225,BALTIMORE,MD,2341,2066,-275,0.46879963694122984
21225,BROOKLYN,MD,7876,7235,-641,0.47879028522268546
21225,BROOKLYN PARK,MD,1880,1753,-127,0.4825213322323149
21226,BALTIMORE,MD,520,432,-88,0.453781512605042
21226,CARVEL BEACH,MD,274,300,26,0.5226480836236934
21226,CHESTNUT HILL COVE,MD,198,193,-5,0.4936061381074169
21226,CURTIS BAY,MD,869,856,-13,0.49623188405797103
21226,ORCHARD BEACH,MD,201,175,-26,0.4654255319148936
21226,STONEY BEACH,MD,593,538,-55,0.47568523430592397
21227,ARBUTUS,MD,783,668,-115,0.4603721571330117
21227,BALTIMORE,MD,655,569,-86,0.46486928104575165
21227,HALETHORPE,MD,11748,10326,-1422,0.4677901603696657
21228,BALTIMORE,MD,688,609,-79,0.46954510408635314
21228,CATONSVILLE,MD,14215,14225,10,0.5001758087201125
21229,BALTIMORE,MD,18221,16102,-2119,0.46913148617545086
21230,BALTIMORE,MD,24503,20524,-3979,0.45581539964909945
21231,BALTIMORE,MD,14250,11105,-3145,0.4379806744231907
21234,BALTIMORE,MD,1562,1422,-140,0.4765415549597855
21234,PARKVILLE,MD,24289,22664,-1625,0.48269546141886566
21236,BALTIMORE,MD,1296,1279,-17,0.4966990291262136
21236,NOTTINGHAM,MD,14103,13931,-172,0.4969322964971106
21237,BALTIMORE,MD,2770,2705,-65,0.4940639269406393
21237,ROSEDALE,MD,10590,9851,-739,0.48192358495181253
21239,BALTIMORE,MD,11445,9338,-2107,0.4493095318288986
21239,IDLEWYLDE,MD,814,732,-82,0.47347994825355755
21244,BALTIMORE,MD,1696,1606,-90,0.4863718958207147
21244,WINDSOR MILL,MD,15695,14418,-1277,0.4787965330588118
21282,BALTIMORE,MD,35,30,-5,0.46153846153846156
21282,PIKESVILLE,MD,126,477,351,0.7910447761194029
21284,LOCH RAVEN,MD,0,13,13,1
21284,TOWSON,MD,23,152,129,0.8685714285714285
21285,TOWSON,MD,0,40,40,1
21286,BALTIMORE,MD,154,170,16,0.5246913580246914
21286,LOCH RAVEN,MD,170,162,-8,0.4879518072289157
21286,TOWSON,MD,8447,8600,153,0.50448759312489
21297,BALTIMORE,MD,36,0,-36,0
21401,ANNAPOLIS,MD,21967,20858,-1109,0.4870519556333917
21402,ANNAPOLIS,MD,498,285,-213,0.36398467432950193
21402,NORTH SEVERN VILLAGE,MD,17,14,-3,0.45161290322580644
21403,ANNAPOLIS,MD,15658,14533,-1125,0.48136861978735385
21404,ANNAPOLIS,MD,23,91,68,0.7982456140350878
21405,ANNAPOLIS,MD,0,92,92,1
21405,SHERWOOD FOREST,MD,0,36,36,1
21409,ANNAPOLIS,MD,5436,6021,585,0.5255302435192458
21412,ANNAPOLIS,MD,6178,0,-6178,0
21501,CUMBERLAND,MD,176,70,-106,0.2845528455284553
21502,CUMBERLAND,MD,13991,11914,-2077,0.45991121405134144
21502,LAVALE,MD,1111,852,-259,0.43402954661232807
21520,ACCIDENT,MD,440,360,-80,0.45
21521,BARTON,MD,186,71,-115,0.27626459143968873
21523,BLOOMINGTON,MD,0,15,15,1
21529,ELLERSLIE,MD,70,0,-70,0
21530,FLINTSTONE,MD,131,169,38,0.5633333333333334
21531,FRIENDSVILLE,MD,509,440,-69,0.4636459430979979
21532,FROSTBURG,MD,4396,4107,-289,0.48300599788310006
21536,GRANTSVILLE,MD,1101,1070,-31,0.49286043298019344
21539,LONACONING,MD,703,516,-187,0.42329778506972926
21541,MC HENRY,MD,816,808,-8,0.4975369458128079
21541,MCHENRY,MD,28,14,-14,0.3333333333333333
21545,MOUNT SAVAGE,MD,178,186,8,0.510989010989011
21550,OAKLAND,MD,4682,4548,-134,0.49274106175514626
21555,OLDTOWN,MD,110,176,66,0.6153846153846154
21557,RAWLINGS,MD,147,182,35,0.5531914893617021
21561,SWANTON,MD,931,971,40,0.5105152471083071
21562,WESTERNPORT,MD,1030,827,-203,0.4453419493807216
21601,EASTON,MD,8844,9362,518,0.5142260793145117
21607,BARCLAY,MD,27,22,-5,0.4489795918367347
21610,BETTERTON,MD,13,13,0,0.5
21612,BOZMAN,MD,0,35,35,1
21613,CAMBRIDGE,MD,8732,8096,-636,0.4811029236985976
21617,CENTREVILLE,MD,2984,3447,463,0.535997512051003
21619,CHESTER,MD,3177,3545,368,0.5273728057125855
21620,CHESTERTOWN,MD,4435,4894,459,0.5246007074713259
21622,CHURCH CREEK,MD,11,0,-11,0
21623,CHURCH HILL,MD,631,629,-2,0.4992063492063492
21625,CORDOVA,MD,276,412,136,0.5988372093023255
21628,CRUMPTON,MD,15,11,-4,0.4230769230769231
21629,DENTON,MD,3434,3331,-103,0.4923872875092387
21631,E NEW MARKET,MD,33,12,-21,0.26666666666666666
21631,EAST NEW MARKET,MD,691,718,27,0.5095812633073101
21632,FEDERALSBURG,MD,2351,1906,-445,0.44773314540756404
21635,GALENA,MD,463,543,80,0.5397614314115308
21636,GOLDSBORO,MD,129,107,-22,0.4533898305084746
21638,GRASONVILLE,MD,2051,1992,-59,0.4927034380410586
21639,GREENSBORO,MD,1491,1462,-29,0.49508973924822214
21640,HENDERSON,MD,274,191,-83,0.410752688172043
21643,HURLOCK,MD,1760,1935,175,0.523680649526387
21644,INGLESIDE,MD,14,0,-14,0
21645,KENNEDYVILLE,MD,164,153,-11,0.48264984227129337
21649,MARYDEL,MD,288,315,27,0.5223880597014925
21651,MILLINGTON,MD,518,544,26,0.512241054613936
21654,OXFORD,MD,399,464,65,0.5376593279258401
21655,PRESTON,MD,1157,1242,85,0.5177157148812005
21657,QUEEN ANNE,MD,106,53,-53,0.3333333333333333
21658,QUEENSTOWN,MD,1295,1506,211,0.5376651196001428
21659,RHODESDALE,MD,25,33,8,0.5689655172413793
21660,RIDGELY,MD,1230,1330,100,0.51953125
21661,ROCK HALL,MD,1098,1127,29,0.5065168539325843
21662,ROYAL OAK,MD,58,123,65,0.6795580110497238
21663,SAINT MICHAELS,MD,1260,1349,89,0.5170563434266002
21663,ST MICHAELS,MD,240,252,12,0.5121951219512195
21664,SECRETARY,MD,23,0,-23,0
21666,STEVENSVILLE,MD,4534,5079,545,0.5283470300634557
21668,SUDLERSVILLE,MD,132,146,14,0.5251798561151079
21671,TILGHMAN,MD,72,153,81,0.68
21673,TRAPPE,MD,904,1082,178,0.5448136958710977
21677,WOOLFORD,MD,17,13,-4,0.43333333333333335
21678,WORTON,MD,524,665,141,0.5592935239697224
21701,FREDERICK,MD,17545,18192,647,0.509052242773596
21702,FORT DETRICK,MD,394,380,-14,0.4909560723514212
21702,FREDERICK,MD,17932,18243,311,0.5042985487214927
21703,FREDERICK,MD,17141,17974,833,0.5118610280506906
21704,FREDERICK,MD,4486,7076,2590,0.6120048434526898
21704,URBANA,MD,984,1524,540,0.6076555023923444
21705,FREDERICK,MD,821,1250,429,0.6035731530661517
21710,ADAMSTOWN,MD,879,1065,186,0.5478395061728395
21711,BIG POOL,MD,13,50,37,0.7936507936507936
21713,BOONSBORO,MD,2528,2669,141,0.5135655185684048
21714,BRADDOCK HTS,MD,11,0,-11,0
21716,BRUNSWICK,MD,2520,3046,526,0.5472511678045275
21717,BUCKEYSTOWN,MD,23,76,53,0.7676767676767676
21719,CASCADE,MD,239,371,132,0.6081967213114754
21722,CLEAR SPRING,MD,1265,1370,105,0.5199240986717267
21723,COOKSVILLE,MD,22,49,27,0.6901408450704225
21727,EMMITSBURG,MD,1532,1363,-169,0.4708117443868739
21733,FAIRPLAY,MD,37,62,25,0.6262626262626263
21734,FUNKSTOWN,MD,515,188,-327,0.267425320056899
21737,GLENELG,MD,121,247,126,0.6711956521739131
21738,GLENWOOD,MD,721,819,98,0.5318181818181819
21740,HAGERSTOWN,MD,28081,26390,-1691,0.48447797910814927
21741,HAGERSTOWN,MD,945,940,-5,0.4986737400530504
21742,HAGERSTOWN,MD,14025,13647,-378,0.4931699913269731
21750,HANCOCK,MD,1251,1205,-46,0.49063517915309446
21754,IJAMSVILLE,MD,1528,2058,530,0.5738984941438929
21755,JEFFERSON,MD,1370,1675,305,0.5500821018062397
21756,KEEDYSVILLE,MD,894,826,-68,0.48023255813953486
21757,KEYMAR,MD,569,578,9,0.5039232781168265
21757,MIDDLEBURG,MD,0,11,11,1
21758,BRUNSWICK,MD,18,17,-1,0.4857142857142857
21758,KNOXVILLE,MD,1110,1165,55,0.512087912087912
21762,LIBERTYTOWN,MD,12,0,-12,0
21765,LISBON,MD,13,0,-13,0
21767,MAUGANSVILLE,MD,616,405,-211,0.3966699314397649
21769,MIDDLETOWN,MD,3105,3456,351,0.5267489711934157
21770,MONROVIA,MD,1484,2843,1359,0.6570372082274093
21771,MOUNT AIRY,MD,6682,7688,1006,0.5350034794711204
21773,MYERSVILLE,MD,1276,1300,24,0.5046583850931677
21774,NEW MARKET,MD,4082,6545,2463,0.6158840688811518
21776,NEW WINDSOR,MD,1350,1635,285,0.5477386934673367
21777,POINT OF ROCKS,MD,201,325,124,0.6178707224334601
21777,PT OF ROCKS,MD,20,16,-4,0.4444444444444444
21778,ROCKY RIDGE,MD,29,42,13,0.5915492957746479
21779,ROHRERSVILLE,MD,27,0,-27,0
21780,SABILLASVILLE,MD,174,171,-3,0.4956521739130435
21782,SHARPSBURG,MD,1313,1086,-227,0.45268862025844103
21783,SMITHSBURG,MD,1962,2210,248,0.5297219558964525
21784,ELDERSBURG,MD,1775,2028,253,0.5332632132526952
21784,SYKESVILLE,MD,7032,7820,788,0.526528413681659
21787,TANEYTOWN,MD,3378,3950,572,0.539028384279476
21788,THURMONT,MD,3125,3247,122,0.5095731324544884
21791,UNION BRIDGE,MD,1361,1298,-63,0.48815344114328696
21793,WALKERSVILLE,MD,2743,3042,299,0.5258426966292135
21794,W FRIENDSHIP,MD,12,41,29,0.7735849056603774
21794,WEST FRIENDSHIP,MD,304,521,217,0.6315151515151515
21795,WILLIAMSPORT,MD,3506,3407,-99,0.4928395776074063
21797,WOODBINE,MD,2029,2337,308,0.5352725606962895
21798,WOODSBORO,MD,499,623,124,0.5552584670231729
21801,SALISBURY,MD,11682,10284,-1398,0.46817809341709915
21802,SALISBURY,MD,873,1558,685,0.6408885232414644
21803,SALISBURY,MD,60,32,-28,0.34782608695652173
21804,SALISBURY,MD,19873,16054,-3819,0.44685055807609875
21811,BERLIN,MD,9737,10730,993,0.5242585625641276
21811,OCEAN PINES,MD,170,187,17,0.5238095238095238
21813,BISHOPVILLE,MD,701,891,190,0.5596733668341709
21817,CRISFIELD,MD,1887,1859,-28,0.49626268019220504
21821,CHANCE,MD,0,24,24,1
21821,DAMES QUARTER,MD,11,12,1,0.5217391304347826
21821,DEAL ISLAND,MD,27,37,10,0.578125
21822,EDEN,MD,754,806,52,0.5166666666666667
21826,FRUITLAND,MD,3082,2262,-820,0.42327844311377244
21829,GIRDLETREE,MD,11,12,1,0.5217391304347826
21830,HEBRON,MD,1185,1177,-8,0.4983065198983912
21835,LINKWOOD,MD,36,0,-36,0
21837,MARDELA SPGS,MD,25,11,-14,0.3055555555555556
21837,MARDELA SPRINGS,MD,594,678,84,0.53301886792452835
21838,MARION,MD,13,25,12,0.6578947368421053
21838,MARION STATION,MD,243,234,-9,0.49056603773584906
21840,NANTICOKE,MD,15,0,-15,0
21841,NEWARK,MD,14,56,42,0.8
21842,OCEAN CITY,MD,8584,8704,120,0.5034706154558075
21843,OCEAN CITY,MD,888,1064,176,0.5450819672131147
21849,PARSONSBURG,MD,902,871,-31,0.4912577552171461
21850,PITTSVILLE,MD,926,939,13,0.503485254691689
21851,POCOMOKE CITY,MD,2667,2557,-110,0.48947166921898927
21853,PRINCESS ANNE,MD,3715,3812,97,0.5064434701740401
21856,QUANTICO,MD,59,37,-22,0.3854166666666667
21861,SHARPTOWN,MD,41,34,-7,0.4533333333333333
21863,SNOW HILL,MD,1666,1449,-217,0.4651685393258427
21864,STOCKTON,MD,14,0,-14,0
21869,VIENNA,MD,69,38,-31,0.35514018691588783
21871,WESTOVER,MD,277,443,166,0.6152777777777778
21872,WHALEYVILLE,MD,46,59,13,0.5619047619047619
21874,WILLARDS,MD,584,587,3,0.5012809564474808
21875,DELMAR,MD,2715,2562,-153,0.4855031267765776
21901,NORTH EAST,MD,7356,7426,70,0.5023677445541875
21902,PERRY POINT,MD,90,52,-38,0.36619718309859156
21903,PERRYVILLE,MD,2203,2198,-5,0.499431947284708
21904,PORT DEPOSIT,MD,2093,2038,-55,0.4933430162188332
21911,RISING SUN,MD,2721,2735,14,0.5012829912023461
21912,WARWICK,MD,34,11,-23,0.24444444444444444
21913,CECILTON,MD,138,118,-20,0.4609375
21914,CHARLESTOWN,MD,68,22,-46,0.24444444444444444
21915,CHESAPEAKE CITY,MD,1034,1100,66,0.5154639175257731
21917,COLORA,MD,272,368,96,0.575
21918,CONOWINGO,MD,970,1007,37,0.5093576125442589
21919,EARLEVILLE,MD,856,1134,278,0.5698492462311557
21921,ELKTON,MD,17465,14981,-2484,0.461721013376071
21922,ELKTON,MD,680,664,-16,0.49404761904761907
22003,ANNANDALE,VA,20733,19280,-1453,0.48184340089470923
22009,BURKE,VA,103,91,-12,0.4690721649484536
22015,BURKE,VA,11805,12088,283,0.505922236638346
22015,SPRINGFIELD,VA,176,224,48,0.56
22025,DUMFRIES,VA,5537,5769,232,0.510260038917389
22025,MONTCLAIR,VA,617,627,10,0.5040192926045016
22026,DUMFRIES,VA,8446,9577,1131,0.5313765743771847
22027,DUNN LORING,VA,729,733,4,0.5013679890560876
22030,FAIRFAX,VA,28100,25431,-2669,0.4750705198856737
22031,FAIRFAX,VA,23777,21232,-2545,0.47172787664689286
22032,FAIRFAX,VA,8160,8541,381,0.5114065026046345
22033,FAIRFAX,VA,20324,19141,-1183,0.4850120359812492
22038,FAIRFAX,VA,227,508,281,0.691156462585034
22039,FAIRFAX STA,VA,234,316,82,0.5745454545454546
22039,FAIRFAX STATION,VA,3710,4659,949,0.5566973354044689
22040,FALLS CHURCH,VA,148,187,39,0.5582089552238806
22041,BAILEYS CROSSROADS,VA,227,219,-8,0.4910313901345291
22041,FALLS CHURCH,VA,12807,10890,-1917,0.4595518420053171
22042,FALLS CHURCH,VA,15436,13431,-2005,0.4652717636055011
22043,FALLS CHURCH,VA,11953,10369,-1584,0.46451930830570737
22044,FALLS CHURCH,VA,6554,5636,-918,0.4623461853978671
22044,SEVEN CORNERS,VA,124,87,-37,0.41232227488151657
22046,FALLS CHURCH,VA,8057,7801,-256,0.49192836423256403
22060,FORT BELVOIR,VA,6532,6072,-460,0.48175182481751827
22066,GREAT FALLS,VA,5131,6240,1109,0.5487644006683668
22079,LORTON,VA,14145,12929,-1216,0.477543030213489
22101,CULPEPER,VA,144,162,18,0.5294117647058824
22101,MC LEAN,VA,8247,9241,994,0.5284194876486734
22101,MCLEAN,VA,2133,2434,301,0.5329537989927743
22102,MC LEAN,VA,18430,17304,-1126,0.48424469692729616
22102,MCLEAN,VA,4408,4171,-237,0.48618720130551346
22103,WEST MCLEAN,VA,0,18,18,1
22116,MERRIFIELD,VA,793,1152,359,0.5922879177377892
22122,NEWINGTON,VA,14,11,-3,0.44
22124,OAKTON,VA,5334,6019,685,0.5301682374702722
22125,OCCOQUAN,VA,880,582,-298,0.39808481532147744
22134,QUANTICO,VA,4480,2722,-1758,0.3779505692863094
22150,SPRINGFIELD,VA,10535,10065,-470,0.4885922330097087
22151,N SPRINGFIELD,VA,78,93,15,0.543859649122807
22151,SPRINGFIELD,VA,5460,4994,-466,0.4777118806198584
22152,SPRINGFIELD,VA,8918,8697,-221,0.49372693726937267
22152,W SPRINGFIELD,VA,171,206,35,0.5464190981432361
22152,WEST SPRINGFIELD,VA,260,248,-12,0.4881889763779528
22153,SPRINGFIELD,VA,9034,9223,189,0.5051760968395684
22172,TRIANGLE,VA,6957,5003,-1954,0.41831103678929765
22180,VIENNA,VA,12664,10958,-1706,0.46388959444585554
22181,VIENNA,VA,5091,5041,-50,0.4975325700750099
22182,TYSONS,VA,511,442,-69,0.46379853095487933
22182,TYSONS CORNER,VA,211,271,60,0.5622406639004149
22182,VIENNA,VA,11257,11354,97,0.5021449736853744
22183,VIENNA,VA,127,157,30,0.5528169014084507
22191,WOODBRIDGE,VA,37621,32964,-4657,0.46701140468938157
22192,LAKE RIDGE,VA,1322,1073,-249,0.4480167014613779
22192,WOODBRIDGE,VA,21544,20472,-1072,0.48724295506473725
22193,DALE CITY,VA,2333,2205,-128,0.48589687086822386
22193,WOODBRIDGE,VA,23164,22037,-1127,0.48753346164907857
22194,WOODBRIDGE,VA,418,684,266,0.6206896551724138
22195,WOODBRIDGE,VA,1182,1825,643,0.6069171932158297
22199,LORTON,VA,996,510,-486,0.3386454183266932
22201,ARLINGTON,VA,39541,29276,-10265,0.4254181379600971
22202,ARLINGTON,VA,31459,27680,-3779,0.4680498486616277
22203,ARLINGTON,VA,23056,18954,-4102,0.45117829088312306
22204,ARLINGTON,VA,31067,26377,-4690,0.4591776338695077
22205,ARLINGTON,VA,5903,5702,-201,0.4913399396811719
22206,ARLINGTON,VA,17654,15291,-2363,0.46413719836090456
22207,ARLINGTON,VA,10962,10739,-223,0.4948619879268236
22209,ARLINGTON,VA,15147,11907,-3240,0.44011976047904194
22209,ROSSLYN,VA,1444,1131,-313,0.4392233009708738
22210,ARLINGTON,VA,96,162,66,0.627906976744186
22211,FORT MYER,VA,118,13,-105,0.09923664122137404
22211,FT MYER,VA,11,0,-11,0
22213,ARLINGTON,VA,1830,1681,-149,0.47878097408145825
22216,ARLINGTON,VA,12,76,64,0.8636363636363636
22219,ARLINGTON,VA,11,28,17,0.717948717948718
22301,ALEXANDRIA,VA,8995,8232,-763,0.47785453067858596
22302,ALEXANDRIA,VA,11810,11416,-394,0.4915181262378369
22303,ALEXANDRIA,VA,12588,10990,-1598,0.46611247773348036
22304,ALEXANDRIA,VA,38122,32063,-6059,0.4568355061622854
22305,ALEXANDRIA,VA,10183,8290,-1893,0.448763059600498
22306,ALEXANDRIA,VA,15084,13160,-1924,0.465939668602181
22307,ALEXANDRIA,VA,4245,4234,-11,0.49935133860125014
22307,BELLEVIEW,VA,159,175,16,0.5239520958083832
22308,ALEXANDRIA,VA,3099,3806,707,0.5511947863866763
22308,FORT HUNT,VA,52,52,0,0.5
22309,ALEXANDRIA,VA,13040,11855,-1185,0.4762000401687086
22310,ALEXANDRIA,VA,11903,11272,-631,0.48638619201725997
22311,ALEXANDRIA,VA,16936,13530,-3406,0.4441016214796823
22312,ALEXANDRIA,VA,17251,14814,-2437,0.4619990644004366
22313,ALEXANDRIA,VA,605,1117,512,0.648664343786295
22314,ALEXANDRIA,VA,33300,32702,-598,0.49546983424744706
22315,ALEXANDRIA,VA,11489,11497,8,0.5001740189680676
22315,KINGSTOWNE,VA,1122,1218,96,0.5205128205128206
22320,ALEXANDRIA,VA,68,23,-45,0.25274725274725274
22401,FREDERICKSBRG,VA,934,922,-12,0.49676724137931033
22401,FREDERICKSBURG,VA,15460,14135,-1325,0.47761446190234835
22402,FREDERICKSBRG,VA,0,16,16,1
22402,FREDERICKSBURG,VA,342,605,263,0.6388595564941922
22403,FREDERICKSBRG,VA,0,15,15,1
22403,FREDERICKSBURG,VA,1022,513,-509,0.33420195439739414
22404,FREDERICKSBRG,VA,86,134,48,0.6090909090909091
22404,FREDERICKSBURG,VA,1082,1200,118,0.5258545135845749
22405,FALMOUTH,VA,233,299,66,0.5620300751879699
22405,FREDERICKSBRG,VA,1326,1425,99,0.5179934569247546
22405,FREDERICKSBURG,VA,8892,10303,1411,0.5367543631153946
22406,FALMOUTH,VA,228,244,16,0.5169491525423728
22406,FREDERICKSBRG,VA,626,649,23,0.5090196078431373
22406,FREDERICKSBURG,VA,9148,10121,973,0.5252478073589704
22407,FREDERICKSBRG,VA,472,515,43,0.5217831813576495
22407,FREDERICKSBURG,VA,21440,23246,1806,0.5202076713064494
22408,FREDERICKSBRG,VA,2379,2579,200,0.5201694231544978
22408,FREDERICKSBURG,VA,9585,10178,593,0.5150027829782927
22427,BOWLING GREEN,VA,1013,1242,229,0.5507760532150776
22427,FORT A P HILL,VA,54,56,2,0.509090909090909
22432,BURGESS,VA,15,43,28,0.7413793103448276
22435,CALLAO,VA,515,542,27,0.5127719962157048
22436,CARET,VA,12,11,-1,0.4782608695652174
22437,CENTER CROSS,VA,21,12,-9,0.36363636363636365
22443,COLONIAL BCH,VA,80,89,9,0.5266272189349113
22443,COLONIAL BEACH,VA,3990,4046,56,0.5034843205574913
22448,DAHLGREN,VA,720,506,-214,0.41272430668841764
22454,DUNNSVILLE,VA,347,414,67,0.5440210249671484
22460,FARNHAM,VA,196,295,99,0.6008146639511202
22463,GARRISONVILLE,VA,169,222,53,0.5677749360613811
22469,HAGUE,VA,395,415,20,0.5123456790123457
22471,HARTWOOD,VA,13,0,-13,0
22473,HEATHSVILLE,VA,1486,1916,430,0.5631981187536743
22480,IRVINGTON,VA,359,564,205,0.6110509209100758
22482,KILMARNOCK,VA,1605,1467,-138,0.4775390625
22485,KING GEORGE,VA,7433,8779,1346,0.5415124599062423
22488,KINSALE,VA,105,112,7,0.5161290322580645
22501,LADYSMITH,VA,15,13,-2,0.4642857142857143
22503,LANCASTER,VA,1200,1323,123,0.5243757431629013
22508,LOCUST GROVE,VA,5505,6308,803,0.5339879793447896
22511,LOTTSBURG,VA,156,226,70,0.5916230366492147
22514,MILFORD,VA,402,646,244,0.6164122137404581
22520,MONTROSS,VA,1606,1917,311,0.54413851830826
22534,PARTLOW,VA,673,913,240,0.5756620428751577
22535,PORT ROYAL,VA,34,36,2,0.5142857142857142
22539,REEDVILLE,VA,750,987,237,0.5682210708117443
22542,RHOADESVILLE,VA,468,562,94,0.545631067961165
22546,RUTHER GLEN,VA,5628,6141,513,0.5217945449910782
22551,SPOTSYLVANIA,VA,5410,7173,1763,0.5700548358896924
22553,SPOTSYLVANIA,VA,6297,6721,424,0.5162851436472576
22554,STAFFORD,VA,25739,26462,723,0.5069251546905231
22555,STAFFORD,VA,896,893,-3,0.4991615427613192
22556,STAFFORD,VA,9465,9679,214,0.5055892185541162
22560,TAPPAHANNOCK,VA,1970,2063,93,0.5115298785023555
22565,THORNBURG,VA,238,171,-67,0.4180929095354523
22567,UNIONVILLE,VA,888,957,69,0.5186991869918699
22572,WARSAW,VA,1558,1759,201,0.5302984624660838
22576,WEEMS,VA,226,443,217,0.6621823617339312
22578,WHITE STONE,VA,883,1006,123,0.532556908417152
22580,WOODFORD,VA,1355,1494,139,0.5243945243945244
22601,WINCHESTER,VA,15695,13674,-2021,0.465592972181552
22602,WINCHESTER,VA,10119,10935,816,0.5193787403818751
22603,WINCHESTER,VA,4749,4837,88,0.5045900271228876
22604,WINCHESTER,VA,2393,1570,-823,0.3961645218268988
22610,BENTONVILLE,VA,437,444,7,0.5039727582292849
22610,BROWNTOWN,VA,16,12,-4,0.42857142857142855
22611,BERRYVILLE,VA,2960,3357,397,0.5314231438974196
22620,BOYCE,VA,788,879,91,0.5272945410917816
22623,CHESTER GAP,VA,13,0,-13,0
22624,CLEAR BROOK,VA,613,727,114,0.5425373134328358
22625,CROSS JCT,VA,124,120,-4,0.4918032786885246
22625,CROSS JUNCTION,VA,1181,1375,194,0.5379499217527387
22627,FLINT HILL,VA,252,162,-90,0.391304347826087
22630,FRONT ROYAL,VA,12622,13759,1137,0.5215496000909746
22630,LAKE FREDERICK,VA,282,306,24,0.5204081632653061
22637,GORE,VA,463,617,154,0.5712962962962963
22639,HUME,VA,11,12,1,0.5217391304347826
22640,HUNTLY,VA,0,14,14,1
22642,LINDEN,VA,1501,1715,214,0.533271144278607
22644,MAURERTOWN,VA,533,718,185,0.5739408473221422
22645,MIDDLETOWN,VA,1248,1578,330,0.5583864118895966
22646,MILLWOOD,VA,12,13,1,0.52
22650,RILEYVILLE,VA,22,15,-7,0.40540540540540543
22652,FORT VALLEY,VA,163,280,117,0.6320541760722348
22654,STAR TANNERY,VA,0,12,12,1
22655,STEPHENS CITY,VA,7605,7945,340,0.5109324758842444
22656,STEPHENSON,VA,1799,2518,719,0.5832754227472782
22657,STRASBURG,VA,4333,4512,179,0.5101187111362352
22660,TOMS BROOK,VA,481,350,-131,0.42117930204572807
22663,WHITE POST,VA,400,562,162,0.5841995841995842
22664,WOODSTOCK,VA,3770,3906,136,0.5088587806149036
22701,CULPEPER,VA,13009,13013,4,0.5000768580431942
22709,ARODA,VA,11,0,-11,0
22712,BEALETON,VA,3693,3709,16,0.5010807889759524
22713,BOSTON,VA,80,147,67,0.6475770925110133
22714,BRANDY STATION,VA,125,112,-13,0.47257383966244726
22715,BRIGHTWOOD,VA,52,74,22,0.5873015873015873
22716,CASTLETON,VA,11,98,87,0.8990825688073395
22718,ELKWOOD,VA,11,11,0,0.5
22720,GOLDVEIN,VA,11,58,47,0.8405797101449275
22724,JEFFERSONTON,VA,418,631,213,0.6015252621544328
22726,LIGNUM,VA,46,28,-18,0.3783783783783784
22727,MADISON,VA,1552,1669,117,0.5181620614715927
22728,MIDLAND,VA,786,924,138,0.5403508771929825
22733,RAPIDAN,VA,67,144,77,0.6824644549763034
22734,REMINGTON,VA,1155,1177,22,0.5047169811320755
22735,REVA,VA,155,306,151,0.6637744034707158
22736,RICHARDSVILLE,VA,11,11,0,0.5
22737,RIXEYVILLE,VA,721,975,254,0.5748820754716981
22738,ROCHELLE,VA,60,73,13,0.5488721804511278
22740,SPERRYVILLE,VA,293,293,0,0.5
22742,SUMERDUCK,VA,324,311,-13,0.48976377952755906
22747,WASHINGTON,VA,251,176,-75,0.41217798594847777
22801,HARRISONBURG,VA,15421,13517,-1904,0.46710208030962747
22801,ROCKINGHAM,VA,1650,1331,-319,0.44649446494464945
22802,HARRISONBURG,VA,9450,8242,-1208,0.465860275830884
22802,ROCKINGHAM,VA,964,849,-115,0.468284611141754
22803,HARRISONBURG,VA,685,716,31,0.5110635260528195
22810,BASYE,VA,409,420,11,0.5066344993968637
22812,BRIDGEWATER,VA,2330,2308,-22,0.4976282880551962
22815,BROADWAY,VA,2645,2730,85,0.5079069767441861
22821,DAYTON,VA,1358,1352,-6,0.4988929889298893
22824,EDINBURG,VA,2156,2209,53,0.5060710194730813
22827,ELKTON,VA,3077,3086,9,0.5007301638812267
22830,FULKS RUN,VA,133,183,50,0.5791139240506329
22834,LINVILLE,VA,11,61,50,0.8472222222222222
22835,LURAY,VA,4229,4252,23,0.5013559721730928
22840,MASSANUTTEN,VA,89,110,21,0.5527638190954773
22840,MC GAHEYSVILLE,VA,1378,1329,-49,0.49094939046915403
22840,MCGAHEYSVILLE,VA,62,89,27,0.5894039735099338
22841,MOUNT CRAWFORD,VA,398,438,40,0.5239234449760766
22841,MT CRAWFORD,VA,45,67,22,0.5982142857142857
22842,MOUNT JACKSON,VA,1759,1911,152,0.520708446866485
22843,MOUNT SOLON,VA,351,314,-37,0.47218045112781953
22844,NEW MARKET,VA,1722,1713,-9,0.49868995633187774
22846,PENN LAIRD,VA,346,459,113,0.5701863354037268
22847,QUICKSBURG,VA,0,25,25,1
22847,SHENDOAH CVRN,VA,0,11,11,1
22849,SHENANDOAH,VA,1589,1524,-65,0.4895599100546097
22850,SINGERS GLEN,VA,11,23,12,0.6764705882352942
22851,STANLEY,VA,2011,1959,-52,0.49345088161209066
22853,TIMBERVILLE,VA,1596,1444,-152,0.475
22901,CHARLOTTESVILLE,VA,18570,16945,-1625,0.4771223426721104
22902,CHARLOTTESVILLE,VA,13495,11871,-1624,0.4679886462193487
22903,CHARLOTTESVILLE,VA,24205,17239,-6966,0.4159588842775794
22904,CHARLOTTESVILLE,VA,11,0,-11,0
22905,CHARLOTTESVILLE,VA,105,208,103,0.6645367412140575
22905,CHARLOTTESVLE,VA,0,12,12,1
22906,CHARLOTTESVILLE,VA,760,893,133,0.5402298850574713
22906,CHARLOTTESVLE,VA,21,16,-5,0.43243243243243246
22911,CHARLOTTESVILLE,VA,7823,8802,979,0.5294436090225564
22911,CHARLOTTESVLE,VA,136,163,27,0.5451505016722408
22920,AFTON,VA,989,1099,110,0.5263409961685823
22922,ARRINGTON,VA,249,275,26,0.5248091603053435
22923,BARBOURSVILLE,VA,1927,2101,174,0.5215988083416088
22932,CROZET,VA,3461,4538,1077,0.5673209151143893
22935,DYKE,VA,55,24,-31,0.3037974683544304
22936,EARLYSVILLE,VA,1414,1861,447,0.5682442748091603
22937,ESMONT,VA,64,114,50,0.6404494382022472
22938,FABER,VA,172,187,15,0.520891364902507
22939,FISHERSVILLE,VA,2548,2946,398,0.5362213323625774
22940,FREE UNION,VA,137,120,-17,0.4669260700389105
22942,GORDONSVILLE,VA,1669,1992,323,0.5441136301556951
22942,ZION CROSSROADS,VA,1289,1539,250,0.5442008486562943
22943,GREENWOOD,VA,25,11,-14,0.3055555555555556
22947,KESWICK,VA,1671,2258,587,0.5747009417154493
22949,LOVINGSTON,VA,272,425,153,0.6097560975609756
22952,LYNCHBURG,VA,14,16,2,0.5333333333333333
22952,LYNDHURST,VA,790,562,-228,0.4156804733727811
22958,NELLYSFORD,VA,782,926,144,0.5421545667447307
22959,NORTH GARDEN,VA,214,424,210,0.664576802507837
22960,ORANGE,VA,3990,3836,-154,0.49016100178890876
22963,PALMYRA,VA,5374,5973,599,0.5263946417555301
22967,LOWESVILLE,VA,16,19,3,0.5428571428571428
22967,MASSIES MILL,VA,0,17,17,1
22967,ROSELAND,VA,594,707,113,0.5434281322059954
22967,WINTERGREEN RESORT,VA,14,12,-2,0.46153846153846156
22968,RUCKERSVILLE,VA,3259,3726,467,0.5334287759484609
22969,SCHUYLER,VA,220,184,-36,0.45544554455445546
22971,SHIPMAN,VA,209,269,60,0.5627615062761506
22973,STANARDSVILLE,VA,2139,1916,-223,0.4725030826140567
22974,TROY,VA,1005,1341,336,0.571611253196931
22980,WAYNESBORO,VA,14772,13654,-1118,0.48033490466474354
23002,AMELIA COURT HOUSE,VA,2710,3007,297,0.5259751617981459
23002,AMELIA CT HSE,VA,49,56,7,0.5333333333333333
23003,ARK,VA,15,0,-15,0
23004,ARVONIA,VA,12,12,0,0.5
23005,ASHBURN,VA,125,121,-4,0.491869918699187
23005,ASHLAND,VA,5598,6019,421,0.5181199965567702
23009,AYLETT,VA,1968,2508,540,0.5603217158176944
23011,BARHAMSVILLE,VA,55,94,39,0.6308724832214765
23015,BEAVERDAM,VA,937,1247,310,0.5709706959706959
23018,BENA,VA,11,0,-11,0
23022,BREMO BLUFF,VA,23,11,-12,0.3235294117647059
23024,BUMPASS,VA,2406,3055,649,0.5594213514008424
23027,CARTERSVILLE,VA,170,194,24,0.532967032967033
23030,CHARLES CITY,VA,1035,1121,86,0.5199443413729128
23030,ROANOKE,VA,25,24,-1,0.4897959183673469
23035,COBBS CREEK,VA,132,310,178,0.7013574660633484
23038,COLUMBIA,VA,189,372,183,0.6631016042780749
23039,CROZIER,VA,14,81,67,0.8526315789473684
23040,CUMBERLAND,VA,1332,1448,116,0.520863309352518
23043,DELTAVILLE,VA,685,858,173,0.5560596241088788
23047,DOSWELL,VA,245,445,200,0.644927536231884
23050,DUTTON,VA,0,23,23,1
23055,FORK UNION,VA,73,34,-39,0.3177570093457944
23058,GLEN ALLEN,VA,738,1097,359,0.5978201634877384
23059,GLEN ALLEN,VA,13255,15947,2692,0.5460927333744264
23060,GLEN ALLEN,VA,13555,13976,421,0.5076459264102284
23061,GLOUCESTER,VA,6178,7164,986,0.5369509818617898
23062,GLOU POINT,VA,40,25,-15,0.38461538461538464
23062,GLOUCESTER POINT,VA,1160,1076,-84,0.481216457960644
23062,GLOUCESTER PT,VA,19,24,5,0.5581395348837209
23063,GOOCHLAND,VA,1296,1572,276,0.5481171548117155
23065,GUM SPRING,VA,171,267,96,0.6095890410958904
23069,HANOVER,VA,637,926,289,0.5924504158669226
23071,HARTFIELD,VA,397,566,169,0.5877466251298027
23072,HAYES,VA,4554,4198,-356,0.4796617915904936
23075,HENRICO,VA,3396,3322,-74,0.4944924084548973
23075,HIGHLAND SPGS,VA,108,106,-2,0.4953271028037383
23075,HIGHLAND SPRINGS,VA,595,634,39,0.51586655817738
23076,HUDGINS,VA,41,68,27,0.6238532110091743
23083,JETERSVILLE,VA,374,393,19,0.5123859191655802
23084,KENTS STORE,VA,185,429,244,0.6986970684039088
23086,KING WILLIAM,VA,565,742,177,0.5677123182861515
23089,LANEXA,VA,1503,1635,132,0.5210325047801148
23090,LIGHTFOOT,VA,327,172,-155,0.34468937875751504
23092,LOCUST HILL,VA,12,24,12,0.6666666666666666
23093,LOUISA,VA,4144,4848,704,0.5391459074733096
23102,MAIDENS,VA,440,812,372,0.6485623003194888
23103,MANAKIN SABOT,VA,1343,2258,915,0.627048042210497
23106,MANQUIN,VA,47,83,36,0.6384615384615384
23109,BEAVERLETT,VA,15,14,-1,0.4827586206896552
23109,MATHEWS,VA,418,587,169,0.5840796019900497
23110,MATTAPONI,VA,12,13,1,0.52
23111,MECHANICSVILLE,VA,11060,11970,910,0.5197568389057751
23112,MIDLOTHIAN,VA,19381,21814,2433,0.5295302828013109
23113,MIDLOTHIAN,VA,9092,10520,1428,0.5364062818682439
23114,MIDLOTHIAN,VA,7332,8340,1008,0.5321592649310873
23116,MECHANICSVILLE,VA,7722,9935,2213,0.5626663646146004
23117,MINERAL,VA,3311,4084,773,0.552265043948614
23120,MOSELEY,VA,3327,5955,2628,0.6415643180349063
23123,NEW CANTON,VA,271,309,38,0.5327586206896552
23124,NEW KENT,VA,1113,2022,909,0.6449760765550239
23126,NEWTOWN,VA,0,12,12,1
23128,NORTH,VA,55,92,37,0.6258503401360545
23129,OILVILLE,VA,0,12,12,1
23138,PORT HAYWOOD,VA,51,112,61,0.6871165644171779
23139,POWHATAN,VA,8013,8283,270,0.5082842415316642
23140,PROVDENCE FRG,VA,117,160,43,0.5776173285198556
23140,PROVIDENCE FORGE,VA,1600,2062,462,0.5630802839978154
23141,QUINTON,VA,2294,2788,494,0.5486029122392759
23146,ROCKVILLE,VA,403,699,296,0.6343012704174229
23148,SAINT STEPHENS CHURCH,VA,109,203,94,0.6506410256410257
23148,ST STEPHENS CHURCH,VA,57,39,-18,0.40625
23149,SALUDA,VA,749,797,48,0.5155239327296248
23150,SANDSTON,VA,4199,4479,280,0.5161327494814474
23153,SANDY HOOK,VA,103,178,75,0.6334519572953736
23156,SHACKLEFORDS,VA,275,241,-34,0.46705426356589147
23168,TOANO,VA,2608,3188,580,0.5500345065562456
23169,TOPPING,VA,254,281,27,0.525233644859813
23175,URBANNA,VA,428,643,215,0.6003734827264239
23176,WAKE,VA,26,36,10,0.5806451612903226
23177,WALKERTON,VA,11,0,-11,0
23181,WEST POINT,VA,1375,1490,115,0.5200698080279232
23183,WHITE MARSH,VA,14,0,-14,0
23185,WILLIAMSBURG,VA,20301,21451,1150,0.5137717953630964
23187,WILLIAMSBURG,VA,598,640,42,0.5169628432956381
23188,WILLIAMSBURG,VA,19271,21563,2292,0.5280648479208503
23192,MONTPELIER,VA,1581,1759,178,0.5266467065868263
23218,RICHMOND,VA,502,256,-246,0.33773087071240104
23219,RICHMOND,VA,6737,5363,-1374,0.44322314049586775
23220,RICHMOND,VA,23455,18318,-5137,0.43851291504081585
23221,RICHMOND,VA,9638,8516,-1122,0.4690977195108516
23222,RICHMOND,VA,11497,10927,-570,0.4872904031394934
23223,RICHMOND,VA,27765,25388,-2377,0.4776400203187026
23224,HENRICO,VA,488,478,-10,0.494824016563147
23224,NORTH CHESTERFIELD,VA,2773,2408,-365,0.4647751399343756
23224,RICHMOND,VA,18619,16855,-1764,0.4751367198511586
23225,NORTH CHESTERFIELD,VA,2438,2185,-253,0.472636815920398
23225,RICHMOND,VA,21772,19008,-2764,0.4661108386463953
23226,RICHMOND,VA,7339,7409,70,0.5023732031461893
23227,RICHMOND,VA,11798,11745,-53,0.49887440003398037
23228,HENRICO,VA,14369,12735,-1634,0.46985684769775676
23228,RICHMOND,VA,4100,3811,-289,0.48173429402098344
23229,HENRICO,VA,9746,9353,-393,0.4897115032200639
23229,RICHMOND,VA,1241,1148,-93,0.4805357890330682
23230,RICHMOND,VA,7199,7909,710,0.5234974847762774
23231,HENRICO,VA,9006,9702,696,0.518601667735728
23231,RICHMOND,VA,4381,4865,484,0.5261734804239672
23233,HENRICO,VA,11820,11928,108,0.5022738756947953
23233,RICHMOND,VA,2141,2103,-38,0.4955230914231857
23234,NORTH CHESTERFIELD,VA,11435,10576,-859,0.4804870292126664
23234,RICHMOND,VA,6255,5974,-281,0.48851091667348107
23235,NORTH CHESTERFIELD,VA,14676,13291,-1385,0.47523867415167875
23235,RICHMOND,VA,547,523,-24,0.48878504672897194
23236,NORTH CHESTERFIELD,VA,8650,9380,730,0.5202440377149196
23237,NORTH CHESTERFIELD,VA,6757,7190,433,0.5155230515523052
23237,RICHMOND,VA,877,950,73,0.5199781061850027
23238,HENRICO,VA,8901,8846,-55,0.49845044232828084
23238,RICHMOND,VA,2282,2491,209,0.5218939870102661
23241,RICHMOND,VA,21,11,-10,0.34375
23242,HENRICO,VA,59,133,74,0.6927083333333334
23255,HENRICO,VA,76,325,249,0.8104738154613467
23255,RICHMOND,VA,19,31,12,0.62
23260,RICHMOND,VA,293,529,236,0.6435523114355232
23261,RICHMOND,VA,181,149,-32,0.45151515151515154
23285,RICHMOND,VA,12,12,0,0.5
23294,HENRICO,VA,10744,9089,-1655,0.45827660969091916
23294,RICHMOND,VA,1865,1588,-277,0.4598899507674486
23301,ACCOMAC,VA,303,320,17,0.5136436597110754
23303,ATLANTIC,VA,26,39,13,0.6
23306,BELLE HAVEN,VA,84,100,16,0.5434782608695652
23307,BIRDSNEST,VA,17,13,-4,0.43333333333333335
23308,BLOXOM,VA,154,233,79,0.6020671834625323
23310,CAPE CHARLES,VA,1591,1830,239,0.5349313066354867
23314,CARROLLTON,VA,3812,4142,330,0.5207442796077445
23315,CARRSVILLE,VA,133,178,45,0.572347266881029
23316,CHERITON,VA,76,39,-37,0.3391304347826087
23320,CHESAPEAKE,VA,30067,28649,-1418,0.4879249267661285
23321,CHESAPEAKE,VA,13003,13908,905,0.5168146854446137
23322,CHEDAPEAKE,VA,306,351,45,0.5342465753424658
23322,CHESAPEAKE,VA,17092,19584,2492,0.5339731704656996
23323,CHESAPEAKE,VA,15202,16333,1131,0.5179324560012685
23324,CHESAPEAKE,VA,9789,8896,-893,0.4761038265988761
23324,SOUTH NORFOLK,VA,208,208,0,0.5
23325,CHESAPEAKE,VA,7882,7078,-804,0.4731283422459893
23327,CHESAPEAKE,VA,840,1166,326,0.5812562313060817
23328,CHESAPEAKE,VA,371,566,195,0.6040554962646745
23336,CHINCOTEAGUE,VA,21,41,20,0.6612903225806451
23336,CHINCOTEAGUE ISLAND,VA,1876,1926,50,0.5065754865860074
23347,EASTVILLE,VA,57,11,-46,0.16176470588235295
23350,EXMORE,VA,910,959,49,0.5131086142322098
23356,GREENBACKVILE,VA,116,115,-1,0.49783549783549785
23356,GREENBACKVILLE,VA,634,780,146,0.5516265912305516
23359,HALLWOOD,VA,34,11,-23,0.24444444444444444
23395,HORNTOWN,VA,141,258,117,0.6466165413533834
23405,MACHIPONGO,VA,48,48,0,0.5
23410,MELFA,VA,324,620,296,0.6567796610169492
23413,NASSAWADOX,VA,39,25,-14,0.390625
23415,NEW CHURCH,VA,488,472,-16,0.49166666666666664
23416,OAK HALL,VA,11,26,15,0.7027027027027027
23417,ONANCOCK,VA,1556,1372,-184,0.4685792349726776
23418,ONLEY,VA,218,144,-74,0.39779005524861877
23420,PAINTER,VA,425,500,75,0.5405405405405406
23421,PARKSLEY,VA,764,787,23,0.5074145712443585
23422,PUNGOTEAGUE,VA,11,0,-11,0
23423,QUINBY,VA,13,0,-13,0
23430,SMITHFIELD,VA,4787,6124,1337,0.5612684446888461
23431,SMITHFIELD,VA,17,37,20,0.6851851851851852
23432,SUFFOLK,VA,181,370,189,0.6715063520871143
23433,SUFFOLK,VA,97,246,149,0.717201166180758
23434,SUFFOLK,VA,17971,19887,1916,0.5253050874319827
23435,SUFFOLK,VA,12908,14883,1975,0.5355330862509445
23436,SUFFOLK,VA,11,59,48,0.8428571428571429
23437,SUFFOLK,VA,1173,1387,214,0.541796875
23438,SUFFOLK,VA,381,586,205,0.6059979317476732
23439,SUFFOLK,VA,429,785,356,0.6466227347611203
23442,TEMPERANCEVILLE,VA,45,25,-20,0.35714285714285715
23450,VA BCH,VA,79,110,31,0.582010582010582
23450,VA BEACH,VA,87,163,76,0.652
23450,VIRGINIA BCH,VA,13,22,9,0.6285714285714286
23450,VIRGINIA BEACH,VA,460,870,410,0.6541353383458647
23451,VA BCH,VA,1292,1340,48,0.5091185410334347
23451,VA BEACH,VA,3902,3755,-147,0.4904009403160507
23451,VAB,VA,671,620,-51,0.48024786986831913
23451,VIRGINIA BEACH,VA,23526,21839,-1687,0.4814063705499835
23452,VA BCH,VA,2130,2059,-71,0.4915254237288136
23452,VA BEACH,VA,1643,1500,-143,0.4772510340439071
23452,VIRGINIA BEACH,VA,22861,21976,-885,0.49013091866092734
23453,VIRGINIA BCH,VA,1772,1614,-158,0.47666863555818073
23453,VIRGINIA BEACH,VA,12369,11258,-1111,0.4764887628560545
23454,VIRGINIA BCH,VA,1259,1090,-169,0.46402724563644104
23454,VIRGINIA BEACH,VA,24545,23379,-1166,0.4878349052666722
23455,VIRGINIA BCH,VA,991,1004,13,0.5032581453634085
23455,VIRGINIA BEACH,VA,23431,21968,-1463,0.4838873102931783
23456,VA BCH,VA,439,440,1,0.5005688282138794
23456,VIRGINIA BEACH,VA,18370,19750,1380,0.5181007345225603
23457,VA BCH,VA,85,114,29,0.5728643216080402
23457,VA BEACH,VA,81,129,48,0.6142857142857143
23457,VIRGINIA BEACH,VA,939,1103,164,0.5401567091087169
23462,VA BCH,VA,942,932,-10,0.4973319103521878
23462,VA BEACH,VA,2772,2520,-252,0.47619047619047616
23462,VIRGINIA BEACH,VA,36852,32665,-4187,0.46988506408504394
23464,VA BCH,VA,3204,3056,-148,0.4881789137380192
23464,VA BEACH,VA,2056,1797,-259,0.46638982610952506
23464,VIRGINIA BCH,VA,1205,1137,-68,0.4854824935952178
23464,VIRGINIA BEACH,VA,22783,21806,-977,0.4890443831438247
23466,VIRGINIA BCH,VA,84,112,28,0.5714285714285714
23466,VIRGINIA BEACH,VA,644,1036,392,0.6166666666666667
23467,VIRGINIA BCH,VA,26,36,10,0.5806451612903226
23467,VIRGINIA BEACH,VA,491,842,351,0.6316579144786196
23471,VIRGINIA BCH,VA,157,230,73,0.5943152454780362
23471,VIRGINIA BEACH,VA,389,642,253,0.6226964112512124
23480,WACHAPREAGUE,VA,0,12,12,1
23487,WINDSOR,VA,1686,1909,223,0.5310152990264256
23501,NORFOLK,VA,606,1086,480,0.6418439716312057
23502,NORFOLK,VA,10448,9920,-528,0.4870384917517675
23503,NORFOLK,VA,19242,16292,-2950,0.4584904598412788
23504,NORFOLK,VA,10268,8258,-2010,0.44575191622584476
23505,NORFOLK,VA,19624,15149,-4475,0.4356540994449717
23507,NORFOLK,VA,4294,3604,-690,0.45631805520384905
23508,NORFOLK,VA,8938,7691,-1247,0.46250526189187563
23509,NORFOLK,VA,6604,6302,-302,0.48830001549666824
23510,NORFOLK,VA,9202,7015,-2187,0.4325707590799778
23511,NAVAL BASE,VA,0,15,15,1
23511,NORFOLK,VA,1205,655,-550,0.3521505376344086
23513,NORFOLK,VA,15209,13318,-1891,0.46685596101938515
23514,NORFOLK,VA,40,11,-29,0.21568627450980393
23517,NORFOLK,VA,5584,4514,-1070,0.44701921172509407
23518,NORFOLK,VA,16479,14893,-1586,0.47472268264694634
23523,NORFOLK,VA,3617,3711,94,0.5064137554585153
23541,NORFOLK,VA,178,363,185,0.6709796672828097
23601,NEWPORT NEWS,VA,12957,12068,-889,0.4822377622377622
23602,NEWPORT NEWS,VA,22240,19883,-2357,0.4720224105595518
23603,NEWPORT NEWS,VA,2154,1948,-206,0.47489029741589467
23604,FORT EUSTIS,VA,2651,2053,-598,0.436437074829932
23604,NEWPORT NEWS,VA,83,69,-14,0.45394736842105265
23605,HAMPTON,VA,358,327,-31,0.47737226277372263
23605,NEWPORT NEWS,VA,7305,6405,-900,0.4671772428884026
23606,NEWPORT NEWS,VA,15594,14379,-1215,0.47973175858272443
23607,NEWPORT NEWS,VA,13696,11043,-2653,0.4463802093859897
23608,NEWPORT NEWS,VA,23724,21298,-2426,0.47305761627648707
23609,NEWPORT NEWS,VA,390,514,124,0.5685840707964602
23612,NEWPORT NEWS,VA,63,128,65,0.6701570680628273
23651,FORT MONROE,VA,52,155,103,0.748792270531401
23651,HAMPTON,VA,0,14,14,1
23661,HAMPTON,VA,5704,5908,204,0.5087840165346194
23662,HAMPTON,VA,96,143,47,0.5983263598326359
23662,POQUOSON,VA,3539,3877,338,0.5227885652642934
23663,HAMPTON,VA,6307,6335,28,0.5011074197120708
23664,HAMPTON,VA,4304,4292,-12,0.4993020009306654
23665,HAMPTON,VA,2384,2358,-26,0.49725854070012654
23665,LANGLEY AFB,VA,693,657,-36,0.4866666666666667
23666,HAMPTON,VA,32338,26559,-5779,0.4509397762195018
23669,HAMPTON,VA,16171,16064,-107,0.4983403133240267
23670,HAMPTON,VA,118,916,798,0.8858800773694391
23690,YORKTOWN,VA,1405,1541,136,0.5230821452817379
23691,YORKTOWN,VA,0,33,33,1
23692,YORKTOWN,VA,6960,7323,363,0.5127074144087377
23693,YORKTOWN,VA,9347,9222,-125,0.4966341752383004
23696,SEAFORD,VA,878,1069,191,0.5490498202362609
23701,PORTSMOUTH,VA,10173,10048,-125,0.496909153849958
23702,PORTSMOUTH,VA,6093,5735,-358,0.48486641866756847
23703,PORTSMOUTH,VA,11733,11104,-629,0.48622848885580416
23704,PORTSMOUTH,VA,10766,9797,-969,0.4764382628993824
23705,PORTSMOUTH,VA,45,167,122,0.7877358490566038
23707,PORTSMOUTH,VA,6965,6493,-472,0.48246396195571406
23801,FORT LEE,VA,4069,3736,-333,0.4786675208199872
23803,NORTH DINWIDDIE,VA,3463,3379,-84,0.4938614440222157
23803,PETERSBURG,VA,6995,6946,-49,0.49824259378810704
23803,SOUTH CHESTERFIELD,VA,6398,6033,-365,0.48531896066285896
23804,PETERSBURG,VA,92,376,284,0.8034188034188035
23805,NORTH DINWIDDIE,VA,1701,1651,-50,0.49254176610978523
23805,PETERSBURG,VA,6850,6384,-466,0.4823938340637751
23805,SOUTH PRINCE GEORGE,VA,631,582,-49,0.47980214344600164
23821,ALBERTA,VA,126,166,40,0.5684931506849316
23824,BLACKSTONE,VA,2844,2410,-434,0.4586981347544728
23827,BOYKINS,VA,221,223,2,0.5022522522522522
23829,CAPRON,VA,22,59,37,0.7283950617283951
23830,CARSON,VA,229,372,143,0.6189683860232945
23831,CHESTER,VA,14724,16088,1364,0.5221342334155524
23831,COLONIAL HEIGHTS,VA,269,318,49,0.5417376490630323
23832,CHESTERFIELD,VA,11948,14426,2478,0.5469780844771366
23833,CHURCH ROAD,VA,262,276,14,0.5130111524163569
23834,COLONIAL HEIGHTS,VA,11730,9142,-2588,0.4380030663089306
23834,SOUTH CHESTERFIELD,VA,766,652,-114,0.459802538787024
23836,CHESTER,VA,6200,6538,338,0.5132673889150573
23837,COURTLAND,VA,1381,1234,-147,0.47189292543021033
23838,CHESTERFIELD,VA,3660,4971,1311,0.5759471671880431
23839,DENDRON,VA,25,26,1,0.5098039215686274
23840,DEWITT,VA,194,271,77,0.5827956989247312
23841,DINWIDDIE,VA,898,1071,173,0.5439309294057897
23842,DISPUTANTA,VA,1716,1904,188,0.5259668508287293
23846,ELBERON,VA,0,35,35,1
23847,EMPORIA,VA,4033,3793,-240,0.4846664962944033
23850,FORD,VA,76,114,38,0.6
23851,FRANKLIN,VA,5309,5065,-244,0.4882398303450935
23856,FREEMAN,VA,179,37,-142,0.1712962962962963
23857,GASBURG,VA,38,46,8,0.5476190476190477
23860,HOPEWELL,VA,14742,10082,-4660,0.4061392201095714
23860,NORTH PRINCE GEORGE,VA,1880,1406,-474,0.42787583688374925
23866,IVOR,VA,479,554,75,0.5363020329138432
23867,JARRATT,VA,707,706,-1,0.4996461429582449
23868,LAWRENCEVILLE,VA,1441,1420,-21,0.4963299545613422
23872,MC KENNEY,VA,665,697,32,0.5117474302496329
23874,NEWSOMS,VA,11,11,0,0.5
23875,PRINCE GEORGE,VA,5213,5394,181,0.5085321014424437
23878,SEDLEY,VA,0,86,86,1
23881,SPRING GROVE,VA,183,292,109,0.6147368421052631
23882,STONY CREEK,VA,513,542,29,0.5137440758293839
23883,SURRY,VA,665,633,-32,0.487673343605547
23885,SUTHERLAND,VA,596,810,214,0.5761024182076814
23888,WAKEFIELD,VA,552,624,72,0.5306122448979592
23889,WARFIELD,VA,12,0,-12,0
23890,WAVERLY,VA,1133,1171,38,0.5082465277777778
23893,WHITE PLAINS,VA,11,0,-11,0
23894,WILSONS,VA,0,34,34,1
23898,ZUNI,VA,218,357,139,0.6208695652173913
23901,FARMVILLE,VA,5463,5107,-356,0.4831598864711448
23915,BASKERVILLE,VA,31,12,-19,0.27906976744186046
23917,BOYDTON,VA,561,874,313,0.6090592334494773
23919,BRACEY,VA,1202,1413,211,0.5403441682600383
23920,BRODNAX,VA,709,720,11,0.5038488453463961
23921,BUCKINGHAM,VA,776,707,-69,0.47673634524612274
23922,BURKEVILLE,VA,443,510,67,0.5351521511017838
23923,CHARLOTTE C H,VA,13,0,-13,0
23923,CHARLOTTE COURT HOUSE,VA,729,664,-65,0.4766690595836324
23924,CHASE CITY,VA,1463,1625,162,0.5262305699481865
23927,CLARKSVILLE,VA,1511,1667,156,0.5245437382001259
23930,CREWE,VA,1764,1655,-109,0.48405966656917226
23936,DILLWYN,VA,1862,1723,-139,0.4806136680613668
23937,DRAKES BRANCH,VA,412,304,-108,0.4245810055865922
23938,DUNDAS,VA,11,0,-11,0
23942,GREEN BAY,VA,44,71,27,0.6173913043478261
23944,KENBRIDGE,VA,1087,1076,-11,0.497457235321313
23947,KEYSVILLE,VA,1263,1302,39,0.5076023391812865
23950,LA CROSSE,VA,1116,905,-211,0.4477981197427016
23954,MEHERRIN,VA,476,481,5,0.5026123301985371
23954,VIRGINIA BEACH,VA,0,17,17,1
23958,PAMPLIN,VA,694,777,83,0.5282121006118287
23959,PHENIX,VA,49,22,-27,0.30985915492957744
23960,PROSPECT,VA,413,464,51,0.5290763968072976
23962,RANDOLPH,VA,0,11,11,1
23964,RED OAK,VA,0,12,12,1
23966,RICE,VA,562,505,-57,0.4732895970009372
23967,SAXE,VA,45,15,-30,0.25
23968,SKIPWITH,VA,12,26,14,0.6842105263157895
23970,SOUTH HILL,VA,3041,2754,-287,0.47523727351164796
23974,VICTORIA,VA,1503,1348,-155,0.47281655559452823
24011,ROANOKE,VA,1342,1129,-213,0.45690004046944555
24012,ROANOKE,VA,13349,11954,-1395,0.47243409872347153
24013,ROANOKE,VA,4369,3909,-460,0.47221551099299347
24014,REY,VA,137,113,-24,0.452
24014,ROANOKE,VA,6770,6589,-181,0.49322554083389475
24015,ROANOKE,VA,7748,7224,-524,0.48250066791343843
24016,ROANOKE,VA,6823,5911,-912,0.46419035652583635
24017,ROANOKE,VA,10811,9731,-1080,0.4737123941193652
24018,ROANOKE,VA,16256,16364,108,0.5016554261189454
24019,ROANOKE,VA,9257,9777,520,0.5136597667332142
24022,ROANOKE,VA,0,133,133,1
24053,ARARAT,VA,797,443,-354,0.357258064516129
24054,AXTON,VA,1589,1348,-241,0.4589717398706163
24055,BASSETT,VA,3671,3316,-355,0.47459567768713323
24059,BENT MOUNTAIN,VA,12,40,28,0.7692307692307693
24060,BLACKSBURG,VA,26974,17255,-9719,0.3901286486242058
24061,BLACKSBURG,VA,0,45,45,1
24062,BLACKSBURG,VA,35,115,80,0.7666666666666667
24064,BLUE RIDGE,VA,1200,1317,117,0.5232419547079857
24065,BOONES MILL,VA,1676,1859,183,0.5258840169731259
24066,BLACKSBURG,VA,22,41,19,0.6507936507936508
24066,BUCHANAN,VA,1196,1252,56,0.511437908496732
24067,CALLAWAY,VA,337,467,130,0.5808457711442786
24068,CHRISTIANSBRG,VA,23,50,27,0.684931506849315
24068,CHRISTIANSBURG,VA,322,387,65,0.5458392101551481
24069,CASCADE,VA,331,281,-50,0.4591503267973856
24070,CATAWBA,VA,137,85,-52,0.38288288288288286
24072,CHECK,VA,100,154,54,0.6062992125984252
24073,CHRISTIANSBRG,VA,300,279,-21,0.48186528497409326
24073,CHRISTIANSBURG,VA,13738,13269,-469,0.4913170659458659
24076,CLAUDVILLE,VA,35,58,23,0.6236559139784946
24077,CLOVERDALE,VA,391,284,-107,0.42074074074074075
24078,COLLINSVILLE,VA,2356,2325,-31,0.4966887417218543
24079,COPPER HILL,VA,365,475,110,0.5654761904761905
24083,DALEVILLE,VA,1732,2213,481,0.5609632446134347
24084,DUBLIN,VA,3403,3420,17,0.5012457863110069
24085,EAGLE ROCK,VA,363,343,-20,0.48583569405099153
24087,ELLISTON,VA,979,1111,132,0.531578947368421
24087,LAFAYETTE,VA,23,20,-3,0.46511627906976744
24088,FERRUM,VA,1117,1197,80,0.517286084701815
24089,FIELDALE,VA,849,723,-126,0.4599236641221374
24090,FINCASTLE,VA,1226,1340,114,0.5222135619641465
24091,FLOYD,VA,2379,2622,243,0.5242951409718056
24092,GLADE HILL,VA,900,875,-25,0.49295774647887325
24095,GOODVIEW,VA,1339,1490,151,0.5266878755744079
24101,HARDY,VA,2087,2413,326,0.5362222222222223
24102,HENRICO,VA,12,12,0,0.5
24102,HENRY,VA,277,177,-100,0.3898678414096916
24104,HUDDLESTON,VA,1450,1581,131,0.5216100296931706
24112,MARTINSVILLE,VA,10099,9900,-199,0.4950247512375619
24114,MARTINSVILLE,VA,26,11,-15,0.2972972972972973
24115,MARTINSVILLE,VA,303,257,-46,0.4589285714285714
24120,MEADOWS OF DAN,VA,506,639,133,0.5580786026200873
24121,MONETA,VA,4750,5077,327,0.5166378345374987
24122,MONTVALE,VA,321,302,-19,0.48475120385232745
24124,NARROWS,VA,1475,1537,62,0.5102921646746348
24127,NEW CASTLE,VA,1154,1188,34,0.5072587532023911
24128,NEWPORT,VA,518,394,-124,0.43201754385964913
24132,PARROTT,VA,13,0,-13,0
24133,PATRICK SPGS,VA,11,39,28,0.78
24133,PATRICK SPRINGS,VA,537,677,140,0.557660626029654
24134,PEARISBURG,VA,1797,1881,84,0.5114192495921697
24136,PEMBROKE,VA,1161,1220,59,0.5123897522049559
24137,PENHOOK,VA,1080,1080,0,0.5
24138,PILOT,VA,131,200,69,0.6042296072507553
24141,RADFORD,VA,9498,8252,-1246,0.4649014084507042
24143,RADFORD,VA,120,351,231,0.7452229299363057
24147,RICH CREEK,VA,186,244,58,0.5674418604651162
24148,RIDGEWAY,VA,2386,2063,-323,0.46369970779950553
24149,RINER,VA,955,986,31,0.5079855744461618
24150,RIPPLEMEAD,VA,11,11,0,0.5
24151,ROCKY MOUNT,VA,6283,6012,-271,0.4889792598617324
24153,SALEM,VA,13110,13677,567,0.5105834919923844
24162,SHAWSVILLE,VA,602,646,44,0.5176282051282052
24165,SPENCER,VA,222,237,15,0.5163398692810458
24168,STANLEYTOWN,VA,42,13,-29,0.23636363636363636
24171,STUART,VA,2145,2316,171,0.5191661062542031
24174,THAXTON,VA,563,673,110,0.5444983818770227
24175,TROUTVILLE,VA,1986,2333,347,0.5401713359573975
24176,UNION HALL,VA,500,628,128,0.5567375886524822
24179,VINTON,VA,6601,6702,101,0.5037961362098775
24184,BURNT CHIMNEY,VA,23,41,18,0.640625
24184,WIRTZ,VA,1419,1516,97,0.5165247018739353
24185,WOOLWINE,VA,11,37,26,0.7708333333333334
24201,BRISTOL,VA,6487,6248,-239,0.490616411464468
24202,BRISTOL,VA,2993,3425,432,0.5336553443440324
24203,BRISTOL,VA,0,13,13,1
24209,BRISTOL,VA,68,43,-25,0.38738738738738737
24210,ABINGDON,VA,5484,5495,11,0.5005009563712542
24211,ABINGDON,VA,2440,2767,327,0.531400038409833
24212,ABINGDON,VA,714,493,-221,0.4084507042253521
24216,APPALACHIA,VA,1125,567,-558,0.3351063829787234
24219,BIG STONE GAP,VA,2836,2397,-439,0.45805465316262184
24220,BIRCHLEAF,VA,17,11,-6,0.39285714285714285
24221,BLACKWATER,VA,14,0,-14,0
24224,CASTLEWOOD,VA,1271,1114,-157,0.46708595387840673
24225,CLEVELAND,VA,224,95,-129,0.29780564263322884
24226,CLINCHCO,VA,166,114,-52,0.40714285714285714
24228,CLINTWOOD,VA,1590,1626,36,0.5055970149253731
24230,COEBURN,VA,2103,1868,-235,0.47041047595064217
24236,DAMASCUS,VA,1132,1111,-21,0.49531876950512704
24237,DANTE,VA,169,58,-111,0.2555066079295154
24243,DRYDEN,VA,406,444,38,0.5223529411764706
24244,DUFFIELD,VA,1254,1274,20,0.5039556962025317
24245,DUNGANNON,VA,67,64,-3,0.48854961832061067
24246,EAST STONE GAP,VA,11,0,-11,0
24248,EWING,VA,542,539,-3,0.49861239592969475
24250,FORT BLACKMORE,VA,37,0,-37,0
24251,GATE CITY,VA,2182,2290,108,0.5120751341681574
24256,HAYSI,VA,864,749,-115,0.4643521388716677
24258,HILTONS,VA,28,60,32,0.6818181818181818
24260,HONAKER,VA,1158,1124,-34,0.4925503943908852
24263,JONESVILLE,VA,1559,1617,58,0.5091309823677582
24265,KEOKEE,VA,0,11,11,1
24266,LEBANON,VA,2251,2422,171,0.5182965974748556
24271,NICKELSVILLE,VA,407,520,113,0.5609492988133765
24273,NORTON,VA,2092,1709,-383,0.44961852144172587
24277,PENNINGTN GAP,VA,108,130,22,0.5462184873949579
24277,PENNINGTON GAP,VA,1706,1764,58,0.5083573487031701
24279,POUND,VA,734,665,-69,0.4753395282344532
24280,ROSEDALE,VA,0,13,13,1
24281,ROSE HILL,VA,519,594,75,0.5336927223719676
24282,SAINT CHARLES,VA,11,13,2,0.5416666666666666
24283,SAINT PAUL,VA,554,515,-39,0.48175865294667913
24283,ST PAUL,VA,13,15,2,0.5357142857142857
24290,WEBER CITY,VA,330,384,54,0.5378151260504201
24293,WISE,VA,2337,2232,-105,0.4885095206828628
24301,PULASKI,VA,5700,4953,-747,0.4649394536750211
24311,ATKINS,VA,462,390,-72,0.45774647887323944
24312,AUSTINVILLE,VA,311,362,51,0.537890044576523
24313,BARREN SPRINGS,VA,26,35,9,0.5737704918032787
24314,BASTIAN,VA,99,149,50,0.6008064516129032
24315,BLAND,VA,600,681,81,0.531615925058548
24317,CANA,VA,902,844,-58,0.4833906071019473
24319,CHILHOWIE,VA,2317,1986,-331,0.46153846153846156
24324,DRAPER,VA,484,478,-6,0.4968814968814969
24325,DUGSPUR,VA,35,90,55,0.72
24326,ELK CREEK,VA,67,64,-3,0.48854961832061067
24328,FANCY GAP,VA,796,950,154,0.54410080183276055
24330,FRIES,VA,964,848,-116,0.46799116997792495
24333,GALAX,VA,5461,5385,-76,0.49649640420431496
24340,GLADE SPRING,VA,1423,1521,98,0.5166440217391305
24343,HILLSVILLE,VA,2883,2947,64,0.5054888507718697
24347,ALLISONIA,VA,28,11,-17,0.28205128205128205
24347,HIWASSEE,VA,158,119,-39,0.4296028880866426
24348,INDEPENDENCE,VA,1190,1221,31,0.5064288676897553
24350,IVANHOE,VA,58,48,-10,0.4528301886792453
24350,WILLIS,VA,14,0,-14,0
24352,LAUREL FORK,VA,49,100,51,0.6711409395973155
24354,MARION,VA,6313,5193,-1120,0.4513297410046932
24360,MAX MEADOWS,VA,1398,1523,125,0.5213967819239986
24361,MEADOWVIEW,VA,1130,1168,38,0.5082680591818973
24363,MOUTH OF WILSON,VA,118,103,-15,0.4660633484162896
24363,MOUTH WILSON,VA,0,18,18,1
24366,ROCKY GAP,VA,65,11,-54,0.14473684210526316
24368,RURAL RETREAT,VA,1581,1558,-23,0.49633641287034086
24370,SALTVILLE,VA,1440,1393,-47,0.4917049064595835
24374,SPEEDWELL,VA,74,145,71,0.6621004566210046
24375,SUGAR GROVE,VA,145,335,190,0.6979166666666666
24378,TROUTDALE,VA,40,26,-14,0.3939393939393939
24380,FLOYD,VA,24,16,-8,0.4
24380,WILLIS,VA,685,763,78,0.5269337016574586
24381,WOODLAWN,VA,1159,1231,72,0.5150627615062762
24382,WYTHEVILLE,VA,5639,5261,-378,0.4826605504587156
24401,STAUNTON,VA,15071,14554,-517,0.4912742616033755
24402,STAUNTON,VA,475,459,-16,0.49143468950749464
24416,BUENA VISTA,VA,3479,3103,-376,0.47143725311455487
24421,CHURCHVILLE,VA,917,863,-54,0.4848314606741573
24422,CLIFTON FORGE,VA,2392,2101,-291,0.467616292009793
24426,COVINGTON,VA,5195,4507,-688,0.4645433931148217
24430,CRAIGSVILLE,VA,614,571,-43,0.48185654008438816
24431,CRIMORA,VA,901,852,-49,0.4860239589275528
24435,FAIRFIELD,VA,495,410,-85,0.4530386740331492
24437,FORT DEFIANCE,VA,36,37,1,0.5068493150684932
24439,GOSHEN,VA,128,142,14,0.5259259259259259
24440,GREENVILLE,VA,810,917,107,0.5309785755645628
24441,GROTTOES,VA,2007,2067,60,0.5073637702503682
24442,HEAD WATERS,VA,11,0,-11,0
24445,HOT SPRINGS,VA,707,732,25,0.5086865879082696
24450,LEXINGTON,VA,6279,6053,-226,0.4908368472267272
24459,MIDDLEBROOK,VA,24,23,-1,0.48936170212765956
24460,MILLBORO,VA,231,247,16,0.5167364016736402
24465,HIGHTOWN,VA,12,31,19,0.7209302325581395
24465,MONTEREY,VA,206,305,99,0.5968688845401174
24467,MOUNT SIDNEY,VA,365,453,88,0.5537897310513448
24471,PORT REPUBLIC,VA,82,77,-5,0.48427672955974843
24472,RAPHINE,VA,688,661,-27,0.4899925871015567
24473,ROCKBRIDGE BATHS,VA,0,84,84,1
24474,SELMA,VA,11,0,-11,0
24477,STUARTS DRAFT,VA,4292,3908,-384,0.4765853658536585
24479,SWOOPE,VA,103,112,9,0.5209302325581395
24482,VERONA,VA,1784,1692,-92,0.48676639815880324
24483,VESUVIUS,VA,24,12,-12,0.3333333333333333
24484,WARM SPRINGS,VA,12,49,37,0.8032786885245902
24486,WEYERS CAVE,VA,912,831,-81,0.47676419965576594
24501,LYNCHBURG,VA,12324,10324,-2000,0.4558459908159661
24502,LYNCHBURG,VA,21625,18462,-3163,0.46054830743133685
24503,LYNCHBURG,VA,6592,7046,454,0.5166446693063499
24504,LYNCHBURG,VA,4893,4338,-555,0.4699382515437114
24505,LYNCHBURG,VA,76,164,88,0.6833333333333333
24506,LYNCHBURG,VA,877,469,-408,0.34843982169390786
24517,ALTAVISTA,VA,1813,1789,-24,0.4966685174902832
24520,ALTON,VA,345,317,-28,0.4788519637462236
24521,AMHERST,VA,2457,2683,226,0.5219844357976654
24522,APPOMATTOX,VA,2584,2895,311,0.5283810914400437
24523,BEDFORD,VA,6441,6319,-122,0.4952194357366771
24526,BIG ISLAND,VA,212,163,-49,0.43466666666666665
24527,BLAIRS,VA,453,633,180,0.5828729281767956
24528,BROOKNEAL,VA,800,865,65,0.5195195195195195
24529,BUFFALO JCT,VA,11,11,0,0.5
24529,BUFFALO JUNCTION,VA,177,135,-42,0.4326923076923077
24530,CALLANDS,VA,22,27,5,0.5510204081632653
24531,CHATHAM,VA,1996,2006,10,0.5012493753123438
24534,CLOVER,VA,104,129,25,0.5536480686695279
24538,CONCORD,VA,1202,1274,72,0.5145395799676898
24540,DANVILLE,VA,10488,10059,-429,0.4895605197839101
24541,DANVILLE,VA,10288,9675,-613,0.4846465962029755
24543,DANVILLE,VA,281,847,566,0.750886524822695
24549,DRY FORK,VA,928,916,-12,0.4967462039045553
24550,EVINGTON,VA,1999,2041,42,0.5051980198019802
24551,FOREST,VA,8997,9635,638,0.5171210820094461
24553,GLADSTONE,VA,190,256,66,0.5739910313901345
24554,GLADYS,VA,791,909,118,0.5347058823529411
24555,GLASGOW,VA,637,678,41,0.5155893536121673
24556,GOODE,VA,606,955,349,0.6117873158231902
24557,GRETNA,VA,2185,1987,-198,0.4762703739213806
24558,HALIFAX,VA,1623,1787,164,0.5240469208211144
24562,HOWARDSVILLE,VA,12,0,-12,0
24563,HURT,VA,1645,1555,-90,0.4859375
24565,JAVA,VA,11,22,11,0.6666666666666666
24566,KEELING,VA,24,77,53,0.7623762376237624
24569,LONG ISLAND,VA,0,24,24,1
24571,LYNCH STATION,VA,172,272,100,0.6126126126126126
24572,MADISON HEIGHTS,VA,4601,4657,56,0.5030244113199395
24572,MADISON HTS,VA,241,290,49,0.5461393596986818
24574,MONROE,VA,1034,1227,193,0.5426802299867315
24577,NATHALIE,VA,1110,1112,2,0.5004500450045004
24578,NATURAL BRIDGE,VA,38,66,28,0.6346153846153846
24579,NATURAL BRIDGE STATION,VA,218,196,-22,0.47342995169082125
24580,NELSON,VA,0,13,13,1
24586,RINGGOLD,VA,1271,1255,-16,0.49683293745051466
24588,RUSTBURG,VA,2626,2704,78,0.5073170731707317
24589,SCOTTSBURG,VA,212,191,-21,0.4739454094292804
24590,SCOTTSVILLE,VA,2191,2352,161,0.5177195685670262
24592,SOUTH BOSTON,VA,4580,3920,-660,0.4611764705882353
24593,SPOUT SPRING,VA,402,352,-50,0.46684350132625996
24594,SUTHERLIN,VA,76,118,42,0.6082474226804123
24595,SWEET BRIAR,VA,102,22,-80,0.1774193548387097
24597,VERNON HILL,VA,26,68,42,0.723404255319149
24598,VIRGILINA,VA,121,116,-5,0.48945147679324896
24602,BANDY,VA,0,11,11,1
24603,BIG ROCK,VA,23,0,-23,0
24605,BLUEFIELD,VA,2876,2467,-409,0.46172562230956393
24609,CEDAR BLUFF,VA,1878,1486,-392,0.4417360285374554
24612,DORAN,VA,13,0,-13,0
24613,FALLS MILLS,VA,45,11,-34,0.19642857142857142
24614,GRUNDY,VA,1777,1300,-477,0.4224894377640559
24620,HURLEY,VA,181,65,-116,0.26422764227642276
24622,JEWELL RIDGE,VA,13,11,-2,0.4583333333333333
24630,N TAZEWELL,VA,181,181,0,0.5
24630,NORTH TAZEWELL,VA,1558,1614,56,0.5088272383354351
24631,OAKWOOD,VA,121,103,-18,0.45982142857142855
24635,POCAHONTAS,VA,23,0,-23,0
24637,POUNDING MILL,VA,1050,838,-212,0.4438559322033898
24639,RAVEN,VA,785,633,-152,0.4464033850493653
24641,RICHLANDS,VA,1822,1642,-180,0.4740184757505774
24649,SWORDS CREEK,VA,371,165,-206,0.30783582089552236
24651,TAZEWELL,VA,1885,1682,-203,0.4715447154471545
24656,VANSANT,VA,694,397,-297,0.3638863428047663
24701,BLUEFIELD,WV,7432,6231,-1201,0.45604918392739513
24712,ATHENS,WV,443,424,-19,0.48904267589388695
24733,LASHMEET,WV,13,0,-13,0
24736,MATOAKA,WV,0,12,12,1
24739,PRINCETON,WV,3503,3363,-140,0.48980483542091463
24740,PRINCETON,WV,6804,6143,-661,0.47447285085347957
24747,ROCK,WV,391,398,7,0.5044359949302915
24801,WELCH,WV,1181,793,-388,0.4017223910840932
24818,BRENTON,WV,0,14,14,1
24827,CYCLONE,WV,187,57,-130,0.2336065573770492
24844,IAEGER,WV,24,11,-13,0.3142857142857143
24850,JOLO,WV,12,14,2,0.5384615384615384
24868,NORTHFORK,WV,46,13,-33,0.22033898305084745
24870,OCEANA,WV,476,215,-261,0.3111432706222865
24872,PANTHER,WV,0,12,12,1
24873,PAYNESVILLE,WV,19,0,-19,0
24874,PINEVILLE,WV,285,251,-34,0.46828358208955223
24892,WAR,WV,406,123,-283,0.23251417769376181
24901,LEWISBURG,WV,4064,3695,-369,0.47622116252094343
24910,ALDERSON,WV,1205,1257,52,0.5105605199025183
24916,ASBURY,WV,11,0,-11,0
24918,BALLARD,WV,54,59,5,0.5221238938053098
24925,CALDWELL,WV,67,56,-11,0.45528455284552843
24931,CLINTONVILLE,WV,14,0,-14,0
24931,CRAWLEY,WV,137,208,71,0.6028985507246377
24934,DUNMORE,WV,16,0,-16,0
24935,FOREST HILL,WV,0,23,23,1
24938,FRANKFORD,WV,170,178,8,0.5114942528735632
24941,GAP MILLS,WV,86,77,-9,0.4723926380368098
24946,HILLSBORO,WV,211,165,-46,0.43882978723404253
24951,LINDSIDE,WV,102,113,11,0.5255813953488372
24954,MARLINTON,WV,1536,1245,-291,0.447680690399137
24957,MAXWELTON,WV,26,23,-3,0.46938775510204084
24963,PETERSTOWN,WV,1186,1159,-27,0.49424307036247334
24966,AUTO,WV,16,0,-16,0
24966,RENICK,WV,151,96,-55,0.38866396761133604
24970,RONCEVERTE,WV,1308,1211,-97,0.48074632790789995
24976,SINKS GROVE,WV,15,61,46,0.8026315789473685
24981,TALCOTT,WV,24,23,-1,0.48936170212765956
24983,UNION,WV,274,372,98,0.5758513931888545
24986,WHITE SULPHUR SPRINGS,WV,1451,1368,-83,0.48527846754168147
24986,WHT SULPHUR SPGS,WV,386,408,22,0.5138539042821159
25003,ALUM CREEK,WV,313,277,-36,0.4694915254237288
25007,ARNETT,WV,23,0,-23,0
25009,ASHFORD,WV,0,16,16,1
25011,BANCROFT,WV,13,0,-13,0
25015,BELLE,WV,1010,945,-65,0.4833759590792839
25015,QUINCY,WV,21,11,-10,0.34375
25015,SHREWSBURY,WV,25,21,-4,0.45652173913043476
25030,BOMONT,WV,13,0,-13,0
25031,BOOMER,WV,24,0,-24,0
25033,BUFFALO,WV,282,272,-10,0.49097472924187724
25035,CABIN CREEK,WV,51,43,-8,0.4574468085106383
25039,CEDAR GROVE,WV,26,0,-26,0
25040,CHARLTON HEIGHTS,WV,11,0,-11,0
25043,CLAY,WV,439,296,-143,0.40272108843537413
25045,CLENDENIN,WV,1167,1187,20,0.5042480883602379
25049,COMFORT,WV,32,11,-21,0.2558139534883721
25053,DANVILLE,WV,1107,750,-357,0.40387722132471726
25063,DUCK,WV,96,109,13,0.5317073170731708
25063,STRANGE CREEK,WV,26,0,-26,0
25064,DUNBAR,WV,4260,3546,-714,0.45426594926979247
25067,EAST BANK,WV,27,43,16,0.6142857142857143
25070,ELEANOR,WV,295,188,-107,0.38923395445134573
25071,ELKVIEW,WV,2476,2530,54,0.50539352776668
25081,FOSTER,WV,12,25,13,0.6756756756756757
25082,FRAZIERS BOTTOM,WV,280,326,46,0.5379537953795379
25082,PLINY,WV,0,11,11,1
25085,GAULEY BRIDGE,WV,14,0,-14,0
25086,GLASGOW,WV,11,0,-11,0
25093,GORDON,WV,11,0,-11,0
25106,HENDERSON,WV,11,12,1,0.5217391304347826
25107,HERNSHAW,WV,13,0,-13,0
25108,HEWETT,WV,0,12,12,1
25109,HOMETOWN,WV,0,12,12,1
25112,INSTITUTE,WV,0,15,15,1
25113,IVYDALE,WV,154,104,-50,0.40310077519379844
25119,KINCAID,WV,11,0,-11,0
25123,LEON,WV,551,666,115,0.5472473294987674
25123,WINFIELD,WV,20,21,1,0.5121951219512195
25125,LIZEMORES,WV,11,24,13,0.6857142857142857
25130,MADISON,WV,1274,819,-455,0.391304347826087
25133,MAYSEL,WV,26,27,1,0.5094339622641509
25136,MONTGOMERY,WV,502,481,-21,0.4893184130213632
25140,NAOMA,WV,11,15,4,0.5769230769230769
25143,NITRO,WV,4186,2940,-1246,0.412573673870334
25154,PEYTONA,WV,0,11,11,1
25159,POCA,WV,1386,1411,25,0.5044690740078656
25162,PRATT,WV,11,0,-11,0
25164,OVAPA,WV,14,0,-14,0
25164,PIGEON,WV,35,39,4,0.527027027027027
25164,PROCIOUS,WV,54,27,-27,0.3333333333333333
25168,RED HOUSE,WV,369,451,82,0.55
25177,SAINT ALBANS,WV,8340,7421,-919,0.47084575851786054
25181,SETH,WV,154,59,-95,0.27699530516431925
25186,SMITHERS,WV,0,11,11,1
25202,TORNADO,WV,82,104,22,0.5591397849462365
25208,WHARTON,WV,12,0,-12,0
25209,WHITESVILLE,WV,83,47,-36,0.36153846153846153
25213,WINFIELD,WV,1540,1685,145,0.5224806201550387
25234,ARNOLDSBURG,WV,95,193,98,0.6701388888888888
25235,CHLOE,WV,120,68,-52,0.3617021276595745
25239,COTTAGEVILLE,WV,299,314,15,0.5122349102773246
25241,EVANS,WV,327,284,-43,0.46481178396072015
25243,GANDEEVILLE,WV,56,77,21,0.5789473684210527
25245,GIVEN,WV,0,31,31,1
25248,KENNA,WV,469,613,144,0.566543438077634
25252,LE ROY,WV,0,24,24,1
25253,LETART,WV,80,74,-6,0.4805194805194805
25259,LOONEYVILLE,WV,25,12,-13,0.32432432432432434
25260,MASON,WV,453,163,-290,0.26461038961038963
25261,MILLSTONE,WV,11,0,-11,0
25262,MILLWOOD,WV,124,76,-48,0.38
25264,MOUNT ALTO,WV,0,11,11,1
25265,NEW HAVEN,WV,173,104,-69,0.37545126353790614
25266,NEWTON,WV,23,0,-23,0
25268,ORMA,WV,12,11,-1,0.4782608695652174
25270,REEDY,WV,12,42,30,0.7777777777777778
25271,RIPLEY,WV,3395,3121,-274,0.47897483118477596
25275,SANDYVILLE,WV,611,445,-166,0.42140151515151514
25276,SPENCER,WV,2953,2933,-20,0.4983010533469249
25285,WALLBACK,WV,12,0,-12,0
25286,WALTON,WV,150,97,-53,0.39271255060728744
25287,WEST COLUMBIA,WV,56,14,-42,0.2
25301,CHARLESTON,WV,2067,2189,122,0.5143327067669173
25302,CHARLESTON,WV,5969,5440,-529,0.4768165483390306
25303,CHARLESTON,WV,239,251,12,0.5122448979591837
25303,S CHARLESTON,WV,258,294,36,0.532608695652174
25303,SOUTH CHARLESTON,WV,2137,2042,-95,0.48863364441253887
25304,CHARLESTON,WV,2865,2864,-1,0.49991272473381043
25306,CHARLESTON,WV,2782,2363,-419,0.45928085519922257
25309,CHARLESTON,WV,335,315,-20,0.4846153846153846
25309,S CHARLESTON,WV,277,264,-13,0.4879852125693161
25309,SOUTH CHARLESTON,WV,3207,3052,-155,0.487617830324333
25311,CHARLESTON,WV,4004,3319,-685,0.4532295507305749
25312,CHARLESTON,WV,1844,1735,-109,0.4847722827605476
25313,CHARLESTON,WV,2596,2413,-183,0.48173288081453386
25313,CROSS LANES,WV,1704,1495,-209,0.4673335417317912
25314,CHARLESTON,WV,4381,4433,52,0.5029498525073747
25315,CHARLESTON,WV,480,492,12,0.5061728395061729
25315,CHESAPEAKE,WV,95,71,-24,0.42771084337349397
25315,MARMET,WV,241,223,-18,0.48060344827586204
25320,CHARLESTON,WV,850,883,33,0.5095210617426428
25320,SISSONVILLE,WV,259,263,4,0.5038314176245211
25321,CHARLESTON,WV,0,12,12,1
25322,CHARLESTON,WV,0,11,11,1
25339,CHARLESTON,WV,0,12,12,1
25356,CHARLESTON,WV,16,33,17,0.673469387755102
25360,CHARLESTON,WV,0,13,13,1
25361,CHARLESTON,WV,0,12,12,1
25362,CHARLESTON,WV,15,13,-2,0.4642857142857143
25375,CHARLESTON,WV,12,0,-12,0
25387,CHARLESTON,WV,2079,1683,-396,0.4473684210526316
25401,MARTINSBURG,WV,7504,7154,-350,0.4880611270296084
25402,MARTINSBURG,WV,864,1014,150,0.5399361022364217
25403,MARTINSBURG,WV,4549,6247,1698,0.578640237124861
25404,MARTINSBURG,WV,10208,9789,-419,0.48952342851427716
25405,MARTINSBURG,WV,4925,5265,340,0.5166830225711482
25411,BERKELEY SPGS,WV,142,191,49,0.5735735735735735
25411,BERKELEY SPRINGS,WV,4326,4527,201,0.5113520840393088
25413,BUNKER HILL,WV,3431,4109,678,0.5449602122015915
25414,CHARLES TOWN,WV,6380,7158,778,0.5287339341113901
25419,FALLING WATERS,WV,4346,5175,829,0.5435353429261632
25420,GERRARDSTOWN,WV,1380,1527,147,0.5252837977296182
25422,GREAT CACAPON,WV,341,597,256,0.6364605543710021
25423,HALLTOWN,WV,30,0,-30,0
25425,BOLIVAR,WV,225,201,-24,0.47183098591549294
25425,HARPERS FERRY,WV,3611,3885,274,0.5182764140875133
25427,HEDGESVILLE,WV,4766,5974,1208,0.5562383612662942
25428,INWOOD,WV,4299,4612,313,0.5175625631242284
25430,KEARNEYSVILLE,WV,2355,2856,501,0.5480713874496258
25434,PAW PAW,WV,537,570,33,0.5149051490514905
25438,RANSON,WV,3322,3074,-248,0.48061288305190747
25442,SHENANDOAH JUNCTION,WV,296,394,98,0.5710144927536231
25442,SHENDOAH JCT,WV,12,0,-12,0
25443,SHEPHERDSTOWN,WV,2534,2491,-43,0.4957213930348259
25444,SLANESVILLE,WV,0,35,35,1
25446,CHARLESTON,WV,0,12,12,1
25446,SUMMIT POINT,WV,46,108,62,0.7012987012987013
25501,ALKOL,WV,24,36,12,0.6
25502,APPLE GROVE,WV,143,62,-81,0.3024390243902439
25503,ASHTON,WV,0,11,11,1
25504,BARBOURSVILLE,WV,3674,3417,-257,0.48187843745593006
25506,BRANCHLAND,WV,955,922,-33,0.4912093766648908
25507,CEREDO,WV,261,229,-32,0.4673469387755102
25508,CHAPMANVILLE,WV,1354,1415,61,0.5110148067894547
25510,CULLODEN,WV,1830,1576,-254,0.46271285965942455
25512,EAST LYNN,WV,0,35,35,1
25514,FORT GAY,WV,730,735,5,0.5017064846416383
25515,GALIPOLIS FRY,WV,0,11,11,1
25515,GALLIPOLIS FERRY,WV,523,325,-198,0.38325471698113206
25517,GENOA,WV,105,109,4,0.5093457943925234
25520,GLENWOOD,WV,54,11,-43,0.16923076923076924
25521,GRIFFITHSVILLE,WV,97,11,-86,0.10185185185185185
25523,HAMLIN,WV,843,799,-44,0.4866017052375152
25524,HARTS,WV,218,204,-14,0.4834123222748815
25524,LEET,WV,12,12,0,0.5
25526,HURRICANE,WV,6539,6534,-5,0.49980876615925957
25529,JULIAN,WV,53,11,-42,0.171875
25530,KENOVA,WV,1644,1432,-212,0.46553966189856955
25535,LAVALETTE,WV,503,597,94,0.5427272727272727
25537,LESAGE,WV,376,362,-14,0.4905149051490515
25541,MILTON,WV,2716,2660,-56,0.4947916666666667
25545,ONA,WV,1010,1132,122,0.5284780578898226
25547,PECKS MILL,WV,12,12,0,0.5
25550,POINT PLEASANT,WV,2760,2551,-209,0.48032385614761813
25550,PT PLEASANT,WV,168,158,-10,0.48466257668711654
25555,PRICHARD,WV,119,95,-24,0.4439252336448598
25557,RANGER,WV,11,0,-11,0
25559,SALT ROCK,WV,254,174,-80,0.40654205607476634
25560,SCOTT DEPOT,WV,2846,3025,179,0.5152444217339465
25564,SOD,WV,74,50,-24,0.4032258064516129
25567,SUMERCO,WV,28,24,-4,0.46153846153846156
25570,WAYNE,WV,1693,1527,-166,0.47422360248447204
25571,WEST HAMLIN,WV,572,362,-210,0.3875802997858672
25601,LOGAN,WV,1412,1554,142,0.523937963587323
25601,WEST LOGAN,WV,156,168,12,0.5185185185185185
25607,AMHERSTDALE,WV,14,16,2,0.5333333333333333
25621,GILBERT,WV,24,76,52,0.76
25625,HOLDEN,WV,42,60,18,0.5882352941176471
25635,MAN,WV,115,162,47,0.5848375451263538
25637,MOUNT GAY,WV,30,13,-17,0.3023255813953488
25638,OMAR,WV,11,0,-11,0
25646,STOLLINGS,WV,44,13,-31,0.22807017543859648
25649,VERDUNVILLE,WV,0,29,29,1
25652,WHITMAN,WV,42,0,-42,0
25661,WILLIAMSON,WV,1679,1531,-148,0.4769470404984424
25669,CRUM,WV,11,0,-11,0
25670,DELBARTON,WV,691,686,-5,0.49818445896877267
25674,KERMIT,WV,221,189,-32,0.4609756097560976
25676,LENORE,WV,33,0,-33,0
25678,MATEWAN,WV,41,115,74,0.7371794871794872
25678,MEADOR,WV,22,34,12,0.6071428571428571
25701,HTGN,WV,192,176,-16,0.4782608695652174
25701,HUNTINGTON,WV,10029,8076,-1953,0.44606462303231154
25702,HUNTINGTON,WV,2749,2325,-424,0.45821836815135986
25703,HUNTINGTON,WV,3113,1618,-1495,0.341999577256394
25704,HUNTINGTON,WV,5890,4830,-1060,0.4505597014925373
25705,HUNTINGTON,WV,8538,7086,-1452,0.4535330261136713
25706,HUNTINGTON,WV,12,0,-12,0
25801,BECKLEY,WV,9899,9112,-787,0.4793014570511809
25802,BECKLEY,WV,585,224,-361,0.276885043263288
25812,ANSTED,WV,334,169,-165,0.3359840954274354
25813,BEAVER,WV,1167,1198,31,0.506553911205074
25813,GLEN MORGAN,WV,248,296,48,0.5441176470588235
25818,BRADLEY,WV,202,24,-178,0.10619469026548672
25823,COAL CITY,WV,111,94,-17,0.4585365853658537
25825,COOL RIDGE,WV,346,387,41,0.5279672578444747
25827,CRAB ORCHARD,WV,477,400,-77,0.45610034207525657
25832,DANIELS,WV,1546,1652,106,0.5165728580362726
25836,ECCLES,WV,22,0,-22,0
25839,FAIRDALE,WV,24,0,-24,0
25840,FAYETTEVILLE,WV,2148,1802,-346,0.4562025316455696
25841,FLAT TOP,WV,26,17,-9,0.3953488372093023
25843,GHENT,WV,36,91,55,0.7165354330708661
25844,GLEN DANIEL,WV,11,0,-11,0
25845,GLEN FORK,WV,12,0,-12,0
25848,GLEN ROGERS,WV,13,0,-13,0
25854,HICO,WV,11,24,13,0.6857142857142857
25865,LESTER,WV,50,17,-33,0.2537313432835821
25871,MABSCOTT,WV,164,69,-95,0.296137339055794
25873,MAC ARTHUR,WV,121,0,-121,0
25878,MIDWAY,WV,0,12,12,1
25880,MOUNT HOPE,WV,1669,1551,-118,0.4816770186335404
25882,MULLENS,WV,441,254,-187,0.36546762589928056
25901,OAK HILL,WV,3261,3084,-177,0.48605200945626476
25904,PAX,WV,14,0,-14,0
25909,PROSPERITY,WV,28,0,-28,0
25911,RALEIGH,WV,0,11,11,1
25917,SCARBRO,WV,516,318,-198,0.381294964028777
25918,SHADY SPRING,WV,1064,941,-123,0.4693266832917706
25921,SOPHIA,WV,414,413,-1,0.49939540507859737
25922,SPANISHBURG,WV,11,0,-11,0
25938,VICTOR,WV,0,12,12,1
25951,HINTON,WV,1597,1664,67,0.5102729224164366
25958,CHARMCO,WV,13,0,-13,0
25958,HINES,WV,11,0,-11,0
25962,RAINELLE,WV,1028,999,-29,0.49284657128761716
25969,JUMPING BRANCH,WV,26,39,13,0.6
25971,LERONA,WV,0,28,28,1
25976,MEADOW BRIDGE,WV,230,328,98,0.5878136200716846
25979,PIPESTEM,WV,35,33,-2,0.4852941176470588
25981,QUINWOOD,WV,32,22,-10,0.4074074074074074
25984,RUPERT,WV,478,400,-78,0.45558086560364464
25989,WHITE OAK,WV,0,11,11,1
26003,ELM GROVE,WV,291,262,-29,0.47377938517179025
26003,WARWOOD,WV,329,272,-57,0.4525790349417637
26003,WHEELING,WV,13425,12976,-449,0.49149653422218853
26030,BEECH BOTTOM,WV,11,14,3,0.56
26031,BENWOOD,WV,484,438,-46,0.4750542299349241
26032,BETHANY,WV,0,23,23,1
26033,CAMERON,WV,787,558,-229,0.41486988847583645
26034,CHESTER,WV,2105,1387,-718,0.3971935853379152
26035,COLLIERS,WV,335,383,48,0.5334261838440112
26037,FOLLANSBEE,WV,2190,1910,-280,0.4658536585365854
26038,GLEN DALE,WV,563,632,69,0.5288702928870292
26039,GLEN EASTON,WV,36,11,-25,0.23404255319148937
26040,MCMECHEN,WV,370,351,-19,0.4868238557558946
26041,MOUNDSVILLE,WV,5080,4862,-218,0.48903641118487223
26047,NEW CUMBERLAND,WV,1444,1452,8,0.5013812154696132
26050,NEWELL,WV,668,232,-436,0.2577777777777778
26055,PROCTOR,WV,109,41,-68,0.2733333333333333
26059,TRIADELPHIA,WV,1218,1133,-85,0.4819225861335602
26060,VALLEY GROVE,WV,91,149,58,0.6208333333333333
26062,WEIRTON,WV,7242,6919,-323,0.4885954381752701
26070,WELLSBURG,WV,2078,1932,-146,0.48179551122194514
26101,PARKERSBURG,WV,11501,10629,-872,0.48029823768639857
26102,PARKERSBURG,WV,103,138,35,0.5726141078838174
26103,PARKERSBURG,WV,0,12,12,1
26104,N PARKERSBURG,WV,113,96,-17,0.45933014354066987
26104,PARKERSBURG,WV,5771,5304,-467,0.4789164785553047
26105,VIENNA,WV,4668,4308,-360,0.4799465240641711
26133,BELLEVILLE,WV,54,116,62,0.6823529411764706
26134,BELMONT,WV,0,11,11,1
26136,BIG BEND,WV,0,13,13,1
26137,BIG SPRINGS,WV,12,0,-12,0
26142,DAVISVILLE,WV,454,478,24,0.5128755364806867
26143,ELIZABETH,WV,920,1032,112,0.5286885245901639
26146,BENS RUN,WV,11,11,0,0.5
26146,FRIENDLY,WV,68,66,-2,0.4925373134328358
26147,GRANTSVILLE,WV,617,529,-88,0.46160558464223383
26149,MIDDLEBOURNE,WV,644,506,-138,0.44
26150,MINERAL WELLS,WV,1781,1848,67,0.5092311931661615
26155,NEW MARTINSVILLE,WV,3237,2957,-280,0.47739748143364547
26159,PADEN CITY,WV,825,730,-95,0.4694533762057878
26160,PALESTINE,WV,26,0,-26,0
26161,PETROLEUM,WV,0,11,11,1
26164,RAVENSWOOD,WV,3067,2788,-279,0.4761742100768574
26167,READER,WV,12,0,-12,0
26170,SAINT MARYS,WV,1458,1415,-43,0.49251653324051514
26175,SISTERSVILLE,WV,924,910,-14,0.4961832061068702
26178,SMITHVILLE,WV,11,0,-11,0
26180,WALKER,WV,185,319,134,0.6329365079365079
26181,WASHINGTON,WV,1318,1392,74,0.5136531365313654
26184,WAVERLY,WV,433,236,-197,0.35276532137518685
26187,WILLIAMSTOWN,WV,1728,1731,3,0.5004336513443192
26201,BUCKHANNON,WV,7117,6537,-580,0.4787608026951809
26205,COTTLE,WV,27,30,3,0.5263157894736842
26205,CRAIGSVILLE,WV,978,910,-68,0.4819915254237288
26206,COWEN,WV,626,615,-11,0.49556809024979853
26208,CAMDEN ON GAULEY,WV,0,11,11,1
26209,SNOWSHOE,WV,45,0,-45,0
26217,DIANA,WV,24,0,-24,0
26218,FRENCH CREEK,WV,678,624,-54,0.4792626728110599
26234,ROCK CAVE,WV,38,60,22,0.6122448979591837
26237,TALLMANSVILLE,WV,12,0,-12,0
26241,ELKINS,WV,6284,5426,-858,0.46336464560204954
26250,BELINGTON,WV,1837,1708,-129,0.48180535966149507
26253,BEVERLY,WV,1209,1031,-178,0.4602678571428571
26257,COALTON,WV,29,29,0,0.5
26260,DAVIS,WV,469,516,47,0.5238578680203045
26261,RICHWOOD,WV,1109,797,-312,0.4181532004197272
26264,DURBIN,WV,36,15,-21,0.29411764705882354
26269,HAMBLETON,WV,11,0,-11,0
26270,HARMAN,WV,12,11,-1,0.4782608695652174
26273,HUTTONSVILLE,WV,12,0,-12,0
26275,JUNIOR,WV,11,0,-11,0
26278,MABIE,WV,12,0,-12,0
26280,MILL CREEK,WV,602,135,-467,0.18317503392130258
26283,MONTROSE,WV,97,125,28,0.5630630630630631
26287,PARSONS,WV,834,885,51,0.5148342059336823
26288,WEBSTER SPGS,WV,24,24,0,0.5
26288,WEBSTER SPRINGS,WV,1100,971,-129,0.4688556253017866
26291,SLATYFORK,WV,39,0,-39,0
26292,THOMAS,WV,103,102,-1,0.4975609756097561
26294,VALLEY HEAD,WV,17,0,-17,0
26301,CLARKSBURG,WV,9784,8165,-1619,0.45489999442865897
26301,NUTTER FORT,WV,556,465,-91,0.455435847208619
26302,CLARKSBURG,WV,338,288,-50,0.46006389776357826
26320,ALMA,WV,36,0,-36,0
26323,ANMOORE,WV,11,15,4,0.5769230769230769
26325,AUBURN,WV,12,0,-12,0
26330,BRIDGEPORT,WV,5973,5709,-264,0.4887005649717514
26335,BURNSVILLE,WV,126,121,-5,0.4898785425101215
26337,CAIRO,WV,75,82,7,0.5222929936305732
26342,COXS MILLS,WV,11,0,-11,0
26346,ELLENBORO,WV,18,27,9,0.6
26347,FLEMINGTON,WV,166,130,-36,0.4391891891891892
26351,GILMER,WV,24,17,-7,0.4146341463414634
26351,GLENVILLE,WV,1197,1124,-73,0.4842740198190435
26354,GRAFTON,WV,3550,3126,-424,0.4682444577591372
26361,GYPSY,WV,30,0,-30,0
26362,HARRISVILLE,WV,1181,908,-273,0.4346577309717568
26369,HEPZIBAH,WV,25,0,-25,0
26372,HORNER,WV,24,11,-13,0.3142857142857143
26374,INDEPENDENCE,WV,22,37,15,0.6271186440677966
26377,JACKSONBURG,WV,0,15,15,1
26378,JANE LEW,WV,1160,1165,5,0.5010752688172043
26384,LINN,WV,12,0,-12,0
26385,LOST CREEK,WV,749,865,116,0.5359355638166047
26386,LUMBERPORT,WV,460,317,-143,0.40797940797940796
26405,MOATSVILLE,WV,88,23,-65,0.2072072072072072
26408,MOUNT CLARE,WV,412,453,41,0.5236994219653179
26408,MT CLARE,WV,16,18,2,0.5294117647058824
26410,NEWBURG,WV,12,26,14,0.6842105263157895
26415,PENNSBORO,WV,888,848,-40,0.48847926267281105
26416,GRAFTON,WV,41,40,-1,0.49382716049382713
26416,PHILIPPI,WV,1926,1931,5,0.5006481721545243
26419,PINE GROVE,WV,27,12,-15,0.3076923076923077
26421,PULLMAN,WV,11,0,-11,0
26425,ROWLESBURG,WV,95,82,-13,0.4632768361581921
26426,BRISTOL,WV,36,32,-4,0.47058823529411764
26426,SALEM,WV,1720,1643,-77,0.48855188819506395
26430,SAND FORK,WV,0,24,24,1
26431,SHINNSTON,WV,1831,1735,-96,0.48653954010095346
26437,SMITHFIELD,WV,27,12,-15,0.3076923076923077
26440,THORNTON,WV,98,39,-59,0.2846715328467153
26444,TUNNELTON,WV,558,468,-90,0.45614035087719296
26447,ROANOKE,WV,49,52,3,0.5148514851485149
26447,WALKERSVILLE,WV,47,47,0,0.5
26448,WALLACE,WV,67,11,-56,0.14102564102564102
26451,WEST MILFORD,WV,62,27,-35,0.30337078651685395
26452,WESTON,WV,4189,3465,-724,0.4527044682518944
26456,WEST UNION,WV,1085,1175,90,0.5199115044247787
26501,MORGANTOWN,WV,7671,6626,-1045,0.4634538714415612
26501,WESTOVER,WV,522,474,-48,0.4759036144578313
26504,MORGANTOWN,WV,81,23,-58,0.22115384615384615
26504,STAR CITY,WV,13,0,-13,0
26505,MORGANTOWN,WV,22622,14486,-8136,0.39037404333297404
26507,MORGANTOWN,WV,167,136,-31,0.44884488448844884
26508,MORGANTOWN,WV,12935,12169,-766,0.4847434671765456
26519,ALBRIGHT,WV,318,198,-120,0.38372093023255816
26525,BRUCETON MILLS,WV,1510,1703,193,0.5300342359165888
26531,DELLSLOW,WV,570,132,-438,0.18803418803418803
26534,GRANVILLE,WV,106,169,63,0.6145454545454545
26537,KINGWOOD,WV,2180,1870,-310,0.4617283950617284
26541,CORE,WV,202,212,10,0.5120772946859904
26541,MAIDSVILLE,WV,587,589,2,0.5008503401360545
26542,MASONTOWN,WV,577,549,-28,0.48756660746003555
26546,PURSGLOVE,WV,11,0,-11,0
26547,REEDSVILLE,WV,868,671,-197,0.4359974009096816
26554,FAIRMONT,WV,14635,12382,-2253,0.4583040307954251
26555,FAIRMONT,WV,171,233,62,0.5767326732673267
26555,MONONGAH,WV,0,23,23,1
26559,BARRACKVILLE,WV,11,59,48,0.8428571428571429
26570,FAIRVIEW,WV,538,550,12,0.5055147058823529
26571,FARMINGTON,WV,343,154,-189,0.30985915492957744
26574,GRANT TOWN,WV,0,12,12,1
26575,HUNDRED,WV,36,46,10,0.5609756097560976
26582,MANNINGTON,WV,1224,1138,-86,0.48179508890770534
26588,RIVESVILLE,WV,645,604,-41,0.4835868694955965
26591,WORTHINGTON,WV,84,108,24,0.5625
26601,CENTRALIA,WV,33,29,-4,0.46774193548387094
26601,SUTTON,WV,1201,1147,-54,0.4885008517887564
26610,BIRCH RIVER,WV,11,23,12,0.6764705882352942
26621,FLATWOODS,WV,12,0,-12,0
26623,FRAMETOWN,WV,113,115,2,0.5043859649122807
26624,GASSAWAY,WV,892,782,-110,0.46714456391875747
26629,LITTLE BIRCH,WV,12,14,2,0.5384615384615384
26651,SUMMERSVILLE,WV,2991,2981,-10,0.4991627595445412
26662,CANVAS,WV,15,0,-15,0
26678,MOUNT LOOKOUT,WV,67,52,-15,0.4369747899159664
26679,MOUNT NEBO,WV,453,384,-69,0.45878136200716846
26681,NETTIE,WV,82,157,75,0.6569037656903766
26690,JODIE,WV,12,0,-12,0
26691,TIOGA,WV,11,0,-11,0
26704,AUGUSTA,WV,1534,1570,36,0.5057989690721649
26705,AURORA,WV,36,0,-36,0
26710,BURLINGTON,WV,257,207,-50,0.44612068965517243
26711,CAPON BRIDGE,WV,621,687,66,0.5252293577981652
26717,ELK GARDEN,WV,11,15,4,0.5769230769230769
26719,FORT ASHBY,WV,512,675,163,0.5686604886267902
26720,GORMANIA,WV,0,12,12,1
26726,KEYSER,WV,4031,3893,-138,0.49129227662796565
26743,NEW CREEK,WV,125,122,-3,0.4939271255060729
26750,PIEDMONT,WV,58,50,-8,0.46296296296296297
26753,RIDGELEY,WV,1521,1516,-5,0.4991768192295028
26757,ROMNEY,WV,2352,2088,-264,0.4702702702702703
26761,SHANKS,WV,11,33,22,0.75
26763,SPRINGFIELD,WV,295,233,-62,0.4412878787878788
26764,TERRA ALTA,WV,1817,1541,-276,0.4589041095890411
26767,WILEY FORD,WV,12,0,-12,0
26801,BAKER,WV,115,174,59,0.6020761245674741
26802,BRANDYWINE,WV,212,74,-138,0.25874125874125875
26807,FRANKLIN,WV,661,482,-179,0.4216972878390201
26808,HIGH VIEW,WV,11,28,17,0.717948717948718
26810,LOST CITY,WV,22,30,8,0.5769230769230769
26810,LOST RIVER,WV,13,11,-2,0.4583333333333333
26812,MATHIAS,WV,231,235,4,0.5042918454935622
26818,FISHER,WV,36,55,19,0.6043956043956044
26833,MAYSVILLE,WV,146,193,47,0.5693215339233039
26836,MOOREFIELD,WV,2797,2558,-239,0.4776844070961718
26845,OLD FIELDS,WV,14,29,15,0.6744186046511628
26847,PETERSBURG,WV,1952,1834,-118,0.4844162704701532
26851,WARDENSVILLE,WV,549,627,78,0.5331632653061225
26852,PURGITSVILLE,WV,0,22,22,1
26865,YELLOW SPRING,WV,0,27,27,1
26866,UPPER TRACT,WV,0,24,24,1
27006,ADVANCE,NC,3514,4636,1122,0.5688343558282208
27006,BERMUDA RUN,NC,402,505,103,0.5567805953693495
27007,ARARAT,NC,210,133,-77,0.3877551020408163
27009,BELEWS CREEK,NC,381,603,222,0.6128048780487805
27011,BOONVILLE,NC,1524,1487,-37,0.4938558618399203
27012,CLEMMONS,NC,9351,11228,1877,0.5456047426988678
27013,CLEVELAND,NC,1479,1764,285,0.543940795559667
27014,COOLEEMEE,NC,660,102,-558,0.13385826771653545
27016,DANBURY,NC,49,108,59,0.6878980891719745
27017,DOBSON,NC,2106,1882,-224,0.4719157472417252
27018,EAST BEND,NC,1590,1793,203,0.5300029559562518
27019,GERMANTON,NC,931,988,57,0.5148514851485149
27020,HAMPTONVILLE,NC,1158,1319,161,0.5324989907145741
27021,KING,NC,4492,5139,647,0.5335894507320113
27022,LAWSONVILLE,NC,71,21,-50,0.22826086956521738
27023,LEWISVILLE,NC,3466,4294,828,0.5533505154639176
27024,LOWGAP,NC,388,602,214,0.6080808080808081
27025,MADISON,NC,2629,2810,181,0.5166390880676595
27027,MAYODAN,NC,1464,1304,-160,0.47109826589595377
27028,MOCKSVILLE,NC,7412,8110,698,0.5224842159515526
27030,MOUNT AIRY,NC,10794,10305,-489,0.48841177306981376
27040,PFAFFTOWN,NC,3195,4200,1005,0.5679513184584178
27041,PILOT MOUNTAIN,NC,1803,1779,-24,0.4966499162479062
27041,PILOT MTN,NC,364,367,3,0.5020519835841313
27043,PINNACLE,NC,1428,1759,331,0.5519297144650142
27045,RURAL HALL,NC,3141,3711,570,0.5415936952714536
27046,SANDY RIDGE,NC,355,278,-77,0.4391785150078989
27047,SILOAM,NC,13,22,9,0.6285714285714286
27048,STONEVILLE,NC,1887,2097,210,0.526355421686747
27049,TOAST,NC,70,54,-16,0.43548387096774194
27050,TOBACCOVILLE,NC,876,1071,195,0.5500770416024653
27051,WALKERTOWN,NC,2829,3195,366,0.5303784860557769
27052,WALNUT COVE,NC,2123,2467,344,0.5374727668845316
27053,BURLINGTON,NC,0,23,23,1
27053,WESTFIELD,NC,388,633,245,0.6199804113614104
27054,WOODLEAF,NC,656,700,44,0.5162241887905604
27055,YADKINVILLE,NC,3681,3494,-187,0.48696864111498256
27101,WINSTON SALEM,NC,13755,11302,-2453,0.45105160234664965
27102,WINSTON SALEM,NC,70,534,464,0.8841059602649006
27103,WINSTON SALEM,NC,21249,17465,-3784,0.45112879061838096
27104,WINSTON SALEM,NC,14509,13176,-1333,0.47592559147552826
27105,WINSTON SALEM,NC,13720,12092,-1628,0.46846428017976133
27106,WINSTON SALEM,NC,22065,20303,-1762,0.4792060045317221
27107,WINSTON SALEM,NC,14706,13331,-1375,0.4754788315440311
27114,WINSTON SALEM,NC,278,765,487,0.7334611697027804
27116,WINSTON SALEM,NC,145,475,330,0.7661290322580645
27117,WINSTON SALEM,NC,11,107,96,0.9067796610169492
27120,WINSTON SALEM,NC,12,25,13,0.6756756756756757
27127,WINSTON SALEM,NC,15880,15038,-842,0.48638333656769517
27130,WINSTON SALEM,NC,0,12,12,1
27201,ALAMANCE,NC,12,0,-12,0
27203,ASHEBORO,NC,11704,7895,-3809,0.4028266748303485
27204,ASHEBORO,NC,1031,1052,21,0.5050408065290446
27205,ASHEBORO,NC,9178,8527,-651,0.4816153628918385
27207,BEAR CREEK,NC,848,628,-220,0.4254742547425474
27208,BENNETT,NC,89,109,20,0.5505050505050505
27209,BISCOE,NC,702,737,35,0.5121612230715775
27212,BLANCH,NC,35,72,37,0.6728971962616822
27214,BROWNS SUMMIT,NC,3558,3894,336,0.5225442834138486
27215,BURLINGTON,NC,18474,18434,-40,0.49945811206242546
27216,BURLINGTON,NC,519,951,432,0.6469387755102041
27217,BURLINGTON,NC,9802,10352,550,0.5136449340081374
27229,CANDOR,NC,1037,543,-494,0.34367088607594937
27231,CEDAR GROVE,NC,132,359,227,0.7311608961303462
27233,CLIMAX,NC,626,759,133,0.548014440433213
27235,COLFAX,NC,1567,2265,698,0.5910751565762005
27239,DENTON,NC,2218,2533,315,0.5331509155967165
27242,EAGLE SPRINGS,NC,223,91,-132,0.2898089171974522
27243,EFLAND,NC,975,1200,225,0.5517241379310345
27244,ELON,NC,2713,3158,445,0.5378981434167944
27248,FRANKLINVILLE,NC,1197,1146,-51,0.48911651728553135
27249,GIBSONVILLE,NC,3942,4219,277,0.5169709594412449
27252,GOLDSBORO,NC,11,13,2,0.5416666666666666
27252,GOLDSTON,NC,217,176,-41,0.44783715012722647
27253,GRAHAM,NC,9723,10782,1059,0.5258229700073153
27258,HAW RIVER,NC,1757,2135,378,0.5485611510791367
27260,HIGH POINT,NC,11085,9391,-1694,0.4586344989255714
27261,HIGH POINT,NC,623,1103,480,0.6390498261877172
27262,HIGH POINT,NC,10061,9010,-1051,0.47244507367206756
27263,ARCHDALE,NC,3883,3214,-669,0.45286740876426657
27263,HIGH POINT,NC,4505,3474,-1031,0.4353929063792455
27265,HIGH POINT,NC,21596,19537,-2059,0.47497143412831544
27278,HILLSBOROUGH,NC,8700,10348,1648,0.5432591348173037
27281,FOXFIRE VILLAGE,NC,117,158,41,0.5745454545454546
27281,JACKSON SPGS,NC,46,73,27,0.6134453781512605
27281,JACKSON SPRINGS,NC,527,867,340,0.6219512195121951
27282,JAMESTOWN,NC,6569,6699,130,0.5048990051251131
27283,ASHEBORO,NC,13,0,-13,0
27283,DENTON,NC,13,25,12,0.6578947368421053
27283,JULIAN,NC,408,593,185,0.5924075924075924
27284,KERNERSVILLE,NC,19350,20704,1354,0.5169021820542268
27285,HAW RIVER,NC,20,16,-4,0.4444444444444444
27285,KERNERSVILLE,NC,601,668,67,0.5263987391646966
27288,EDEN,NC,9290,8090,-1200,0.4654775604142693
27289,EDEN,NC,80,186,106,0.6992481203007519
27291,LEASBURG,NC,153,254,101,0.6240786240786241
27292,LEXINGTON,NC,11492,12206,714,0.5150645624103299
27293,LEXINGTON,NC,438,649,211,0.5970561177552898
27295,LEXINGTON,NC,10150,11567,1417,0.5326242114472532
27298,LIBERTY,NC,2333,2723,390,0.5385680379746836
27299,LINWOOD,NC,1589,1642,53,0.5082017951098731
27301,MC LEANSVILLE,NC,2665,2785,120,0.5110091743119266
27302,MEBANE,NC,11876,13668,1792,0.5350767303476355
27305,MILTON,NC,40,76,36,0.6551724137931034
27306,MOUNT GILEAD,NC,1579,2000,421,0.5588153115395362
27310,OAK RIDGE,NC,1811,2551,740,0.5848234754699679
27311,PELHAM,NC,677,768,91,0.5314878892733564
27312,PITTSBORO,NC,6007,8315,2308,0.5805753386398548
27313,PLEASANT GARDEN,NC,1615,1676,61,0.5092676997872987
27313,PLEASANT GDN,NC,243,191,-52,0.4400921658986175
27314,PROSPECT HILL,NC,0,28,28,1
27315,PROVIDENCE,NC,114,225,111,0.6637168141592921
27316,RAMSEUR,NC,1854,1783,-71,0.49023920813857574
27317,RANDLEMAN,NC,4764,4954,190,0.5097756740069973
27320,REIDSVILLE,NC,11739,11199,-540,0.48822913941930424
27323,REIDSVILLE,NC,163,394,231,0.7073608617594255
27325,ROBBINS,NC,1251,1048,-203,0.4558503697259678
27326,RUFFIN,NC,771,894,123,0.5369369369369369
27330,SANFORD,NC,11925,22301,10376,0.6515806696663355
27331,SANFORD,NC,491,794,303,0.6178988326848249
27332,SANFORD,NC,11139,12132,993,0.5213355678741781
27340,SAXAPAHAW,NC,0,86,86,1
27341,SEAGROVE,NC,906,1118,212,0.5523715415019763
27343,SEMORA,NC,178,261,83,0.5945330296127562
27344,SILER CITY,NC,4247,4070,-177,0.4893591439220873
27349,SNOW CAMP,NC,1517,1666,149,0.5234055922086083
27350,SOPHIA,NC,1351,1608,257,0.5434268333896587
27351,SOUTHMONT,NC,11,11,0,0.5
27355,STALEY,NC,314,355,41,0.5306427503736921
27356,STAR,NC,728,727,-1,0.49965635738831615
27357,STOKESDALE,NC,2185,3025,840,0.5806142034548945
27358,SUMMERFIELD,NC,3390,4192,802,0.5528884199419678
27360,THOMASVILLE,NC,14005,13913,-92,0.4983523175012537
27361,THOMASVILLE,NC,994,683,-311,0.40727489564698865
27370,TRINITY,NC,3633,4479,846,0.5521449704142012
27371,TROY,NC,1995,1927,-68,0.49133095359510454
27373,WALLBURG,NC,12,0,-12,0
27374,WELCOME,NC,91,195,104,0.6818181818181818
27376,WEST END,NC,2766,3759,993,0.5760919540229885
27377,WHITSETT,NC,4325,5291,966,0.5502287853577371
27379,YANCEYVILLE,NC,994,1129,135,0.5317946302402261
27401,GREENSBORO,NC,10739,8278,-2461,0.4352947362885839
27402,GREENSBORO,NC,162,652,490,0.800982800982801
27403,GREENSBORO,NC,9482,7029,-2453,0.42571618920719523
27404,GREENSBORO,NC,384,401,17,0.510828025477707
27405,GREENSBORO,NC,21292,19218,-2074,0.4744013823747223
27406,GREENSBORO,NC,27258,21084,-6174,0.43614248479582973
27407,GREENSBORO,NC,24501,20630,-3871,0.45711373556978574
27408,GREENSBORO,NC,7532,7919,387,0.5125234612646431
27409,GREENSBORO,NC,12207,10455,-1752,0.4613449827905745
27410,GREENSBORO,NC,26133,25033,-1100,0.4892506742758863
27415,GREENSBORO,NC,317,732,415,0.69780743565300285
27416,GREENSBORO,NC,286,533,247,0.6507936507936508
27417,GREENSBORO,NC,138,449,311,0.7649063032367973
27419,GREENSBORO,NC,850,1185,335,0.5823095823095823
27420,GREENSBORO,NC,0,173,173,1
27429,GREENSBORO,NC,16,33,17,0.673469387755102
27435,GREENSBORO,NC,11,108,97,0.907563025210084
27438,GREENSBORO,NC,329,716,387,0.6851674641148325
27455,GREENSBORO,NC,14045,12979,-1066,0.48027679100059206
27501,ANGIER,NC,5833,7019,1186,0.5461406784936197
27502,APEX,NC,14403,19113,4710,0.5702649480844969
27503,BAHAMA,NC,677,860,183,0.5595315549772284
27504,BENSON,NC,4686,5896,1210,0.5571725571725572
27505,BROADWAY,NC,2280,2365,85,0.5091496232508074
27505,KNIGTDALE,NC,33,52,19,0.611764705882353
27506,BUIES CREEK,NC,611,25,-586,0.03930817610062893
27507,BULLOCK,NC,103,131,28,0.5598290598290598
27508,BUNN,NC,594,747,153,0.5570469798657718
27509,BUTNER,NC,1186,1193,7,0.5014712063892391
27510,CARRBORO,NC,12235,8869,-3366,0.42025208491281274
27510,CARY,NC,152,156,4,0.5064935064935064
27511,CARY,NC,13596,12356,-1240,0.47610974106041926
27512,CARY,NC,784,1314,530,0.6263107721639657
27513,CARY,NC,22860,21888,-972,0.4891391794046661
27514,CHAPEL HILL,NC,15396,13095,-2301,0.4596188269979994
27515,BURLINGTON,NC,0,18,18,1
27515,CHAPEL HILL,NC,518,617,99,0.5436123348017621
27516,CHAPEL HILL,NC,16054,16659,605,0.5092470883135145
27517,CHAPEL HILL,NC,13788,14455,667,0.5118082356690153
27518,CARY,NC,9873,10173,300,0.5074827895839569
27519,CARY,NC,27259,31342,4083,0.53483728946605
27520,CLAYTON,NC,16860,19012,2152,0.5299955396966993
27521,COATS,NC,1612,1726,114,0.5170760934691432
27521,F V,NC,71,98,27,0.5798816568047337
27522,CREEDMOOR,NC,4135,4442,307,0.5178967004780226
27523,APEX,NC,6497,11052,4555,0.6297794746139381
27524,FOUR OAKS,NC,3337,3950,613,0.5420612048854124
27525,FRANKLINTON,NC,4426,6586,2160,0.5980748274609516
27526,FUQUAY VARINA,NC,17946,25936,7990,0.591039606216672
27527,CLAYTON,NC,11454,17079,5625,0.5985700767532331
27528,CLAYTON,NC,801,1152,351,0.5898617511520737
27529,GARNER,NC,21574,24328,2754,0.5299986928674132
27530,GOLDSBORO,NC,13184,13433,249,0.5046774617725514
27531,GOLDSBORO,NC,0,13,13,1
27532,GOLDSBORO,NC,199,427,228,0.6821086261980831
27533,GOLDSBORO,NC,258,413,155,0.6154992548435171
27534,GOLDSBORO,NC,14522,12661,-1861,0.4657690468307398
27536,HENDERSON,NC,8505,6022,-2483,0.41453844565292214
27537,HENDERSON,NC,4956,5427,471,0.5226813059809303
27539,APEX,NC,7589,8659,1070,0.5329271294928607
27540,HOLLY SPRINGS,NC,13324,19056,5732,0.5885114268066708
27541,HURDLE MILLS,NC,565,873,308,0.6070931849791377
27542,KENLY,NC,2499,2597,98,0.5096153846153846
27544,KITTRELL,NC,1150,929,-221,0.44684944684944683
27545,KNIGHTDALE,NC,14772,13429,-1343,0.4761887876316443
27546,LILLINGTON,NC,6508,7275,767,0.5278241311760865
27549,LOUISBURG,NC,6232,6796,564,0.5216456862143076
27551,MACON,NC,237,682,445,0.7421109902067464
27553,MANSON,NC,162,278,116,0.6318181818181818
27555,MICRO,NC,124,79,-45,0.3891625615763547
27557,MIDDLESEX,NC,2009,2239,230,0.5270715630885122
27559,MONCURE,NC,453,691,238,0.6040209790209791
27560,MORRISVILLE,NC,28134,27459,-675,0.4939290917921321
27562,NEW HILL,NC,858,2455,1597,0.7410202233625113
27563,NORLINA,NC,1263,1198,-65,0.48679398618447783
27565,OXFORD,NC,7164,6559,-605,0.4779567150040079
27568,PINE LEVEL,NC,49,104,55,0.6797385620915033
27569,PRINCETON,NC,2404,2660,256,0.5252764612954186
27571,ROLESVILLE,NC,2250,3037,787,0.5744278418763004
27572,ROUGEMONT,NC,1333,1598,265,0.5452064141931081
27573,ROXBORO,NC,3857,3850,-7,0.49954586739327883
27574,ROXBORO,NC,2666,3117,451,0.5389936019367111
27576,SELMA,NC,6272,5523,-749,0.4682492581602374
27577,SMITHFIELD,NC,7370,8233,863,0.5276549381529193
27581,STEM,NC,1182,965,-217,0.44946436888681884
27582,STOVALL,NC,0,16,16,1
27583,TIMBERLAKE,NC,1575,1769,194,0.5290071770334929
27587,WAKE FOREST,NC,23039,29640,6601,0.5626530496023083
27588,WAKE FOREST,NC,776,836,60,0.5186104218362283
27589,WARRENTON,NC,1677,1736,59,0.5086434222092001
27591,WENDELL,NC,6494,9847,3353,0.6025947004467291
27592,WILLOW SPRING,NC,4381,5473,1092,0.5554089709762533
27596,YOUNGSVILLE,NC,5846,8389,2543,0.5893220934316825
27597,ZEBULON,NC,7404,10995,3591,0.5975868253709441
27601,RALEIGH,NC,7802,6506,-1296,0.4547106513838412
27602,RALEIGH,NC,141,131,-10,0.48161764705882354
27603,RALEIGH,NC,25126,23344,-1782,0.4816174953579534
27604,BRENTWOOD,NC,541,502,-39,0.4813039309683605
27604,RALEIGH,NC,21733,19461,-2272,0.4724231684225858
27605,RALEIGH,NC,6611,5464,-1147,0.45250517598343687
27606,RALEIGH,NC,32112,24195,-7917,0.4296979061217966
27607,RALEIGH,NC,14188,11728,-2460,0.45253897206359006
27608,RALEIGH,NC,5152,4461,-691,0.46405908665349005
27609,RALEIGH,NC,22632,20324,-2308,0.4731353012384766
27610,RALEIGH,NC,26882,25754,-1128,0.48928490006839426
27611,RALEIGH,NC,688,1342,654,0.6610837438423646
27612,RALEIGH,NC,25584,23422,-2162,0.47794147655389135
27613,RALEIGH,NC,19263,18625,-638,0.49158044763513514
27614,RALEIGH,NC,12658,13644,986,0.5187438217626036
27615,RALEIGH,NC,18721,18555,-166,0.497773366241013
27616,RALEIGH,NC,25096,25648,552,0.5054390666876872
27617,LOUISBURG,NC,267,239,-28,0.4723320158102767
27617,RALEIGH,NC,15934,14501,-1433,0.4764580252998193
27619,RALEIGH,NC,87,174,87,0.6666666666666666
27620,RALEIGH,NC,434,850,416,0.661993769470405
27622,RALEIGH,NC,123,88,-35,0.41706161137440756
27623,RALEIGH,NC,14,110,96,0.8870967741935484
27624,RALEIGH,NC,712,1162,450,0.6200640341515475
27627,RALEIGH,NC,237,419,182,0.6387195121951219
27628,RALEIGH,NC,31,11,-20,0.2619047619047619
27629,RALEIGH,NC,163,743,580,0.8200883002207505
27636,RALEIGH,NC,30,184,154,0.8598130841121495
27658,RALEIGH,NC,239,238,-1,0.4989517819706499
27661,RALEIGH,NC,34,24,-10,0.41379310344827586
27675,RALEIGH,NC,286,496,210,0.6342710997442456
27701,DURHAM,NC,16584,14593,-1991,0.4680694101420919
27702,DURHAM,NC,222,681,459,0.7541528239202658
27703,DURHAM,NC,26960,31541,4581,0.5391531768687715
27704,DURHAM,NC,16373,14359,-2014,0.46723285175061824
27705,DURHAM,NC,26673,21613,-5060,0.4476038603321874
27707,DURHAM,NC,26875,24092,-2783,0.4726980202876371
27709,DURHAM,NC,485,702,217,0.5914069081718618
27709,RESEARCH TRIANGLE PARK,NC,118,200,82,0.6289308176100629
27709,RTP,NC,12,12,0,0.5
27712,DURHAM,NC,5177,6187,1010,0.5444385779655051
27713,DURHAM,NC,28195,27319,-876,0.49211009835356845
27715,DURHAM,NC,300,483,183,0.6168582375478927
27717,DURHAM,NC,438,821,383,0.6521048451151708
27722,DURHAM,NC,74,37,-37,0.3333333333333333
27801,ROCKY MOUNT,NC,6637,5978,-659,0.473880301228696
27802,ROCKY MOUNT,NC,212,567,355,0.7278562259306803
27803,ROCKY MOUNT,NC,6276,6485,209,0.5081890134002037
27804,ROCKY MOUNT,NC,10976,10925,-51,0.4988356696041277
27805,AULANDER,NC,1039,805,-234,0.43655097613882865
27806,AURORA,NC,603,668,65,0.5255704169944925
27807,BAILEY,NC,1559,1618,59,0.5092854894554611
27808,BATH,NC,685,790,105,0.535593220338983
27809,BATTLEBORO,NC,906,932,26,0.5070729053318824
27810,BELHAVEN,NC,1245,1267,22,0.5043789808917197
27811,BELLARTHUR,NC,0,11,11,1
27812,BETHEL,NC,379,346,-33,0.4772413793103448
27813,BLACK CREEK,NC,46,52,6,0.5306122448979592
27814,BLOUNTS CREEK,NC,171,307,136,0.6422594142259415
27816,CASTALIA,NC,369,388,19,0.512549537648613
27817,CHOCOWINITY,NC,2285,2550,265,0.5274043433298863
27818,COMO,NC,11,25,14,0.6944444444444444
27820,CONWAY,NC,318,315,-3,0.4976303317535545
27821,EDWARD,NC,11,0,-11,0
27822,ELM CITY,NC,1837,1983,146,0.5191099476439791
27823,ENFIELD,NC,1310,1386,76,0.5140949554896143
27824,ENGELHARD,NC,282,201,-81,0.4161490683229814
27828,FARMVILLE,NC,2528,2704,176,0.5168195718654435
27829,FOUNTAIN,NC,123,190,67,0.6070287539936102
27830,EUREKA,NC,61,56,-5,0.47863247863247865
27830,FREMONT,NC,843,1018,175,0.5470177324019344
27831,GARYSBURG,NC,495,506,11,0.5054945054945055
27832,GASTON,NC,453,460,7,0.5038335158817087
27833,GREENVILLE,NC,128,497,369,0.7952
27834,GREENVILLE,NC,25619,22796,-2823,0.47084581224827016
27835,GREENVILLE,NC,214,354,140,0.6232394366197183
27836,GREENVILLE,NC,55,181,126,0.7669491525423728
27837,GRIMESLAND,NC,1249,1610,361,0.5631339629240993
27839,HALIFAX,NC,347,394,47,0.5317139001349528
27842,HENRICO,NC,562,545,-17,0.49232158988256547
27843,HOBGOOD,NC,15,0,-15,0
27844,HOLLISTER,NC,415,316,-99,0.4322845417236662
27845,JACKSON,NC,88,135,47,0.6053811659192825
27846,JAMESVILLE,NC,632,523,-109,0.45281385281385284
27847,KELFORD,NC,17,0,-17,0
27849,LEWISTON,NC,62,40,-22,0.39215686274509803
27849,LEWISTON WOODVILLE,NC,96,53,-43,0.35570469798657717
27850,LITTLETON,NC,2132,2337,205,0.5229357798165137
27851,LUCAMA,NC,1470,1195,-275,0.44840525328330205
27852,MACCLESFIELD,NC,376,554,178,0.5956989247311828
27855,MURFREESBORO,NC,1357,1320,-37,0.49308927904370564
27856,NASHVILLE,NC,3837,4240,403,0.5249473814535099
27857,OAK CITY,NC,23,64,41,0.735632183908046
27858,GREENVILLE,NC,23522,20436,-3086,0.4648983120251149
27860,PANTEGO,NC,225,181,-44,0.4458128078817734
27863,PIKEVILLE,NC,3892,4325,433,0.526347815504442
27864,PINETOPS,NC,1025,1080,55,0.5130641330166271
27865,PINETOWN,NC,265,182,-83,0.407158836689038
27869,RICH SQUARE,NC,235,193,-42,0.45093457943925236
27870,ROANOKE RAPIDS,NC,8634,7978,-656,0.48025523717794366
27871,ROBERSONVILLE,NC,1016,1067,51,0.5122419587133942
27874,SCOTLAND NECK,NC,1115,1037,-78,0.48187732342007433
27875,SCRANTON,NC,12,31,19,0.7209302325581395
27876,SEABOARD,NC,65,91,26,0.5833333333333334
27878,SHARPSBURG,NC,739,652,-87,0.46872753414809487
27879,SIMPSON,NC,0,25,25,1
27880,SIMS,NC,466,637,171,0.5775158658204895
27882,SPRING HOPE,NC,1727,1934,207,0.5282709642174269
27883,STANTONSBURG,NC,635,874,239,0.5791915175612988
27884,STOKES,NC,51,66,15,0.5641025641025641
27885,SWANQUARTER,NC,37,22,-15,0.3728813559322034
27886,TARBORO,NC,5304,5251,-53,0.4974893415442918
27888,WALSTONBURG,NC,200,255,55,0.5604395604395604
27889,WASHINGTON,NC,7898,8444,546,0.5167054216130217
27890,WELDON,NC,807,579,-228,0.41774891774891776
27891,WHITAKERS,NC,882,1022,140,0.5367647058823529
27892,WILLIAMSTON,NC,3582,3583,1,0.500069783670621
27893,WILSON,NC,13062,11909,-1153,0.47691321933442793
27894,WILSON,NC,193,421,228,0.6856677524429967
27895,WILSON,NC,58,104,46,0.6419753086419753
27896,WILSON,NC,6457,6644,187,0.5071368597816961
27897,WOODLAND,NC,360,347,-13,0.4908062234794908
27906,ELIZABETH CITY,NC,265,560,295,0.6787878787878788
27909,ELIZABETH CITY,NC,14018,14280,262,0.5046293024241996
27910,AHOSKIE,NC,3212,2787,-425,0.46457742957159526
27915,AVON,NC,263,416,153,0.6126656848306333
27916,AYDLETT,NC,0,82,82,1
27917,BARCO,NC,37,27,-10,0.421875
27919,BELVIDERE,NC,48,39,-9,0.4482758620689655
27920,BUXTON,NC,438,373,-65,0.4599260172626387
27921,CAMDEN,NC,1323,1584,261,0.544891640866873
27923,COINJOCK,NC,50,46,-4,0.4791666666666667
27924,COLERAIN,NC,299,377,78,0.5576923076923077
27925,COLUMBIA,NC,1227,955,-272,0.4376718606782768
27926,CORAPEAKE,NC,164,231,67,0.5848101265822785
27927,COROLLA,NC,1164,1435,271,0.5521354367064255
27928,CRESWELL,NC,296,252,-44,0.45985401459854014
27929,CURRITUCK,NC,372,429,57,0.5355805243445693
27932,EDENTON,NC,4062,4415,353,0.5208210451810782
27935,EURE,NC,149,121,-28,0.44814814814814813
27936,FRISCO,NC,162,278,116,0.6318181818181818
27937,GATES,NC,892,898,6,0.5016759776536313
27938,GATESVILLE,NC,77,150,73,0.6607929515418502
27939,GRANDY,NC,1050,1231,181,0.5396755808855765
27941,HARBINGER,NC,33,60,27,0.6451612903225806
27943,HATTERAS,NC,11,92,81,0.8932038834951457
27944,HERTFORD,NC,3466,4196,730,0.5476376925084834
27946,HOBBSVILLE,NC,25,15,-10,0.375
27947,JARVISBURG,NC,130,209,79,0.616519174041298
27948,KILL DEVIL HILLS,NC,5960,6132,172,0.5071121402580219
27949,DUCK,NC,88,91,3,0.5083798882681564
27949,KITTY HAWK,NC,4148,4605,457,0.5261053353136068
27949,SOUTHERN SHORES,NC,87,102,15,0.5396825396825397
27950,KNOTTS ISLAND,NC,617,610,-7,0.4971475142624287
27953,MANNS HARBOR,NC,0,22,22,1
27954,MANTEO,NC,2620,2538,-82,0.49205118262892594
27956,MAPLE,NC,11,0,-11,0
27957,MERRY HILL,NC,138,132,-6,0.4888888888888889
27958,MOYOCK,NC,3803,5146,1343,0.5750363169069169
27959,NAGS HEAD,NC,1996,1910,-86,0.48899129544290837
27960,OCRACOKE,NC,117,171,54,0.59375
27962,PLYMOUTH,NC,1973,2019,46,0.5057615230460922
27964,POINT HARBOR,NC,38,53,15,0.5824175824175825
27966,POWELLS POINT,NC,420,341,-79,0.4480946123521682
27968,RODANTHE,NC,156,292,136,0.6517857142857143
27970,ROPER,NC,431,583,152,0.5749506903353058
27973,SHAWBORO,NC,290,535,245,0.6484848484848484
27974,SHILOH,NC,83,117,34,0.585
27976,SOUTH MILLS,NC,1016,1252,236,0.5520282186948854
27979,SUNBURY,NC,278,84,-194,0.23204419889502761
27980,TYNER,NC,140,298,158,0.680365296803653
27981,WANCHESE,NC,389,247,-142,0.38836477987421386
27983,WINDSOR,NC,1651,1672,21,0.5031597953656335
27986,WINTON,NC,79,12,-67,0.13186813186813187
28001,ALBEMARLE,NC,8204,8520,316,0.5094475005979431
28002,ALBEMARLE,NC,258,475,217,0.6480218281036835
28006,ALEXIS,NC,16,120,104,0.8823529411764706
28009,BADIN,NC,102,128,26,0.5565217391304348
28012,BELMONT,NC,10792,13170,2378,0.549620232034054
28016,BESSEMER CITY,NC,4474,4504,30,0.501670750723992
28017,BOILING SPGS,NC,11,0,-11,0
28017,BOILING SPRINGS,NC,209,11,-198,0.05
28018,BOSTIC,NC,1259,1510,251,0.5453232213795594
28018,HUNTERSVILLE,NC,26,28,2,0.5185185185185185
28020,CASAR,NC,254,360,106,0.5863192182410424
28021,CHERRYVILLE,NC,3959,4045,86,0.5053723138430785
28023,CHINA GROVE,NC,3580,4032,452,0.5296899632159747
28025,CONCORD,NC,19310,20229,919,0.5116214370621411
28026,CONCORD,NC,252,561,309,0.6900369003690037
28027,CONCORD,NC,31609,34374,2765,0.5209523665186487
28031,CORNELIUS,NC,16222,16453,231,0.5035348125478194
28032,CRAMERTON,NC,1407,1453,46,0.5080419580419581
28032,DENVER,NC,30,37,7,0.5522388059701493
28033,CROUSE,NC,676,894,218,0.5694267515923567
28034,DALLAS,NC,6433,6908,475,0.5178022636983735
28036,DAVIDSON,NC,7513,9279,1766,0.5525845640781324
28037,DENVER,NC,8761,13307,4546,0.60299981874207
28038,EARL,NC,16,0,-16,0
28039,EAST SPENCER,NC,12,0,-12,0
28040,ELLENBORO,NC,1966,2199,233,0.5279711884753902
28041,FAITH,NC,26,56,30,0.6829268292682927
28042,FALLSTON,NC,11,0,-11,0
28043,FOREST CITY,NC,6258,6297,39,0.5015531660692951
28052,GASTONIA,NC,14033,13520,-513,0.49069066889267954
28053,GASTONIA,NC,317,772,455,0.7089072543617998
28054,GASTONIA,NC,18187,16914,-1273,0.48186661348679527
28055,GASTONIA,NC,120,507,387,0.8086124401913876
28056,GASTONIA,NC,9847,11023,1176,0.5281744130330618
28070,HUNTERSVILLE,NC,805,1306,501,0.6186641402179062
28071,GOLD HILL,NC,657,760,103,0.5363443895553988
28072,GRANITE QUARRY,NC,45,47,2,0.5108695652173914
28073,GROVER,NC,1990,1672,-318,0.4565811032222829
28075,HARRISBURG,NC,5300,6673,1373,0.557337342353629
28077,HIGH SHOALS,NC,51,26,-25,0.33766233766233766
28078,HUNTERSVILLE,NC,28570,33386,4816,0.5388662922073729
28079,INDIAN TRAIL,NC,14146,15598,1452,0.5244082840236687
28080,IRON STATION,NC,1915,2614,699,0.5771693530580703
28081,KANNAPOLIS,NC,9126,9980,854,0.5223490003140375
28082,KANNAPOLIS,NC,215,411,196,0.6565495207667732
28083,KANNAPOLIS,NC,9024,9203,179,0.5049102979096944
28086,KINGS MOUNTAIN,NC,8831,8919,88,0.5024788732394366
28086,KINGS MTN,NC,419,305,-114,0.4212707182320442
28088,LANDIS,NC,1263,1384,121,0.5228560634680771
28090,LAWNDALE,NC,1859,1924,65,0.5085910652920962
28091,LILESVILLE,NC,158,276,118,0.6359447004608295
28092,LINCOLNTON,NC,12479,12462,-17,0.4996591957018564
28093,LINCOLNTON,NC,283,445,162,0.6112637362637363
28097,LOCUST,NC,2046,2820,774,0.5795314426633785
28098,LOWELL,NC,1447,1453,6,0.5010344827586207
28101,MC ADENVILLE,NC,97,103,6,0.515
28103,MARSHVILLE,NC,2216,2694,478,0.5486761710794298
28104,MATTHEWS,NC,7878,10595,2717,0.573539760731879
28104,STALLINGS,NC,138,195,57,0.5855855855855856
28104,WEDDINGTON,NC,202,257,55,0.5599128540305011
28105,MATTHEWS,NC,17135,18367,1232,0.5173511351473157
28106,MATTHEWS,NC,983,1303,320,0.5699912510936133
28107,MIDLAND,NC,2264,3238,974,0.58851326790258085
28108,MINERAL SPRINGS,NC,27,17,-10,0.38636363636363635
28110,MONROE,NC,15395,17051,1656,0.5255193244159526
28111,MONROE,NC,510,847,337,0.6241709653647752
28112,MONROE,NC,6899,7175,276,0.5098053147648145
28114,MOORESBORO,NC,1735,1901,166,0.5228272827282728
28115,MOORESVILLE,NC,15985,18507,2522,0.5365592021338281
28117,MOORESVILLE,NC,23727,26807,3080,0.5304745319982586
28119,MORVEN,NC,357,277,-80,0.43690851735015773
28120,MOUNT HOLLY,NC,7722,8884,1162,0.5349873539684451
28120,MT HOLLY,NC,376,452,76,0.5458937198067633
28120,SHELBY,NC,161,225,64,0.582901554404145
28123,MOUNT MOURNE,NC,0,13,13,1
28124,MOUNT PLEASANT,NC,1663,1864,201,0.5284944712220017
28124,MT PLEASANT,NC,23,37,14,0.6166666666666667
28125,MOUNT ULLA,NC,427,705,278,0.622791519434629
28126,NEWELL,NC,0,11,11,1
28127,NEW LONDON,NC,1867,2285,418,0.5503371868978806
28128,NORWOOD,NC,1783,2044,261,0.5340998170891037
28128,RICHFIELD,NC,36,31,-5,0.4626865671641791
28129,OAKBORO,NC,1205,1478,273,0.5508758852031308
28130,PAW CREEK,NC,140,186,46,0.5705521472392638
28133,PEACHLAND,NC,458,470,12,0.5064655172413793
28134,PINEVILLE,NC,6416,6951,535,0.5200119697763148
28135,POLKTON,NC,701,755,54,0.5185439560439561
28137,RICHFIELD,NC,565,813,248,0.5899854862119013
28138,ROCKWELL,NC,2639,3146,507,0.5438202247191011
28139,RUTHERFORDTON,NC,6419,6619,200,0.5076698880196349
28144,SALISBURY,NC,9579,9520,-59,0.4984554165139536
28145,SALISBURY,NC,836,1137,301,0.5762797769893563
28146,SALISBURY,NC,7775,9001,1226,0.5365402956604673
28147,SALISBURY,NC,7190,7541,351,0.5119136514832666
28150,SHELBY,NC,8801,9053,252,0.5070572420746051
28151,SHELBY,NC,384,696,312,0.6444444444444445
28152,SHELBY,NC,7353,7074,-279,0.4903306300686213
28159,SPENCER,NC,1217,1267,50,0.5100644122383253
28160,SPINDALE,NC,1641,1648,7,0.5010641532380663
28163,STANFIELD,NC,1144,1484,340,0.5646879756468798
28164,STANLEY,NC,4419,4711,292,0.5159912376779847
28166,TROUTMAN,NC,3416,4939,1523,0.5911430281268701
28167,UNION MILLS,NC,509,777,268,0.604199066874028
28168,VALE,NC,2432,2516,84,0.5084882780921585
28169,WACO,NC,12,11,-1,0.4782608695652174
28170,WADESBORO,NC,2991,2953,-38,0.4968034993270525
28173,MARVIN,NC,244,332,88,0.5763888888888888
28173,WAXHAW,NC,15260,21089,5829,0.5801810228617018
28174,WINGATE,NC,1995,2022,27,0.5033607169529499
28174,WINGAYE,NC,40,37,-3,0.4805194805194805
28202,CHARLOTTE,NC,21266,17492,-3774,0.4513132772588885
28203,CHARLOTTE,NC,20325,16371,-3954,0.4461249182472204
28204,CHARLOTTE,NC,11135,10163,-972,0.47718095595830595
28205,CHARLOTTE,NC,30065,27868,-2197,0.48103844095765796
28206,CHARLOTTE,NC,8973,9582,609,0.516410670978173
28207,CHARLOTTE,NC,3723,3790,67,0.5044589378410754
28208,CHARLOTTE,NC,20525,18578,-1947,0.4751042119530471
28209,CHARLOTTE,NC,18587,16876,-1711,0.4758762654033782
28210,CHARLOTTE,NC,26307,21997,-4310,0.4553867174561113
28211,CHARLOTTE,NC,15335,15821,486,0.5077994607780203
28212,CHARLOTTE,NC,21539,16059,-5480,0.42712378317995636
28213,CHARLOTTE,NC,22281,19969,-2312,0.4726390532544379
28214,CHARLOTTE,NC,15320,16195,875,0.5138822782801841
28215,CHARLOTTE,NC,23881,26409,2528,0.5251342215152117
28216,CHARLOTTE,NC,28856,27259,-1597,0.48577029314799963
28217,CHARLOTTE,NC,17843,16342,-1501,0.4780459265759836
28218,CHARLOTTE,NC,11,89,78,0.89
28219,CHARLOTTE,NC,19,95,76,0.8333333333333334
28220,CHARLOTTE,NC,342,776,434,0.6940966010733453
28221,CHARLOTTE,NC,0,146,146,1
28222,CHARLOTTE,NC,74,149,75,0.6681614349775785
28224,CHARLOTTE,NC,397,808,411,0.6705394190871369
28226,CHARLOTTE,NC,18253,17215,-1038,0.48536709146272694
28227,CHARLOTTE,NC,9980,10032,52,0.5012992204677194
28227,MINT HILL,NC,11475,11434,-41,0.49910515517918724
28229,CHARLOTTE,NC,134,608,474,0.8194070080862533
28230,CHARLOTTE,NC,128,36,-92,0.21951219512195122
28231,CHARLOTTE,NC,58,183,125,0.7593360995850622
28232,CHARLOTTE,NC,89,15,-74,0.14423076923076922
28233,CHARLOTTE,NC,122,153,31,0.5563636363636364
28234,CHARLOTTE,NC,13,0,-13,0
28236,CHARLOTTE,NC,136,13,-123,0.087248322147651
28237,CHARLOTTE,NC,16,128,112,0.8888888888888888
28241,CHARLOTTE,NC,14,94,80,0.8703703703703703
28247,CHARLOTTE,NC,344,750,406,0.6855575868372943
28256,CHARLOTTE,NC,391,1167,776,0.7490372272143774
28262,CHARLOTTE,NC,34484,31113,-3371,0.474305227373203
28266,CHARLOTTE,NC,224,598,374,0.7274939172749392
28269,CHARLOTTE,NC,38754,39341,587,0.5037582431653755
28270,CHARLOTTE,NC,13209,13289,80,0.5015095478904068
28271,CHARLOTTE,NC,277,676,399,0.7093389296956978
28273,CHARLOTTE,NC,23539,23860,321,0.5033861473870757
28277,CHARLOTTE,NC,37660,38606,946,0.5062019772900113
28278,CHARLOTTE,NC,16277,20304,4027,0.5550422350400481
28281,CHARLOTTE,NC,0,20,20,1
28297,CHARLOTTE,NC,100,168,68,0.6268656716417911
28299,CHARLOTTE,NC,11,92,81,0.8932038834951457
28301,E FAYETTEVILLE,NC,884,781,-103,0.4690690690690691
28301,FAYETTEVILLE,NC,7633,7705,72,0.5023471117485983
28301,STEDMAN,NC,137,161,24,0.540268456375839
28302,FAYETTEVILLE,NC,298,888,590,0.7487352445193929
28303,FAYETTEVILLE,NC,20619,17742,-2877,0.46250097755532965
28304,FAYETTEVILLE,NC,22128,18769,-3359,0.4589334180991271
28305,FAYETTEVILLE,NC,5216,3740,-1476,0.417597141581063
28306,FAYETTEVILLE,NC,19406,19493,87,0.5011182806755958
28307,FAYETTEVILLE,NC,487,333,-154,0.4060975609756098
28307,FORT BRAGG,NC,13578,7456,-6122,0.3544737092326709
28309,FAYETTEVILLE,NC,192,404,212,0.6778523489932886
28311,FAYETTEVILLE,NC,22238,19065,-3173,0.4615887465801516
28312,EASTOVER,NC,1083,1086,3,0.5006915629322268
28312,FAYETTEVILLE,NC,5263,5520,257,0.5119169062413058
28314,FAYETTEVILLE,NC,42574,33543,-9031,0.440676852739861
28315,ABERDEEN,NC,5807,6394,587,0.524055405294648
28318,AUTRYVILLE,NC,1100,995,-105,0.47494033412887826
28320,BLADENBORO,NC,2421,1734,-687,0.41732851985559566
28323,BUNNLEVEL,NC,1639,1841,202,0.5290229885057471
28325,CALYPSO,NC,15,0,-15,0
28326,CAMERON,NC,10521,10243,-278,0.4933057214409555
28327,CARTHAGE,NC,2984,3445,461,0.5358531653445325
28327,WHISPER PNES,NC,164,173,9,0.5133531157270029
28327,WHISPERING PINES,NC,2182,2616,434,0.5452271779908295
28328,CLINTON,NC,6156,5764,-392,0.4835570469798658
28329,CLINTON,NC,333,519,186,0.6091549295774648
28330,CORDOVA,NC,12,27,15,0.6923076923076923
28331,CUMBERLAND,NC,208,70,-138,0.2517985611510791
28333,DUDLEY,NC,3645,2858,-787,0.43948946640012304
28334,DUNN,NC,6708,6659,-49,0.49816712800179547
28335,DUNN,NC,187,305,118,0.6199186991869918
28337,ELIZABETHTOWN,NC,2829,2916,87,0.5075718015665797
28338,ELLERBE,NC,914,944,30,0.5080731969860065
28339,ERWIN,NC,1962,2198,236,0.5283653846153846
28340,FAIRMONT,NC,1975,2161,186,0.5224854932301741
28341,CHADBOURN,NC,0,18,18,1
28341,FAISON,NC,654,580,-74,0.4700162074554295
28343,COUNCIL,NC,11,12,1,0.5217391304347826
28343,GIBSON,NC,101,125,24,0.5530973451327433
28344,GODWIN,NC,393,494,101,0.5569334836527621
28344,MIDWAY PARK,NC,14,11,-3,0.44
28345,HAMLET,NC,3888,3392,-496,0.46593406593406594
28347,HOFFMAN,NC,60,25,-35,0.29411764705882354
28348,HOPE MILLS,NC,15426,15044,-382,0.49373153921890384
28349,KENANSVILLE,NC,829,778,-51,0.48413192283758555
28351,LAUREL HILL,NC,1153,1089,-64,0.4857270294380018
28352,LAURINBURG,NC,6403,6076,-327,0.48689798862088307
28353,LAURINBURG,NC,183,292,109,0.6147368421052631
28355,LEMON SPRINGS,NC,136,0,-136,0
28356,LINDEN,NC,1612,1978,366,0.550974930362117
28357,LUMBER BRIDGE,NC,756,741,-15,0.49498997995991983
28358,LUMBERTON,NC,10672,10080,-592,0.48573631457208943
28359,LUMBERTON,NC,1135,1458,323,0.5622830698033167
28360,LUMBERTON,NC,2622,2249,-373,0.4617121740915623
28363,MARSTON,NC,24,23,-1,0.48936170212765956
28364,MAXTON,NC,2490,2137,-353,0.46185433326129244
28365,MOUNT OLIVE,NC,3912,3552,-360,0.4758842443729904
28366,NEWTON GROVE,NC,1014,1014,0,0.5
28368,OLIVIA,NC,51,25,-26,0.32894736842105265
28369,ORRUM,NC,252,303,51,0.5459459459459459
28370,PINEHURST,NC,13,0,-13,0
28371,PARKTON,NC,2774,2793,19,0.5017064846416383
28372,PEMBROKE,NC,2535,2428,-107,0.48922022969977835
28373,PINEBLUFF,NC,757,904,147,0.5442504515352198
28374,PINEHURST,NC,7944,9808,1864,0.5525011266336187
28374,RAEFORD,NC,174,196,22,0.5297297297297298
28376,RAEFORD,NC,18728,19306,578,0.5075984645317347
28377,RED SPRINGS,NC,3845,2150,-1695,0.3586321934945788
28379,ROCKINGHAM,NC,7470,6655,-815,0.47115044247787613
28380,ROCKINGHAM,NC,133,233,100,0.6366120218579235
28382,ROSEBORO,NC,1734,1714,-20,0.4970997679814385
28383,RAYNHAM,NC,28,14,-14,0.3333333333333333
28383,ROWLAND,NC,977,1097,120,0.5289296046287367
28384,SAINT PAULS,NC,2568,2624,56,0.5053929121725732
28385,SALEMBURG,NC,611,706,95,0.5360668185269551
28386,SHANNON,NC,1516,1014,-502,0.4007905138339921
28387,SOUTHERN PINES,NC,8993,8787,-206,0.49420697412823394
28387,SOUTHERN PNES,NC,151,171,20,0.531055900621118
28388,SOUTHERN PINES,NC,469,504,35,0.5179856115107914
28388,SOUTHERN PNES,NC,45,42,-3,0.4827586206896552
28390,SPRING LAKE,NC,15234,13166,-2068,0.4635915492957747
28391,STEDMAN,NC,1742,1885,143,0.5197132616487455
28392,TAR HEEL,NC,59,71,12,0.5461538461538461
28393,TURKEY,NC,362,192,-170,0.34657039711191334
28394,VASS,NC,2133,2416,283,0.5311057375247307
28395,WADE,NC,633,896,263,0.5860039241334205
28396,WAGRAM,NC,572,791,219,0.5803374908290535
28398,WARSAW,NC,2483,1715,-768,0.4085278704144831
28399,WHITE OAK,NC,123,220,97,0.641399416909621
28401,ANDREWS,NC,252,237,-15,0.48466257668711654
28401,CAPE FEAR,NC,347,329,-18,0.48668639053254437
28401,WILMINGTON,NC,13806,13141,-665,0.48766096411474374
28402,WILMINGTON,NC,489,888,399,0.644880174291939
28403,WILMINGTON,NC,25641,20206,-5435,0.44072676511003994
28404,WILMINGTON,NC,25,119,94,0.8263888888888888
28405,WILMINGTON,NC,17767,17603,-164,0.4976816511167656
28406,WILMINGTON,NC,623,781,158,0.5562678062678063
28408,WILMINGTON,NC,226,371,145,0.6214405360134003
28409,WILMINGTON,NC,10435,12500,2065,0.5450185306300415
28411,WILMINGTON,NC,15333,17170,1837,0.5282589299449282
28412,WILMINGTON,NC,24186,24323,137,0.5014121090931579
28420,ASH,NC,849,928,79,0.522228474957794
28421,ATKINSON,NC,212,286,74,0.5742971887550201
28422,BOLIVIA,NC,2743,4645,1902,0.6287222523010287
28423,BOLTON,NC,126,149,23,0.5418181818181819
28423,WILMINGTON,NC,18,0,-18,0
28425,BURGAW,NC,3083,3403,320,0.524668516805427
28428,CAROLINA BEACH,NC,4905,4767,-138,0.49286600496277916
28429,CASTLE HAYNE,NC,2593,3493,900,0.5739401906013802
28430,CERRO GORDO,NC,91,105,14,0.5357142857142857
28431,CHADBOURN,NC,1716,1654,-62,0.4908011869436202
28432,CLARENDON,NC,147,298,151,0.6696629213483146
28433,CLARKTON,NC,1257,1048,-209,0.4546637744034707
28434,COUNCIL,NC,30,0,-30,0
28435,CURRIE,NC,658,633,-25,0.4903175832687839
28436,DELCO,NC,298,509,211,0.630731102850062
28438,EVERGREEN,NC,113,120,7,0.5150214592274678
28439,FAIR BLUFF,NC,130,159,29,0.5501730103806228
28441,GARLAND,NC,421,515,94,0.5502136752136753
28441,INGOLD,NC,0,16,16,1
28442,HALLSBORO,NC,195,264,69,0.5751633986928104
28443,HAMPSTEAD,NC,10270,13050,2780,0.5596054888507719
28444,HARRELLS,NC,373,348,-25,0.4826629680998613
28445,HOLLY RIDGE,NC,3986,4956,970,0.5542384254081861
28445,SURF CITY,NC,2057,2607,550,0.5589622641509434
28445,TOPSAIL BEACH,NC,273,352,79,0.5632
28447,IVANHOE,NC,37,85,48,0.6967213114754098
28448,KELLY,NC,51,82,31,0.6165413533834586
28449,KURE BEACH,NC,1301,1418,117,0.5215152629643252
28450,LAKE WACCAMAW,NC,483,730,247,0.6018136850783182
28451,LELAND,NC,16096,22658,6562,0.5846622284151314
28452,LONGWOOD,NC,0,13,13,1
28453,MAGNOLIA,NC,765,554,-211,0.4200151630022744
28454,MAPLE HILL,NC,1130,1041,-89,0.47950253339474896
28455,NAKINA,NC,102,128,26,0.5565217391304348
28456,RIEGELWOOD,NC,695,692,-3,0.4989185291997116
28456,SANDYFIELD,NC,18,13,-5,0.41935483870967744
28457,ROCKY POINT,NC,3525,3872,347,0.52345545491415435
28458,ROSE HILL,NC,1242,1315,73,0.5142745404771216
28459,SHALLOTTE,NC,643,841,198,0.566711590296496
28460,N TOPSAIL BEACH,NC,1024,1092,68,0.5160680529300568
28460,SNEADS FERRY,NC,7837,8324,487,0.5150671369345956
28461,SAINT JAMES,NC,614,834,220,0.5759668508287292
28461,SOUTHPORT,NC,9748,13036,3288,0.5721558988764045
28462,HOLDEN BEACH,NC,187,232,45,0.5536992840095465
28462,SUPPLY,NC,4760,5932,1172,0.5548073325851104
28463,TABOR CITY,NC,1743,1850,107,0.5148900640133593
28464,TEACHEY,NC,257,433,176,0.6275362318840579
28465,CASWELL BEACH,NC,91,97,6,0.5159574468085106
28465,OAK ISLAND,NC,4683,5765,1082,0.55178024502297085
28466,WALLACE,NC,2552,2577,25,0.5024371222460519
28467,CALABASH,NC,2524,3807,1283,0.6013268046122255
28467,CAROLINA SHORES,NC,2392,3522,1130,0.5955360162326683
28468,SUNSET BEACH,NC,2628,3632,1004,0.5801916932907348
28469,OCEAN ISL BCH,NC,402,573,171,0.5876923076923077
28469,OCEAN ISLE BEACH,NC,4145,5957,1812,0.5896852108493368
28470,SHALLOTTE,NC,3677,4384,707,0.5438531199603027
28472,WHITEVILLE,NC,5240,5095,-145,0.4929850024189647
28478,WATHA,NC,146,179,33,0.5507692307692308
28478,WILLARD,NC,793,961,168,0.5478905359179019
28479,WINNABOW,NC,2191,3064,873,0.5830637488106565
28480,WRIGHTSVILLE BEACH,NC,1705,1726,21,0.5030603322646459
28480,WRITSVLLE BCH,NC,75,94,19,0.5562130177514792
28501,KINSTON,NC,7372,6210,-1162,0.4572227948755706
28502,KINSTON,NC,11,224,213,0.9531914893617022
28503,KINSTON,NC,346,225,-121,0.39404553415061294
28504,KINSTON,NC,6595,5689,-906,0.4631227613155324
28508,ALBERTSON,NC,74,137,63,0.6492890995260664
28510,ARAPAHOE,NC,234,538,304,0.6968911917098446
28510,MINNESOTT BEACH,NC,40,99,59,0.7122302158273381
28511,ATLANTIC,NC,25,0,-25,0
28512,ATLANTIC BCH,NC,238,263,25,0.5249500998003992
28512,ATLANTIC BEACH,NC,1611,1838,227,0.5329080893012468
28512,INDIAN BEACH,NC,43,50,7,0.5376344086021505
28512,PINE KNOLL SHORES,NC,245,253,8,0.5080321285140562
28512,SALTER PATH,NC,36,42,6,0.5384615384615384
28513,AYDEN,NC,3009,3584,575,0.543606855756105
28515,BAYBORO,NC,551,591,40,0.5175131348511384
28515,MESIC,NC,18,15,-3,0.45454545454545453
28516,BEAUFORT,NC,4820,5009,189,0.5096144063485604
28518,BEULAVILLE,NC,2672,2576,-96,0.49085365853658536
28519,BRIDGETON,NC,508,56,-452,0.09929078014184398
28521,CHINQUAPIN,NC,272,376,104,0.5802469135802469
28523,COVE CITY,NC,437,473,36,0.5197802197802198
28525,DEEP RUN,NC,523,580,57,0.5258386219401632
28526,DOVER,NC,480,405,-75,0.4576271186440678
28527,ERNUL,NC,24,22,-2,0.4782608695652174
28528,GLOUCESTER,NC,40,55,15,0.5789473684210527
28529,GRANTSBORO,NC,328,534,206,0.6194895591647331
28530,GRIFTON,NC,1877,2017,140,0.5179763739085773
28531,HARKERS ISLAND,NC,157,273,116,0.6348837209302326
28532,HAVELOCK,NC,14014,10525,-3489,0.4289090834997351
28538,HOOKERTON,NC,250,295,45,0.5412844036697247
28539,HUBERT,NC,9637,9485,-152,0.49602552034306036
28540,JACKSONVILLE,NC,26759,23475,-3284,0.4673129752757097
28541,JACKSONVILLE,NC,628,681,53,0.5202444614209321
28541,LELAND,NC,20,12,-8,0.375
28543,JACKSONVILLE,NC,75,79,4,0.512987012987013
28543,TARAWA TERRACE,NC,3410,2341,-1069,0.40705964180142584
28544,JACKSONVILLE,NC,57,51,-6,0.4722222222222222
28544,MIDWAY PARK,NC,4515,2968,-1547,0.39663236669784846
28545,JACKSONVILLE,NC,0,14,14,1
28546,JACKSONVILLE,NC,34711,28186,-6525,0.44812948153330046
28547,CAMP LEJEUNE,NC,4600,3788,-812,0.4515975202670482
28551,LA GRANGE,NC,3821,3697,-124,0.4917531258313381
28555,MAYSVILLE,NC,1727,2200,473,0.5602240896358543
28556,MERRITT,NC,102,185,83,0.6445993031358885
28557,MOREHEAD CITY,NC,6715,7057,342,0.5124164972407784
28560,NEW BERN,NC,13962,12843,-1119,0.4791270285394516
28561,NEW BERN,NC,562,646,84,0.5347682119205298
28562,NEW BERN,NC,17399,16354,-1045,0.4845198945278938
28562,TRENT WOODS,NC,1097,983,-114,0.47259615384615383
28563,NEW BERN,NC,91,100,9,0.5235602094240838
28570,NEWPORT,NC,8125,8649,524,0.5156194109932037
28571,ORIENTAL,NC,1452,1670,218,0.5349135169762973
28572,PINK HILL,NC,1379,1335,-44,0.4918938835666912
28573,POLLOCKSVILLE,NC,315,367,52,0.5381231671554252
28574,RICHLANDS,NC,8562,8003,-559,0.48312707515846665
28577,MOREHEAD,NC,0,12,12,1
28578,SEVEN SPRINGS,NC,1031,869,-162,0.4573684210526316
28580,SNOW HILL,NC,2230,2321,91,0.5099978026807295
28582,STELLA,NC,533,710,177,0.5711987127916331
28584,CAPE CARTERET,NC,805,920,115,0.5333333333333333
28584,CEDAR POINT,NC,415,464,49,0.5278725824800911
28584,SWANSBORO,NC,4860,5518,658,0.5317016766236269
28585,TRENTON,NC,948,1126,178,0.5429122468659595
28586,VANCEBORO,NC,2733,2297,-436,0.45666003976143144
28590,WINTERVILLE,NC,10212,10590,378,0.5090856648399192
28594,EMERALD ISLE,NC,2756,3266,510,0.5423447359681169
28601,HICKORY,NC,19149,18854,-295,0.496118727468884
28602,HICKORY,NC,9665,9797,132,0.5033912239235433
28603,HICKORY,NC,1138,1380,242,0.5480540111199365
28604,BANNER ELK,NC,4487,6709,2222,0.5992318685244731
28604,BEECH MOUNTAIN,NC,602,628,26,0.510569105691057
28604,SEVEN DEVILS,NC,777,373,-404,0.3243478260869565
28604,SUGAR MOUNTAIN,NC,635,192,-443,0.23216444981862153
28605,BLOWING ROCK,NC,4139,3913,-226,0.48596621957277697
28606,BOOMER,NC,261,412,151,0.612184249628529
28607,BOONE,NC,14359,11968,-2391,0.4545903445132374
28609,CATAWBA,NC,1686,1832,146,0.5207504263786242
28610,CLAREMONT,NC,2717,2881,164,0.5146480886030725
28611,COLLETTSVILLE,NC,0,36,36,1
28612,CONNELLY SPRINGS,NC,2928,2919,-9,0.49923037455105185
28613,CONOVER,NC,6833,6920,87,0.5031629462662692
28615,CRESTON,NC,171,212,41,0.5535248041775457
28617,CRUMPLER,NC,293,293,0,0.5
28618,DEEP GAP,NC,697,661,-36,0.48674521354933725
28619,DREXEL,NC,168,194,26,0.5359116022099447
28621,ELKIN,NC,3177,3280,103,0.5079758401734552
28622,ELK PARK,NC,395,456,61,0.535840188014101
28623,ENNICE,NC,104,209,105,0.6677316293929713
28624,FERGUSON,NC,77,139,62,0.6435185185185185
28625,STATESVILLE,NC,10388,11391,1003,0.5230267689058267
28626,FLEETWOOD,NC,806,1006,200,0.5551876379690949
28627,GLADE VALLEY,NC,286,398,112,0.5818713450292398
28627,STATESVILLE,NC,0,16,16,1
28628,GLEN ALPINE,NC,0,24,24,1
28630,GRANITE FALLS,NC,6539,5694,-845,0.46546227417640806
28631,GRASSY CREEK,NC,0,16,16,1
28634,HARMONY,NC,1235,1465,230,0.5425925925925926
28635,HAYS,NC,688,608,-80,0.4691358024691358
28636,HIDDENITE,NC,1036,962,-74,0.48148148148148145
28637,HILDEBRAN,NC,594,643,49,0.5198059822150364
28638,HUDSON,NC,3570,3754,184,0.5125614418350628
28640,JEFFERSON,NC,1718,1982,264,0.5356756756756756
28642,JONESVILLE,NC,2315,1698,-617,0.4231248442561675
28643,LANSING,NC,556,723,167,0.565285379202502
28644,LAUREL SPRINGS,NC,121,360,239,0.7484407484407485
28645,LENOIR,NC,12525,13056,531,0.5103787967632227
28646,LINVILLE,NC,758,1281,523,0.6282491417361452
28647,LINVILLE FALLS,NC,0,12,12,1
28649,MC GRADY,NC,0,13,13,1
28650,MAIDEN,NC,3335,3799,464,0.532520325203252
28651,MILLERS CREEK,NC,1558,1533,-25,0.4959560012940796
28653,MONTEZUMA,NC,0,38,38,1
28654,MORAVIAN FALLS,NC,972,1050,78,0.5192878338278932
28655,MORGANTON,NC,13390,14319,929,0.5167635064419502
28657,NEWLAND,NC,3418,4174,756,0.5497892518440464
28658,NEWTON,NC,7759,7874,115,0.5036781168041963
28659,N WILKESBORO,NC,88,71,-17,0.44654088050314467
28659,NORTH WILKESBORO,NC,5857,5506,-351,0.4845551350875649
28660,OLIN,NC,240,337,97,0.584055459272097
28662,PINEOLA,NC,97,77,-20,0.4425287356321839
28663,PINEY CREEK,NC,0,24,24,1
28665,PURLEAR,NC,445,581,136,0.5662768031189084
28666,ICARD,NC,101,123,22,0.5491071428571429
28667,RHODHISS,NC,0,11,11,1
28668,ROARING GAP,NC,211,328,117,0.608534322820037
28669,ROARING RIVER,NC,413,496,83,0.5456545654565457
28670,RONDA,NC,563,517,-46,0.4787037037037037
28671,RUTHERFORD COLLEGE,NC,39,15,-24,0.2777777777777778
28673,SHERRILLS FORD,NC,2576,3126,550,0.5482286916871273
28673,SHERRILLS FRD,NC,58,80,22,0.5797101449275363
28675,SPARTA,NC,2323,2453,130,0.5136097152428811
28676,STATE ROAD,NC,773,913,140,0.5415183867141162
28677,STATESVILLE,NC,13293,13105,-188,0.49643912417607394
28678,STONY POINT,NC,1298,1270,-28,0.4945482866043614
28679,SUGAR GROVE,NC,525,455,-70,0.4642857142857143
28680,MORGANTON,NC,662,816,154,0.5520974289580515
28681,TAYLORSVILLE,NC,5384,5547,163,0.5074558594822066
28682,TERRELL,NC,777,781,4,0.5012836970474968
28683,THURMOND,NC,128,151,23,0.5412186379928315
28684,TODD,NC,499,664,165,0.5709372312983663
28684,WEST JEFFERSON,NC,24,0,-24,0
28685,TRAPHILL,NC,191,255,64,0.5717488789237668
28687,STATESVILLE,NC,515,902,387,0.6365561044460127
28689,UNION GROVE,NC,299,174,-125,0.3678646934460888
28690,VALDESE,NC,2763,2568,-195,0.48171074845244793
28692,VILAS,NC,1558,1380,-178,0.4697072838665759
28693,WARRENSVILLE,NC,86,54,-32,0.38571428571428573
28694,W JEFFERSON,NC,45,77,32,0.6311475409836066
28694,WEST JEFFERSON,NC,2677,2990,313,0.5276160225869067
28697,WILKESBORO,NC,3158,3448,290,0.5219497426581895
28698,ZIONVILLE,NC,503,584,81,0.5372585096596136
28701,ALEXANDER,NC,1245,1331,86,0.5166925465838509
28702,ALMOND,NC,39,62,23,0.6138613861386139
28704,ARDEN,NC,13067,14368,1301,0.5237105886641151
28705,BAKERSVILLE,NC,1848,2038,190,0.5244467318579517
28707,BALSAM,NC,87,163,76,0.652
28708,BALSAM GROVE,NC,52,0,-52,0
28709,BARNARDSVILLE,NC,674,713,39,0.5140591204037491
28711,BLACK MOUNTAIN,NC,6336,6886,550,0.5207986688851913
28712,BREVARD,NC,7764,8945,1181,0.5353402358010653
28713,BRYSON CITY,NC,3697,3742,45,0.503024600080656
28714,BURNSVILLE,NC,5867,6115,248,0.5103488566182607
28715,CANDLER,NC,9659,9648,-11,0.49971512922774125
28716,CANTON,NC,5870,5907,37,0.5015708584529167
28717,CASHIERS,NC,2652,2926,274,0.5245607744711366
28718,CEDAR MOUNTAIN,NC,88,154,66,0.6363636363636364
28719,CHEROKEE,NC,1044,1207,163,0.5362061306086184
28721,CLYDE,NC,3685,3976,291,0.518992298655528
28722,COLUMBUS,NC,2482,2663,181,0.5175898931000972
28723,CULLOWHEE,NC,3777,3118,-659,0.4522117476432197
28724,DANA,NC,337,16,-321,0.0453257790368272
28725,DILLSBORO,NC,291,14,-277,0.04590163934426229
28726,EAST FLAT ROCK,NC,1063,964,-99,0.4755796743956586
28727,EDNEYVILLE,NC,188,24,-164,0.11320754716981132
28728,ENKA,NC,594,252,-342,0.2978723404255319
28729,ETOWAH,NC,1242,1341,99,0.519163763066202
28730,FAIRVIEW,NC,3384,3605,221,0.5158105594505652
28731,FLAT ROCK,NC,3803,4467,664,0.5401451027811366
28732,FLETCHER,NC,6285,7156,871,0.5324008630310245
28734,FRANKLIN,NC,12133,13239,1106,0.5217956802774713
28735,GERTON,NC,0,16,16,1
28736,GLENVILLE,NC,780,955,175,0.5504322766570605
28738,HAZELWOOD,NC,0,17,17,1
28739,HENDERSONVILLE,NC,7883,9054,1171,0.5345692861781898
28739,LAUREL PARK,NC,363,426,63,0.5399239543726235
28740,GREEN MOUNTAIN,NC,456,599,143,0.5677725118483412
28740,GREEN MTN,NC,51,75,24,0.5952380952380952
28741,HIGHLANDS,NC,4998,4914,-84,0.4957627118644068
28742,HORSE SHOE,NC,949,1046,97,0.5243107769423558
28743,HOT SPRINGS,NC,576,746,170,0.5642965204236006
28744,FRANKLIN,NC,1107,1116,9,0.5020242914979757
28745,LAKE JUNALUSKA,NC,860,875,15,0.5043227665706052
28745,LK JUNALUSKA,NC,33,39,6,0.5416666666666666
28746,LAKE LURE,NC,1737,2010,273,0.5364291433146517
28747,LAKE TOXAWAY,NC,1234,1564,330,0.5589706933523946
28748,LEICESTER,NC,3923,4219,296,0.5181773520019651
28749,LITTLE SWITZERLAND,NC,222,277,55,0.5551102204408818
28749,LTL SWITZRLND,NC,0,25,25,1
28751,MAGGIE VALLEY,NC,3661,4442,781,0.5481920276440825
28752,MARION,NC,8444,8421,-23,0.4993181144381856
28753,MARSHALL,NC,3155,3501,346,0.5259915865384616
28754,MARS HILL,NC,2743,3315,572,0.5472103004291845
28755,MICAVILLE,NC,11,0,-11,0
28756,MILL SPRING,NC,1353,1773,420,0.5671785028790787
28757,MONTREAT,NC,214,196,-18,0.47804878048780486
28758,HENDERSONVILLE,NC,0,11,11,1
28758,MOUNTAIN HOME,NC,106,100,-6,0.4854368932038835
28759,MILLS RIVER,NC,2318,2717,399,0.539622641509434
28760,NAPLES,NC,28,0,-28,0
28761,NEBO,NC,2276,2719,443,0.5443443443443443
28762,OLD FORT,NC,2041,2142,101,0.5120726751135549
28763,OTTO,NC,1254,1404,150,0.5282167042889391
28766,PENROSE,NC,284,376,92,0.5696969696969697
28768,PISGAH FOREST,NC,1959,2375,416,0.5479926165205353
28771,ROBBINSVILLE,NC,1729,1883,154,0.5213178294573644
28772,ROSMAN,NC,520,468,-52,0.47368421052631576
28773,SALISBURY,NC,54,51,-3,0.4857142857142857
28773,SALUDA,NC,1224,1423,199,0.5375897242160937
28774,SAPPHIRE,NC,2028,2072,44,0.5053658536585366
28775,SCALY MOUNTAIN,NC,140,321,181,0.6963123644251626
28776,SKYLAND,NC,483,318,-165,0.3970037453183521
28777,SPRUCE PINE,NC,3109,2882,-227,0.4810549157068937
28778,SWANNANOA,NC,3932,3951,19,0.5012051249524293
28779,SYLVA,NC,5988,5998,10,0.5004171533455698
28781,TOPTON,NC,147,428,281,0.7443478260869565
28782,TRYON,NC,2904,2880,-24,0.4979253112033195
28783,TUCKASEGEE,NC,227,334,107,0.5953654188948306
28785,WAYNESVILLE,NC,3207,3997,790,0.5548306496390893
28786,WAYNESVILLE,NC,9436,10015,579,0.5148835535448049
28787,WEAVERVILLE,NC,7977,9169,1192,0.5347602939461099
28788,WEBSTER,NC,22,13,-9,0.37142857142857144
28789,WHITTIER,NC,2332,2426,94,0.5098781000420345
28790,ZIRCONIA,NC,724,934,210,0.5633293124246079
28791,HENDERSONVILLE,NC,5107,5454,347,0.5164283685257078
28792,HENDERSONVILLE,NC,12520,14006,1486,0.5280102540903264
28793,HENDERSONVILLE,NC,879,829,-50,0.4853629976580796
28793,HENDERSONVLLE,NC,47,31,-16,0.3974358974358974
28801,ASHEVILLE,NC,12031,10497,-1534,0.46595348011363635
28802,ASHEVILLE,NC,1010,1132,122,0.5284780578898226
28803,ASHEVILLE,NC,20806,20878,72,0.5008636407254582
28804,ASHEVILLE,NC,10958,11282,324,0.5072841726618705
28805,ASHEVILLE,NC,9203,9155,-48,0.49869266804662815
28806,ASHEVILLE,NC,23588,22437,-1151,0.48749592612710485
28813,ASHEVILLE,NC,355,260,-95,0.42276422764227645
28814,ASHEVILLE,NC,500,531,31,0.5150339476236664
28815,ASHEVILLE,NC,540,488,-52,0.47470817120622566
28816,ASHEVILLE,NC,770,794,24,0.5076726342710998
28901,ANDREWS,NC,1828,1842,14,0.5019073569482289
28902,BRASSTOWN,NC,185,527,342,0.7401685393258427
28904,HAYESVILLE,NC,4140,5077,937,0.5508299880655311
28905,MARBLE,NC,1356,1298,-58,0.48907309721175585
28906,MURPHY,NC,8744,10786,2042,0.5522785458269329
28909,WARNE,NC,132,243,111,0.648
29001,ALCOLU,SC,170,312,142,0.6473029045643154
29002,BALLENTINE,SC,0,12,12,1
29003,BAMBERG,SC,1561,1639,78,0.5121875
29006,BATESBURG,SC,2238,2326,88,0.5096406660823839
29009,BETHUNE,SC,373,543,170,0.5927947598253275
29010,BISHOPVILLE,SC,3345,2866,-479,0.4614393817420705
29014,BLACKSTOCK,SC,128,147,19,0.5345454545454545
29015,BLAIR,SC,0,11,11,1
29016,BLYTHEWOOD,SC,7754,11101,3347,0.588756298064174
29018,BOWMAN,SC,737,812,75,0.5242091672046482
29020,CAMDEN,SC,8119,8101,-18,0.49944512946979036
29021,CAMDEN,SC,248,181,-67,0.4219114219114219
29030,CAMERON,SC,91,201,110,0.6883561643835616
29031,CARLISLE,SC,53,65,12,0.5508474576271186
29032,CASSATT,SC,974,1165,191,0.5446470313230481
29033,CAYCE,SC,5691,4892,-799,0.46225077955211186
29033,WEST COLUMBIA,SC,175,193,18,0.5244565217391305
29036,CHAPIN,SC,6980,10184,3204,0.5933348869727336
29037,CHAPPELLS,SC,11,80,69,0.8791208791208791
29038,COPE,SC,226,391,165,0.6337115072933549
29039,CORDOVA,SC,1108,1018,-90,0.47883349012229537
29040,DALZELL,SC,2727,2939,212,0.5187080833039182
29042,DENMARK,SC,1140,1141,1,0.5002192021043402
29044,EASTOVER,SC,1270,1346,76,0.514525993883792
29045,ELGIN,SC,9118,11817,2699,0.5644614282302365
29047,ELLOREE,SC,873,1010,137,0.5363781200212427
29048,EUTAWVILLE,SC,1186,1406,220,0.5424382716049383
29051,GABLE,SC,11,12,1,0.5217391304347826
29052,GADSDEN,SC,126,147,21,0.5384615384615384
29053,GASTON,SC,6497,6288,-209,0.4918263590144701
29054,GILBERT,SC,2671,3339,668,0.5555740432612313
29055,GREAT FALLS,SC,1206,1197,-9,0.49812734082397003
29056,GREELEYVILLE,SC,148,227,79,0.6053333333333333
29058,HEATH SPRINGS,SC,957,1127,170,0.5407869481765835
29059,HOLLY HILL,SC,1251,1367,116,0.5221543162719633
29061,HOPKINS,SC,3775,4100,325,0.5206349206349207
29063,IRMO,SC,12537,13738,1201,0.5228544243577545
29065,JENKINSVILLE,SC,0,22,22,1
29067,KERSHAW,SC,2519,2698,179,0.517155453325666
29069,LAMAR,SC,1035,1129,94,0.5217190388170055
29070,BATESBURG LEESVILLE,SC,137,136,-1,0.4981684981684982
29070,LEESVILLE,SC,3614,4205,591,0.5377925565929147
29070,LEXINGTON,SC,76,82,6,0.5189873417721519
29070,WEST COLUMBIA,SC,84,119,35,0.5862068965517241
29071,LEXINGTON,SC,1102,829,-273,0.42931123770067325
29072,LEXINGTON,SC,21080,23727,2647,0.5295377954337492
29073,LEXINGTON,SC,14519,17204,2685,0.5423194527629795
29074,LIBERTY HILL,SC,0,11,11,1
29075,LITTLE MOUNTAIN,SC,320,649,329,0.6697626418988648
29075,LITTLE MTN,SC,13,25,12,0.6578947368421053
29078,LUGOFF,SC,4473,4915,442,0.5235406902428632
29080,BISHOPVILLE,SC,0,21,21,1
29080,LYNCHBURG,SC,339,450,111,0.5703422053231939
29081,EHRHARDT,SC,76,77,1,0.5032679738562091
29101,MC BEE,SC,494,533,39,0.5189873417721519
29102,MANNING,SC,5124,5213,89,0.5043049240592048
29104,MAYESVILLE,SC,103,50,-53,0.32679738562091504
29105,MONETTA,SC,38,85,47,0.6910569105691057
29107,LIVINGSTON,SC,59,54,-5,0.4778761061946903
29107,NEESES,SC,401,489,88,0.549438202247191
29108,NEWBERRY,SC,5894,5632,-262,0.48863439180982127
29111,NEW ZION,SC,47,70,23,0.5982905982905983
29112,NORTH,SC,917,1043,126,0.5321428571428571
29113,NORWAY,SC,25,40,15,0.6153846153846154
29114,OLANTA,SC,180,217,37,0.5465994962216625
29115,ORANGEBURG,SC,8362,7567,-795,0.47504551447046267
29116,ORANGEBURG,SC,834,846,12,0.5035714285714286
29118,ORANGEBURG,SC,4247,3756,-491,0.46932400349868797
29123,PELION,SC,2927,2297,-630,0.43970137825421135
29125,PINEWOOD,SC,453,476,23,0.5123789020452099
29126,POMARIA,SC,401,511,110,0.5603070175438597
29127,PROSPERITY,SC,2046,2683,637,0.5673503912032142
29128,REMBERT,SC,757,922,165,0.5491363907087552
29129,RIDGE SPRING,SC,446,574,128,0.5627450980392157
29130,RIDGEWAY,SC,1392,1800,408,0.5639097744360902
29133,ROWESVILLE,SC,0,22,22,1
29135,SAINT MATTHEWS,SC,1326,1483,157,0.5279458882164472
29135,ST MATTHEWS,SC,315,391,76,0.5538243626062322
29137,SALLEY,SC,450,492,42,0.5222929936305732
29138,SALUDA,SC,1742,1744,2,0.5002868617326449
29142,SANTEE,SC,1505,1608,103,0.5165435271442339
29145,SILVERSTREET,SC,11,22,11,0.6666666666666666
29146,SPRINGFIELD,SC,189,148,-41,0.4391691394658754
29148,SUMMERTON,SC,1970,2011,41,0.5051494599346897
29150,SUMTER,SC,15160,14686,-474,0.4920592374187496
29151,SUMTER,SC,1467,839,-628,0.36383347788378145
29152,SHAW AFB,SC,2417,1842,-575,0.4324958910542381
29153,SUMTER,SC,4111,4157,46,0.5027818093855829
29154,SUMTER,SC,9829,10075,246,0.5061796623794212
29160,SWANSEA,SC,2239,2357,118,0.5128372497824195
29161,TIMMONSVILLE,SC,3086,2613,-473,0.458501491489735
29162,TURBEVILLE,SC,658,466,-192,0.41459074733096085
29163,ORANGEBURG,SC,15,11,-4,0.4230769230769231
29163,VANCE,SC,199,300,101,0.6012024048096193
29164,WAGENER,SC,1341,1459,118,0.5210714285714285
29166,WARD,SC,11,12,1,0.5217391304347826
29168,WEDGEFIELD,SC,929,1037,108,0.5274669379450662
29169,WEST COLUMBIA,SC,10097,8919,-1178,0.4690260832982751
29170,WEST COLUMBIA,SC,6896,7047,151,0.5054149035358244
29171,WEST COLUMBIA,SC,459,1016,557,0.6888135593220339
29172,WEST COLUMBIA,SC,2890,2994,104,0.508837525492862
29177,WHITE ROCK,SC,13,0,-13,0
29178,WHITMIRE,SC,903,748,-155,0.4530587522713507
29180,WINNSBORO,SC,3310,3304,-6,0.4995464166918657
29201,COLUMBIA,SC,12748,8804,-3944,0.4085003711952487
29202,COLUMBIA,SC,1085,2455,1370,0.693502824858757
29203,COLUMBIA,SC,17543,14353,-3190,0.4499937296212691
29204,COLUMBIA,SC,7283,6120,-1163,0.45661419085279414
29205,COLUMBIA,SC,11392,8926,-2466,0.4393148931981494
29206,COLUMBIA,SC,8841,8460,-381,0.48898907577596673
29209,COLUMBIA,SC,15196,13993,-1203,0.47939292199116107
29210,COLUMBIA,SC,22658,18353,-4305,0.44751408158786665
29211,COLUMBIA,SC,41,0,-41,0
29212,COLUMBIA,SC,12675,12642,-33,0.49934826401232374
29221,COLUMBIA,SC,548,1231,683,0.6919617762788083
29223,COLUMBIA,SC,23612,21157,-2455,0.4725814737876656
29224,COLUMBIA,SC,487,1117,630,0.6963840399002493
29229,COLUMBIA,SC,22462,22683,221,0.5024476686233248
29230,COLUMBIA,SC,24,280,256,0.9210526315789473
29240,COLUMBIA,SC,118,48,-70,0.2891566265060241
29250,COLUMBIA,SC,352,129,-223,0.2681912681912682
29260,COLUMBIA,SC,119,375,256,0.7591093117408907
29290,COLUMBIA,SC,311,776,465,0.7138914443422263
29301,SPARTANBURG,SC,17537,14878,-2659,0.4589850377911461
29302,SPARTANBURG,SC,5490,5676,186,0.5083288554540569
29303,SPARTANBURG,SC,10741,8890,-1851,0.45285517803474096
29304,SPARTANBURG,SC,797,1325,528,0.6244109330819981
29306,SPARTANBURG,SC,7823,7221,-602,0.47999202339803243
29307,SPARTANBURG,SC,6945,6959,14,0.5005034522439585
29316,BOILING SPGS,SC,478,608,130,0.5598526703499079
29316,BOILING SPRINGS,SC,11002,12279,1277,0.5274257978609166
29320,ARCADIA,SC,196,185,-11,0.48556430446194226
29320,MB,SC,14,19,5,0.5757575757575758
29321,BUFFALO,SC,774,626,-148,0.4471428571428571
29322,CAMPOBELLO,SC,2378,3019,641,0.559384843431536
29323,CHESNEE,SC,4303,4920,617,0.533448986230077
29325,CLINTON,SC,4868,4539,-329,0.4825130222174976
29330,COWPENS,SC,2476,2498,22,0.5022114997989545
29332,CROSS HILL,SC,883,1069,186,0.5476434426229508
29333,DRAYTON,SC,645,613,-32,0.4872813990461049
29334,DUNCAN,SC,6772,8367,1595,0.5526785124512847
29335,ENOREE,SC,1120,1348,228,0.546191247974068
29335,HORNTOWN,SC,13,19,6,0.59375
29340,GAFFNEY,SC,6542,5149,-1393,0.44042425797622103
29341,GAFFNEY,SC,6373,5674,-699,0.4709886278741595
29342,GAFFNEY,SC,948,921,-27,0.492776886035313
29346,GLENDALE,SC,17,17,0,0.5
29348,GRAMLING,SC,0,13,13,1
29349,INMAN,SC,10265,12632,2367,0.5516879940603573
29351,JOANNA,SC,437,340,-97,0.4375804375804376
29353,JONESVILLE,SC,844,996,152,0.5413043478260869
29355,KINARDS,SC,0,13,13,1
29356,LANDRUM,SC,3029,3383,354,0.5276044915782907
29360,LAURENS,SC,6825,6630,-195,0.4927536231884058
29364,LOCKHART,SC,17,12,-5,0.41379310344827586
29365,LYMAN,SC,4561,5296,735,0.5372831490311454
29368,MAYO,SC,0,11,11,1
29369,MOORE,SC,4641,5146,505,0.5257995299887606
29370,MOUNTVILLE,SC,0,35,35,1
29372,PACOLET,SC,1180,1415,235,0.5452793834296724
29373,PACOLET MILLS,SC,11,0,-11,0
29374,PAULINE,SC,669,862,193,0.5630306988896147
29375,REIDVILLE,SC,161,157,-4,0.4937106918238994
29376,ROEBUCK,SC,2429,2705,276,0.5268796260225944
29377,STARTEX,SC,146,43,-103,0.2275132275132275
29378,UNA,SC,71,126,55,0.6395939086294417
29379,UNION,SC,6027,5485,-542,0.4764593467685893
29384,WATERLOO,SC,1099,1371,272,0.5550607287449393
29385,WELLFORD,SC,3136,3142,6,0.5004778591908251
29388,WOODRUFF,SC,5316,5863,547,0.5244655156990786
29401,CHARLESTON,SC,7694,6073,-1621,0.4411273334786083
29402,CHARLESTON,SC,106,584,478,0.8463768115942029
29402,CHARLESTON AFB,SC,0,29,29,1
29403,CHARLESTON,SC,16665,13355,-3310,0.4448700866089274
29403,SUMMERVILLE,SC,295,264,-31,0.47227191413237923
29404,CHARLESTON AFB,SC,1113,1357,244,0.5493927125506073
29404,CHAS AFB,SC,24,13,-11,0.35135135135135137
29404,JOINT BASE CHARLESTON,SC,62,81,19,0.5664335664335665
29405,CHARLESTON,SC,346,289,-57,0.45511811023622045
29405,N CHARLESTON,SC,338,367,29,0.5205673758865248
29405,NORTH CHARLESTON,SC,13377,11981,-1396,0.4724741698872151
29406,CHARLESTON,SC,7744,6112,-1632,0.44110854503464203
29406,NORTH CHARLESTON,SC,8617,7046,-1571,0.4498499648853987
29407,CHARLESTON,SC,20493,18587,-1906,0.47561412487205734
29410,HANAHAN,SC,8347,7532,-815,0.4743371748850683
29412,CHARLESTON,SC,20172,18726,-1446,0.4814129261144532
29413,CHARLESTON,SC,492,768,276,0.6095238095238096
29414,CHARLESTON,SC,25776,24515,-1261,0.48746296554055396
29415,CHARLESTON,SC,0,25,25,1
29415,N CHARLESTON,SC,17,19,2,0.5277777777777778
29415,NORTH CHARLESTON,SC,401,548,147,0.5774499473129611
29416,CHARLESTON,SC,264,484,220,0.6470588235294118
29416,LADSON,SC,14,0,-14,0
29417,CHARLESTON,SC,574,518,-56,0.47435897435897434
29418,NORTH CHARLESTON,SC,12543,9932,-2611,0.4419132369299221
29419,CHARLESTON,SC,97,146,49,0.6008230452674898
29419,N CHARLESTON,SC,45,104,59,0.697986577181208
29419,NORTH CHARLESTON,SC,699,1256,557,0.6424552429667519
29420,CHARLESTON,SC,198,222,24,0.5285714285714286
29420,N CHARLESTON,SC,441,402,-39,0.47686832740213525
29420,NORTH CHARLESTON,SC,9604,8844,-760,0.47940156114483956
29422,CHARLESTON,SC,1192,508,-684,0.2988235294117647
29423,NORTH CHARLESTON,SC,612,1189,577,0.6601887840088839
29426,ADAMS RUN,SC,171,214,43,0.5558441558441558
29429,AWENDAW,SC,906,1341,435,0.5967957276368492
29429,MOUNT PLEASANT,SC,188,274,86,0.5930735930735931
29431,BONNEAU,SC,1744,2003,259,0.5345609821190286
29432,BRANCHVILLE,SC,352,360,8,0.5056179775280899
29434,CORDESVILLE,SC,12,0,-12,0
29435,COTTAGEVILLE,SC,1429,1348,-81,0.48541591645660787
29436,CROSS,SC,1536,1482,-54,0.49105367793240556
29437,COTTAGEVILLE,SC,0,11,11,1
29437,DORCHESTER,SC,563,617,54,0.5228813559322034
29438,EDISTO ISLAND,SC,1664,1770,106,0.5154338963308096
29439,FOLLY BEACH,SC,1176,1224,48,0.51
29440,GEORGETOWN,SC,7040,7096,56,0.5019807583474816
29442,GEORGETOWN,SC,1283,651,-632,0.33660806618407446
29445,GOOSE CREEK,SC,27024,22842,-4182,0.4580676212248827
29446,GREEN POND,SC,38,47,9,0.5529411764705883
29448,HARLEYVILLE,SC,370,531,161,0.5893451720310766
29449,HOLLYWOOD,SC,2060,2527,467,0.5509047307608459
29449,YONGES ISLAND,SC,37,44,7,0.5432098765432098
29450,HUGER,SC,727,1270,543,0.6359539308963446
29451,ISLE OF PALMS,SC,2571,3464,893,0.5739850869925435
29453,JAMESTOWN,SC,62,68,6,0.5230769230769231
29455,JOHNS ISLAND,SC,11254,15999,4745,0.5870546361868418
29455,KIAWAH ISLAND,SC,332,448,116,0.5743589743589743
29455,SEABROOK ISL,SC,861,1134,273,0.5684210526315789
29455,SEABROOK ISLAND,SC,260,478,218,0.6476964769647696
29456,LADSON,SC,19802,19072,-730,0.4906106909502495
29457,JOHNS ISLAND,SC,355,441,86,0.5540201005025126
29458,MC CLELLANVILLE,SC,491,562,71,0.533713200379867
29458,MCCLELLANVLE,SC,54,56,2,0.509090909090909
29461,MONCKS CORNER,SC,14328,16225,1897,0.5310444146237685
29464,MOUNT PLEASANT,SC,23886,23181,-705,0.4925106762699981
29464,MT PLEASANT,SC,5214,5226,12,0.5005747126436781
29465,MOUNT PLEASANT,SC,918,1260,342,0.5785123966942148
29465,MT PLEASANT,SC,80,99,19,0.553072625698324
29466,MOUNT PLEASANT,SC,14360,17838,3478,0.554009565811541
29466,MT PLEASANT,SC,942,1178,236,0.5556603773584906
29468,PINEVILLE,SC,238,372,134,0.6098360655737705
29469,PINOPOLIS,SC,12,0,-12,0
29470,RAVENEL,SC,1277,1655,378,0.5644611186903138
29471,REEVESVILLE,SC,103,34,-69,0.24817518248175183
29472,RIDGEVILLE,SC,2134,2670,536,0.5557868442964197
29474,ROUND O,SC,682,583,-99,0.4608695652173913
29475,RUFFIN,SC,470,514,44,0.5223577235772358
29477,SAINT GEORGE,SC,1814,1769,-45,0.493720346078705
29479,SAINT STEPHEN,SC,1774,1658,-116,0.4831002331002331
29481,SMOAKS,SC,98,86,-12,0.4673913043478261
29482,SULLIVANS IS,SC,43,27,-16,0.38571428571428573
29482,SULLIVANS ISLAND,SC,819,864,45,0.5133689839572193
29483,SUMMERVILLE,SC,23957,25314,1357,0.5137707779424002
29484,SUMMERVILLE,SC,1651,1842,191,0.527340395075866
29485,SUMMERVILLE,SC,26587,26519,-68,0.49935977102398976
29486,SUMMERVILLE,SC,19138,27938,8800,0.5934658849519925
29487,WADMALAW IS,SC,15,15,0,0.5
29487,WADMALAW ISLAND,SC,660,717,57,0.5206971677559913
29488,WALTERBORO,SC,7823,7165,-658,0.4780491059514278
29492,CHARLESTON,SC,1515,1908,393,0.5574057843996494
29492,DANIEL ISLAND,SC,11337,13410,2073,0.541883864710874
29501,FLORENCE,SC,16566,16321,-245,0.4962751239091434
29502,FLORENCE,SC,845,1283,438,0.6029135338345865
29502,NMB,SC,20,28,8,0.5833333333333334
29503,FLORENCE,SC,0,59,59,1
29504,FLORENCE,SC,216,528,312,0.7096774193548387
29505,FLORENCE,SC,7800,7602,-198,0.49357226334242305
29506,FLORENCE,SC,5939,5506,-433,0.48108344255133245
29510,ANDREWS,SC,2063,2125,62,0.5074021012416428
29510,BENNETTSVILLE,SC,46,50,4,0.5208333333333334
29511,AYNOR,SC,1787,2227,440,0.5548081714000996
29511,GALIVANTS FERRY,SC,34,51,17,0.6
29512,BENNETTSVILLE,SC,5091,4540,-551,0.4713944554044232
29518,CADES,SC,0,11,11,1
29520,CHERAW,SC,3949,3547,-402,0.4731856990394877
29520,MB,SC,111,77,-34,0.4095744680851064
29525,CLIO,SC,170,190,20,0.5277777777777778
29526,CONWAY,SC,17628,21517,3889,0.5496742879039469
29527,CONWAY,SC,8374,9862,1488,0.5407984207062952
29528,CONWAY,SC,950,1328,378,0.5829675153643546
29530,COWARD,SC,587,562,-25,0.48912097476066146
29532,DARLINGTON,SC,5600,5291,-309,0.4858139748416123
29536,DILLON,SC,4318,4146,-172,0.4898393194706994
29540,DARLINGTON,SC,1339,1457,118,0.521101573676681
29541,EFFINGHAM,SC,2219,2351,132,0.5144420131291029
29543,FORK,SC,0,13,13,1
29544,AYNOR,SC,34,39,5,0.5342465753424658
29544,GALIVANTS FERRY,SC,1774,2120,346,0.544427324088341
29545,GREEN SEA,SC,279,395,116,0.586053412462908
29545,TABOR CITY,SC,12,12,0,0.5
29546,GRESHAM,SC,253,315,62,0.5545774647887324
29547,HAMER,SC,215,323,108,0.6003717472118959
29550,HARTSVILLE,SC,8038,8017,-21,0.4993459981314232
29551,HARTSVILLE,SC,312,499,187,0.6152897657213316
29554,HEMINGWAY,SC,1591,1814,223,0.5327459618208517
29555,JOHNSONVILLE,SC,1411,1406,-5,0.49911253106141285
29556,KINGSTREE,SC,2821,2799,-22,0.49804270462633454
29560,LAKE CITY,SC,3529,3264,-265,0.4804946268217283
29563,LAKE VIEW,SC,418,486,68,0.5376106194690266
29563,LATTA,SC,0,19,19,1
29564,LANE,SC,37,73,36,0.6636363636363637
29565,LATTA,SC,1537,1623,86,0.5136075949367088
29566,LITTLE RIVER,SC,10428,14755,4327,0.5859111305245602
29568,LONGS,SC,5394,8102,2708,0.6003260225251926
29569,LORIS,SC,4876,6017,1141,0.5523730836316901
29570,MC COLL,SC,966,919,-47,0.48753315649867374
29571,MARION,SC,3745,4020,275,0.5177076625885383
29572,MYRTLE BEACH,SC,8066,12300,4234,0.6039477560640283
29574,MULLINS,SC,2985,2993,8,0.5006691201070592
29575,MYRTLE BEACH,SC,3626,5353,1727,0.5961688384007128
29575,SURFSIDE BCH,SC,203,245,42,0.546875
29575,SURFSIDE BEACH,SC,5804,8251,2447,0.5870508715759516
29576,MURRELLS INLET,SC,15730,20323,4593,0.5636978892186503
29577,MYRTLE BEACH,SC,19341,23158,3817,0.5449069389867996
29578,MYRTLE BEACH,SC,2302,2460,158,0.5165896682066359
29579,MYRTLE BEACH,SC,35345,33506,-1839,0.4866450741456188
29580,NESMITH,SC,0,23,23,1
29581,MB,SC,19,27,8,0.5869565217391305
29581,NICHOLS,SC,973,1148,175,0.5412541254125413
29582,NMB,SC,295,302,7,0.5058626465661642
29582,NORTH MYRTLE BEACH,SC,12089,16049,3960,0.5703674745895231
29583,PAMPLICO,SC,752,903,151,0.545619335347432
29584,PATRICK,SC,313,449,136,0.589238845144357
29585,LITCHFIELD,SC,109,248,139,0.6946778711484594
29585,PAWLEYS ISL,SC,590,706,116,0.5447530864197531
29585,PAWLEYS ISLAND,SC,7236,9551,2315,0.5689521653660571
29587,MYRTLE BEACH,SC,620,767,147,0.5529920692141312
29587,SURFSIDE BCH,SC,99,159,60,0.6162790697674418
29587,SURFSIDE BEACH,SC,516,673,157,0.5660218671152228
29588,MYRTLE BEACH,SC,21600,23902,2302,0.5252955914025758
29590,SALTERS,SC,119,146,27,0.5509433962264151
29591,SCRANTON,SC,849,923,74,0.5208803611738149
29592,SELLERS,SC,18,47,29,0.7230769230769231
29593,SOCIETY HILL,SC,237,182,-55,0.4343675417661098
29596,WALLACE,SC,421,465,44,0.5248306997742663
29597,N MYRTLE BCH,SC,149,361,212,0.707843137254902
29597,NORTH MYRTLE BEACH,SC,1633,2255,622,0.5799897119341564
29598,N MYRTLE BCH,SC,0,70,70,1
29598,NORTH MYRTLE BEACH,SC,515,519,4,0.5019342359767892
29601,GREENVILLE,SC,12728,11321,-1407,0.47074722441681566
29602,GREENVILLE,SC,1293,1377,84,0.5157303370786517
29604,GREENVILLE,SC,229,590,361,0.7203907203907204
29605,GREENVILLE,SC,14531,14445,-86,0.4985160132523468
29606,GREENVILLE,SC,537,1036,499,0.6586141131595677
29607,GREENVILLE,SC,28886,28512,-374,0.4967420467612112
29608,GREENVILLE,SC,133,342,209,0.72
29609,GREENVILLE,SC,13467,12647,-820,0.4842996094049169
29610,GREENVILLE,SC,176,633,457,0.7824474660074165
29611,GREENVILLE,SC,12713,11903,-810,0.48354728631784205
29615,GREENVILLE,SC,23169,20925,-2244,0.4745543611375697
29616,GREENVILLE,SC,745,1075,330,0.5906593406593407
29617,GREENVILLE,SC,10709,9218,-1491,0.4625884478345963
29620,ABBEVILLE,SC,3213,3329,116,0.5088657902782023
29621,ANDERSON,SC,13551,14628,1077,0.5191099755136804
29622,ANDERSON,SC,967,1358,391,0.5840860215053764
29623,ANDERSON,SC,76,12,-64,0.13636363636363635
29624,ANDERSON,SC,6114,5666,-448,0.48098471986417657
29625,ANDERSON,SC,10533,10796,263,0.5061653148295747
29626,ANDERSON,SC,3649,3950,301,0.5198052375312541
29627,BELTON,SC,5415,5967,552,0.5242488139167106
29628,CALHOUN FALLS,SC,478,582,104,0.5490566037735849
29630,CENTRAL,SC,6621,5477,-1144,0.4527194577616135
29631,CLEMSON,SC,7014,4645,-2369,0.398404665923321
29633,CLEMSON,SC,102,116,14,0.5321100917431193
29635,CLEVELAND,SC,255,515,260,0.6688311688311688
29638,DONALDS,SC,411,573,162,0.5823170731707317
29639,DUE WEST,SC,209,121,-88,0.36666666666666664
29640,EASLEY,SC,10814,10380,-434,0.48976125318486363
29641,EASLEY,SC,491,588,97,0.5449490268767377
29642,EASLEY,SC,9712,11194,1482,0.5354443700373098
29642,GREENVILLE,SC,231,224,-7,0.49230769230769234
29643,FAIR PLAY,SC,1313,1429,116,0.5211524434719184
29644,FOUNTAIN INN,SC,8102,8252,150,0.5045860339977987
29645,GRAY COURT,SC,2988,2968,-20,0.4983210208193418
29646,GREENWOOD,SC,8367,7599,-768,0.4759488913942127
29648,GREENWOOD,SC,58,11,-47,0.15942028985507245
29649,GREENWOOD,SC,9547,9258,-289,0.49231587343791544
29650,GREER,SC,14887,16414,1527,0.5243921919427494
29651,GREER,SC,14716,17945,3229,0.5494320443342212
29652,GREER,SC,382,651,269,0.6302032913843175
29653,GREER,SC,25,40,15,0.6153846153846154
29653,HODGES,SC,1187,1257,70,0.5143207855973814
29654,HONEA PATH,SC,3536,3431,-105,0.49246447538395294
29655,IVA,SC,1842,2302,460,0.5555019305019305
29656,LA FRANCE,SC,17,0,-17,0
29657,LIBERTY,SC,4620,4618,-2,0.4998917514613553
29661,GREENVILLE,SC,37,37,0,0.5
29661,MARIETTA,SC,1917,2034,117,0.5148063781321185
29662,MAULDIN,SC,8129,7686,-443,0.4859943092001265
29664,MOUNTAIN REST,SC,238,366,128,0.6059602649006622
29665,NEWRY,SC,13,0,-13,0
29666,NINETY SIX,SC,1982,2044,62,0.5076999503229012
29669,PELZER,SC,4003,4770,767,0.5437136669326342
29670,PENDLETON,SC,3425,3786,361,0.525031202329774
29671,PICKENS,SC,5364,5778,414,0.518578352180937
29672,SENECA,SC,4349,4870,521,0.5282568608308927
29673,PIEDMONT,SC,9941,11431,1490,0.5348586936178177
29676,SALEM,SC,2394,2994,600,0.5556792873051225
29677,SANDY SPRINGS,SC,11,64,53,0.8533333333333334
29678,SENECA,SC,9313,8704,-609,0.48309929511017374
29679,SENECA,SC,587,851,264,0.5917941585535466
29680,SIMPSONVILLE,SC,14290,16426,2136,0.534770152363589
29681,SIMPSONVILLE,SC,19558,23859,4301,0.5495312895870281
29682,SIX MILE,SC,1167,1484,317,0.5597887589588835
29683,SLATER,SC,22,0,-22,0
29684,STARR,SC,1153,1296,143,0.5291955900367497
29685,SUNSET,SC,628,992,364,0.6123456790123457
29686,TAMASSEE,SC,50,107,57,0.6815286624203821
29687,TAYLORS,SC,16508,16165,-343,0.4947510176598415
29689,TOWNVILLE,SC,1683,1728,45,0.5065963060686016
29690,TRAVELERS REST,SC,6808,8073,1265,0.5425038639876353
29691,WALHALLA,SC,3614,3646,32,0.5022038567493113
29692,WARE SHOALS,SC,1829,1628,-201,0.4709285507665606
29693,WESTMINSTER,SC,4781,4892,111,0.5057376201798821
29696,WEST UNION,SC,1671,1920,249,0.5346700083542189
29697,WILLIAMSTON,SC,4250,4312,62,0.5036206493809857
29702,BLACKSBURG,SC,3090,3146,56,0.5044900577293137
29704,CATAWBA,SC,1052,1108,56,0.512962962962963
29706,CHESTER,SC,5389,5445,56,0.5025844563411482
29707,FORT MILL,SC,9001,12954,3953,0.5900250512411751
29707,INDIAN LAND,SC,2537,3773,1236,0.5979397781299525
29708,FORT MILL,SC,11088,13502,2414,0.5490849938999594
29708,TEGA CAY,SC,3277,4052,775,0.5528721517260199
29709,CHESTERFIELD,SC,1533,1518,-15,0.4975417895771878
29710,CLOVER,SC,13725,16835,3110,0.5508835078534031
29710,LAKE WYLIE,SC,303,330,27,0.5213270142180095
29712,EDGEMOOR,SC,310,526,216,0.6291866028708134
29714,FORT LAWN,SC,776,949,173,0.5501449275362319
29715,FORT MILL,SC,14607,18025,3418,0.5523719048786467
29716,FORT MILL,SC,923,1250,327,0.5752416014726185
29717,HICKORY GROVE,SC,129,192,63,0.5981308411214953
29718,JEFFERSON,SC,684,812,128,0.5427807486631016
29720,LANCASTER,SC,14641,17542,2901,0.5450703787714011
29721,LANCASTER,SC,665,821,156,0.5524899057873486
29726,MC CONNELLS,SC,198,426,228,0.6826923076923077
29727,MOUNT CROGHAN,SC,388,252,-136,0.39375
29728,PAGELAND,SC,2790,2734,-56,0.4949312092686459
29729,RICHBURG,SC,458,510,52,0.5268595041322314
29730,ROCK HILL,SC,22617,21755,-862,0.49028666726764625
29731,ROCK HILL,SC,512,1007,495,0.662936142198815
29732,ROCK HILL,SC,24742,22873,-1869,0.4803738317757009
29741,RUBY,SC,264,271,7,0.5065420560747663
29742,SHARON,SC,533,625,92,0.5397236614853195
29743,SMYRNA,SC,11,108,97,0.907563025210084
29745,YORK,SC,9634,11136,1502,0.5361579200770342
29801,AIKEN,SC,10466,10456,-10,0.4997610171111748
29802,AIKEN,SC,725,941,216,0.5648259303721489
29803,AIKEN,SC,14412,16310,1898,0.5308899160210924
29804,AIKEN,SC,324,317,-7,0.49453978159126366
29805,AIKEN,SC,1602,1977,375,0.5523889354568315
29809,NEW ELLENTON,SC,762,835,73,0.5228553537883531
29810,ALLENDALE,SC,1326,1231,-95,0.4814235432147047
29812,BARNWELL,SC,3158,3133,-25,0.4980130344937212
29816,BATH,SC,15,0,-15,0
29817,BLACKVILLE,SC,1136,1048,-88,0.47985347985347987
29819,BRADLEY,SC,101,77,-24,0.43258426966292135
29821,CLARKS HILL,SC,50,93,43,0.6503496503496503
29822,CLEARWATER,SC,94,84,-10,0.47191011235955055
29824,EDGEFIELD,SC,1374,1581,207,0.5350253807106599
29827,FAIRFAX,SC,456,525,69,0.5351681957186545
29828,GLOVERVILLE,SC,52,30,-22,0.36585365853658536
29829,GRANITEVILLE,SC,3445,4557,1112,0.5694826293426644
29831,JACKSON,SC,1195,1239,44,0.5090386195562859
29832,JOHNSTON,SC,1213,1199,-14,0.49709784411276947
29834,LANGLEY,SC,86,32,-54,0.2711864406779661
29835,MC CORMICK,SC,2433,2758,325,0.5313041803120786
29839,MONTMORENCI,SC,13,11,-2,0.4583333333333333
29841,NORTH AUGUSTA,SC,12410,11302,-1108,0.476636302294197
29842,BEECH ISLAND,SC,1821,2247,426,0.5523598820058997
29843,OLAR,SC,103,86,-17,0.455026455026455
29845,PARKSVILLE,SC,0,14,14,1
29845,PLUM BRANCH,SC,39,45,6,0.5357142857142857
29847,TRENTON,SC,1486,1370,-116,0.4796918767507003
29848,TROY,SC,51,59,8,0.5363636363636364
29851,WARRENVILLE,SC,3020,2873,-147,0.4875275750890887
29853,WILLISTON,SC,1891,1810,-81,0.4890570116184815
29856,WINDSOR,SC,956,1134,178,0.5425837320574163
29860,NORTH AUGUSTA,SC,4473,5679,1206,0.5593971631205674
29861,NORTH AUGUSTA,SC,600,854,254,0.5873452544704264
29901,BEAUFORT,SC,228,466,238,0.6714697406340058
29902,BEAUFORT,SC,7672,7132,-540,0.4817616860308025
29903,BEAUFORT,SC,267,497,230,0.650523560209424
29906,BEAUFORT,SC,12991,10634,-2357,0.45011640211640214
29907,BEAUFORT,SC,4497,5427,930,0.5468561064087062
29907,LADYS ISLAND,SC,585,688,103,0.5404556166535742
29909,BLUFFTON,SC,7735,10210,2475,0.5689607132906102
29909,OKATIE,SC,4022,5725,1703,0.5873602133989946
29910,BLUFFTON,SC,22063,26011,3948,0.5410616965511503
29911,BRUNSON,SC,98,103,5,0.5124378109452736
29915,DAUFUSKIE ISLAND,SC,60,231,171,0.7938144329896907
29916,EARLY BRANCH,SC,58,126,68,0.6847826086956522
29918,ESTILL,SC,532,574,42,0.5189873417721519
29920,FRIPP ISLAND,SC,195,326,131,0.6257197696737045
29920,SAINT HELENA ISLAND,SC,3649,4335,686,0.5429609218436874
29920,ST HELENA IS,SC,81,110,29,0.5759162303664922
29924,HAMPTON,SC,1231,1157,-74,0.48450586264656614
29925,HILTON HEAD,SC,68,118,50,0.6344086021505376
29925,HILTON HEAD ISLAND,SC,370,555,185,0.6
29926,HHI,SC,343,194,-149,0.3612662942271881
29926,HILTON HEAD,SC,1399,1607,208,0.5345974717232203
29926,HILTON HEAD ISLAND,SC,9576,11180,1604,0.5386394295625362
29927,HARDEEVILLE,SC,3556,5002,1446,0.5844823556905819
29928,HILTON HEAD,SC,511,509,-2,0.49901960784313726
29928,HILTON HEAD ISLAND,SC,11770,17097,5327,0.5922679876675789
29929,ISLANDTON,SC,35,23,-12,0.39655172413793105
29934,PINELAND,SC,27,52,25,0.6582278481012658
29935,PORT ROYAL,SC,4006,2583,-1423,0.39201699802701473
29936,RIDGELAND,SC,5265,5001,-264,0.48714202220923436
29938,HILTON HEAD,SC,50,187,137,0.7890295358649789
29938,HILTON HEAD ISLAND,SC,610,862,252,0.5855978260869565
29940,BEAUFORT,SC,11,13,2,0.5416666666666666
29940,SEABROOK,SC,614,797,183,0.5648476257973069
29941,SHELDON,SC,100,200,100,0.6666666666666666
29944,VARNVILLE,SC,1004,1111,107,0.5252955082742317
29945,WALTERBORO,SC,0,12,12,1
29945,YEMASSEE,SC,910,997,87,0.5228106974305191
30002,AVONDALE EST,GA,71,47,-24,0.3983050847457627
30002,AVONDALE ESTATES,GA,3730,3061,-669,0.45074363127668976
30003,NORCROSS,GA,137,416,279,0.7522603978300181
30004,ALPHARETTA,GA,22050,24083,2033,0.5220341187436326
30004,MILTON,GA,3173,3282,109,0.5084430673896204
30005,ALPHARETTA,GA,15221,16410,1189,0.5187948531503904
30005,JOHNS CREEK,GA,1162,1220,58,0.5121746431570109
30006,MARIETTA,GA,705,1398,693,0.6647646219686163
30007,MARIETTA,GA,97,160,63,0.622568093385214
30008,MARIETTA,GA,11903,10540,-1363,0.46963418437820253
30009,ALPHARETTA,GA,11595,13281,1686,0.5338880849011095
30010,NORCROSS,GA,461,972,511,0.6782972784368457
30010,PEACHTREE COR,GA,90,133,43,0.5964125560538116
30010,PEACHTREE CORNERS,GA,168,224,56,0.5714285714285714
30011,AUBURN,GA,6082,7473,1391,0.5513094798967171
30012,CONYERS,GA,12405,11891,-514,0.489422127099111
30013,CONYERS,GA,13566,14057,491,0.5088875212685081
30014,COVINGTON,GA,13275,14293,1018,0.5184634358676726
30014,PORTERDALE,GA,601,808,207,0.5734563520227112
30015,CONYERS,GA,21,39,18,0.65
30015,COVINGTON,GA,883,1729,846,0.6619448698315467
30016,COVINGTON,GA,20085,21348,1263,0.5152414741872421
30017,GRAYSON,GA,8804,9599,795,0.521599739172961
30019,DACULA,GA,15594,18510,2916,0.5427515833919775
30021,CLARKSTON,GA,17738,11265,-6473,0.38840809571423646
30022,ALPHARETTA,GA,21822,21621,-201,0.4976866238519439
30022,JOHNS CREEK,GA,2964,3067,103,0.5085392140606865
30023,ALPHARETTA,GA,805,1485,680,0.648471615720524
30024,SUWANEE,GA,28686,33166,4480,0.5362154821186057
30025,SOCIAL CIRCLE,GA,2877,3401,524,0.5417330359987257
30028,CUMMING,GA,9231,13236,4005,0.5891307250634263
30030,DECATUR,GA,14624,14939,315,0.5053276054527619
30031,DECATUR,GA,897,1660,763,0.6491982792334767
30032,DECATUR,GA,22798,20432,-2366,0.4726347443904696
30033,DECATUR,GA,16539,16089,-450,0.4931040823832291
30034,DECATUR,GA,18584,17561,-1023,0.4858486650989072
30035,DECATUR,GA,10971,9615,-1356,0.4670649956280968
30036,DECATUR,GA,777,1738,961,0.6910536779324056
30036,DULUTH,GA,11,35,24,0.7608695652173914
30037,DECATUR,GA,376,1131,755,0.7504976775049768
30038,LITHONIA,GA,16815,16315,-500,0.49245396921219436
30038,STONECREST,GA,1501,1495,-6,0.49899866488651534
30039,SNELLVILLE,GA,19730,17952,-1778,0.47640783397908815
30040,CUMMING,GA,22141,27776,5635,0.5564436965362501
30041,CUMMING,GA,19723,24001,4278,0.5489205013265026
30042,LAWRENCEVILLE,GA,786,1657,871,0.6782644289807613
30043,LAWRENCEVILLE,GA,32040,31942,-98,0.4992341596073896
30044,LAWRENCEVILLE,GA,34685,30813,-3872,0.47044184555253593
30045,LAWRENCEVILLE,GA,13968,14316,348,0.5061518879932118
30046,LAWRENCEVILLE,GA,17198,16491,-707,0.48950696072902133
30047,LILBURN,GA,18004,18057,53,0.5007348659216327
30048,LILBURN,GA,549,1311,762,0.7048387096774194
30049,LAWRENCEVILLE,GA,603,1145,542,0.6550343249427918
30052,LOGANVILLE,GA,24398,28989,4591,0.5429973589075993
30052,WALNUT GROVE,GA,572,554,-18,0.4920071047957371
30054,OXFORD,GA,3714,4220,506,0.5318880766322158
30055,MANSFIELD,GA,860,1207,347,0.5839380745041123
30056,NEWBORN,GA,564,693,129,0.5513126491646778
30058,LITHONIA,GA,25536,25756,220,0.5021445839507136
30060,MARIETTA,GA,15186,13220,-1966,0.4653946349362811
30061,MARIETTA,GA,2272,1604,-668,0.41382868937048506
30062,MARIETTA,GA,20555,21199,644,0.5077118359917613
30064,MARIETTA,GA,14972,16900,1928,0.530245983935743
30065,LAWRENCEVILLE,GA,14,0,-14,0
30065,MARIETTA,GA,344,743,399,0.6835326586936522
30066,MARIETTA,GA,20863,21674,811,0.5095328772597973
30067,MARIETTA,GA,29216,24700,-4516,0.45812003857852956
30068,MARIETTA,GA,10167,10930,763,0.5180831397829075
30070,PORTERDALE,GA,872,305,-567,0.25913338997451146
30071,NORCROSS,GA,9001,8223,-778,0.47741523455643287
30071,PEACHTREE CORNERS,GA,191,151,-40,0.4415204678362573
30072,PINE LAKE,GA,850,1536,686,0.6437552388935457
30074,LITHONIA,GA,56,139,83,0.7128205128205128
30074,REDAN,GA,235,675,440,0.7417582417582418
30075,ROSWELL,GA,16916,18141,1225,0.5174715463388196
30076,ROSWELL,GA,19500,19320,-180,0.49768160741885625
30077,ROSWELL,GA,525,929,404,0.6389270976616231
30078,SNELLVILLE,GA,13027,14409,1382,0.525185887155562
30079,SCOTTDALE,GA,2406,1812,-594,0.4295874822190612
30080,SMYRNA,GA,34127,31034,-3093,0.47626647841500286
30081,SMYRNA,GA,944,1711,767,0.6444444444444445
30082,SMYRNA,GA,12059,11643,-416,0.49122436925153995
30083,STONE MOUNTAIN,GA,26722,24461,-2261,0.47791258816403887
30083,STONE MTN,GA,494,423,-71,0.4612868047982552
30084,TUCKER,GA,14930,13793,-1137,0.4802074992166556
30085,TUCKER,GA,588,1236,648,0.6776315789473685
30086,STONE MOUNTAIN,GA,622,1491,869,0.705631803123521
30086,STONE MTN,GA,29,69,40,0.7040816326530612
30087,SMOKE RISE,GA,253,263,10,0.5096899224806202
30087,STONE MOUNTAIN,GA,10389,10642,253,0.5060149303409253
30087,STONE MTN,GA,1534,1618,84,0.5133248730964467
30088,SMYRNA,GA,301,306,5,0.5041186161449753
30088,ST MOUNTAIN,GA,192,180,-12,0.4838709677419355
30088,STONE MOUNTAIN,GA,11533,10193,-1340,0.46916137346957565
30091,NORCROSS,GA,1009,1640,631,0.6191015477538694
30092,EAST NORCROSS,GA,478,378,-100,0.441588785046729
30092,NORCROSS,GA,6104,5402,-702,0.4694941769511559
30092,PEACHTREE CORNERS,GA,13317,11827,-1490,0.4703706649697741
30093,NORCROSS,GA,26665,17238,-9427,0.39263831628818074
30094,CONYERS,GA,11361,11878,517,0.5111235423210981
30095,CONYERS,GA,24,44,20,0.6470588235294118
30095,DULUTH,GA,1224,1360,136,0.5263157894736842
30096,BERKELEY LAKE,GA,741,706,-35,0.4879060124395301
30096,DULUTH,GA,40464,36911,-3553,0.4770403877221325
30097,DULUTH,GA,16248,17206,958,0.5143181682310037
30097,JOHNS CREEK,GA,2269,2519,250,0.5261069340016709
30097,PEACHTREE CORNERS,GA,657,709,52,0.5190336749633968
30101,ACWORTH,GA,20619,21960,1341,0.5157471993236102
30102,ACWORTH,GA,15612,15338,-274,0.4955735056542811
30103,ADAIRSVILLE,GA,5266,5834,568,0.5255855855855855
30104,ARAGON,GA,1712,1743,31,0.5044862518089726
30105,ARMUCHEE,GA,559,658,99,0.5406737880032868
30106,AUSTELL,GA,10163,9342,-821,0.47895411432965906
30107,BALL GROUND,GA,4379,5489,1110,0.5562423996757195
30107,BALLGROUND,GA,72,107,35,0.5977653631284916
30108,BOWDON,GA,2692,2745,53,0.5048740114033474
30110,BREMEN,GA,4941,5321,380,0.5185149093743909
30111,CLARKDALE,GA,12,121,109,0.9097744360902256
30112,CARROLLTON,GA,934,1549,615,0.6238421264599275
30113,BUCHANAN,GA,1907,2247,340,0.5409244102070294
30114,CANTON,GA,22078,25055,2977,0.531580845691978
30115,CANTON,GA,14539,18706,4167,0.5626710783576477
30116,CARROLLTON,GA,8533,7274,-1259,0.4601758714493579
30117,CARROLLTON,GA,13330,12945,-385,0.49267364414843007
30120,CARTERSVILLE,GA,20068,17978,-2090,0.4725332492246228
30121,CARTERSVILLE,GA,10763,9948,-815,0.48032446526000677
30122,LITHIA SPGS,GA,638,601,-37,0.4850686037126715
30122,LITHIA SPRINGS,GA,11961,11837,-124,0.497394739053702
30123,CASSVILLE,GA,170,58,-112,0.2543859649122807
30124,ALBANY,GA,26,23,-3,0.46938775510204084
30124,CAVE SPRING,GA,1115,1139,24,0.5053238686779059
30125,CEDARTOWN,GA,8090,7077,-1013,0.46660512955759215
30126,MABLETON,GA,17016,17115,99,0.5014502944537225
30127,POWDER SPRINGS,GA,20200,22505,2305,0.5269874721929516
30132,DALLAS,GA,16614,20796,4182,0.5558941459502806
30133,DOUGLASVILLE,GA,1010,1596,586,0.612432847275518
30134,DOUGLASVILLE,GA,21721,17800,-3921,0.45039346170390426
30135,DOUGLASVILLE,GA,28322,25575,-2747,0.4745162068389706
30137,EMERSON,GA,576,474,-102,0.4514285714285714
30139,FAIRMOUNT,GA,1201,1305,104,0.5207501995211492
30141,HIRAM,GA,9992,10222,230,0.5056891263480756
30142,HOLLY SPRINGS,GA,876,488,-388,0.35777126099706746
30143,BIG CANOE,GA,2048,2524,476,0.5520559930008749
30143,JASPER,GA,6695,8378,1683,0.5558283022623234
30144,KENNESAW,GA,25561,24580,-981,0.4902175864063341
30145,EUHARLEE,GA,664,668,4,0.5015015015015015
30145,KINGSTON,GA,1633,1968,335,0.546514856984171
30146,LEBANON,GA,31,12,-19,0.27906976744186046
30147,CHESTER,GA,34,31,-3,0.47692307692307695
30147,LINDALE,GA,1699,1631,-68,0.48978978978978976
30148,AUSTELL,GA,12,0,-12,0
30148,LAWRENCEVILLE,GA,0,11,11,1
30148,MARBLE HILL,GA,48,170,122,0.7798165137614679
30152,KENNESAW,GA,14562,15176,614,0.5103234918286368
30153,ROCKMART,GA,8757,6973,-1784,0.44329307056579786
30154,DOUGLASVILLE,GA,890,1409,519,0.6128751631143976
30156,KENNESAW,GA,680,1088,408,0.6153846153846154
30157,DALLAS,GA,17660,18783,1123,0.5154076228631013
30160,KENNESAW,GA,141,307,166,0.6852678571428571
30161,ROME,GA,15116,12465,-2651,0.45194155396831154
30162,ROME,GA,899,682,-217,0.43137254901960786
30164,ROME,GA,829,175,-654,0.17430278884462153
30165,ROME,GA,15727,13713,-2014,0.46579483695652174
30168,AUSTELL,GA,12412,10937,-1475,0.4684140648421774
30169,CANTON,GA,12,0,-12,0
30170,ROOPVILLE,GA,621,934,313,0.6006430868167203
30171,RYDAL,GA,1091,1309,218,0.5454166666666667
30172,SHANNON,GA,183,161,-22,0.4680232558139535
30173,SILVER CREEK,GA,2242,2114,-128,0.485307621671258
30175,TALKING ROCK,GA,1971,2240,269,0.5319401567323676
30176,TALLAPOOSA,GA,2421,2639,218,0.5215415019762846
30177,TATE,GA,37,46,9,0.5542168674698795
30178,TAYLORSVILLE,GA,1139,1229,90,0.5190033783783784
30179,TEMPLE,GA,8652,7165,-1487,0.45299361446544856
30180,VILLA RICA,GA,20178,17907,-2271,0.4701851122489169
30182,WACO,GA,625,908,283,0.5923026744944553
30183,WALESKA,GA,1970,2623,653,0.571086435880688
30184,WHITE,GA,2161,2439,278,0.5302173913043479
30185,WHITESBURG,GA,1286,1541,255,0.5451008135833039
30187,WINSTON,GA,2857,3421,564,0.5449187639375598
30188,WOODSTOCK,GA,22576,25441,2865,0.5298331840806381
30189,WOODSTOCK,GA,14087,14765,678,0.5117496187439345
30204,BARNESVILLE,GA,4141,4296,155,0.5091857295247125
30205,BROOKS,GA,747,1147,400,0.6055966209081309
30206,CONCORD,GA,802,973,171,0.548169014084507
30212,EXPERIMENT,GA,75,222,147,0.7474747474747475
30213,FAIRBURN,GA,17082,19189,2107,0.5290452427559207
30214,FAYETTEVILLE,GA,12571,13514,943,0.5180755223308415
30215,FAYETTEVILLE,GA,9431,10857,1426,0.535143927444795
30216,FLOVILLA,GA,271,505,234,0.6507731958762887
30217,CENTRALHATCHEE,GA,62,66,4,0.515625
30217,FRANKLIN,GA,2659,2926,267,0.5239033124440465
30218,GAY,GA,152,275,123,0.6440281030444965
30220,GRANTVILLE,GA,1948,1968,20,0.5025536261491318
30220,LONE OAK,GA,32,33,1,0.5076923076923077
30222,ALPHARETTA,GA,14,15,1,0.5172413793103449
30222,GREENVILLE,GA,1094,1272,178,0.5376162299239222
30223,GRIFFIN,GA,14704,15034,330,0.5055484565202771
30224,GRIFFIN,GA,11443,10457,-986,0.47748858447488585
30228,HAMPTON,GA,19723,22226,2503,0.5298338458604496
30230,HOGANSVILLE,GA,3201,3322,121,0.5092748735244519
30233,JACKSON,GA,8179,8386,207,0.506248113492303
30234,JENKINSBURG,GA,549,754,205,0.5786646201074443
30236,JONESBORO,GA,21062,19104,-1958,0.4756261514713937
30237,JONESBORO,GA,887,1788,901,0.668411214953271
30238,JONESBORO,GA,16527,15355,-1172,0.4816197227275579
30240,LAGRANGE,GA,10002,9549,-453,0.4884149148381157
30241,LAGRANGE,GA,9379,10035,656,0.5168950242093334
30248,LOCUST GROVE,GA,11232,14128,2896,0.5570977917981073
30248,MCDONOUGH,GA,229,258,29,0.5297741273100616
30250,LOVEJOY,GA,1168,571,-597,0.3283496262219667
30251,LUTHERSVILLE,GA,839,847,8,0.5023724792408066
30252,MCDONOUGH,GA,15476,17956,2480,0.5370902129696099
30253,MCDONOUGH,GA,30981,32408,1427,0.5112558961333985
30256,MEANSVILLE,GA,622,774,152,0.5544412607449857
30257,MILNER,GA,1569,1901,332,0.5478386167146974
30258,MOLENA,GA,530,740,210,0.5826771653543307
30259,MORELAND,GA,1088,1364,276,0.5562805872756933
30260,LAKE CITY,GA,812,707,-105,0.46543778801843316
30260,MORROW,GA,11931,10344,-1587,0.4643771043771044
30263,NEWNAN,GA,21289,22227,938,0.5107776450041364
30264,NEWNAN,GA,86,313,227,0.7844611528822055
30265,NEWNAN,GA,13877,15544,1667,0.5283301043472349
30266,ORCHARD HILL,GA,25,23,-2,0.4791666666666667
30268,CHATTAHOOCHEE HILLS,GA,321,318,-3,0.49765258215962443
30268,PALMETTO,GA,4211,4482,271,0.5155872541125043
30269,PEACHTREE CITY,GA,14386,16337,1951,0.5317514565634867
30271,NEWNAN,GA,810,1395,585,0.6326530612244898
30272,RED OAK,GA,34,523,489,0.9389587073608617
30273,REX,GA,7979,6696,-1283,0.4562862010221465
30274,RIVERDALE,GA,16019,14707,-1312,0.4786500032545727
30276,SENOIA,GA,4784,6890,2106,0.5902004454342984
30277,SHARPSBURG,GA,5397,6691,1294,0.553524156187955
30281,STOCKBRIDGE,GA,31477,30556,-921,0.49257653184595296
30284,SUNNY SIDE,GA,69,141,72,0.6714285714285714
30285,THE ROCK,GA,34,66,32,0.66
30286,THOMASTON,GA,9551,8767,-784,0.47860028387378534
30287,MORROW,GA,226,124,-102,0.35428571428571426
30288,CONLEY,GA,3815,3280,-535,0.46229739252995067
30290,TYRONE,GA,2791,3449,658,0.552724358974359
30291,UNION CITY,GA,12734,11597,-1137,0.4766347457975422
30292,WILLIAMSON,GA,1639,2101,462,0.5617647058823529
30293,WOODBURY,GA,542,701,159,0.5639581657280772
30294,ELLENWOOD,GA,14882,14699,-183,0.49690679828268147
30295,ZEBULON,GA,1357,1546,189,0.5325525318635894
30296,RIVERDALE,GA,10942,11078,136,0.503088101725704
30297,FOREST PARK,GA,12860,9516,-3344,0.4252770825884877
30298,FOREST PARK,GA,217,847,630,0.7960526315789473
30301,ATLANTA,GA,621,945,324,0.603448275862069
30302,ATLANTA,GA,41,627,586,0.938622754491018
30303,ATLANTA,GA,2695,2706,11,0.5010183299389002
30305,ATLANTA,GA,22640,21915,-725,0.49186398832903155
30306,ATLANTA,GA,14816,11961,-2855,0.4466893229263921
30307,ATLANTA,GA,12323,11529,-794,0.48335569344289786
30308,ATLANTA,GA,20917,18127,-2790,0.4642710787829116
30309,ATLANTA,GA,31474,26988,-4486,0.46163319763265026
30310,ATLANTA,GA,14445,13996,-449,0.4921064660173693
30311,ATLANTA,GA,16061,14546,-1515,0.47525075963014995
30312,ATLANTA,GA,19282,17052,-2230,0.46931248967908845
30313,ATLANTA,GA,3568,3609,41,0.5028563466629511
30314,ATLANTA,GA,9764,9083,-681,0.4819334642118109
30315,ATLANTA,GA,15102,14159,-943,0.483886401695089
30316,ATLANTA,GA,19497,20118,621,0.5078379401741765
30317,ATLANTA,GA,7394,7652,258,0.5085737072976206
30318,ATLANTA,GA,37104,34969,-2135,0.48518862819641195
30319,ATLANTA,GA,6480,5878,-602,0.4756433079786373
30319,BROOKHAVEN,GA,17244,16181,-1063,0.48409872849663427
30321,ATLANTA,GA,828,1935,1107,0.7003257328990228
30324,ATLANTA,GA,28229,23880,-4349,0.45827016446295266
30325,ATLANTA,GA,441,1173,732,0.7267657992565055
30326,ATLANTA,GA,10874,10586,-288,0.49328984156570366
30327,ATLANTA,GA,8660,9075,415,0.511700028192839
30327,SANDY SPGS,GA,398,445,47,0.527876631079478
30328,ATLANTA,GA,16472,15310,-1162,0.48171921213265373
30328,SANDY SPGS,GA,4764,4795,31,0.5016215085259964
30328,SANDY SPRINGS,GA,6298,6143,-155,0.49377059721887306
30329,ATLANTA,GA,16715,13476,-3239,0.44635818621443474
30329,BROOKHAVEN,GA,2557,2212,-345,0.4638288949465297
30331,ATLANTA,GA,25842,25152,-690,0.49323449817625603
30333,ATLANTA,GA,94,169,75,0.6425855513307985
30336,ATLANTA,GA,1445,1841,396,0.5602556299452222
30336,SOUTH FULTON,GA,23,34,11,0.5964912280701754
30337,ATLANTA,GA,3006,2757,-249,0.478396668401874
30337,COLLEGE PARK,GA,3531,3483,-48,0.4965782720273738
30338,ATLANTA,GA,7279,6704,-575,0.47943931917328186
30338,DUNWOODY,GA,9624,9480,-144,0.4962311557788945
30339,ATLANTA,GA,31637,29178,-2459,0.47978294828578477
30340,ATLANTA,GA,8010,6582,-1428,0.4510690789473684
30340,DORAVILLE,GA,3085,2455,-630,0.44314079422382674
30341,ATLANTA,GA,11603,10727,-876,0.48038513210927003
30341,CHAMBLEE,GA,5238,4869,-369,0.4817453250222618
30342,ATLANTA,GA,17262,16945,-317,0.49536644546437864
30342,SANDY SPGS,GA,372,313,-59,0.4569343065693431
30342,SANDY SPRINGS,GA,410,460,50,0.5287356321839081
30343,ATLANTA,GA,11,12,1,0.5217391304347826
30344,ATLANTA,GA,12637,11513,-1124,0.4767287784679089
30344,EAST POINT,GA,5009,4727,-282,0.4855176663927691
30345,ATLANTA,GA,10604,9702,-902,0.47778981581798485
30346,ATLANTA,GA,5180,4071,-1109,0.4400605339963247
30346,DUNWOODY,GA,3199,2623,-576,0.45053246307110956
30348,ATLANTA,GA,13,0,-13,0
30349,ATLANTA,GA,25351,24187,-1164,0.4882514433364286
30349,COLLEGE PARK,GA,12431,12016,-415,0.49151225099194173
30350,ATLANTA,GA,17374,15121,-2253,0.46533312817356515
30350,DUNWOODY,GA,452,394,-58,0.4657210401891253
30350,SANDY SPGS,GA,2277,2053,-224,0.4741339491916859
30350,SANDY SPRINGS,GA,4633,4356,-277,0.48459227945266437
30353,ATLANTA,GA,44,11,-33,0.2
30354,ATLANTA,GA,4853,4924,71,0.5036309706453922
30354,HAPEVILLE,GA,2217,2195,-22,0.49750679963735267
30355,ATLANTA,GA,547,1282,735,0.7009294696555495
30356,ATLANTA,GA,13,207,194,0.9409090909090909
30356,DUNWOODY,GA,27,62,35,0.6966292134831461
30357,ATLANTA,GA,1355,1511,156,0.5272156315422191
30358,ATLANTA,GA,241,522,281,0.6841415465268676
30358,SANDY SPGS,GA,44,102,58,0.6986301369863014
30358,SANDY SPRINGS,GA,17,79,62,0.8229166666666666
30359,ATLANTA,GA,90,172,82,0.6564885496183206
30360,ATLANTA,GA,3914,3571,-343,0.4770875083500334
30360,DORAVILLE,GA,1002,838,-164,0.45543478260869563
30360,DUNWOODY,GA,467,443,-24,0.4868131868131868
30361,ATLANTA,GA,13,0,-13,0
30362,ATLANTA,GA,149,290,141,0.6605922551252847
30362,DORAVILLE,GA,0,38,38,1
30363,ATLANTA,GA,3333,2522,-811,0.43074295473953883
30364,ATLANTA,GA,393,727,334,0.6491071428571429
30364,EAST POINT,GA,275,584,309,0.6798603026775321
30366,ATLANTA,GA,149,385,236,0.7209737827715356
30366,CHAMBLEE,GA,49,131,82,0.7277777777777777
30374,ATLANTA,GA,0,26,26,1
30377,ATLANTA,GA,68,483,415,0.8765880217785844
30401,SWAINSBORO,GA,5639,4132,-1507,0.42288404462184015
30410,AILEY,GA,94,205,111,0.68561872909699
30411,ALAMO,GA,333,402,69,0.5469387755102041
30413,BARTOW,GA,171,104,-67,0.3781818181818182
30415,BROOKLET,GA,2112,2510,398,0.5430549545651233
30417,CLAXTON,GA,2829,2875,46,0.5040322580645161
30420,COBBTOWN,GA,449,475,26,0.5140692640692641
30421,COLLINS,GA,853,873,20,0.5057937427578215
30425,GARFIELD,GA,60,101,41,0.6273291925465838
30426,GIRARD,GA,25,106,81,0.8091603053435115
30427,GLENNVILLE,GA,3038,3009,-29,0.49760211675210847
30428,GLENWOOD,GA,260,309,49,0.5430579964850615
30429,HAGAN,GA,14,0,-14,0
30434,LOUISVILLE,GA,1339,1234,-105,0.4795958025650991
30436,LYONS,GA,4520,3442,-1078,0.43230344134639537
30439,METTER,GA,3162,3097,-65,0.4948074772327848
30441,MIDVILLE,GA,122,371,249,0.7525354969574036
30442,MILLEN,GA,1817,1826,9,0.5012352456766401
30442,PERKINS,GA,155,181,26,0.5386904761904762
30445,MOUNT VERNON,GA,867,834,-33,0.49029982363315694
30446,NEWINGTON,GA,69,264,195,0.7927927927927928
30450,PORTAL,GA,834,830,-4,0.4987980769230769
30452,REGISTER,GA,137,281,144,0.6722488038277512
30453,REIDSVILLE,GA,2454,1998,-456,0.44878706199460916
30454,ROCKLEDGE,GA,11,12,1,0.5217391304347826
30455,ROCKY FORD,GA,0,12,12,1
30456,SARDIS,GA,280,288,8,0.5070422535211268
30457,SOPERTON,GA,1758,1674,-84,0.48776223776223776
30458,STATESBORO,GA,16504,14020,-2484,0.4593107063294457
30459,STATESBORO,GA,1310,1632,322,0.5547246770904147
30461,STATESBORO,GA,5034,5181,147,0.5071953010279001
30467,HILTONIA,GA,67,69,2,0.5073529411764706
30467,SYLVANIA,GA,3197,3179,-18,0.49858845671267255
30470,TARRYTOWN,GA,0,51,51,1
30471,TWIN CITY,GA,992,1018,26,0.5064676616915423
30473,UVALDA,GA,626,638,12,0.504746835443038
30474,VIDALIA,GA,5993,5309,-684,0.4697398690497257
30475,VIDALIA,GA,533,560,27,0.5123513266239708
30477,WADLEY,GA,356,452,96,0.5594059405940595
30501,GAINESVILLE,GA,12169,11370,-799,0.4830281660223459
30502,CHESTNUT MOUNTAIN,GA,0,24,24,1
30502,CHESTNUT MTN,GA,11,11,0,0.5
30503,GAINESVILLE,GA,702,1336,634,0.6555446516192346
30504,GAINESVILLE,GA,9907,9850,-57,0.4985574733006023
30506,GAINESVILLE,GA,13174,14775,1601,0.528641454077069
30507,GAINESVILLE,GA,6550,6433,-117,0.4954941076792729
30510,ALTO,GA,2481,1943,-538,0.4391952983725136
30511,BALDWIN,GA,1035,960,-75,0.48120300751879697
30512,BLAIRSVILLE,GA,8454,11027,2573,0.5660387043786254
30513,BLUE RIDGE,GA,5903,5589,-314,0.48633832231117297
30514,BLAIRSVILLE,GA,3187,1596,-1591,0.3336817896717541
30515,BUFORD,GA,872,1489,617,0.6306649724692927
30516,BOWERSVILLE,GA,255,355,100,0.5819672131147541
30517,BRASELTON,GA,5801,7056,1255,0.5488060978455316
30518,BUFORD,GA,16583,18138,1555,0.5223927882261455
30518,SUGAR HILL,GA,1893,2063,170,0.5214863498483316
30519,BUFORD,GA,19296,22535,3239,0.538715306829863
30520,CANON,GA,1113,1270,157,0.5329416701636592
30521,CARNESVILLE,GA,1448,1826,378,0.5577275503970678
30522,CHERRY LOG,GA,312,464,152,0.5979381443298969
30523,CLARKESVILLE,GA,4358,5042,684,0.5363829787234042
30525,CLAYTON,GA,3842,3929,87,0.5055977351692189
30527,CLERMONT,GA,1294,1616,322,0.5553264604810997
30528,CLEVELAND,GA,8465,9558,1093,0.5303223658658381
30529,COMMERCE,GA,5967,5310,-657,0.47086991221069435
30530,COMMERCE,GA,1692,1837,145,0.520544063474072
30531,CORNELIA,GA,3831,3730,-101,0.4933209892871313
30533,DAHLONEGA,GA,9620,9610,-10,0.499739989599584
30534,DAWSONVILLE,GA,11431,14024,2593,0.5509330190532312
30535,DEMOREST,GA,2279,2463,184,0.5194010965837199
30536,ELLIJAY,GA,2391,2989,598,0.5555762081784387
30537,DILLARD,GA,872,1030,158,0.5415352260778128
30537,SKY VALLEY,GA,46,19,-27,0.2923076923076923
30538,EASTANOLLEE,GA,856,852,-4,0.49882903981264637
30539,EAST ELLIJAY,GA,88,88,0,0.5
30540,ELLIJAY,GA,7119,7829,710,0.5237489965212737
30541,EPWORTH,GA,369,400,31,0.5201560468140443
30542,FLOWERY BR,GA,937,1183,246,0.5580188679245283
30542,FLOWERY BRANCH,GA,12470,15238,2768,0.5499494730763679
30543,GILLSVILLE,GA,1181,1277,96,0.5195280716029292
30545,HELEN,GA,729,827,98,0.531491002570694
30546,HIAWASSEE,GA,4423,5368,945,0.5482586048411807
30547,HOMER,GA,1107,1427,320,0.5631412786108919
30548,HOSCHTON,GA,6529,10532,4003,0.6173143426528339
30549,JEFFERSON,GA,8064,10696,2632,0.5701492537313433
30552,LAKEMONT,GA,805,871,66,0.5196897374701671
30553,LAVONIA,GA,3111,3568,457,0.5342117083395718
30554,LULA,GA,2239,2714,475,0.5479507369271149
30555,MC CAYSVILLE,GA,765,793,28,0.5089858793324775
30557,MARTIN,GA,1917,1869,-48,0.4936608557844691
30558,MAYSVILLE,GA,1833,1938,105,0.5139220365950676
30559,MINERAL BLUFF,GA,1518,1957,439,0.5631654676258993
30560,MORGANTON,GA,1974,2430,456,0.5517711171662125
30562,MOUNTAIN CITY,GA,12,0,-12,0
30563,MOUNT AIRY,GA,1220,1429,209,0.5394488486221215
30564,MURRAYVILLE,GA,1529,1758,229,0.5348341953148767
30565,NICHOLSON,GA,1490,1511,21,0.5034988337220926
30566,OAKWOOD,GA,4434,5005,571,0.5302468481830702
30567,PENDERGRASS,GA,1610,2383,773,0.59679439018282
30568,RABUN GAP,GA,882,797,-85,0.47468731387730795
30571,SANDY SPRINGS,GA,31,49,18,0.6125
30571,SAUTE NACOCHE,GA,187,194,7,0.5091863517060368
30571,SAUTEE,GA,160,232,72,0.5918367346938775
30571,SAUTEE NACOOCHEE,GA,775,1010,235,0.5658263305322129
30572,SUCHES,GA,214,489,275,0.6955903271692745
30573,TALLULAH FALLS,GA,0,11,11,1
30575,TALMO,GA,204,299,95,0.5944333996023857
30576,TIGER,GA,834,938,104,0.5293453724604966
30577,TOCCOA,GA,9281,8527,-754,0.478829739442947
30582,YOUNG HARRIS,GA,2169,2696,527,0.5541623843782117
30601,ATHENS,GA,9449,7104,-2345,0.4291669183833746
30603,ATHENS,GA,146,188,42,0.562874251497006
30604,ATHENS,GA,559,1002,443,0.6418962203715567
30605,ATHENS,GA,19721,14676,-5045,0.4266651161438498
30606,ATHENS,GA,21156,18865,-2291,0.4713775267984308
30607,ATHENS,GA,3009,2886,-123,0.4895674300254453
30608,ATHENS,GA,325,815,490,0.7149122807017544
30619,ARNOLDSVILLE,GA,156,277,121,0.6397228637413395
30620,BETHLEHEM,GA,5472,6157,685,0.5294522314902399
30621,BISHOP,GA,1204,1407,203,0.5388739946380697
30622,BOGART,GA,3153,3590,437,0.5324039744920659
30624,BOWMAN,GA,623,789,166,0.5587818696883853
30625,BUCKHEAD,GA,698,927,229,0.5704615384615385
30627,CARLTON,GA,342,301,-41,0.4681181959564541
30628,COLBERT,GA,1958,2175,217,0.5262521171062182
30629,COMER,GA,1846,1671,-175,0.4751208416263861
30630,CRAWFORD,GA,594,729,135,0.5510204081632653
30631,CRAWFORDVILLE,GA,123,145,22,0.5410447761194029
30633,DANIELSVILLE,GA,2095,2557,462,0.5496560619088564
30634,DEWY ROSE,GA,382,479,97,0.5563298490127758
30635,ELBERTON,GA,4496,4766,270,0.5145756855970632
30639,FRANKLIN SPRINGS,GA,39,0,-39,0
30641,GOOD HOPE,GA,352,701,349,0.6657169990503324
30642,GREENSBORO,GA,4935,6888,1953,0.5825932504440497
30643,HARTWELL,GA,5316,6237,921,0.5398597766813814
30646,HULL,GA,2415,2463,48,0.504920049200492
30647,ILA,GA,17,0,-17,0
30648,LEXINGTON,GA,663,746,83,0.5294535131298793
30650,MADISON,GA,4169,4850,681,0.5377536312229737
30655,MONROE,GA,9757,11469,1712,0.540327899745595
30656,MONROE,GA,4356,5526,1170,0.5591985428051002
30660,RAYLE,GA,33,47,14,0.5875
30662,ROYSTON,GA,3168,2797,-371,0.4689019279128248
30663,RUTLEDGE,GA,851,871,20,0.5058072009291521
30666,STATHAM,GA,3002,3960,958,0.5688020683711578
30667,STEPHENS,GA,14,0,-14,0
30668,TIGNALL,GA,251,388,137,0.6071987480438185
30669,UNION POINT,GA,567,646,79,0.5325638911788954
30669,WOODVILLE,GA,109,91,-18,0.455
30673,WASHINGTON,GA,1867,1941,74,0.5097163865546218
30677,WATKINSVILLE,GA,5447,6388,941,0.5397549640895648
30678,WHITE PLAINS,GA,38,214,176,0.8492063492063492
30680,WINDER,GA,17083,17336,253,0.5036752956216044
30683,WINTERVILLE,GA,2590,2527,-63,0.493844049247606
30701,CALHOUN,GA,13488,14289,801,0.514418403715304
30703,CALHOUN,GA,1160,828,-332,0.4164989939637827
30705,CHATSWORTH,GA,9584,9532,-52,0.4986398828206738
30707,CHICKAMAUGA,GA,4253,4717,464,0.5258639910813824
30710,COHUTTA,GA,2232,1853,-379,0.4536107711138311
30711,CRANDALL,GA,748,809,61,0.5195889531149647
30719,DALTON,GA,0,53,53,1
30720,DALTON,GA,10930,8506,-2424,0.4376414900185223
30721,DALTON,GA,12717,11492,-1225,0.4746994919244909
30722,DALTON,GA,722,934,212,0.5640096618357487
30724,ETON,GA,0,24,24,1
30725,FLINTSTONE,GA,1487,1519,32,0.5053226879574185
30726,GRAYSVILLE,GA,13,11,-2,0.4583333333333333
30728,LA FAYETTE,GA,6741,6981,240,0.5087450808919982
30728,LAFAYETTE,GA,138,134,-4,0.49264705882352944
30730,LYERLY,GA,381,368,-13,0.49132176234979974
30731,CLOUDLAND,GA,48,52,4,0.52
30731,MENLO,GA,651,756,105,0.5373134328358209
30733,PLAINVILLE,GA,485,568,83,0.5394112060778727
30734,RANGER,GA,711,1066,355,0.5998874507597074
30735,RESACA,GA,2388,2123,-265,0.47062735535358013
30736,RINGGOLD,GA,13111,14180,1069,0.5195852112418013
30738,RISING FAWN,GA,854,1160,306,0.5759682224428997
30739,ROCK SPRING,GA,1621,1972,351,0.548844976342889
30740,ROCKY FACE,GA,2411,2419,8,0.5008281573498965
30741,ROSSVILLE,GA,11556,11646,90,0.5019394879751745
30742,FORT OGLETHORPE,GA,3485,2967,-518,0.4598574085554867
30742,FT OGLETHORPE,GA,860,807,-53,0.48410317936412717
30746,SUGAR VALLEY,GA,319,203,-116,0.3888888888888889
30747,SUMMERVILLE,GA,5327,5287,-40,0.49811569625023555
30750,LOOKOUT MOUNTAIN,GA,852,931,79,0.5221536735838475
30750,LOOKOUT MTN,GA,45,48,3,0.5161290322580645
30752,TRENTON,GA,2974,3054,80,0.506635700066357
30753,TRION,GA,2194,2332,138,0.5152452496685815
30755,TUNNEL HILL,GA,2946,3079,133,0.5110373443983403
30757,WILDWOOD,GA,324,554,230,0.6309794988610479
30802,APPLING,GA,1300,1701,401,0.566811062979007
30803,AVERA,GA,0,22,22,1
30805,BLYTHE,GA,969,870,-99,0.4730831973898858
30808,DEARING,GA,948,1019,71,0.518047788510422
30809,EVANS,GA,17125,19780,2655,0.5359707356726731
30810,GIBSON,GA,289,338,49,0.5390749601275917
30813,GROVETOWN,GA,21442,22949,1507,0.5169741614291186
30814,HARLEM,GA,2663,3303,640,0.5536372779081462
30815,HEPHZIBAH,GA,14019,13471,-548,0.49003273917788287
30816,KEYSVILLE,GA,296,276,-20,0.4825174825174825
30817,LINCOLNTON,GA,1782,2069,287,0.5372630485588159
30820,MITCHELL,GA,57,49,-8,0.46226415094339623
30821,NORWOOD,GA,23,64,41,0.735632183908046
30823,STAPLETON,GA,88,77,-11,0.4666666666666667
30824,THOMSON,GA,5365,5267,-98,0.4953912716328066
30828,WARRENTON,GA,993,891,-102,0.4729299363057325
30830,WAYNESBORO,GA,5018,4575,-443,0.4769102470551444
30833,WRENS,GA,1050,1040,-10,0.49760765550239233
30901,AUGUSTA,GA,7710,7225,-485,0.4837629728824908
30903,AUGUSTA,GA,703,1015,312,0.5908032596041909
30904,AUGUSTA,GA,11870,10071,-1799,0.45900369171870015
30905,AUGUSTA,GA,518,406,-112,0.4393939393939394
30905,FORT GORDON,GA,2861,2261,-600,0.4414291292463881
30906,AUGUSTA,GA,21712,19977,-1735,0.47919115354170166
30907,AUGUSTA,GA,15183,14084,-1099,0.4812245874192777
30907,MARTINEZ,GA,4990,4837,-153,0.49221532512465654
30909,AUGUSTA,GA,27495,25152,-2343,0.4777480198301898
30914,AUGUSTA,GA,23,285,262,0.9253246753246753
30916,AUGUSTA,GA,852,1658,806,0.6605577689243027
30917,AUGUSTA,GA,269,866,597,0.7629955947136564
30919,AUGUSTA,GA,448,869,421,0.659832953682612
30919,DACULA,GA,0,17,17,1
31001,ABBEVILLE,GA,544,578,34,0.5151515151515151
31002,ADRIAN,GA,542,633,91,0.5387234042553192
31005,BONAIRE,GA,6860,7811,951,0.5324108786040488
31006,BUTLER,GA,981,940,-41,0.48932847475273294
31007,BYROMVILLE,GA,11,0,-11,0
31008,BYRON,GA,6896,7574,678,0.5234277816171389
31009,CADWELL,GA,109,131,22,0.5458333333333333
31010,CORDELE,GA,269,353,84,0.567524115755627
31012,CHESTER,GA,11,39,28,0.78
31014,COCHRAN,GA,4349,3808,-541,0.4668382983940174
31015,CORDELE,GA,6775,6514,-261,0.490179847994582
31016,CULLODEN,GA,78,120,42,0.6060606060606061
31017,DANVILLE,GA,53,193,140,0.7845528455284553
31018,DAVISBORO,GA,39,23,-16,0.3709677419354839
31019,DEXTER,GA,610,590,-20,0.49166666666666664
31020,DRY BRANCH,GA,200,349,149,0.6357012750455373
31021,DUBLIN,GA,9301,8864,-437,0.48797137352050646
31022,DUDLEY,GA,99,168,69,0.6292134831460674
31022,MACON,GA,0,19,19,1
31023,EASTMAN,GA,4505,4608,103,0.505651267420169
31024,EATONTON,GA,6739,7689,950,0.532922095924591
31025,ELKO,GA,51,353,302,0.8737623762376238
31027,DUBLIN,GA,64,80,16,0.5555555555555556
31027,E DUBLIN,GA,227,241,14,0.5149572649572649
31027,EAST DUBLIN,GA,2573,2540,-33,0.4967729317426169
31028,CENTERVILLE,GA,2549,2506,-43,0.4957467853610287
31029,BARNESVILLE,GA,72,130,58,0.6435643564356436
31029,FORSYTH,GA,4176,5340,1164,0.5611601513240857
31030,FORT VALLEY,GA,5289,4817,-472,0.4766475361171581
31031,GORDON,GA,1308,1301,-7,0.49865848984285166
31031,IVEY,GA,188,196,8,0.5104166666666666
31032,GRAY,GA,3335,3701,366,0.5260090960773166
31033,HADDOCK,GA,299,266,-33,0.47079646017699117
31034,HARDWICK,GA,68,224,156,0.7671232876712328
31035,HARRISON,GA,68,104,36,0.6046511627906976
31036,HAWKINSVILLE,GA,3673,3602,-71,0.49512027491408933
31037,HELENA,GA,36,32,-4,0.47058823529411764
31037,MC RAE HELENA,GA,811,669,-142,0.452027027027027
31040,DUBLIN,GA,1265,852,-413,0.40245630609352856
31042,IRWINTON,GA,170,87,-83,0.33852140077821014
31044,JEFFERSONVILLE,GA,630,745,115,0.5418181818181819
31046,JULIETTE,GA,760,926,166,0.5492289442467378
31047,KATHLEEN,GA,5022,7046,2024,0.5838581372224063
31049,KITE,GA,260,288,28,0.5255474452554745
31051,LILLY,GA,11,0,-11,0
31052,LIZELLA,GA,1996,2312,316,0.5366759517177344
31054,MC INTYRE,GA,60,0,-60,0
31055,MC RAE,GA,53,41,-12,0.43617021276595747
31055,MC RAE HELENA,GA,1676,1502,-174,0.4726242920075519
31057,MARSHALLVILLE,GA,81,138,57,0.6301369863013698
31058,MAUK,GA,315,445,130,0.5855263157894737
31059,MILLEDGEVILLE,GA,453,264,-189,0.3682008368200837
31060,MILAN,GA,172,206,34,0.544973544973545
31061,MILLEDGEVILLE,GA,12036,11270,-766,0.4835664635716125
31063,MONROE,GA,23,21,-2,0.4772727272727273
31063,MONTEZUMA,GA,1335,1189,-146,0.47107765451664024
31064,MONTICELLO,GA,2731,3458,727,0.5587332363871385
31065,MONTROSE,GA,77,45,-32,0.36885245901639346
31066,MUSELLA,GA,11,23,12,0.6764705882352942
31068,OGLETHORPE,GA,821,766,-55,0.48267170762444866
31069,PERRY,GA,7915,9467,1552,0.5446438844781958
31070,PINEHURST,GA,12,0,-12,0
31071,PINEVIEW,GA,29,50,21,0.6329113924050633
31072,PITTS,GA,87,135,48,0.6081081081081081
31075,RENTZ,GA,570,601,31,0.5132365499573015
31076,REYNOLDS,GA,647,467,-180,0.41921005385996407
31077,RHINE,GA,15,46,31,0.7540983606557377
31078,ROBERTA,GA,839,834,-5,0.4985056784219964
31079,ROCHELLE,GA,510,579,69,0.5316804407713499
31082,SANDERSVILLE,GA,2909,2866,-43,0.49627705627705626
31083,SCOTLAND,GA,0,12,12,1
31085,SHADY DALE,GA,24,14,-10,0.3684210526315789
31087,SPARTA,GA,1427,1800,373,0.5577936163619461
31088,WARNER ROBINS,GA,23759,22499,-1260,0.4863807341432833
31089,TENNILLE,GA,1252,1338,86,0.5166023166023166
31090,TOOMSBORO,GA,11,37,26,0.7708333333333334
31091,UNADILLA,GA,513,497,-16,0.49207920792079207
31092,VIENNA,GA,1791,1571,-220,0.4672813801308745
31093,WARNER ROBINS,GA,12059,11242,-817,0.4824685635809622
31094,WARTHEN,GA,16,24,8,0.6
31095,WARNER ROBINS,GA,1020,1675,655,0.62152133580705
31096,WRIGHTSVILLE,GA,1219,1287,68,0.5135674381484437
31097,YATESVILLE,GA,37,191,154,0.8377192982456141
31098,ROBINS A F B,GA,237,240,3,0.5031446540880503
31098,ROBINS AFB,GA,156,133,-23,0.4602076124567474
31098,WARNER ROBINS,GA,1382,1293,-89,0.48336448598130843
31106,ATLANTA,GA,45,70,25,0.6086956521739131
31107,ATLANTA,GA,96,145,49,0.6016597510373444
31119,ATLANTA,GA,145,490,345,0.7716535433070866
31126,ATLANTA,GA,332,190,-142,0.36398467432950193
31131,ATLANTA,GA,502,1172,670,0.7001194743130227
31139,ATLANTA,GA,805,1238,433,0.6059716103768967
31141,ATLANTA,GA,47,382,335,0.8904428904428905
31145,ATLANTA,GA,0,36,36,1
31146,ATLANTA,GA,116,385,269,0.7684630738522954
31146,DUNWOODY,GA,0,39,39,1
31150,ATLANTA,GA,76,425,349,0.8483033932135728
31150,SANDY SPRINGS,GA,11,28,17,0.717948717948718
31156,ATLANTA,GA,0,136,136,1
31156,SANDY SPGS,GA,0,33,33,1
31201,MACON,GA,4861,4088,-773,0.4568108168510448
31202,MACON,GA,24,179,155,0.8817733990147784
31203,MACON,GA,232,289,57,0.5547024952015355
31204,MACON,GA,12633,11632,-1001,0.47937358335050484
31205,MACON,GA,384,882,498,0.6966824644549763
31206,MACON,GA,11621,9869,-1752,0.45923685435086087
31208,MACON,GA,355,1150,795,0.7641196013289037
31209,MACON,GA,109,51,-58,0.31875
31210,MACON,GA,16275,15316,-959,0.48482162641258586
31211,MACON,GA,5593,5405,-188,0.49145299145299143
31216,MACON,GA,4045,4778,733,0.5415391590162076
31217,MACON,GA,5274,5041,-233,0.4887057682985943
31220,MACON,GA,5708,5748,40,0.5017458100558659
31221,MACON,GA,425,946,521,0.6900072939460248
31301,ALLENHURST,GA,2434,2325,-109,0.48854801428871614
31302,BLOOMINGDALE,GA,3030,3281,251,0.5198859134843923
31303,CLYO,GA,269,507,238,0.6533505154639175
31305,DARIEN,GA,2409,2158,-251,0.4725202539960587
31307,EDEN,GA,22,38,16,0.6333333333333333
31308,ELLABELL,GA,2689,2730,41,0.5037829857907363
31309,FLEMING,GA,27,23,-4,0.46
31310,HINESVILLE,GA,712,954,242,0.5726290516206483
31312,GUYTON,GA,8076,9249,1173,0.5338528138528138
31313,HINESVILLE,GA,27266,23790,-3476,0.4659589470385459
31314,HINESVILLE,GA,0,12,12,1
31315,FORT STEWART,GA,6553,4945,-1608,0.430074795616629
31315,HINESVILLE,GA,197,124,-73,0.3862928348909657
31316,LUDOWICI,GA,5575,7063,1488,0.5588700743788574
31320,MIDWAY,GA,4330,4784,454,0.5249067368883037
31321,NEVILS,GA,105,105,0,0.5
31321,PEMBROKE,GA,2083,2241,158,0.5182701202590194
31322,POOLER,GA,16665,17627,962,0.5140265951242272
31323,RICEBORO,GA,131,261,130,0.6658163265306123
31324,RICHMOND HILL,GA,15596,17987,2391,0.5355983682220171
31326,RINCON,GA,11672,10126,-1546,0.46453803101201946
31328,TYBEE ISLAND,GA,1875,2036,161,0.5205829711071337
31329,SPRINGFIELD,GA,2945,3480,535,0.5416342412451361
31331,TOWNSEND,GA,2441,2618,177,0.5174935758054952
31333,WALTHOURVILLE,GA,0,59,59,1
31401,SAVANNAH,GA,13037,10836,-2201,0.4539018975411553
31402,SAVANNAH,GA,356,809,453,0.6944206008583691
31403,SAVANNAH,GA,239,746,507,0.7573604060913706
31404,SAVANNAH,GA,14495,12691,-1804,0.4668211579489443
31405,SAVANNAH,GA,19912,17063,-2849,0.461473968897904
31406,SAVANNAH,GA,14664,12970,-1694,0.4693493522472317
31407,PORT WENTWORTH,GA,6870,6785,-85,0.4968875869644819
31407,SAVANNAH,GA,8247,8999,752,0.5218021570219181
31408,GARDEN CITY,GA,1500,1291,-209,0.46255822285919024
31408,SAVANNAH,GA,2441,1920,-521,0.44026599403806466
31410,SAVANNAH,GA,9520,9380,-140,0.4962962962962963
31411,SAVANNAH,GA,4137,4948,811,0.5446340121078701
31412,SAVANNAH,GA,499,593,94,0.543040293040293
31414,SAVANNAH,GA,176,465,289,0.7254290171606864
31415,GARDEN CITY,GA,109,102,-7,0.4834123222748815
31415,SAVANNAH,GA,4840,3740,-1100,0.4358974358974359
31416,SAVANNAH,GA,785,1412,627,0.6426945835229859
31418,GARDEN CITY,GA,27,158,131,0.8540540540540541
31418,GARDEN CTY,GA,0,38,38,1
31418,SAVANNAH,GA,47,257,210,0.8453947368421053
31419,SAVANNAH,GA,31396,26104,-5292,0.45398260869565216
31420,SAVANNAH,GA,562,1096,534,0.661037394451146
31501,WAYCROSS,GA,6891,5873,-1018,0.4601222187402068
31502,WAYCROSS,GA,580,826,246,0.5874822190611664
31503,WAYCROSS,GA,7741,6727,-1014,0.46495714680674594
31510,ALMA,GA,3644,3463,-181,0.48726607570001407
31512,AMBROSE,GA,150,157,7,0.511400651465798
31513,BAXLEY,GA,4481,4351,-130,0.4926403985507246
31515,BAXLEY,GA,255,110,-145,0.3013698630136986
31516,BLACKSHEAR,GA,5109,5515,406,0.5191076807228916
31518,BRISTOL,GA,51,11,-40,0.1774193548387097
31519,BROXTON,GA,1040,1059,19,0.5045259647451167
31520,BRUNSWICK,GA,9768,8879,-889,0.47616238537030087
31520,SAINT SIMONS ISLAND,GA,278,283,5,0.5044563279857398
31521,BRUNSWICK,GA,1213,1258,45,0.509105625252934
31522,SAINT SIMONS ISLAND,GA,6163,7241,1078,0.5402118770516264
31522,ST SIMONS IS,GA,791,1032,241,0.5660998354360943
31522,ST SIMONS ISLAND,GA,2551,3127,576,0.5507220852412822
31523,BRUNSWICK,GA,4449,5201,752,0.5389637305699482
31525,BRUNSWICK,GA,15101,13405,-1696,0.4702518767978671
31527,JEKYLL ISLAND,GA,733,1462,729,0.6660592255125285
31532,DENTON,GA,12,0,-12,0
31533,DOUGLAS,GA,7145,5828,-1317,0.4492407307484776
31534,DOUGLAS,GA,1177,708,-469,0.37559681697612735
31535,DOUGLAS,GA,3623,3636,13,0.5008954401432705
31537,FOLKSTON,GA,3018,2918,-100,0.4915768194070081
31539,HAZLEHURST,GA,5507,4957,-550,0.47371941896024466
31542,HOBOKEN,GA,386,526,140,0.5767543859649122
31543,HORTENSE,GA,1345,1666,321,0.5533045499833942
31544,JACKSONVILLE,GA,0,11,11,1
31545,JESUP,GA,7403,6208,-1195,0.456101682462714
31546,JESUP,GA,2368,2307,-61,0.493475935828877
31547,KINGS BAY,GA,480,12,-468,0.024390243902439025
31548,KINGSLAND,GA,13447,12269,-1178,0.4770959713796858
31549,LUMBER CITY,GA,345,187,-158,0.35150375939849626
31550,MANOR,GA,25,22,-3,0.46808510638297873
31551,MERSHON,GA,15,11,-4,0.4230769230769231
31552,BRUNSWICK,GA,12,0,-12,0
31552,MILLWOOD,GA,0,11,11,1
31553,NAHUNTA,GA,1759,1816,57,0.507972027972028
31554,NICHOLLS,GA,1258,1422,164,0.5305970149253731
31555,ODUM,GA,855,844,-11,0.4967628016480283
31557,PATTERSON,GA,978,926,-52,0.48634453781512604
31558,SAINT MARYS,GA,15262,12042,-3220,0.44103428069147377
31558,ST MARYS,GA,259,227,-32,0.4670781893004115
31560,SCREVEN,GA,927,811,-116,0.4666283084004603
31561,SEA ISLAND,GA,120,211,91,0.6374622356495468
31562,SAINT GEORGE,GA,586,459,-127,0.43923444976076553
31563,SURRENCY,GA,142,24,-118,0.14457831325301204
31565,WAVERLY,GA,485,744,259,0.6053702196908055
31566,WAYNESVILLE,GA,1039,1068,29,0.5068818224964404
31567,WEST GREEN,GA,25,23,-2,0.4791666666666667
31568,WHITE OAK,GA,53,172,119,0.7644444444444445
31569,WOODBINE,GA,2071,2105,34,0.5040708812260536
31598,JESUP,GA,199,322,123,0.6180422264875239
31601,VALDOSTA,GA,13138,12181,-957,0.4811011493344919
31602,VALDOSTA,GA,17584,15197,-2387,0.4635917147127909
31603,VALDOSTA,GA,238,1121,883,0.8248712288447387
31604,VALDOSTA,GA,793,1098,305,0.5806451612903226
31605,VALDOSTA,GA,11078,10867,-211,0.49519252677147413
31606,VALDOSTA,GA,947,983,36,0.5093264248704663
31620,ADEL,GA,4030,4137,107,0.5065507530304886
31622,ALAPAHA,GA,277,362,85,0.5665101721439749
31624,AXSON,GA,0,65,65,1
31625,BARNEY,GA,0,26,26,1
31626,BOSTON,GA,828,1014,186,0.5504885993485342
31629,DIXIE,GA,13,50,37,0.7936507936507936
31630,DU PONT,GA,11,12,1,0.5217391304347826
31632,HAHIRA,GA,4642,5358,716,0.5358
31634,HOMERVILLE,GA,1853,1581,-272,0.4603960396039604
31635,LAKELAND,GA,2684,2810,126,0.5114670549690572
31636,LAKE PARK,GA,3694,3751,57,0.5038280725319007
31637,LENOX,GA,581,745,164,0.5618401206636501
31638,MORVEN,GA,21,71,50,0.7717391304347826
31639,NASHVILLE,GA,4330,4241,-89,0.4948080737370202
31641,NAYLOR,GA,368,410,42,0.5269922879177378
31642,PEARSON,GA,897,996,99,0.526148969889065
31643,QUITMAN,GA,3303,3033,-270,0.4786931818181818
31645,RAY CITY,GA,2031,2187,156,0.5184921763869133
31647,SPARKS,GA,1654,1448,-206,0.46679561573178596
31648,STATENVILLE,GA,214,11,-203,0.04888888888888889
31650,WILLACOOCHEE,GA,877,705,-172,0.44563843236409606
31699,MOODY AFB,GA,0,52,52,1
31701,ALBANY,GA,8434,7400,-1034,0.46734874321081216
31702,ALBANY,GA,25,126,101,0.8344370860927153
31703,ALBANY,GA,415,32,-383,0.07158836689038031
31705,ALBANY,GA,11445,10419,-1026,0.47653677277716794
31706,ALBANY,GA,356,908,552,0.7183544303797469
31707,ALBANY,GA,11444,10511,-933,0.4787519927123662
31708,ALBANY,GA,183,564,381,0.7550200803212851
31709,AMERICUS,GA,5919,4949,-970,0.45537357379462645
31711,ANDERSONVILLE,GA,35,36,1,0.5070422535211268
31712,ARABI,GA,73,123,50,0.6275510204081632
31714,ASHBURN,GA,1905,1960,55,0.5071151358344114
31716,BACONTON,GA,1006,833,-173,0.45296356715606306
31719,AMERICUS,GA,2164,2227,63,0.507173764518333
31720,BARWICK,GA,11,0,-11,0
31721,ALBANY,GA,6240,6542,302,0.5118134877171022
31722,BERLIN,GA,14,0,-14,0
31730,CAMILLA,GA,3312,2722,-590,0.45111037454424924
31733,CHULA,GA,103,135,32,0.5672268907563025
31735,COBB,GA,86,90,4,0.5113636363636364
31738,COOLIDGE,GA,705,451,-254,0.39013840830449825
31743,DE SOTO,GA,22,0,-22,0
31744,DOERUN,GA,659,716,57,0.5207272727272727
31749,ENIGMA,GA,639,760,121,0.5432451751250893
31750,FITZGERALD,GA,6669,6538,-131,0.49504050882107975
31756,HARTSFIELD,GA,11,0,-11,0
31757,THOMASVILLE,GA,4007,3486,-521,0.4652342186040304
31758,THOMASVILLE,GA,276,495,219,0.642023346303502
31763,LEESBURG,GA,9117,9728,611,0.5162111966038737
31764,LESLIE,GA,11,36,25,0.7659574468085106
31765,MEIGS,GA,339,446,107,0.5681528662420382
31768,MOULTRIE,GA,7410,6712,-698,0.47528678657413964
31771,MOULTRIE,GA,32,24,-8,0.42857142857142855
31771,NORMAN PARK,GA,1298,1358,60,0.5112951807228916
31773,OCHLOCKNEE,GA,1700,1415,-285,0.45425361155698235
31774,OCILLA,GA,1862,1944,82,0.5107724645296899
31775,OMEGA,GA,588,334,-254,0.36225596529284165
31776,MOULTRIE,GA,340,703,363,0.6740172579098753
31778,PAVO,GA,632,663,31,0.511969111969112
31779,PELHAM,GA,3790,2707,-1083,0.41665384023395413
31780,PLAINS,GA,133,232,99,0.6356164383561644
31781,POULAN,GA,208,168,-40,0.44680851063829785
31783,REBECCA,GA,34,49,15,0.5903614457831325
31784,SALE CITY,GA,24,0,-24,0
31787,SMITHVILLE,GA,67,89,22,0.5705128205128205
31788,MOULTRIE,GA,2969,2705,-264,0.4767359887204794
31789,SUMNER,GA,140,86,-54,0.3805309734513274
31790,SYCAMORE,GA,183,194,11,0.5145888594164456
31791,SYLVESTER,GA,3775,3655,-120,0.4919246298788694
31792,METCALF,GA,207,217,10,0.5117924528301887
31792,THOMASVILLE,GA,8438,8190,-248,0.4925426990618234
31793,TIFTON,GA,2942,3544,602,0.5464076472402097
31794,TIFTON,GA,9367,8521,-846,0.47635286225402507
31795,TY TY,GA,548,535,-13,0.4939981532779317
31796,WARWICK,GA,60,99,39,0.6226415094339622
31798,WRAY,GA,25,14,-11,0.358974358974359
31799,THOMASVILLE,GA,167,483,316,0.7430769230769231
31801,BOX SPRINGS,GA,557,745,188,0.5721966205837173
31803,BUENA VISTA,GA,1027,1111,84,0.519644527595884
31804,CATAULA,GA,1287,1683,396,0.5666666666666667
31805,CUSSETA,GA,797,904,107,0.5314520870076426
31806,ELLAVILLE,GA,1233,1142,-91,0.4808421052631579
31806,MACON,GA,18,31,13,0.6326530612244898
31807,ELLERSLIE,GA,461,848,387,0.6478227654698243
31808,FORTSON,GA,2682,3106,424,0.5366275051831375
31811,HAMILTON,GA,1467,1675,208,0.5330999363462763
31815,LUMPKIN,GA,101,208,107,0.6731391585760518
31816,MANCHESTER,GA,2309,1957,-352,0.45874355368026254
31820,MIDLAND,GA,3697,4568,871,0.552692075015124
31822,PINE MOUNTAIN,GA,1789,2110,321,0.5411644011284945
31823,PINE MOUNTAIN VALLEY,GA,0,24,24,1
31824,PRESTON,GA,75,175,100,0.7
31825,RICHLAND,GA,178,266,88,0.5990990990990991
31826,SHILOH,GA,236,310,74,0.5677655677655677
31827,TALBOTTON,GA,51,162,111,0.7605633802816901
31829,UPATOI,GA,89,140,51,0.611353711790393
31830,WARM SPRINGS,GA,436,383,-53,0.46764346764346765
31831,WAVERLY HALL,GA,863,1129,266,0.5667670682730924
31833,WEST POINT,GA,2452,2124,-328,0.46416083916083917
31836,WOODLAND,GA,0,25,25,1
31901,COLUMBUS,GA,4681,3761,-920,0.4455105425254679
31902,COLUMBUS,GA,151,505,354,0.7698170731707317
31903,COLUMBUS,GA,10436,9031,-1405,0.4639132891560076
31904,COLUMBUS,GA,16028,14307,-1721,0.4716334267347948
31905,FORT BENNING,GA,7905,6806,-1099,0.46264699884440214
31906,COLUMBUS,GA,13773,9143,-4630,0.39897887938558213
31907,COLUMBUS,GA,22547,20791,-1756,0.4797406433153353
31908,COLUMBUS,GA,679,1232,553,0.6446886446886447
31909,COLUMBUS,GA,19674,17644,-2030,0.47280132911731604
31914,COLUMBUS,GA,764,437,-327,0.3638634471273938
31917,COLUMBUS,GA,92,384,292,0.8067226890756303
31995,FORT BENNING,GA,442,185,-257,0.29505582137161085
32003,FLEMING ISLAND,FL,11342,12087,745,0.5158990994067182
32003,ORANGE PARK,FL,176,201,25,0.53315649867374
32004,PONTE VEDRA,FL,156,171,15,0.5229357798165137
32004,PONTE VEDRA BEACH,FL,868,1230,362,0.5862726406101049
32004,ST AUG,FL,24,27,3,0.5294117647058824
32006,FLEMING ISLAND,FL,146,416,270,0.7402135231316725
32008,BRANFORD,FL,1771,2371,600,0.5724287783679382
32009,BRYCEVILLE,FL,550,751,201,0.5772482705611068
32011,CALLAHAN,FL,4810,5494,684,0.5331909937888198
32024,LAKE CITY,FL,6412,6905,493,0.5185101749643313
32025,LAKE CITY,FL,8430,7917,-513,0.4843090475316572
32033,ELKTON,FL,2118,2308,190,0.5214640759150474
32034,AMELIA ISLAND,FL,332,419,87,0.5579227696404794
32034,FERNANDINA,FL,3057,3612,555,0.5416104363472785
32034,FERNANDINA BCH,FL,3475,4967,1492,0.58836768538261075
32034,FERNANDINA BEACH,FL,13064,15534,2470,0.5431848381005665
32035,FERNANDINA BCH,FL,29,23,-6,0.4423076923076923
32035,FERNANDINA BEACH,FL,2350,1668,-682,0.41513190642110503
32038,FORT WHITE,FL,3342,3875,533,0.5369267008452265
32040,GLEN SAINT MARY,FL,2077,2312,235,0.5267714741398952
32040,GLEN ST MARY,FL,346,363,17,0.5119887165021156
32041,YULEE,FL,583,933,350,0.6154353562005277
32042,GRAHAM,FL,0,13,13,1
32043,GREEN COVE SPRINGS,FL,10919,26350,15431,0.7070219217043655
32044,HAMPTON,FL,362,543,181,0.6
32046,HILLIARD,FL,3154,3641,487,0.5358351729212656
32050,MIDDLEBURG,FL,1119,591,-528,0.3456140350877193
32052,JASPER,FL,1914,2219,305,0.536898136946528
32053,JENNINGS,FL,929,1107,178,0.543713163064833
32054,LAKE BUTLER,FL,3427,3360,-67,0.49506409311919847
32055,LAKE CITY,FL,6934,7219,285,0.5100685367059987
32056,LAKE CITY,FL,1170,1679,509,0.5893295893295893
32058,LAWTEY,FL,1061,1275,214,0.545804794520548
32059,LEE,FL,856,1239,383,0.5914081145584725
32060,LIVE OAK,FL,6363,7403,1040,0.5377742263547871
32062,MC ALPIN,FL,879,1217,338,0.5806297709923665
32063,MACCLENNY,FL,4736,5125,389,0.5197241659060947
32064,DOWLING PARK,FL,435,376,-59,0.4636251541307028
32064,LIVE OAK,FL,3526,3729,203,0.5139903514817368
32065,ORANGE PARK,FL,17700,18228,528,0.5073480293921175
32066,DOWLING PARK,FL,38,40,2,0.5128205128205128
32066,MAYO,FL,1521,1888,367,0.5538281020827222
32066,MIDDLEBURG,FL,29,38,9,0.5671641791044776
32067,ORANGE PARK,FL,785,871,86,0.5259661835748792
32068,MIDDLEBURG,FL,21072,23422,2350,0.5264080550186542
32071,O BRIEN,FL,1540,1781,241,0.5362842517314061
32073,ORANGE PARK,FL,21632,20838,-794,0.4906522251000706
32079,PENNEY FARMS,FL,68,59,-9,0.4645669291338583
32080,SAINT AUGUSTINE,FL,14396,16722,2326,0.5373738672151167
32080,ST AUGUSTINE,FL,1955,2370,415,0.5479768786127167
32081,PONTE VEDRA,FL,7185,11047,3862,0.6059126810004388
32081,PONTE VEDRA BEACH,FL,1808,3462,1654,0.6569259962049336
32082,PONTE VEDRA,FL,570,654,84,0.5343137254901961
32082,PONTE VEDRA BEACH,FL,14445,15381,936,0.5156910078455039
32083,RAIFORD,FL,339,300,-39,0.4694835680751174
32084,SAINT AUGUSTINE,FL,17094,15854,-1240,0.4811824693456355
32084,ST AUGUSTINE,FL,5310,4759,-551,0.47263879233290296
32085,SAINT AUGUSTINE,FL,1685,1739,54,0.5078855140186916
32085,ST AUGUSTINE,FL,303,242,-61,0.44403669724770645
32086,SAINT AUGUSTINE,FL,13951,15862,1911,0.5320497769429443
32086,ST AUGUSTINE,FL,830,988,158,0.5434543454345434
32086,ST AUGUSTINE BEACH,FL,354,402,48,0.5317460317460317
32087,SANDERSON,FL,1164,1117,-47,0.4896975010960105
32091,STARKE,FL,5370,5961,591,0.5260788985967699
32092,SAINT AUGUSTINE,FL,12498,18245,5747,0.593468431838142
32092,ST AUGUSTINE,FL,3116,4741,1625,0.6034109711085656
32094,WELLBORN,FL,1002,1206,204,0.5461956521739131
32095,SAINT AUGUSTINE,FL,5267,9218,3951,0.636382464618571
32095,ST AUGUSTINE,FL,1195,1861,666,0.6089659685863874
32096,WHITE SPRINGS,FL,910,1197,287,0.5681063122923588
32097,YULEE,FL,9451,11991,2540,0.5592295494823244
32102,ASTOR,FL,2147,2409,262,0.5287532923617209
32110,BUNNELL,FL,4746,6049,1303,0.5603520148216767
32111,CANDLER,FL,0,11,11,1
32112,CRESCENT CITY,FL,3430,3674,244,0.5171734234234234
32113,CITRA,FL,2822,3627,805,0.5624127771747558
32114,DAYTONA BEACH,FL,25079,21598,-3481,0.4627118280952075
32115,DAYTONA BEACH,FL,639,1112,473,0.6350656767561393
32116,DAYTONA BEACH,FL,41,123,82,0.75
32116,DAYTONA BEACH SHORES,FL,0,12,12,1
32117,DAYTONA BEACH,FL,13193,12594,-599,0.48838562066157365
32117,HOLLY HILL,FL,5719,6018,299,0.5127374968049757
32118,DAYTONA BEACH,FL,16191,17038,847,0.5127448915104277
32119,DAYTONA BEACH,FL,2493,2205,-288,0.46934865900383144
32119,SOUTH DAYTONA,FL,13628,12848,-780,0.48526967819912376
32120,DAYTONA BEACH,FL,995,1785,790,0.6420863309352518
32120,ORLANDO,FL,44,76,32,0.6333333333333333
32121,DAYTONA BEACH,FL,0,11,11,1
32121,SOUTH DAYTONA,FL,11,11,0,0.5
32123,PORT ORANGE,FL,0,14,14,1
32124,DAYTONA BEACH,FL,3721,7682,3961,0.6736823642900991
32125,DAYTONA BEACH,FL,22,86,64,0.7962962962962963
32125,HOLLY HILL,FL,56,147,91,0.7241379310344828
32126,DAYTONA BEACH,FL,0,17,17,1
32127,PONCE INLET,FL,614,978,364,0.614321608040201
32127,PORT ORANGE,FL,14389,15198,809,0.5136715449352757
32127,PT ORANGE,FL,2134,1842,-292,0.46327967806841047
32128,PORT ORANGE,FL,9240,10703,1463,0.5366795366795367
32128,PT ORANGE,FL,1149,1453,304,0.5584166026133743
32129,PORT ORANGE,FL,14124,14657,533,0.509259580973559
32129,PT ORANGE,FL,483,673,190,0.5821799307958477
32130,DE LEON SPGS,FL,370,231,-139,0.3843594009983361
32130,DE LEON SPRINGS,FL,3320,2031,-1289,0.3795552233227434
32131,EAST PALATKA,FL,1692,1663,-29,0.49567809239940386
32132,EDGEWATER,FL,5510,5422,-88,0.49597511891694107
32134,FORT MC COY,FL,3455,4048,593,0.5395175263228043
32134,FORT MCCOY,FL,60,136,76,0.6938775510204082
32134,SALT SPRINGS,FL,862,1057,195,0.5508077123501823
32135,PALM COAST,FL,2737,2796,59,0.505331646484728
32136,BEVERLY BEACH,FL,653,639,-14,0.49458204334365324
32136,FLAGLER BEACH,FL,5839,7174,1335,0.5512948589871667
32137,PALM COAST,FL,25843,30503,4660,0.541351648741703
32139,GEORGETOWN,FL,777,1003,226,0.5634831460674158
32140,FLORAHOME,FL,598,647,49,0.5196787148594377
32141,EDGEWATER,FL,10749,11056,307,0.5070396698005045
32142,PALM COAST,FL,154,0,-154,0
32143,PALM COAST,FL,300,0,-300,0
32145,HASTINGS,FL,2208,2641,433,0.5446483811095071
32147,HOLLISTER,FL,195,422,227,0.6839546191247974
32148,INTERLACHEN,FL,5217,5584,367,0.5169891676696602
32157,LAKE CITY,FL,0,11,11,1
32157,LAKE COMO,FL,38,14,-24,0.2692307692307692
32158,LADY LAKE,FL,1347,1561,214,0.5367950481430537
32159,LADY LAKE,FL,22899,27668,4769,0.5471552593588704
32159,THE VILLAGES,FL,1951,1860,-91,0.488060876410391
32162,LADY LAKE,FL,1644,2467,823,0.6000972999270251
32162,THE VILLAGES,FL,44370,50196,5826,0.5308038830023476
32163,THE VILLAGES,FL,25830,42517,16687,0.6220755848830234
32164,PALM COAST,FL,23374,28537,5163,0.5497293444549325
32168,NEW SMYRNA BEACH,FL,16889,21946,5057,0.565108793614008
32169,NEW SMYRNA BEACH,FL,10289,14510,4221,0.5851042380741159
32170,NEW SMYRNA,FL,83,90,7,0.5202312138728323
32170,NEW SMYRNA BEACH,FL,1100,1381,281,0.5566303909713826
32173,ORMOND BEACH,FL,878,1288,410,0.5946445060018467
32174,ORMOND BEACH,FL,26509,29890,3381,0.5299739357080799
32175,ORMOND BEACH,FL,713,951,238,0.5715144230769231
32176,ORMOND BEACH,FL,10086,11851,1765,0.5402288371244929
32177,PALATKA,FL,9612,9606,-6,0.4998438963471745
32178,PALATKA,FL,1015,955,-60,0.4847715736040609
32179,OCKLAWAHA,FL,4257,5285,1028,0.5538671138126179
32180,PIERSON,FL,975,1174,199,0.5463006049325267
32181,POMONA PARK,FL,1186,1339,153,0.5302970297029703
32181,WELAKA,FL,28,17,-11,0.37777777777777777
32183,OCKLAWAHA,FL,192,374,182,0.6607773851590106
32187,SAN MATEO,FL,757,803,46,0.5147435897435897
32189,SATSUMA,FL,2874,3168,294,0.5243296921549155
32190,SEVILLE,FL,111,232,121,0.6763848396501457
32192,SPARR,FL,28,14,-14,0.3333333333333333
32193,WELAKA,FL,744,946,202,0.5597633136094674
32195,WEIRSDALE,FL,1978,2181,203,0.5244049050252465
32202,JACKSONVILLE,FL,4327,4812,485,0.5265346317977897
32203,JACKSONVILLE,FL,936,2035,1099,0.6849545607539549
32204,JACKSONVILLE,FL,7401,6646,-755,0.4731259343632092
32205,JACKSONVILLE,FL,17601,16433,-1168,0.48284068872304164
32206,JACKSONVILLE,FL,10510,9894,-616,0.4849049206038032
32207,JACKSONVILLE,FL,19342,18580,-762,0.4899530615473867
32208,JACKSONVILLE,FL,14699,15482,783,0.5129717371856466
32209,JACKSONVILLE,FL,19417,18226,-1191,0.4841803256913636
32210,JACKSONVILLE,FL,34112,32255,-1857,0.4860096132113852
32211,JACKSONVILLE,FL,19245,17824,-1421,0.4808330410855432
32212,JACKSONVILLE,FL,578,530,-48,0.47833935018050544
32212,JACKSONVILLE NAS,FL,54,52,-2,0.49056603773584906
32216,JACKSONVILLE,FL,24769,21885,-2884,0.4690916105800146
32217,JACKSONVILLE,FL,9890,8885,-1005,0.4732356857523302
32218,JACKSONVILLE,FL,31012,33041,2029,0.5158384462866689
32219,JACKSONVILLE,FL,4990,6159,1169,0.5524262265674051
32220,JACKSONVILLE,FL,3985,4450,465,0.5275637225844695
32221,JACKSONVILLE,FL,11291,13029,1738,0.5357319078947368
32222,JACKSONVILLE,FL,8487,10582,2095,0.5549320887304001
32223,JACKSONVILLE,FL,9321,9763,442,0.5115803814713896
32224,JACKSONVILLE,FL,22416,20594,-1822,0.4788188793303883
32225,JACKSONVILLE,FL,27139,26203,-936,0.4912264257058228
32226,JACKSONVILLE,FL,8263,10878,2615,0.5683088657854867
32227,JACKSONVILLE,FL,1195,1094,-101,0.4779379641764963
32233,ATLANTIC BCH,FL,1090,1119,29,0.5065640561339972
32233,ATLANTIC BEACH,FL,9206,9059,-147,0.49597591021078563
32233,JACKSONVILLE,FL,3332,3229,-103,0.49215058680079254
32234,BALDWIN,FL,166,212,46,0.5608465608465608
32234,JACKSONVILLE,FL,2324,3187,863,0.5782979495554346
32235,JACKSONVILLE,FL,424,670,246,0.6124314442413162
32236,JACKSONVILLE,FL,903,1660,757,0.6476785017557549
32238,JACKSONVILLE,FL,456,1072,616,0.7015706806282722
32239,JACKSONVILLE,FL,891,1352,461,0.6027641551493536
32240,JACKSONVILLE,FL,15,37,22,0.7115384615384616
32240,JACKSONVILLE BEACH,FL,230,422,192,0.647239263803681
32240,JAX BCH,FL,27,18,-9,0.4
32241,JACKSONVILLE,FL,1231,1802,571,0.5941312232113419
32244,JACKSONVILLE,FL,31944,30075,-1869,0.48493203695641657
32245,JACKSONVILLE,FL,1089,1864,775,0.6312224856078564
32245,ORLANDO,FL,16,36,20,0.6923076923076923
32246,JACKSONVILLE,FL,30801,29684,-1117,0.490766305695627
32246,JAX,FL,745,728,-17,0.4942294636795655
32247,JACKSONVILLE,FL,489,990,501,0.6693711967545639
32250,JACKSONVILLE BEACH,FL,14770,14025,-745,0.48706372634137873
32250,JAX BCH,FL,627,705,78,0.5292792792792793
32254,JACKSONVILLE,FL,8335,7675,-660,0.47938788257339165
32255,JACKSONVILLE,FL,416,599,183,0.5901477832512315
32256,JACKSONVILLE,FL,46820,46979,159,0.5008475570102027
32257,JACKSONVILLE,FL,18798,17929,-869,0.48816946660495003
32258,JACKSONVILLE,FL,19511,20038,527,0.5066626210523654
32259,FRUIT COVE,FL,2207,3575,1368,0.6182981667243168
32259,JACKSONVILLE,FL,2285,3544,1259,0.6079945102075828
32259,JULINGTON CREEK,FL,304,471,167,0.607741935483871
32259,SAINT JOHNS,FL,11062,16797,5735,0.6029290355001974
32259,ST JOHNS,FL,1405,2269,864,0.6175830157866086
32260,JACKSONVILLE,FL,195,389,194,0.666095890410959
32260,SAINT JOHNS,FL,62,100,38,0.6172839506172839
32260,ST JOHNS,FL,45,124,79,0.7337278106508875
32266,JACKSONVILLE,FL,93,87,-6,0.48333333333333334
32266,NEPTUNE BEACH,FL,3374,3113,-261,0.4798828426082935
32277,JACKSONVILLE,FL,17440,15918,-1522,0.4771868817075364
32301,TALLAHASSEE,FL,18034,14953,-3081,0.4532997847636948
32302,TALLAHASSEE,FL,368,655,287,0.6402737047898338
32303,TALLAHASSEE,FL,24893,22105,-2788,0.470339163368654
32304,TALLAHASSEE,FL,20446,14811,-5635,0.42008679127549137
32305,TALLAHASSEE,FL,6181,6074,-107,0.4956344349245206
32308,TALLAHASSEE,FL,12508,11590,-918,0.480952776163997
32309,TALLAHASSEE,FL,8620,9544,924,0.5254349262277032
32310,TALLAHASSEE,FL,6233,5517,-716,0.469531914893617
32311,TALLAHASSEE,FL,10165,10274,109,0.5026664709623758
32312,TALLAHASSEE,FL,9679,11341,1662,0.5395337773549
32314,TALLAHASSEE,FL,815,1636,821,0.6674826601387189
32315,TALLAHASSEE,FL,195,287,92,0.5954356846473029
32316,TALLAHASSEE,FL,256,847,591,0.7679057116953762
32317,TALLAHASSEE,FL,4386,5661,1275,0.5634517766497462
32318,TALLAHASSEE,FL,217,748,531,0.7751295336787565
32320,APALACHICOLA,FL,1147,1271,124,0.5256410256410257
32321,BRISTOL,FL,1456,1480,24,0.5040871934604905
32322,CARRABELLE,FL,1785,1968,183,0.5243804956035172
32324,CHATTAHOOCHEE,FL,1212,1198,-14,0.4970954356846473
32326,CRAWFORDVILLE,FL,518,368,-150,0.4153498871331828
32327,CRAWFORDVILLE,FL,7968,10080,2112,0.5585106382978723
32328,EASTPOINT,FL,1679,2024,345,0.546583850931677
32328,SAINT GEORGE ISLAND,FL,264,382,118,0.5913312693498453
32328,ST GEORGE ISL,FL,72,198,126,0.7333333333333333
32329,APALACHICOLA,FL,46,104,58,0.6933333333333334
32330,GREENSBORO,FL,0,12,12,1
32331,GREENVILLE,FL,1030,1096,66,0.51552210724365
32332,GRETNA,FL,73,98,25,0.5730994152046783
32333,HAVANA,FL,3011,3399,388,0.5302652106084244
32334,CLAY HILL,FL,0,12,12,1
32334,HOSFORD,FL,323,372,49,0.5352517985611511
32336,LAMONT,FL,47,128,81,0.7314285714285714
32340,MADISON,FL,3369,2960,-409,0.467688418391531
32341,MADISON,FL,12,113,101,0.904
32343,MIDWAY,FL,1166,1229,63,0.5131524008350731
32344,MONTICELLO,FL,2830,3575,745,0.5581576893052302
32345,MONTICELLO,FL,36,81,45,0.6923076923076923
32346,ALLIGATOR POINT,FL,177,253,76,0.5883720930232558
32346,OCHLOCKONEE BAY,FL,25,35,10,0.5833333333333334
32346,PANACEA,FL,1065,1066,1,0.5002346316283435
32347,PERRY,FL,2335,2231,-104,0.4886114761279019
32348,PERRY,FL,3495,3584,89,0.5062861986156236
32350,PINETTA,FL,266,264,-2,0.4981132075471698
32351,QUINCY,FL,4103,3927,-176,0.48904109589041095
32352,QUINCY,FL,945,1017,72,0.518348623853211
32353,QUINCY,FL,119,693,574,0.853448275862069
32358,JACKSONVILLE,FL,0,13,13,1
32358,SAINT TERESA,FL,0,22,22,1
32358,SOPCHOPPY,FL,602,852,250,0.5859697386519945
32359,STEINHATCHEE,FL,883,1115,232,0.5580580580580581
32362,WOODVILLE,FL,75,65,-10,0.4642857142857143
32399,TALLAHASSEE,FL,29,0,-29,0
32401,PANAMA CITY,FL,12070,11030,-1040,0.47748917748917746
32401,PANAMA CITY BEACH,FL,231,186,-45,0.4460431654676259
32402,PANAMA CITY,FL,376,751,375,0.6663708961845608
32403,PANAMA CITY,FL,216,218,2,0.5023041474654378
32403,TYNDALL AFB,FL,104,60,-44,0.36585365853658536
32404,PANAMA CITY,FL,17560,19622,2062,0.5277284707654242
32404,PARKER,FL,328,393,65,0.5450762829403606
32405,PANAMA CITY,FL,15034,14992,-42,0.4993006061413442
32406,PANAMA CITY,FL,371,703,332,0.654562383612663
32407,P C BEACH,FL,505,611,106,0.5474910394265233
32407,PANAMA CITY,FL,627,457,-170,0.4215867158671587
32407,PANAMA CITY BEACH,FL,10758,11852,1094,0.5241928350287484
32408,P C BEACH,FL,236,209,-27,0.4696629213483146
32408,PANAMA CITY,FL,6148,7099,951,0.5358949196044387
32408,PANAMA CITY BEACH,FL,4590,4833,243,0.5128939828080229
32409,PANAMA CITY,FL,2538,3098,560,0.549680624556423
32409,SOUTHPORT,FL,855,1076,221,0.5572242361470741
32410,MEXICO BEACH,FL,151,59,-92,0.28095238095238095
32411,PANAMA CITY,FL,644,681,37,0.5139622641509434
32412,PANAMA CITY,FL,643,1139,496,0.6391694725028059
32413,P C BEACH,FL,890,1066,176,0.5449897750511248
32413,PANAMA CITY BEACH,FL,10568,12824,2256,0.5482216142270862
32417,P C BEACH,FL,170,235,65,0.5802469135802469
32417,PANAMA CITY,FL,803,1144,341,0.5875706214689266
32417,PANAMA CITY BEACH,FL,847,970,123,0.5338470005503577
32420,ALFORD,FL,1027,1158,131,0.5299771167048055
32421,ALTHA,FL,1446,1497,51,0.508664627930683
32423,BASCOM,FL,34,92,58,0.7301587301587301
32423,ENGLEWOOD,FL,11,0,-11,0
32424,BLOUNTSTOWN,FL,2073,2002,-71,0.4912883435582822
32425,BONIFAY,FL,4462,4597,135,0.5074511535489569
32426,CAMPBELLTON,FL,24,23,-1,0.48936170212765956
32427,CARYVILLE,FL,229,344,115,0.6003490401396161
32428,CHIPLEY,FL,5542,5958,416,0.5180869565217391
32428,SUNNY HILLS,FL,241,304,63,0.5577981651376147
32430,CLARKSVILLE,FL,105,137,32,0.5661157024793388
32431,COTTONDALE,FL,1828,1948,120,0.5158898305084746
32433,DEFUNIAK SPGS,FL,360,453,93,0.5571955719557196
32433,DEFUNIAK SPRINGS,FL,5340,6493,1153,0.5487196822445702
32435,DEFUNIAK SPRINGS,FL,2626,3018,392,0.5347271438695961
32438,FOUNTAIN,FL,1642,1997,355,0.5487771365759824
32439,FREEPORT,FL,6645,8800,2155,0.5697636775655552
32440,GRACEVILLE,FL,1858,2065,207,0.5263828702523579
32442,GRAND RIDGE,FL,952,992,40,0.5102880658436214
32443,GREENWOOD,FL,730,859,129,0.540591567023285
32444,LYNN HAVEN,FL,9829,10215,386,0.5096288166034724
32445,MALONE,FL,179,197,18,0.523936170212766
32446,MARIANNA,FL,3669,3382,-287,0.47964827684016453
32447,MARIANNA,FL,316,427,111,0.5746971736204576
32448,MARIANNA,FL,2907,3185,278,0.5228168089297439
32449,KINARD,FL,13,0,-13,0
32449,WEWAHITCHKA,FL,0,11,11,1
32455,BRUCE,FL,16,36,20,0.6923076923076923
32455,PONCE DE LEON,FL,1283,1409,126,0.5234026745913819
32456,MEXICO BEACH,FL,430,430,0,0.5
32456,PORT SAINT JOE,FL,2828,3656,828,0.5638494756323257
32456,PORT ST JOE,FL,987,1250,263,0.5587840858292356
32457,PORT SAINT JOE,FL,552,766,214,0.5811836115326252
32457,PORT ST JOE,FL,175,332,157,0.6548323471400395
32459,SANTA ROSA BEACH,FL,14922,17292,2370,0.5367852486496554
32460,SNEADS,FL,1214,1290,76,0.5151757188498403
32461,ALYS BEACH,FL,64,55,-9,0.46218487394957986
32461,INLET BEACH,FL,1699,2204,505,0.5646938252626185
32461,PANAMA CITY BEACH,FL,38,61,23,0.6161616161616161
32461,ROSEMARY BEACH,FL,597,846,249,0.5862785862785863
32461,SEACREST,FL,256,309,53,0.5469026548672566
32461,WATERSOUND,FL,155,248,93,0.6153846153846154
32462,LANTANA,FL,16,15,-1,0.4838709677419355
32462,VERNON,FL,1176,1322,146,0.5292233787029623
32464,WESTVILLE,FL,869,1006,137,0.5365333333333333
32465,WEWAHITCHKA,FL,2166,2536,370,0.5393449595916632
32466,YOUNGSTOWN,FL,2071,2491,420,0.5460324419114424
32501,PENSACOLA,FL,5154,4814,-340,0.4829454253611557
32502,PENSACOLA,FL,3312,3167,-145,0.48881000154344806
32503,PENSACOLA,FL,14142,13378,-764,0.4861191860465116
32504,PENSACOLA,FL,11110,10313,-797,0.4813984969425384
32505,PENSACOLA,FL,13573,12200,-1373,0.47336359756334145
32506,PENSACOLA,FL,18606,17901,-705,0.4903443175281453
32507,PENSACOLA,FL,18385,18352,-33,0.49955086152924844
32508,PENSACOLA,FL,1443,1078,-365,0.4276080920269734
32513,PENSACOLA,FL,22,1853,1831,0.9882666666666666
32514,PENSACOLA,FL,21691,19658,-2033,0.4754165759752352
32516,PENSACOLA,FL,504,943,439,0.6516931582584657
32522,PENSACOLA,FL,12,62,50,0.8378378378378378
32523,PENSACOLA,FL,0,42,42,1
32524,PENSACOLA,FL,1024,1451,427,0.5862626262626263
32526,BELLVIEW,FL,619,750,131,0.547845142439737
32526,PENSACOLA,FL,15564,18499,2935,0.5430819364119426
32530,BAGDAD,FL,203,23,-180,0.10176991150442478
32531,BAKER,FL,2079,2486,407,0.5445783132530121
32533,CANTONMENT,FL,9175,10999,1824,0.5452067016952513
32534,PENSACOLA,FL,7625,8361,736,0.5230201426247967
32535,CENTURY,FL,1153,1317,164,0.5331983805668016
32536,CRESTVIEW,FL,13669,26000,12331,0.6554236305427412
32538,PAXTON,FL,88,0,-88,0
32539,CRESTVIEW,FL,13025,14554,1529,0.5277203669458647
32540,DESTIN,FL,899,999,100,0.5263435194942044
32541,DESTIN,FL,14838,16836,1998,0.5315400644061375
32542,EGLIN AFB,FL,4383,4690,307,0.5169183291083435
32544,HURLBURT FIELD,FL,2963,1952,-1011,0.39715157680569685
32544,HURLBURT FLD,FL,229,143,-86,0.3844086021505376
32547,FORT WALTON BEACH,FL,20001,17307,-2694,0.46389514313284014
32547,FT WALTON BCH,FL,1377,1234,-143,0.47261585599387207
32548,FORT WALTON BEACH,FL,12424,13312,888,0.5172520982281629
32548,FT WALTON BCH,FL,320,253,-67,0.44153577661431065
32549,FORT WALTON BEACH,FL,970,1260,290,0.5650224215246636
32549,FT WALTON BCH,FL,19,25,6,0.5681818181818182
32550,DESTIN,FL,112,739,627,0.8683901292596945
32550,MIRAMAR BEACH,FL,7622,10026,2404,0.5681097008159565
32550,SANDESTIN,FL,394,561,167,0.587434554973822
32560,GONZALEZ,FL,0,13,13,1
32561,GULF BREEZE,FL,3265,3648,383,0.5277014320844785
32561,PENSACOLA BCH,FL,686,572,-114,0.4546899841017488
32561,PENSACOLA BEACH,FL,475,556,81,0.539282250242483
32562,GULF BREEZE,FL,444,568,124,0.5612648221343873
32563,GULF BREEZE,FL,11610,13529,1919,0.5381677871037034
32564,HOLT,FL,1089,1384,295,0.5596441568944601
32565,JAY,FL,1616,2049,433,0.5590723055934516
32565,MARY ESTHER,FL,68,108,40,0.6136363636363636
32566,FT WALTON,FL,451,466,15,0.5081788440567067
32566,NAVARRE,FL,20796,22698,1902,0.5218650848392882
32567,LAUREL HILL,FL,1306,1717,411,0.5679788289778366
32568,MC DAVID,FL,410,670,260,0.6203703703703703
32568,WALNUT HILL,FL,63,97,34,0.60625
32569,MARY ESTHER,FL,8433,7870,-563,0.4827332392811139
32570,MILTON,FL,13653,14847,1194,0.5209473684210526
32571,MILTON,FL,7431,8814,1383,0.5425669436749769
32571,PACE,FL,6042,7358,1316,0.5491044776119403
32572,MILTON,FL,869,1096,227,0.5577608142493639
32577,CANTONMENT,FL,24,29,5,0.5471698113207547
32577,MOLINO,FL,1271,1553,282,0.5499291784702549
32578,NICEVILLE,FL,14712,15239,527,0.5087977029147608
32579,SHALIMAR,FL,5450,5496,46,0.5021012241914855
32580,VALPARAISO,FL,2341,2295,-46,0.49503882657463333
32583,MILTON,FL,9468,11746,2278,0.5536909588007919
32588,NICEVILLE,FL,530,465,-65,0.46733668341708545
32591,PENSACOLA,FL,804,938,134,0.5384615384615384
32601,GAINESVILLE,FL,11713,8413,-3300,0.4180164960747292
32603,GAINESVILLE,FL,2716,1441,-1275,0.3466442145778205
32604,GAINESVILLE,FL,211,44,-167,0.17254901960784313
32605,GAINESVILLE,FL,11083,10206,-877,0.47940250833763914
32606,GAINESVILLE,FL,12556,12068,-488,0.4900909681611436
32607,GAINESVILLE,FL,19234,16315,-2919,0.45894399279867226
32608,GAINESVILLE,FL,32554,27565,-4989,0.45850729386716343
32609,GAINESVILLE,FL,8009,7335,-674,0.47803701772679874
32612,GAINESVILLE,FL,0,12,12,1
32614,GAINESVILLE,FL,1237,1933,696,0.6097791798107256
32615,ALACHUA,FL,5239,6183,944,0.5413237611626686
32616,ALACHUA,FL,428,501,73,0.5392895586652314
32617,ANTHONY,FL,1782,1794,12,0.5016778523489933
32618,ARCHER,FL,2586,2636,50,0.504787437763309
32619,BELL,FL,1746,2024,278,0.5368700265251989
32621,BRONSON,FL,1979,2363,384,0.5442192538000922
32622,BROOKER,FL,183,265,82,0.5915178571428571
32625,CEDAR KEY,FL,1190,1645,455,0.5802469135802469
32626,CHIEFLAND,FL,3773,4298,525,0.5325238508239376
32627,GAINESVILLE,FL,369,793,424,0.6824440619621343
32628,CROSS CITY,FL,1301,1385,84,0.5156366344005957
32634,FAIRFIELD,FL,0,16,16,1
32635,GAINESVILLE,FL,703,1070,367,0.6034968979131415
32640,HAWTHORNE,FL,4429,4049,-380,0.47758905402217505
32641,GAINESVILLE,FL,4954,4563,-391,0.47945781233582013
32643,HIGH SPRINGS,FL,3882,4574,692,0.5409176915799432
32644,CHIEFLAND,FL,322,367,45,0.532656023222061
32648,HORSESHOE BEACH,FL,11,0,-11,0
32653,GAINESVILLE,FL,4505,4825,320,0.5171489817792069
32655,HIGH SPRINGS,FL,433,552,119,0.5604060913705584
32656,KEYSTONE HEIGHTS,FL,6243,6497,254,0.5099686028257456
32658,LA CROSSE,FL,12,0,-12,0
32663,LOWELL,FL,0,47,47,1
32664,MC INTOSH,FL,45,62,17,0.5794392523364486
32666,MELBOURNE,FL,42,48,6,0.5333333333333333
32666,MELROSE,FL,2040,2470,430,0.5476718403547672
32667,MICANOPY,FL,1330,1455,125,0.5224416517055656
32668,MORRISTON,FL,2494,3152,658,0.5582713425433935
32669,NEWBERRY,FL,5675,7792,2117,0.578599539615356
32680,OLD TOWN,FL,4132,5219,1087,0.5581221259758314
32681,ORANGE LAKE,FL,11,69,58,0.8625
32686,REDDICK,FL,2529,2259,-270,0.4718045112781955
32692,SUWANNEE,FL,11,11,0,0.5
32693,FANNING SPGS,FL,342,419,77,0.5505913272010512
32693,FANNING SPRINGS,FL,266,248,-18,0.48249027237354086
32693,TRENTON,FL,3397,3998,601,0.5406355645706559
32694,WALDO,FL,809,947,138,0.5392938496583144
32696,WILLISTON,FL,4250,6032,1782,0.5866562925500876
32697,WORTHINGTON SPRINGS,FL,11,50,39,0.819672131147541
32701,ALTAMONTE SPG,FL,406,304,-102,0.428169014084507
32701,ALTAMONTE SPRINGS,FL,15787,14358,-1429,0.47629789351467905
32702,ALTOONA,FL,1867,2038,171,0.5218950064020487
32702,APOPKA,FL,28,53,25,0.654320987654321
32703,APOPKA,FL,22306,22245,-61,0.4993153913492402
32704,APOPKA,FL,1095,1897,802,0.634024064171123
32706,CASSADAGA,FL,0,11,11,1
32707,CASSELBERRY,FL,22064,19226,-2838,0.4656333252603536
32708,WINTER SPGS,FL,1937,1842,-95,0.4874305371791479
32708,WINTER SPRINGS,FL,20147,19780,-367,0.49540411250532224
32709,CHRISTMAS,FL,998,1393,395,0.5826014219991635
32710,CLARCONA,FL,1327,604,-723,0.3127912998446401
32712,APOPKA,FL,15729,17671,1942,0.5290718562874251
32713,DEBARY,FL,9278,11551,2273,0.5545633491766288
32714,ALTAMONTE SPRINGS,FL,28755,24100,-4655,0.45596443099044554
32715,ALTAMONTE SPRINGS,FL,107,73,-34,0.40555555555555556
32716,ALTAMONTE SPG,FL,245,250,5,0.5050505050505051
32716,ALTAMONTE SPRINGS,FL,3152,1852,-1300,0.3701039168665068
32718,APOPKA,FL,13,18,5,0.5806451612903226
32718,CASSELBERRY,FL,309,690,381,0.6906906906906907
32719,OKEECHOBEE,FL,0,15,15,1
32719,WINTER SPGS,FL,14,72,58,0.8372093023255814
32719,WINTER SPRINGS,FL,69,285,216,0.8050847457627118
32720,DELAND,FL,14369,15851,1482,0.5245201853077432
32721,DELAND,FL,1903,1537,-366,0.4468023255813954
32722,GLENWOOD,FL,0,11,11,1
32724,DELAND,FL,18008,20898,2890,0.5371408009047448
32725,DELTONA,FL,23392,22480,-912,0.4900592954307639
32725,ENTERPRISE,FL,472,551,79,0.5386119257086999
32726,DELAND,FL,286,234,-52,0.45
32726,EUSTIS,FL,11860,11634,-226,0.4951902613433217
32727,EUSTIS,FL,614,955,341,0.6086679413639261
32728,DELTONA,FL,599,679,80,0.5312989045383412
32730,CASSELBERRY,FL,455,370,-85,0.4484848484848485
32730,FERN PARK,FL,3691,3271,-420,0.4698362539500144
32732,GENEVA,FL,2330,2199,-131,0.4855376462795319
32733,GOLDENROD,FL,729,682,-47,0.4833451452870305
32735,GRAND ISLAND,FL,3289,3563,274,0.5199941622883829
32736,EUSTIS,FL,3353,4009,656,0.5445531105677804
32738,DELTONA,FL,19179,20575,1396,0.5175579815867586
32739,DELTONA,FL,713,944,231,0.5697042848521424
32744,LAKE HELEN,FL,1679,2026,347,0.5468286099865047
32746,LAKE MARY,FL,26801,26410,-391,0.4963259476424048
32747,LAKE MONROE,FL,476,882,406,0.6494845360824743
32747,LEESBURG,FL,17,17,0,0.5
32750,LONGWOOD,FL,10969,11700,731,0.5161233402443866
32751,MAITLAND,FL,13434,14186,752,0.5136133236784939
32752,LONGWOOD,FL,308,557,249,0.6439306358381502
32753,DEBARY,FL,294,370,76,0.5572289156626506
32754,MIMS,FL,5937,7173,1236,0.5471395881006865
32756,MOUNT DORA,FL,701,1178,477,0.6269292176689728
32757,MOUNT DORA,FL,15399,17627,2228,0.533730999818325
32759,OAK HILL,FL,2873,2668,-205,0.4815015340191301
32762,OVIEDO,FL,2515,1142,-1373,0.3122778233524747
32763,ORANGE CITY,FL,12077,13965,1888,0.5362491360110591
32764,OSTEEN,FL,1631,2038,407,0.5554647042790951
32765,OVIEDO,FL,26557,25211,-1346,0.48699969092875905
32766,CHULUOTA,FL,2301,2526,225,0.5233064014916097
32766,OVIEDO,FL,1616,1837,221,0.5320011584129742
32767,PAISLEY,FL,1689,1573,-116,0.4822194972409565
32768,PLYMOUTH,FL,51,61,10,0.5446428571428571
32771,SANFORD,FL,33676,33249,-427,0.4968098617855809
32772,SANFORD,FL,1086,1860,774,0.6313645621181263
32773,SANFORD,FL,16941,15203,-1738,0.47296540567446493
32774,ORANGE CITY,FL,486,791,305,0.6194205168363351
32776,SORRENTO,FL,4707,5836,1129,0.553542634923646
32777,TANGERINE,FL,23,0,-23,0
32778,TAVARES,FL,15846,17103,1257,0.5190749339888919
32779,LONGWOOD,FL,11126,11841,715,0.5155658118169547
32779,WEKIVA SPRINGS,FL,242,253,11,0.5111111111111111
32780,TITUSVILLE,FL,22402,23951,1549,0.5167087351411991
32781,TITUSVILLE,FL,1048,1268,220,0.5474956822107081
32784,UMATILLA,FL,4822,7164,2342,0.5976973135324545
32789,WINTER PARK,FL,16225,15357,-868,0.4862579950604775
32790,WINTER PARK,FL,987,1294,307,0.567295046032442
32791,LONGWOOD,FL,136,282,146,0.6746411483253588
32792,WINTER PARK,FL,34078,30544,-3534,0.4726563708953607
32793,WINTER PARK,FL,558,924,366,0.6234817813765182
32794,MAITLAND,FL,376,637,261,0.6288252714708786
32795,LAKE MARY,FL,2937,2021,-916,0.40762404195240015
32796,TITUSVILLE,FL,10404,10426,22,0.5005280844935189
32798,ZELLWOOD,FL,1639,1975,336,0.5464858882125069
32801,ORLANDO,FL,21625,19915,-1710,0.4794174289841117
32802,ORLANDO,FL,2791,2511,-280,0.47359486986043003
32803,ORLANDO,FL,18528,16430,-2098,0.46999256250357574
32804,ORLANDO,FL,11574,12512,938,0.5194718923856182
32805,ORLANDO,FL,13050,11656,-1394,0.47178822957985916
32806,ORLANDO,FL,15239,14300,-939,0.48410575848877757
32807,AZALEA PARK,FL,787,655,-132,0.45423023578363386
32807,ORLANDO,FL,19927,17223,-2704,0.463606998654105
32808,ORLANDO,FL,32478,25878,-6600,0.44345054493111247
32809,BELLE ISLE,FL,2524,2153,-371,0.46033782339106266
32809,ORLANDO,FL,11791,9493,-2298,0.4460157865062958
32810,LOCKHART,FL,424,398,-26,0.48418491484184917
32810,ORLANDO,FL,20763,18507,-2256,0.47127578304048895
32811,ORLANDO,FL,30116,22528,-7588,0.42793100828204544
32812,BELLE ISLE,FL,2534,2229,-305,0.4679823640562671
32812,ORLANDO,FL,16183,14699,-1484,0.47597305873971896
32814,ORLANDO,FL,8484,7655,-829,0.47431687217299706
32817,ORLANDO,FL,18258,14757,-3501,0.4469786460699682
32817,UNION PARK,FL,338,304,-34,0.4735202492211838
32818,ORLANDO,FL,22011,17897,-4114,0.44845644983461963
32818,PINE HILLS,FL,510,369,-141,0.4197952218430034
32819,ORLANDO,FL,19600,21487,1887,0.5229634677635262
32820,ORLANDO,FL,3289,3742,453,0.5322144787370218
32821,ORLANDO,FL,26929,22658,-4271,0.45693427712908624
32822,ORLANDO,FL,45630,38550,-7080,0.4579472558802566
32824,ORLANDO,FL,25751,25529,-222,0.49783541341653664
32825,ORLANDO,FL,30585,27663,-2922,0.474917593737124
32826,ALAFAYA,FL,335,280,-55,0.45528455284552843
32826,ORLANDO,FL,15384,12038,-3346,0.4389905914958792
32827,ORLANDO,FL,10863,12796,1933,0.5408512616763177
32828,ORLANDO,FL,33054,29710,-3344,0.47336052514180105
32829,ORLANDO,FL,10493,9695,-798,0.4802357836338419
32830,ORLANDO,FL,0,12,12,1
32832,ORLANDO,FL,20802,22629,1827,0.52103336326587
32833,ORLANDO,FL,3749,4217,468,0.5293748430831032
32835,ORLANDO,FL,31009,25297,-5712,0.4492771640677725
32836,ORLANDO,FL,12037,12904,867,0.5173810192053245
32837,ORLANDO,FL,31787,27465,-4322,0.4635286572605144
32839,ORLANDO,FL,41988,33761,-8227,0.4456956527478911
32853,ORLANDO,FL,282,410,128,0.5924855491329479
32854,ORLANDO,FL,805,689,-116,0.46117804551539493
32855,ORLANDO,FL,924,1741,817,0.6532833020637898
32856,ORLANDO,FL,786,1123,337,0.5882661079099005
32857,ORLANDO,FL,372,892,520,0.7056962025316456
32858,ORLANDO,FL,412,1114,702,0.7300131061598951
32859,ORLANDO,FL,1143,2167,1024,0.6546827794561934
32860,ORLANDO,FL,897,1783,886,0.6652985074626866
32861,ORLANDO,FL,1595,3214,1619,0.6683302141817425
32862,ORLANDO,FL,2598,1160,-1438,0.30867482703565724
32867,ORLANDO,FL,753,1162,409,0.6067885117493472
32868,ORLANDO,FL,1617,3583,1966,0.6890384615384615
32869,ORLANDO,FL,1953,2980,1027,0.6040948712750862
32872,ORLANDO,FL,1153,1896,743,0.6218432272876353
32877,ORLANDO,FL,1523,2517,994,0.623019801980198
32878,ALAFAYA,FL,21,38,17,0.6440677966101694
32878,ORLANDO,FL,1332,1953,621,0.5945205479452055
32901,MELBOURNE,FL,18434,18200,-234,0.49680624556423
32902,MELBOURNE,FL,829,1099,270,0.5700207468879668
32903,INDIALANTIC,FL,7699,8512,813,0.5250755659737215
32903,MELBOURNE,FL,238,154,-84,0.39285714285714285
32904,MELBOURNE,FL,18666,21029,2363,0.5297644539614561
32904,WEST MELBOURNE,FL,841,919,78,0.522159090909091
32905,PALM BAY,FL,19097,18560,-537,0.4928698515548238
32906,PALM BAY,FL,528,889,361,0.6273817925194072
32907,PALM BAY,FL,18233,19589,1356,0.5179260747712972
32908,PALM BAY,FL,5784,7377,1593,0.5605197173467061
32909,PALM BAY,FL,15936,19486,3550,0.5501101010671334
32910,PALM BAY,FL,765,848,83,0.5257284562926224
32911,PALM BAY,FL,555,1006,451,0.6444586803331198
32912,CAPE CANAVERAL,FL,20,25,5,0.5555555555555556
32912,MELBOURNE,FL,725,793,68,0.5223978919631094
32912,W MELBOURNE,FL,24,16,-8,0.4
32912,WEST MELBOURNE,FL,140,222,82,0.6132596685082873
32920,CAPE CANAVERAL,FL,10926,10859,-67,0.4984622446637595
32920,CPE CANAVERAL,FL,1660,1295,-365,0.43824027072758037
32922,COCOA,FL,10163,9689,-474,0.4880616562562966
32923,COCOA,FL,835,1590,755,0.6556701030927835
32924,COCOA,FL,0,26,26,1
32925,PATRICK AFB,FL,1251,931,-320,0.42667277726856095
32925,PATRICK AIR FORCE BASE,FL,510,306,-204,0.375
32926,COCOA,FL,11053,11426,373,0.5082966324124739
32927,COCOA,FL,10340,11051,711,0.5166191388901875
32927,PORT SAINT JOHN,FL,493,503,10,0.5050200803212851
32931,COCOA BEACH,FL,12581,13405,824,0.5158546909874547
32932,COCOA BEACH,FL,535,655,120,0.5504201680672269
32934,EAU GALLIE,FL,160,246,86,0.6059113300492611
32934,MELBOURNE,FL,8027,9375,1348,0.5387311803241007
32935,MELBOURNE,FL,24981,23501,-1480,0.48473660327544243
32936,EAU GALLIE,FL,36,36,0,0.5
32936,MELBOURNE,FL,563,847,284,0.6007092198581561
32937,INDIAN HARBOUR BEACH,FL,6249,6670,421,0.516293830791857
32937,SATELLITE BEACH,FL,8798,9278,480,0.5132772737331268
32940,MELBOURNE,FL,22478,27631,5153,0.5514179089584705
32940,VIERA,FL,473,550,77,0.5376344086021505
32941,MELBOURNE,FL,819,1108,289,0.5749870264660093
32948,FELLSMERE,FL,1684,1456,-228,0.4636942675159236
32949,GRANT,FL,1023,1383,360,0.5748129675810474
32949,GRANT VALKARIA,FL,182,190,8,0.510752688172043
32950,MALABAR,FL,2086,2494,408,0.5445414847161572
32951,MELBOURNE,FL,117,120,3,0.5063291139240507
32951,MELBOURNE BCH,FL,1279,1281,2,0.500390625
32951,MELBOURNE BEACH,FL,6618,8835,2217,0.5717336439526306
32952,MERRITT IS,FL,971,1072,101,0.5247185511502692
32952,MERRITT ISLAND,FL,8068,8521,453,0.5136536258966785
32953,MERRITT IS,FL,673,730,57,0.5203136136849608
32953,MERRITT ISLAND,FL,11179,11328,149,0.5033100813080374
32954,MERRITT ISLAND,FL,773,908,135,0.5401546698393813
32955,ROCKLEDGE,FL,20370,20887,517,0.5062656034127542
32956,MELBOURNE,FL,19,17,-2,0.4722222222222222
32956,ROCKLEDGE,FL,973,908,-65,0.48272195640616694
32957,ROSELAND,FL,134,114,-20,0.4596774193548387
32958,SEBASTIAN,FL,17226,19868,2642,0.5356122283927319
32959,SHARPES,FL,169,404,235,0.7050610820244329
32960,VERO BEACH,FL,13750,13696,-54,0.49901625009108797
32961,VERO BEACH,FL,760,1146,386,0.6012591815320042
32962,VERO BEACH,FL,15327,16815,1488,0.5231472839275714
32963,INDIAN RIVER SHORES,FL,459,1081,622,0.701948051948052
32963,INDN RIV SHRS,FL,167,261,94,0.6098130841121495
32963,VERO BEACH,FL,20370,21389,1019,0.5122009626667305
32964,VERO BEACH,FL,411,680,269,0.6232813932172319
32965,VERO BEACH,FL,832,1299,467,0.6095729704364148
32966,VERO BEACH,FL,14246,16447,2201,0.5358550809630861
32967,VERO BEACH,FL,15277,17035,1758,0.5272035157217133
32968,VERO BEACH,FL,6179,7113,934,0.5351339151369244
32969,SOUTHPORT,FL,13,17,4,0.5666666666666667
32969,VERO BEACH,FL,725,795,70,0.5230263157894737
32970,WABASSO,FL,229,293,64,0.5613026819923371
32976,BAREFOOT BAY,FL,4169,4206,37,0.5022089552238806
32976,MICCO,FL,240,576,336,0.7058823529411765
32976,SEBASTIAN,FL,5351,6595,1244,0.5520676377029968
32978,SEBASTIAN,FL,1014,924,-90,0.47678018575851394
33001,LONG KEY,FL,900,1198,298,0.5710200190657769
33002,HIALEAH,FL,287,676,389,0.7019730010384216
33004,DANIA,FL,7374,7291,-83,0.4971701329696556
33004,DANIA BEACH,FL,4152,4014,-138,0.49155033063923587
33008,HALLANDALE,FL,777,1528,751,0.6629067245119306
33008,HALLANDALE BEACH,FL,332,461,129,0.5813366960907944
33009,HALLANDALE,FL,4431,3984,-447,0.4734402852049911
33009,HALLANDALE BEACH,FL,24230,22823,-1407,0.48504877478587977
33010,HIALEAH,FL,19427,15377,-4050,0.4418170325249971
33011,HIALEAH,FL,383,1028,645,0.7285613040396882
33012,HIALEAH,FL,27025,23430,-3595,0.46437419482707365
33013,HIALEAH,FL,11789,10366,-1423,0.46788535319341007
33014,HIALEAH,FL,5854,4980,-874,0.4596640206756507
33014,MIAMI GARDENS,FL,468,343,-125,0.42293464858199753
33014,MIAMI LAKES,FL,11391,9888,-1503,0.4646834907655435
33015,HIALEAH,FL,25804,21057,-4747,0.44935020592817054
33016,HIALEAH,FL,12793,10805,-1988,0.4578777862530723
33016,HIALEAH GARDENS,FL,975,819,-156,0.45652173913043476
33016,HIALEAH GDNS,FL,910,713,-197,0.43930991990141716
33016,MIAMI LAKES,FL,2242,2043,-199,0.476779463243874
33017,HIALEAH,FL,819,1586,767,0.6594594594594595
33017,MIAMI GARDENS,FL,0,21,21,1
33018,HIALEAH,FL,12792,13022,230,0.5044549469280235
33018,HIALEAH GARDENS,FL,1399,1411,12,0.502135231316726
33018,HIALEAH GDNS,FL,296,388,92,0.5672514619883041
33018,MIAMI LAKES,FL,2321,2576,255,0.5260363487849704
33019,HOLLYWOOD,FL,11302,11741,439,0.5095256694006857
33020,HOLLYWOOD,FL,29617,25448,-4169,0.4621447380368655
33021,HOLLYWOOD,FL,22371,21233,-1138,0.48695073846436104
33022,HOLLYWOOD,FL,1135,2051,916,0.6437539234149403
33023,HOLLYWOOD,FL,13877,12630,-1247,0.4764779114950768
33023,MIRAMAR,FL,5548,4935,-613,0.4707621863970238
33023,PEMBROKE PINES,FL,468,424,-44,0.47533632286995514
33023,WEST PARK,FL,3228,2897,-331,0.4729795918367347
33024,HOLLYWOOD,FL,17926,16485,-1441,0.47906192787190144
33024,PEMBROKE PINES,FL,10083,9450,-633,0.4837966518199969
33025,HOLLYWOOD,FL,807,768,-39,0.4876190476190476
33025,MIRAMAR,FL,29696,26554,-3142,0.4720711111111111
33025,PEMBROKE PINES,FL,9862,8906,-956,0.4745311167945439
33026,HOLLYWOOD,FL,2302,2374,72,0.5076988879384089
33026,PEMBROKE PINES,FL,7980,7945,-35,0.4989010989010989
33027,MIRAMAR,FL,12821,13627,806,0.5152374470659408
33027,PEMBROKE PINES,FL,9752,10065,313,0.5078972599283443
33028,PEMBROKE PINES,FL,8961,8973,12,0.5003345600535296
33028,PEMBROKE PNES,FL,393,417,24,0.5148148148148148
33029,MIRAMAR,FL,5084,5437,353,0.5167759718657923
33029,PEMBROKE PINES,FL,6429,7051,622,0.5230712166172107
33030,HOMESTEAD,FL,8946,8060,-886,0.4739503704574856
33031,HOMESTEAD,FL,1680,1896,216,0.5302013422818792
33031,KEY WEST,FL,39,38,-1,0.4935064935064935
33031,REDLAND,FL,30,40,10,0.5714285714285714
33032,HOMESTEAD,FL,19569,21796,2227,0.5269188927837544
33032,PRINCETON,FL,1396,1568,172,0.5290148448043185
33033,HOMESTEAD,FL,22281,21382,-899,0.48970524242493646
33034,FLORIDA CITY,FL,2807,3583,776,0.5607198748043819
33034,HOMESTEAD,FL,5083,6149,1066,0.5474537037037037
33035,HOMESTEAD,FL,7963,8037,74,0.5023125
33036,ISLAMORADA,FL,3590,4168,578,0.5372518690384119
33037,KEY LARGO,FL,11476,13159,1683,0.5341587172721738
33040,KEY WEST,FL,25358,24288,-1070,0.4892237038230673
33041,KEY WEST,FL,1127,1068,-59,0.4865603644646925
33042,LITTLE TORCH KEY,FL,254,349,95,0.5787728026533997
33042,LTL TORCH KEY,FL,210,122,-88,0.3674698795180723
33042,RAMROD KEY,FL,107,130,23,0.5485232067510548
33042,SUMMERLAND KEY,FL,6437,7349,912,0.5330770346728565
33043,BIG PINE KEY,FL,4839,5576,737,0.5353816610657706
33045,KEY WEST,FL,789,715,-74,0.4753989361702128
33050,DUCK KEY,FL,384,792,408,0.673469387755102
33050,GRASSY KEY,FL,162,352,190,0.6848249027237354
33050,MARATHON,FL,8221,8476,255,0.5076361022938253
33051,KEY COL BCH,FL,11,31,20,0.7380952380952381
33051,KEY COLONY BEACH,FL,1574,1780,206,0.5307096004770423
33052,MARATHON,FL,0,11,11,1
33052,MARATHON SHORES,FL,46,43,-3,0.48314606741573035
33052,MARATHON SHRS,FL,16,0,-16,0
33054,MIAMI GARDENS,FL,1585,1499,-86,0.48605706874189364
33054,OPA LOCKA,FL,10324,9967,-357,0.4912029964023459
33055,MIAMI GARDENS,FL,14442,12831,-1611,0.4704652953470465
33056,MIAMI GARDENS,FL,12065,11518,-547,0.48840266293516515
33060,POMPANO BEACH,FL,17443,16063,-1380,0.4794066734316242
33061,POMPANO BEACH,FL,898,1685,787,0.6523422377080914
33062,HILLSBORO BEACH,FL,2711,4498,1787,0.6239422943542794
33062,POMPANO BEACH,FL,19674,20196,522,0.5065462753950338
33063,COCONUT CREEK,FL,1832,1660,-172,0.4753722794959908
33063,MARGATE,FL,24378,22830,-1548,0.4836044738179969
33063,POMPANO BEACH,FL,1022,853,-169,0.45493333333333336
33064,DEERFIELD BEACH,FL,10400,9533,-867,0.47825214468469374
33064,LIGHTHOUSE POINT,FL,6442,5609,-833,0.4654385528171936
33064,LIGHTHOUSE PT,FL,1297,1348,51,0.509640831758034
33064,POMPANO BEACH,FL,10121,9513,-608,0.4845166547825201
33065,CORAL SPRINGS,FL,27467,24111,-3356,0.4674667493892745
33066,COCONUT CREEK,FL,9878,10682,804,0.5195525291828794
33066,POMPANO BEACH,FL,727,804,77,0.5251469627694317
33067,CORAL SPRINGS,FL,7292,7937,645,0.5211767023442117
33067,PARKLAND,FL,3980,4039,59,0.5036787629380222
33068,MARGATE,FL,4109,3499,-610,0.4599106203995794
33068,N LAUDERDALE,FL,513,449,-64,0.46673596673596673
33068,NORTH LAUDERDALE,FL,17193,14888,-2305,0.4640753093731492
33068,POMPANO BEACH,FL,278,344,66,0.5530546623794212
33069,POMPANO BEACH,FL,17624,17448,-176,0.49749087591240876
33070,TAVERNIER,FL,4704,4982,278,0.5143506091265745
33071,CORAL SPRINGS,FL,17012,16634,-378,0.4943826903643821
33073,COCONUT CREEK,FL,16916,15423,-1493,0.4769164167104734
33074,LIGHTHOUSE POINT,FL,188,732,544,0.7956521739130434
33074,LIGHTHOUSE PT,FL,26,84,58,0.7636363636363637
33075,CORAL SPRINGS,FL,816,1195,379,0.5942317255096967
33076,CORAL SPRINGS,FL,6922,8865,1943,0.5615379742826376
33076,PARKLAND,FL,6249,7339,1090,0.540108919634972
33077,CORAL SPRINGS,FL,773,1451,678,0.6524280575539568
33081,HOLLYWOOD,FL,613,1222,609,0.6659400544959128
33081,LAKEVIEW,FL,11,19,8,0.6333333333333333
33082,PEMBROKE PINES,FL,457,1023,566,0.6912162162162162
33082,PEMBROKE PNES,FL,0,18,18,1
33083,HOLLYWOOD,FL,160,807,647,0.8345398138572906
33083,KEY LARGO,FL,0,14,14,1
33084,HOLLYWOOD,FL,333,570,237,0.6312292358803987
33084,PEMBROKE PINES,FL,275,534,259,0.6600741656365884
33090,HOMESTEAD,FL,775,1696,921,0.6863617968433833
33092,HOMESTEAD,FL,412,961,549,0.6999271667880553
33092,NARANJA,FL,18,27,9,0.6
33092,PRINCETON,FL,150,349,199,0.6993987975951904
33093,COCONUT CREEK,FL,15,29,14,0.6590909090909091
33093,MARGATE,FL,605,1424,819,0.7018235584031542
33093,POMPANO BEACH,FL,12,35,23,0.7446808510638298
33097,COCONUT CREEK,FL,208,637,429,0.7538461538461538
33101,MIAMI,FL,938,2191,1253,0.7002237136465325
33102,MIAMI,FL,0,125,125,1
33109,MIAMI,FL,35,51,16,0.5930232558139535
33109,MIAMI BEACH,FL,353,373,20,0.5137741046831956
33114,CORAL GABLES,FL,612,1280,668,0.6765327695560254
33114,MIAMI,FL,85,122,37,0.5893719806763285
33116,FLA CITY,FL,17,22,5,0.5641025641025641
33116,MIAMI,FL,432,737,305,0.630453378956373
33119,MIAMI BEACH,FL,219,800,581,0.7850834151128557
33122,DORAL,FL,2827,2345,-482,0.4534029389017788
33122,MIAMI,FL,669,631,-38,0.48538461538461536
33125,MIAMI,FL,20490,16619,-3871,0.447842841359239
33126,DORAL,FL,999,863,-136,0.46348012889366275
33126,MIAMI,FL,22702,19001,-3701,0.45562669352324775
33127,MIAMI,FL,11702,9634,-2068,0.4515373078365204
33128,MIAMI,FL,3433,3257,-176,0.4868460388639761
33129,MIAMI,FL,8518,6781,-1737,0.4432315837636447
33130,MIAMI,FL,23511,19390,-4121,0.4519708165310832
33131,MIAMI,FL,24021,22928,-1093,0.4883597094719802
33132,MIAMI,FL,16539,16060,-479,0.4926531488695972
33133,COCONUT GROVE,FL,2163,1814,-349,0.4561227055569525
33133,CORAL GABLES,FL,1928,1542,-386,0.4443804034582133
33133,MIAMI,FL,15117,14117,-1000,0.4828966272148868
33134,CORAL GABLES,FL,20382,18192,-2190,0.47161300357753927
33134,MIAMI,FL,2586,2415,-171,0.4829034193161368
33135,MIAMI,FL,15566,12591,-2975,0.44717121852470076
33136,MIAMI,FL,8829,8359,-470,0.4863276704677682
33137,MIAMI,FL,22562,22313,-249,0.49722562674094706
33138,EL PORTAL,FL,1147,1025,-122,0.47191528545119704
33138,MIAMI,FL,10628,10355,-273,0.4934947338321498
33138,MIAMI SHORES,FL,3024,2902,-122,0.4897063786702666
33139,MIAMI,FL,615,499,-116,0.447935368043088
33139,MIAMI BEACH,FL,32777,28928,-3849,0.468811279474921
33140,MIAMI BEACH,FL,12615,11923,-692,0.4858994213057299
33141,MIAMI BEACH,FL,21225,17532,-3693,0.45235699357535414
33141,NORTH BAY VILLAGE,FL,5423,4301,-1122,0.4423076923076923
33141,NORTH BAY VLG,FL,593,587,-6,0.49745762711864405
33142,MIAMI,FL,19878,17138,-2740,0.46298897773935593
33143,CORAL GABLES,FL,1305,1282,-23,0.4955546965597217
33143,MIAMI,FL,8183,7650,-533,0.483168066696141
33143,SOUTH MIAMI,FL,5742,5573,-169,0.4925320371188688
33144,MIAMI,FL,6508,6233,-275,0.48920806844046777
33144,WEST MIAMI,FL,4070,3768,-302,0.4807348813472825
33145,CORAL GABLES,FL,897,710,-187,0.4418170504044804
33145,MIAMI,FL,12419,10745,-1674,0.4638663443274046
33146,COCONUT GROVE,FL,173,141,-32,0.44904458598726116
33146,CORAL GABLES,FL,6170,5780,-390,0.48368200836820086
33146,MIAMI,FL,599,476,-123,0.4427906976744186
33147,MIAMI,FL,18200,16481,-1719,0.4752169775958017
33149,KEY BISCAYNE,FL,6370,6438,68,0.5026545908806995
33149,MIAMI,FL,132,91,-41,0.4080717488789238
33150,EL PORTAL,FL,1282,1064,-218,0.453537936913896
33150,MIAMI,FL,7778,6911,-867,0.4704881203621758
33150,MIAMI SHORES,FL,1745,1474,-271,0.4579061820441131
33152,MIAMI,FL,366,1191,825,0.7649325626204239
33153,MIAMI,FL,88,248,160,0.7380952380952381
33153,MIAMI SHORES,FL,64,154,90,0.7064220183486238
33154,BAL HARBOUR,FL,4115,3756,-359,0.47719476559522295
33154,BAY HARBOR ISLANDS,FL,1855,1753,-102,0.48586474501108645
33154,INDIAN CREEK VILLAGE,FL,181,216,35,0.5440806045340051
33154,MIAMI BEACH,FL,236,193,-43,0.44988344988344986
33154,SURFSIDE,FL,3450,3256,-194,0.4855353414852371
33155,MIAMI,FL,17465,15444,-2021,0.46929411407213834
33156,CORAL GABLES,FL,883,859,-24,0.4931113662456946
33156,KENDALL,FL,530,590,60,0.5267857142857143
33156,MIAMI,FL,6096,6193,97,0.5039466189274961
33156,PINECREST,FL,5553,5524,-29,0.4986909813126298
33157,CUTLER BAY,FL,467,437,-30,0.4834070796460177
33157,MIAMI,FL,20551,19788,-763,0.49054265103249955
33157,PALMETTO BAY,FL,830,821,-9,0.49727437916414297
33158,CORAL GABLES,FL,526,494,-32,0.4843137254901961
33158,PALMETTO BAY,FL,817,1176,359,0.5900652282990466
33158,VILLAGE OF PALMETTO BAY,FL,199,242,43,0.5487528344671202
33160,AVENTURA,FL,14385,14429,44,0.5007635177344346
33160,N MIAMI BEACH,FL,688,551,-137,0.4447134786117837
33160,NORTH MIAMI BEACH,FL,2925,3695,770,0.5581570996978852
33160,SUNNY ISL BCH,FL,1173,1341,168,0.5334128878281623
33160,SUNNY ISLES BEACH,FL,10195,10072,-123,0.4969655104356836
33161,BISCAYNE PARK,FL,831,680,-151,0.4500330906684315
33161,MIAMI,FL,6932,5762,-1170,0.45391523554435165
33161,MIAMI SHORES,FL,627,547,-80,0.46592844974446335
33161,NORTH MIAMI,FL,11876,9967,-1909,0.4563017900471547
33162,MIAMI,FL,4134,3548,-586,0.46185889091382454
33162,N MIAMI BEACH,FL,316,238,-78,0.4296028880866426
33162,NORTH MIAMI BEACH,FL,11754,10063,-1691,0.4612458174817803
33163,MIAMI,FL,41,96,55,0.7007299270072993
33163,OJUS,FL,0,12,12,1
33164,MIAMI,FL,96,310,214,0.7635467980295566
33164,N MIAMI BEACH,FL,0,30,30,1
33164,NORTH MIAMI BEACH,FL,0,15,15,1
33165,MIAMI,FL,16233,14227,-2006,0.4670715692711753
33165,OLYMPIA HEIGHTS,FL,777,647,-130,0.45435393258426965
33166,DORAL,FL,6439,6639,200,0.507646429117602
33166,MEDLEY,FL,703,672,-31,0.48872727272727273
33166,MIAMI,FL,3503,3808,305,0.520858979619751
33166,MIAMI SPRINGS,FL,4028,4023,-5,0.49968947956775556
33166,VIRGINIA GARDENS,FL,930,933,3,0.500805152979066
33167,MIAMI,FL,5233,4620,-613,0.46889272302851925
33167,NORTH MIAMI,FL,773,721,-52,0.4825970548862115
33168,MIAMI,FL,4748,4793,45,0.5023582433707159
33168,MIAMI SHORES,FL,292,294,2,0.5017064846416383
33168,NORTH MIAMI,FL,2455,2563,108,0.5107612594659227
33169,MIAMI,FL,10799,10423,-376,0.49114126849495804
33169,MIAMI GARDENS,FL,3494,3606,112,0.507887323943662
33169,N MIAMI BEACH,FL,337,314,-23,0.4823348694316436
33169,NORTH MIAMI BEACH,FL,324,294,-30,0.47572815533980584
33170,GOULDS,FL,590,693,103,0.5401402961808262
33170,MIAMI,FL,4454,5107,653,0.5341491475787051
33172,DORAL,FL,2512,2140,-372,0.46001719690455717
33172,MIAMI,FL,20197,15476,-4721,0.43382950690998795
33172,SWEETWATER,FL,869,681,-188,0.4393548387096774
33173,MIAMI,FL,11292,10351,-941,0.4782608695652174
33174,MIAMI,FL,11007,9872,-1135,0.47281957948177594
33175,MIAMI,FL,14974,13742,-1232,0.47854854436551053
33176,MIAMI,FL,16254,15399,-855,0.4864941711686096
33176,PALMETTO BAY,FL,368,312,-56,0.4588235294117647
33177,MIAMI,FL,17539,18157,618,0.5086564320932317
33178,DORAL,FL,33381,30577,-2804,0.4780793645830076
33178,MEDLEY,FL,1637,1592,-45,0.49303189842056366
33179,MIAMI,FL,15896,15755,-141,0.49777258222489024
33179,MIAMI GARDENS,FL,681,818,137,0.5456971314209473
33179,N MIAMI BEACH,FL,779,885,106,0.5318509615384616
33179,NORTH MIAMI BEACH,FL,1416,1552,136,0.522911051212938
33180,AVENTURA,FL,13910,13102,-808,0.4850436842884644
33180,MIAMI,FL,7470,7291,-179,0.49393672515412235
33181,MIAMI,FL,3236,2794,-442,0.4633499170812604
33181,NORTH MIAMI,FL,5924,5634,-290,0.4874545769164215
33181,NORTH MIAMI BEACH,FL,3346,3233,-113,0.4914120687034504
33182,DORAL,FL,203,184,-19,0.4754521963824289
33182,MIAMI,FL,3114,3141,27,0.5021582733812949
33183,KENDALL,FL,1692,1371,-321,0.4476003917727718
33183,MIAMI,FL,9745,8360,-1385,0.46175089754211546
33184,MIAMI,FL,6728,5657,-1071,0.4567622123536536
33185,MIAMI,FL,7241,7654,413,0.5138637126552534
33186,MIAMI,FL,25784,23851,-1933,0.4805278533293039
33187,MIAMI,FL,5095,5620,525,0.5244983667755483
33189,CUTLER BAY,FL,8542,8229,-313,0.4906684157176078
33189,MIAMI,FL,210,197,-13,0.48402948402948404
33190,CUTLER BAY,FL,5818,5462,-356,0.48421985815602836
33192,FORT MYERS,FL,0,13,13,1
33193,MIAMI,FL,15363,13009,-2354,0.4585154377555336
33194,MIAMI,FL,2261,2688,427,0.5431400282885431
33196,MIAMI,FL,19756,17600,-2156,0.4711425206124853
33197,MIAMI,FL,967,1700,733,0.6374203224596925
33197,QUAIL HEIGHTS,FL,108,268,160,0.7127659574468085
33222,DORAL,FL,142,322,180,0.6939655172413793
33222,MIAMI,FL,479,963,484,0.6678224687933426
33231,MIAMI,FL,131,709,578,0.844047619047619
33233,MIAMI,FL,267,499,232,0.6514360313315927
33234,CORAL GABLES,FL,0,26,26,1
33234,MIAMI,FL,0,26,26,1
33238,MIAMI,FL,126,969,843,0.8849315068493151
33239,CARL FISHER,FL,0,11,11,1
33239,MIAMI BEACH,FL,76,203,127,0.7275985663082437
33242,MIAMI,FL,176,850,674,0.8284600389863548
33243,MIAMI,FL,161,248,87,0.6063569682151589
33243,SOUTH MIAMI,FL,66,220,154,0.7692307692307693
33245,MIAMI,FL,216,590,374,0.7320099255583127
33247,MIAMI,FL,786,1881,1095,0.7052868391451068
33255,LUDLAM,FL,14,29,15,0.6744186046511628
33255,MIAMI,FL,153,602,449,0.7973509933774835
33256,KENDALL,FL,40,74,34,0.6491228070175439
33256,MIAMI,FL,559,827,268,0.5966810966810967
33256,PINECREST,FL,83,122,39,0.5951219512195122
33257,MIAMI,FL,0,245,245,1
33257,PERRINE,FL,12,0,-12,0
33261,MIAMI,FL,584,1493,909,0.7188252286952335
33261,NORTH MIAMI,FL,241,557,316,0.6979949874686717
33265,MIAMI,FL,620,963,343,0.6083385975994946
33265,OLYMPIA HEIGHTS,FL,51,87,36,0.6304347826086957
33266,MIAMI,FL,14,0,-14,0
33266,MIAMI SPRINGS,FL,0,63,63,1
33269,MIAMI,FL,732,1483,751,0.6695259593679458
33280,AVENTURA,FL,0,12,12,1
33280,MIAMI,FL,23,269,246,0.9212328767123288
33283,MIAMI,FL,549,1096,547,0.6662613981762918
33296,MIAMI,FL,231,849,618,0.7861111111111111
33301,FORT LAUDERDALE,FL,19567,21920,2353,0.5283582809072721
33301,FT LAUDERDALE,FL,1631,1641,10,0.5015281173594132
33302,FORT LAUDERDALE,FL,613,1408,795,0.6966848095002474
33302,FT LAUDERDALE,FL,0,16,16,1
33303,FORT LAUDERDALE,FL,77,78,1,0.5032258064516129
33303,FT LAUDERDALE,FL,18,13,-5,0.41935483870967744
33304,FORT LAUDERDALE,FL,18351,18676,325,0.5043886893348097
33304,FT LAUDERDALE,FL,370,337,-33,0.4766619519094767
33305,FORT LAUDERDALE,FL,7004,6614,-390,0.4856807166984873
33305,POMPANO BEACH,FL,234,179,-55,0.43341404358353514
33305,WILTON MANORS,FL,2058,2051,-7,0.4991482112436116
33306,FORT LAUDERDALE,FL,2483,2506,23,0.5023050711565444
33306,FT LAUDERDALE,FL,320,231,-89,0.4192377495462795
33306,OAKLAND PARK,FL,111,85,-26,0.4336734693877551
33306,WILTON MANORS,FL,83,51,-32,0.3805970149253731
33307,FORT LAUDERDALE,FL,471,774,303,0.6216867469879518
33307,FT LAUDERDALE,FL,12,23,11,0.6571428571428571
33307,OAKLAND PARK,FL,200,341,141,0.6303142329020333
33308,FORT LAUDERDALE,FL,19583,21368,1785,0.5217943395765671
33308,FT LAUDERDALE,FL,2923,2907,-16,0.4986277873070326
33308,LAUDERDALE BY THE SEA,FL,1347,1182,-165,0.46737841043890865
33309,FORT LAUDERDALE,FL,9262,8423,-839,0.47627933276788237
33309,FT LAUDERDALE,FL,497,480,-17,0.49129989764585463
33309,LAUDERDALE LAKES,FL,447,353,-94,0.44125
33309,OAKLAND PARK,FL,9227,8879,-348,0.4903899259913841
33310,FORT LAUDERDALE,FL,1725,4182,2457,0.7079735906551549
33310,FT LAUDERDALE,FL,85,184,99,0.6840148698884758
33310,OAKLAND PARK,FL,164,329,165,0.6673427991886409
33311,FORT LAUDERDALE,FL,13467,12402,-1065,0.4794155166415401
33311,FT LAUDERDALE,FL,3441,3364,-77,0.4943423952975753
33311,LAUDERDALE LAKES,FL,9498,8432,-1066,0.4702732849972114
33311,LAUDERHILL,FL,3706,3421,-285,0.48000561245966045
33311,OAKLAND PARK,FL,686,546,-140,0.4431818181818182
33311,WILTON MANORS,FL,3270,3100,-170,0.48665620094191525
33312,DAVIE,FL,585,605,20,0.5084033613445378
33312,FORT LAUDERDALE,FL,24287,22987,-1300,0.48625037018234124
33313,CITY OF SUNRISE,FL,2629,2163,-466,0.45137729549248745
33313,FORT LAUDERDALE,FL,648,599,-49,0.48035284683239776
33313,LAUDERDALE LAKES,FL,6443,5414,-1029,0.456607910938686
33313,LAUDERHILL,FL,12683,11174,-1509,0.46837406212013244
33313,PLANTATION,FL,4215,3660,-555,0.46476190476190476
33313,SUNRISE,FL,3700,2974,-726,0.4456098291878933
33314,DAVIE,FL,15522,13983,-1539,0.47391967463141843
33314,FORT LAUDERDALE,FL,1338,1262,-76,0.48538461538461536
33315,FORT LAUDERDALE,FL,8261,7875,-386,0.48803916707982153
33315,FT LAUDERDALE,FL,398,403,5,0.5031210986267166
33316,FORT LAUDERDALE,FL,10249,11552,1303,0.5298839502775102
33316,FT LAUDERDALE,FL,361,162,-199,0.30975143403441685
33317,DAVIE,FL,853,875,22,0.5063657407407407
33317,FORT LAUDERDALE,FL,482,549,67,0.5324927255092143
33317,PLANTATION,FL,10990,11221,231,0.5052001260636622
33318,FORT LAUDERDALE,FL,333,612,279,0.6476190476190476
33318,FT LAUDERDALE,FL,12,27,15,0.6923076923076923
33318,PLANTATION,FL,400,759,359,0.6548748921484038
33319,FORT LAUDERDALE,FL,1593,1386,-207,0.4652567975830816
33319,LAUDERDALE LAKES,FL,1396,1340,-56,0.489766081871345
33319,LAUDERHILL,FL,16725,15886,-839,0.4871362423722057
33319,TAMARAC,FL,4210,3710,-500,0.4684343434343434
33320,FORT LAUDERDALE,FL,253,483,230,0.65625
33320,FT LAUDERDALE,FL,18,45,27,0.7142857142857143
33320,TAMARAC,FL,360,868,508,0.7068403908794788
33321,FORT LAUDERDALE,FL,1607,1770,163,0.5241338466094166
33321,TAMARAC,FL,21492,20810,-682,0.49193891541771073
33322,FORT LAUDERDALE,FL,388,388,0,0.5
33322,PLANTATION,FL,4257,4410,153,0.5088265835929388
33322,SUNRISE,FL,12387,12936,549,0.5108399478734748
33323,PLANTATION,FL,432,409,-23,0.4863258026159334
33323,SUNRISE,FL,10539,10310,-229,0.4945081298863255
33324,DAVIE,FL,8577,8048,-529,0.4840902255639098
33324,FORT LAUDERDALE,FL,546,501,-45,0.4785100286532951
33324,PLANTATION,FL,19287,18650,-637,0.4916045022010175
33325,DAVIE,FL,5956,5811,-145,0.4938387014532166
33325,FORT LAUDERDALE,FL,887,801,-86,0.4745260663507109
33325,PLANTATION,FL,3192,3323,131,0.5100537221795856
33325,SUNRISE,FL,1068,1125,57,0.5129958960328317
33326,DAVIE,FL,314,287,-27,0.47753743760399336
33326,FORT LAUDERDALE,FL,887,827,-60,0.4824970828471412
33326,SUNRISE,FL,1791,1810,19,0.502638156067759
33326,WESTON,FL,11812,11732,-80,0.4983010533469249
33327,WESTON,FL,6551,6461,-90,0.49654165385797727
33328,COOPER CITY,FL,4709,4949,240,0.5124249326982813
33328,DAVIE,FL,4200,4144,-56,0.49664429530201343
33328,FORT LAUDERDALE,FL,228,262,34,0.5346938775510204
33329,COOPER CITY,FL,0,19,19,1
33329,DAVIE,FL,478,908,430,0.6551226551226551
33329,FORT LAUDERDALE,FL,247,420,173,0.6296851574212894
33330,COOPER CITY,FL,1593,1919,326,0.5464123006833713
33330,DAVIE,FL,1420,1813,393,0.5607794618001856
33330,FORT LAUDERDALE,FL,69,96,27,0.5818181818181818
33330,SOUTHWEST RANCHES,FL,440,476,36,0.519650655021834
33331,DAVIE,FL,2190,2370,180,0.5197368421052632
33331,SOUTHWEST RANCHES,FL,877,1031,154,0.540356394129979
33331,WESTON,FL,3563,3963,400,0.5265745415891576
33332,FORT LAUDERDALE,FL,670,717,47,0.5169430425378515
33332,FT LAUDERDALE,FL,209,223,14,0.5162037037037037
33332,SOUTHWEST RANCHES,FL,491,517,26,0.5128968253968254
33332,WESTON,FL,1771,1881,110,0.5150602409638554
33334,FORT LAUDERDALE,FL,6029,5520,-509,0.4779634600398303
33334,FT LAUDERDALE,FL,401,354,-47,0.4688741721854305
33334,OAKLAND PARK,FL,7511,6945,-566,0.4804233536247925
33334,WILTON MANORS,FL,3177,2865,-312,0.4741807348560079
33335,FORT LAUDERDALE,FL,191,429,238,0.6919354838709677
33335,FT LAUDERDALE,FL,39,61,22,0.61
33338,FORT LAUDERDALE,FL,228,414,186,0.6448598130841121
33338,FT LAUDERDALE,FL,0,35,35,1
33339,FORT LAUDERDALE,FL,182,325,143,0.6410256410256411
33339,FT LAUDERDALE,FL,0,86,86,1
33345,FORT LAUDERDALE,FL,307,508,201,0.6233128834355828
33345,FT LAUDERDALE,FL,12,29,17,0.7073170731707317
33345,SUNRISE,FL,285,508,223,0.6406052963430012
33346,FORT LAUDERDALE,FL,22,123,101,0.8482758620689655
33346,FT LAUDERDALE,FL,0,58,58,1
33348,FORT LAUDERDALE,FL,74,54,-20,0.421875
33351,FORT LAUDERDALE,FL,433,370,-63,0.46077210460772106
33351,LAUDERHILL,FL,748,709,-39,0.48661633493479756
33351,SUNRISE,FL,15367,14106,-1261,0.47860753910358633
33355,DAVIE,FL,29,115,86,0.7986111111111112
33355,FORT LAUDERDALE,FL,83,137,54,0.6227272727272727
33359,FORT LAUDERDALE,FL,119,527,408,0.8157894736842105
33359,FT LAUDERDALE,FL,0,62,62,1
33359,TAMARAC,FL,0,28,28,1
33394,FORT LAUDERDALE,FL,11,0,-11,0
33401,WEST PALM BCH,FL,1709,1478,-231,0.46375902102290556
33401,WEST PALM BEACH,FL,26601,24532,-2069,0.4797684469911799
33402,PALM BEACH GARDENS,FL,24,30,6,0.5555555555555556
33402,WEST PALM BCH,FL,53,124,71,0.7005649717514124
33402,WEST PALM BEACH,FL,768,1313,545,0.6309466602594906
33403,LAKE PARK,FL,2817,2467,-350,0.4668811506434519
33403,NORTH PALM BEACH,FL,191,147,-44,0.4349112426035503
33403,PALM BEACH GARDENS,FL,967,834,-133,0.4630760688506385
33403,RIVIERA BEACH,FL,155,149,-6,0.4901315789473684
33403,W PLM BCH,FL,115,155,40,0.5740740740740741
33403,WEST PALM BCH,FL,120,150,30,0.5555555555555556
33403,WEST PALM BEACH,FL,3077,2912,-165,0.4862247453665053
33404,PALM BEACH SHORES,FL,1652,1772,120,0.5175233644859814
33404,RIVIERA BEACH,FL,15162,17172,2010,0.5310818333642605
33404,WEST PALM BEACH,FL,3501,2403,-1098,0.4070121951219512
33405,WEST PALM BCH,FL,2580,2212,-368,0.46160267111853087
33405,WEST PALM BEACH,FL,7202,6492,-710,0.4740762377683657
33406,GLEN RIDGE,FL,245,220,-25,0.4731182795698925
33406,LAKE CLARKE,FL,190,191,1,0.5013123359580053
33406,LAKE CLARKE SHORES,FL,576,563,-13,0.4942932396839333
33406,PALM SPRINGS,FL,986,896,-90,0.4760892667375133
33406,WEST PALM BCH,FL,1140,1033,-107,0.4753796594569719
33406,WEST PALM BEACH,FL,7902,7278,-624,0.47944664031620554
33407,MANGONIA PARK,FL,684,661,-23,0.49144981412639405
33407,RIVIERA BEACH,FL,1131,945,-186,0.4552023121387283
33407,WEST PALM BCH,FL,2916,2540,-376,0.4655425219941349
33407,WEST PALM BEACH,FL,13257,12342,-915,0.4821282081331302
33408,JUNO BEACH,FL,3395,2981,-414,0.467534504391468
33408,N PALM BEACH,FL,273,218,-55,0.4439918533604888
33408,NORTH PALM BEACH,FL,11261,13134,1873,0.5383890141422423
33408,WEST PALM BEACH,FL,370,282,-88,0.4325153374233129
33409,WEST PALM BCH,FL,2234,1919,-315,0.46207560799422104
33409,WEST PALM BEACH,FL,16936,14733,-2203,0.4652183523319334
33410,PALM BCH GDNS,FL,2500,2309,-191,0.48014140153878143
33410,PALM BEACH GARDENS,FL,16811,18125,1314,0.518805816349897
33410,WEST PALM BEACH,FL,2192,2124,-68,0.49212233549582945
33411,ROYAL PALM BEACH,FL,22792,23871,1079,0.5115616226989264
33411,ROYAL PLM BCH,FL,937,815,-122,0.4651826484018265
33411,WEST PALM BCH,FL,1410,1465,55,0.5095652173913043
33411,WEST PALM BEACH,FL,7753,7889,136,0.504347270170055
33412,PALM BEACH GARDENS,FL,572,1090,518,0.6558363417569194
33412,WEST PALM BCH,FL,1402,1109,-293,0.44165671047391475
33412,WEST PALM BEACH,FL,5512,6641,1129,0.5464494363531638
33413,GREENACRES,FL,5313,5103,-210,0.4899193548387097
33413,WEST PALM BCH,FL,288,350,62,0.54858934169279
33413,WEST PALM BEACH,FL,2277,2039,-238,0.4724281742354032
33414,VILLAGE OF WELLINGTON,FL,1131,1056,-75,0.4828532235939643
33414,WEINGTON,FL,549,686,137,0.5554655870445344
33414,WELLINGTON,FL,27456,26779,-677,0.4937586429427491
33415,HAVERHILL,FL,494,416,-78,0.45714285714285713
33415,WEST PALM BCH,FL,2032,1824,-208,0.4730290456431535
33415,WEST PALM BEACH,FL,18948,16638,-2310,0.46754341595009274
33416,PALM SPRINGS,FL,41,59,18,0.59
33416,WEST PALM BCH,FL,169,294,125,0.6349892008639308
33416,WEST PALM BEACH,FL,1239,2355,1116,0.6552587646076795
33417,WEST PALM BCH,FL,3612,3729,117,0.5079689415610952
33417,WEST PALM BEACH,FL,17502,16153,-1349,0.4799584014262368
33418,PALM BCH GDNS,FL,2088,2732,644,0.566804979253112
33418,PALM BEACH GARDENS,FL,20941,25284,4343,0.5469767441860465
33418,RIVIERA BEACH,FL,1831,1569,-262,0.46147058823529413
33418,WEST PALM BEACH,FL,3886,2775,-1111,0.41660411349647203
33419,LAKEWORTH,FL,0,31,31,1
33419,RIVIERA BEACH,FL,227,649,422,0.7408675799086758
33419,WEST PALM BCH,FL,82,149,67,0.645021645021645
33419,WEST PALM BEACH,FL,248,513,265,0.6741130091984231
33420,PALM BCH GDNS,FL,42,55,13,0.5670103092783505
33420,PALM BEACH GARDENS,FL,489,702,213,0.5894206549118388
33420,WEST PALM BCH,FL,11,25,14,0.6944444444444444
33420,WEST PALM BEACH,FL,428,564,136,0.5685483870967742
33421,ROYAL PALM BEACH,FL,1118,1744,626,0.6093640810621943
33421,ROYAL PLM BCH,FL,19,52,33,0.7323943661971831
33421,WEST PALM BEACH,FL,45,85,40,0.6538461538461539
33422,HAVERHILL,FL,72,176,104,0.7096774193548387
33422,WEST PALM BCH,FL,101,224,123,0.6892307692307692
33422,WEST PALM BEACH,FL,865,1816,951,0.6773591943304738
33424,BOYNTON BEACH,FL,1008,1098,90,0.5213675213675214
33425,BOYNTON BEACH,FL,404,1163,759,0.7421825143586471
33426,BOYNTON BEACH,FL,19390,19533,143,0.5018369601520951
33427,BOCA RATON,FL,162,417,255,0.7202072538860104
33427,WEST PALM,FL,12,0,-12,0
33428,BOCA RATON,FL,18546,18819,273,0.5036531513448415
33429,BOCA RATON,FL,493,1008,515,0.6715522984676882
33430,BELLE GLADE,FL,5096,4927,-169,0.4915693904020752
33431,BOCA RATON,FL,12854,13142,288,0.5055393137405755
33432,BOCA RATON,FL,20711,20852,141,0.5016962201958473
33433,BOCA RATON,FL,26248,26109,-139,0.4986725748228508
33434,BOCA RATON,FL,16444,17308,864,0.5127992415264281
33435,BOYNTON BEACH,FL,22411,24216,1805,0.5193557380916636
33435,OCEAN RIDGE,FL,2370,1135,-1235,0.3238231098430813
33436,BOYNTON BEACH,FL,27901,27706,-195,0.49824662362652183
33437,BOYNTON BEACH,FL,26028,27987,1959,0.518133851707859
33438,BOCA RATON,FL,0,12,12,1
33438,CANAL POINT,FL,0,26,26,1
33440,CLERMONT,FL,149,161,12,0.5193548387096775
33440,CLEWISTON,FL,5219,5652,433,0.5199153711710054
33441,DEERFIELD BCH,FL,1800,1506,-294,0.455535390199637
33441,DEERFIELD BEACH,FL,14974,13987,-987,0.4829598425468734
33442,DEERFIELD BCH,FL,335,729,394,0.6851503759398496
33442,DEERFIELD BEACH,FL,20419,20780,361,0.5043811743003471
33443,DEERFIELD BCH,FL,57,84,27,0.5957446808510638
33443,DEERFIELD BEACH,FL,743,1281,538,0.6329051383399209
33444,DELRAY BEACH,FL,13063,12740,-323,0.4937410378638143
33445,DELRAY BEACH,FL,21137,21843,706,0.5082131223825035
33446,DELRAY BEACH,FL,23351,27408,4057,0.5399633562520932
33446,WEST DELRAY BEACH,FL,264,447,183,0.6286919831223629
33448,DELRAY BEACH,FL,36,218,182,0.8582677165354331
33449,LAKE WORTH,FL,2530,2295,-235,0.47564766839378236
33449,WELLINGTON,FL,2044,2504,460,0.5505716798592788
33454,GREENACRES,FL,735,1232,497,0.6263345195729537
33454,LAKE WORTH,FL,169,279,110,0.6227678571428571
33455,HOBE SOUND,FL,14959,16094,1135,0.5182752069043248
33458,JUPITER,FL,25409,24789,-620,0.493824455157576
33460,LAKE WORTH,FL,4454,4124,-330,0.48076474702727906
33460,LAKE WORTH BEACH,FL,12542,11697,-845,0.4825694129295763
33461,LAKE WORTH,FL,9856,8450,-1406,0.4615972905058451
33461,LAKE WORTH BEACH,FL,4341,3976,-365,0.47805699170373933
33461,PALM SPRINGS,FL,4782,4608,-174,0.4907348242811502
33461,VILLAGE OF PALM SPRINGS,FL,1856,1551,-305,0.455239213384209
33462,ATLANTIS,FL,432,356,-76,0.4517766497461929
33462,HYPOLUXO,FL,1075,1154,79,0.5177209510991476
33462,LAKE WORTH,FL,3117,3322,205,0.5159186209038671
33462,LANTANA,FL,14138,13425,-713,0.48706599426767766
33463,GREENACRES,FL,13335,12229,-1106,0.47836801752464403
33463,LAKE WORTH,FL,10517,10249,-268,0.4935471443706058
33465,LAKE WORTH,FL,63,62,-1,0.496
33465,LANTANA,FL,22,112,90,0.835820895522388
33466,LAKE WORTH,FL,355,992,637,0.7364513734224202
33467,GREENACRES,FL,464,457,-7,0.496199782844734
33467,LAKE WORTH,FL,24363,28983,4620,0.5433022157237656
33468,JUPITER,FL,1205,1453,248,0.5466516177577125
33469,JUPITER,FL,6484,5708,-776,0.4681758530183727
33469,TEQUESTA,FL,4215,5340,1125,0.5588697017268446
33470,LOXAHATCHEE,FL,9561,15300,5739,0.6154217449016532
33470,WELLINGTON,FL,172,321,149,0.6511156186612576
33471,MOORE HAVEN,FL,3011,4497,1486,0.5989611081513053
33472,BOYNTON BEACH,FL,8593,9915,1322,0.5357142857142857
33473,BOYNTON BEACH,FL,5105,7025,1920,0.5791426215993405
33474,BOYNTON BEACH,FL,713,982,269,0.5793510324483776
33475,HOBE SOUND,FL,691,948,257,0.5784014643075046
33476,LEHIGH ACRES,FL,38,37,-1,0.49333333333333335
33476,PAHOKEE,FL,2023,1860,-163,0.47901107391192377
33477,JUPITER,FL,17382,18402,1020,0.5142521797451375
33478,JUPITER,FL,5048,6296,1248,0.5550070521861777
33480,PALM BEACH,FL,15966,15750,-216,0.4965947786606129
33480,S PALM BCH,FL,199,231,32,0.5372093023255814
33481,BOCA RATON,FL,554,1008,454,0.645326504481434
33482,DELRAY BEACH,FL,946,1848,902,0.6614173228346457
33483,DELRAY BEACH,FL,14627,15008,381,0.506428209886958
33483,GULF STREAM,FL,484,449,-35,0.4812433011789925
33484,DELRAY BEACH,FL,22299,24640,2341,0.5249366198683397
33486,BOCA RATON,FL,10421,9584,-837,0.47908022994251437
33487,BOCA RATON,FL,12703,11899,-804,0.48365986505162184
33487,HIGHLAND BEACH,FL,5563,7117,1554,0.5612776025236593
33488,BOCA RATON,FL,176,567,391,0.7631224764468372
33493,SOUTH BAY,FL,955,989,34,0.5087448559670782
33496,BOCA RATON,FL,14943,18797,3854,0.557113218731476
33497,BOCA RATON,FL,127,344,217,0.7303609341825902
33498,BOCA RATON,FL,5257,6261,1004,0.5435839555478381
33503,BALM,FL,11,0,-11,0
33508,BRANDON,FL,524,658,134,0.55668358714044
33509,BRANDON,FL,1852,3328,1476,0.6424710424710425
33510,BRANDON,FL,15977,14032,-1945,0.4675930554167083
33511,BRANDON,FL,37459,33527,-3932,0.47230439805031976
33513,BUSHNELL,FL,5202,9191,3989,0.6385743069547697
33514,CENTER HILL,FL,1162,820,-342,0.41372351160444
33521,COLEMAN,FL,70,89,19,0.559748427672956
33523,DADE CITY,FL,6908,8994,2086,0.565589234058609
33524,CRYSTAL SPRINGS,FL,26,58,32,0.6904761904761905
33525,DADE CITY,FL,9751,12199,2448,0.5557630979498861
33526,DADE CITY,FL,656,1091,435,0.6244991413852318
33527,DOVER,FL,4119,4909,790,0.5437527691626052
33530,DURANT,FL,46,74,28,0.6166666666666667
33534,GIBSONTON,FL,8767,9166,399,0.511124742095578
33537,LACOOCHEE,FL,12,12,0,0.5
33538,LAKE PANASOFFKEE,FL,2984,3832,848,0.562206572769953
33539,ZEPHYRHILLS,FL,1408,1864,456,0.5696821515892421
33540,ZEPHYRHILLS,FL,6715,9298,2583,0.5806532192593518
33541,ZEPHYRHILLS,FL,17871,24904,7033,0.5822092343658679
33542,ZEPHYRHILLS,FL,21912,23189,1277,0.5141571140329483
33543,WESLEY CHAPEL,FL,14061,19328,5267,0.5788732816196951
33543,ZEPHYRHILLS,FL,664,822,158,0.5531628532974427
33544,WESLEY CHAPEL,FL,13141,13818,677,0.5125561037130457
33545,WESLEY CHAPEL,FL,10406,14513,4107,0.5824069986757093
33547,LITHIA,FL,11850,12193,343,0.5071330532795408
33548,LUTZ,FL,3723,4672,949,0.5565217391304348
33549,LUTZ,FL,8123,8388,265,0.5080249530615953
33550,MANGO,FL,911,440,-471,0.32568467801628426
33556,ODESSA,FL,12455,19387,6932,0.6088499466113938
33558,LUTZ,FL,11060,13788,2728,0.5548937540244687
33559,LUTZ,FL,8449,7768,-681,0.47900351483011655
33563,PLANT CITY,FL,13143,11971,-1172,0.4766664012104802
33564,PLANT CITY,FL,12,13,1,0.52
33565,PLANT CITY,FL,7180,6336,-844,0.46877774489493934
33566,PLANT CITY,FL,8184,7513,-671,0.47862648913805184
33567,PLANT CITY,FL,3900,2980,-920,0.4331395348837209
33568,RIVERVIEW,FL,1637,2545,908,0.6085604973696795
33569,RIVERVIEW,FL,11000,13730,2730,0.5551961180752123
33570,RUSKIN,FL,15961,22322,6361,0.5830786510983987
33571,SUN CITY CENTER,FL,764,756,-8,0.49736842105263157
33571,SUN CITY CTR,FL,452,60,-392,0.1171875
33572,APOLLO BEACH,FL,13022,16256,3234,0.5552291823211968
33573,RUSKIN,FL,319,668,349,0.6767983789260384
33573,SUN CITY CENTER,FL,23449,28117,4668,0.545262382189815
33574,SAINT LEO,FL,0,11,11,1
33575,RUSKIN,FL,865,1265,400,0.5938967136150235
33576,SAN ANTONIO,FL,3190,4438,1248,0.5818038804404825
33578,RIVERVIEW,FL,36091,38348,2257,0.515160063944975
33579,RIVERVIEW,FL,17666,24149,6483,0.5775200286978357
33583,SEFFNER,FL,666,1246,580,0.6516736401673641
33584,SEFFNER,FL,13593,12125,-1468,0.4714596780465044
33585,SUMTERVILLE,FL,638,924,286,0.5915492957746479
33586,SUN CITY,FL,161,85,-76,0.34552845528455284
33592,THONOTOSASSA,FL,6450,7249,799,0.5291627126067596
33593,TRILBY,FL,136,44,-92,0.24444444444444444
33594,VALRICO,FL,14758,15270,512,0.5085253763154389
33595,VALRICO,FL,940,1313,373,0.5827785175321794
33596,VALRICO,FL,10623,11525,902,0.5203630124616219
33597,WEBSTER,FL,4632,4813,181,0.5095817893065114
33598,WIMAUMA,FL,8487,13715,5228,0.6177371407981262
33601,TAMPA,FL,20,74,54,0.7872340425531915
33602,TAMPA,FL,20452,19653,-799,0.4900386485475626
33603,TAMPA,FL,11918,10441,-1477,0.4669707947582629
33604,TAMPA,FL,23483,21413,-2070,0.4769467213114754
33605,TAMPA,FL,11015,9340,-1675,0.45885531810366004
33605,YBOR CITY,FL,1391,955,-436,0.407075873827792
33606,TAMPA,FL,15277,13698,-1579,0.4727523727351165
33607,TAMPA,FL,22593,18764,-3829,0.4537079575404406
33608,FT LAUDERDALE,FL,23,16,-7,0.41025641025641024
33608,MACDILL AFB,FL,65,68,3,0.5112781954887218
33608,TAMPA,FL,446,864,418,0.6595419847328244
33609,TAMPA,FL,11433,10366,-1067,0.47552640029359144
33610,TAMPA,FL,25398,23318,-2080,0.47865177765005334
33611,TAMPA,FL,22979,21929,-1050,0.48830943261779636
33612,TAMPA,FL,29105,25767,-3338,0.46958375856538853
33613,TAMPA,FL,24801,20195,-4606,0.44881767268201617
33614,TAMPA,FL,36668,29849,-6819,0.44874242674804937
33615,TAMPA,FL,32340,26639,-5701,0.45166923820342836
33616,TAMPA,FL,10900,10440,-460,0.48922211808809746
33617,TAMPA,FL,15825,13551,-2274,0.4612949346405229
33617,TEMPLE TER,FL,561,500,-61,0.471253534401508
33617,TEMPLE TERR,FL,5734,5140,-594,0.47268714364539266
33617,TEMPLE TERRACE,FL,7824,6863,-961,0.4672839926465582
33618,TAMPA,FL,14365,13549,-816,0.4853836784409257
33619,TAMPA,FL,30870,25016,-5854,0.44762552338689476
33620,TAMPA,FL,0,59,59,1
33621,TAMPA,FL,2670,1774,-896,0.3991899189918992
33622,TAMPA,FL,632,1121,489,0.6394751853964632
33623,TAMPA,FL,82,179,97,0.685823754789272
33624,TAMPA,FL,18729,17822,-907,0.48759267872288037
33625,TAMPA,FL,13838,13756,-82,0.49851416974704643
33626,TAMPA,FL,15284,15486,202,0.5032824179395515
33626,WESTCHASE,FL,1231,1337,106,0.5206386292834891
33629,PALMA CEIA,FL,582,532,-50,0.47755834829443444
33629,TAMPA,FL,10119,9923,-196,0.4951102684362838
33630,TAMPA,FL,15,1110,1095,0.9866666666666667
33634,TAMPA,FL,14467,12819,-1648,0.46980136333650957
33635,TAMPA,FL,11759,10974,-785,0.4827343509435622
33637,TAMPA,FL,6785,6164,-621,0.47602131438721135
33637,TEMPLE TERR,FL,259,241,-18,0.482
33637,TEMPLE TERRACE,FL,6096,5307,-789,0.4654038410944488
33646,TAMPA,FL,1332,1740,408,0.56640625
33647,TAMPA,FL,38976,37260,-1716,0.4887454745789391
33662,TAMPA,FL,86,0,-86,0
33672,TAMPA,FL,157,541,384,0.7750716332378224
33673,TAMPA,FL,0,11,11,1
33674,TAMPA,FL,682,1502,820,0.6877289377289377
33675,TAMPA,FL,942,2706,1764,0.7417763157894737
33675,YBOR CITY,FL,42,156,114,0.7878787878787878
33677,TAMPA,FL,312,767,455,0.7108433734939759
33679,TAMPA,FL,693,1017,324,0.5947368421052631
33680,TAMPA,FL,1044,2165,1121,0.6746650046743534
33681,TAMPA,FL,651,984,333,0.6018348623853211
33682,TAMPA,FL,1099,1820,721,0.6235011990407674
33684,TAMPA,FL,1265,2085,820,0.6223880597014926
33685,TAMPA,FL,2268,1938,-330,0.4607703281027104
33687,TAMPA,FL,1428,2842,1414,0.6655737704918033
33687,TEMPLE TER,FL,79,159,80,0.6680672268907563
33688,CARROLLWOOD,FL,70,108,38,0.6067415730337079
33688,TAMPA,FL,1562,1445,-117,0.48054539408047886
33689,TAMPA,FL,829,1329,500,0.6158480074142725
33694,TAMPA,FL,488,707,219,0.5916317991631799
33701,SAINT PETERSBURG,FL,18188,17562,-626,0.49124475524475525
33701,ST PETERSBURG,FL,2397,2374,-23,0.4975896038566338
33702,SAINT PETERSBURG,FL,17345,16084,-1261,0.4811391306949056
33702,ST PETERSBURG,FL,2822,2922,100,0.5087047353760445
33703,SAINT PETERSBURG,FL,12614,12202,-412,0.49169890393294646
33704,SAINT PETERSBURG,FL,9073,8857,-216,0.4939765755716676
33704,ST PETERSBURG,FL,465,486,21,0.5110410094637224
33705,SAINT PETERSBURG,FL,16569,16155,-414,0.4936743674367437
33705,ST PETE,FL,342,373,31,0.5216783216783217
33705,ST PETERSBURG,FL,1597,1607,10,0.5015605493133583
33706,SAINT PETE BEACH,FL,6937,8159,1222,0.540474297827239
33706,SAINT PETERSBURG,FL,1119,705,-414,0.38651315789473684
33706,ST PETE BEACH,FL,1835,2448,613,0.5715619892598646
33706,TREASURE IS,FL,800,840,40,0.5121951219512195
33706,TREASURE ISLAND,FL,3747,4134,387,0.5245527217358203
33707,GULFPORT,FL,9771,10258,487,0.5121573718108743
33707,SAINT PETERSBURG,FL,5882,5988,106,0.5044650379106992
33707,SOUTH PASADENA,FL,3822,3928,106,0.5068387096774194
33708,MADEIRA BEACH,FL,6126,7324,1198,0.5445353159851302
33708,NORTH REDINGTON BEACH,FL,373,240,-133,0.3915171288743883
33708,REDINGTON BCH,FL,433,561,128,0.5643863179074446
33708,REDINGTON BEACH,FL,328,255,-73,0.43739279588336194
33708,REDINGTON SHORES,FL,1293,1363,70,0.5131777108433735
33708,SAINT PETERSBURG,FL,6038,6685,647,0.5254263931462705
33709,KENNETH CITY,FL,2803,3108,305,0.5257993571307731
33709,SAINT PETERSBURG,FL,12128,12633,505,0.5101974879851379
33709,ST PETERSBURG,FL,314,290,-24,0.48013245033112584
33710,SAINT PETERSBURG,FL,14230,14197,-33,0.49941956590565306
33710,ST PETERSBURG,FL,644,627,-17,0.49331235247836347
33711,SAINT PETERSBURG,FL,10479,10749,270,0.506359525155455
33711,ST PETE,FL,257,362,105,0.5848142164781907
33711,ST PETERSBURG,FL,948,941,-7,0.49814716781365803
33712,SAINT PETERSBURG,FL,15326,13544,-1782,0.4691375129892622
33712,ST PETERSBURG,FL,918,839,-79,0.47751849743881614
33713,SAINT PETERSBURG,FL,17319,16777,-542,0.4920518535898639
33713,ST PETERSBURG,FL,773,903,130,0.538782816229117
33714,SAINT PETERSBURG,FL,10418,10083,-335,0.4918296668455197
33714,ST PETE,FL,270,313,43,0.5368782161234992
33714,ST PETERSBURG,FL,401,413,12,0.5073710073710074
33715,SAINT PETERSBURG,FL,5976,8340,2364,0.5825649622799665
33715,ST PETERSBURG,FL,1656,612,-1044,0.2698412698412698
33715,TIERRA VERDE,FL,1102,1166,64,0.5141093474426808
33716,SAINT PETERSBURG,FL,19908,17467,-2441,0.4673444816053512
33716,ST PETERSBURG,FL,358,324,-34,0.4750733137829912
33730,SAINT PETERSBURG,FL,38,252,214,0.8689655172413793
33730,ST PETERSBURG,FL,0,12,12,1
33731,SAINT PETERSBURG,FL,799,1198,399,0.599899849774662
33731,ST PETERSBURG,FL,61,114,53,0.6514285714285715
33732,SAINT PETERSBURG,FL,370,623,253,0.6273917421953675
33732,ST PETERSBURG,FL,133,127,-6,0.48846153846153845
33733,SAINT PETERSBURG,FL,2740,2719,-21,0.49807657080051293
33733,ST PETE,FL,68,58,-10,0.4603174603174603
33734,LARGO,FL,18,13,-5,0.41935483870967744
33734,SAINT PETERSBURG,FL,373,659,286,0.6385658914728682
33734,ST PETERSBURG,FL,29,57,28,0.6627906976744186
33736,SAINT PETERSBURG,FL,615,726,111,0.5413870246085011
33736,ST PETE BEACH,FL,204,230,26,0.5299539170506913
33736,ST PETERSBURG,FL,29,46,17,0.6133333333333333
33738,MADEIRA BEACH,FL,350,509,159,0.5925494761350407
33738,SAINT PETERSBURG,FL,186,222,36,0.5441176470588235
33742,GULFPORT,FL,0,19,19,1
33742,SAINT PETERSBURG,FL,490,687,197,0.5836873406966865
33742,ST PETERSBURG,FL,41,128,87,0.757396449704142
33743,SAINT PETERSBURG,FL,2105,1311,-794,0.38378220140515223
33743,ST PETERSBURG,FL,32,25,-7,0.43859649122807015
33744,BAY PINES,FL,239,224,-15,0.4838012958963283
33744,ST PETERSBURG,FL,12,11,-1,0.4782608695652174
33747,SAINT PETERSBURG,FL,734,1314,580,0.6416015625
33747,ST PETERSBURG,FL,13,26,13,0.6666666666666666
33755,CLEARWATER,FL,15093,14061,-1032,0.4823008849557522
33756,BELLEAIR,FL,2577,2378,-199,0.4799192734611504
33756,CLEARWATER,FL,15655,15775,120,0.5019090041361757
33757,CLEARWATER,FL,427,819,392,0.6573033707865169
33758,CLEARWATER,FL,3591,3048,-543,0.4591052869408043
33759,CLEARWATER,FL,12433,11952,-481,0.49013737953660036
33760,CLEARWATER,FL,11665,10653,-1012,0.47732771753741376
33761,CLEARWATER,FL,9509,10406,897,0.5225207130303791
33762,CLEARWATER,FL,4986,5095,109,0.5054062097014185
33763,CLEARWATER,FL,13045,13524,479,0.5090142647446272
33764,CLEARWATER,FL,18856,20132,1276,0.5163640094388017
33765,CLEARWATER,FL,9266,8408,-858,0.475727056693448
33766,CLEARWATER,FL,155,236,81,0.6035805626598465
33767,CLEARWATER,FL,2605,2935,330,0.529783393501805
33767,CLEARWATER BEACH,FL,6235,7019,784,0.529575977063528
33770,BELLEAIR BLUFFS,FL,736,719,-17,0.4941580756013746
33770,LARGO,FL,16527,16319,-208,0.49683370882299216
33771,LARGO,FL,21624,22403,779,0.5088468439821019
33772,SEMINOLE,FL,13280,13397,117,0.5021929002511527
33773,LARGO,FL,9946,10123,177,0.5044097862374807
33774,LARGO,FL,10864,11470,606,0.5135667592012179
33775,SEMINOLE,FL,1077,1081,4,0.5009267840593142
33776,SEMINOLE,FL,5092,5281,189,0.5091101899161284
33777,LARGO,FL,114,156,42,0.5777777777777777
33777,SEMINOLE,FL,7550,8400,850,0.5266457680250783
33778,LARGO,FL,7564,8092,528,0.5168625447112928
33778,SEMINOLE,FL,506,566,60,0.5279850746268657
33779,LARGO,FL,1713,2055,342,0.5453821656050956
33780,PINELLAS PARK,FL,1073,1691,618,0.611794500723589
33781,PINELLAS PARK,FL,13884,13477,-407,0.49256240634479737
33782,PINELLAS PARK,FL,12206,13291,1085,0.5212770129819194
33784,SAINT PETERSBURG,FL,16,0,-16,0
33785,INDIAN RK BCH,FL,152,83,-69,0.35319148936170214
33785,INDIAN RKS BEACH,FL,469,341,-128,0.42098765432098767
33785,INDIAN ROCKS BEACH,FL,4664,5102,438,0.5224247388900266
33785,INDIAN SHORES,FL,941,1079,138,0.5341584158415842
33786,BELLEAIR BCH,FL,198,209,11,0.5135135135135135
33786,BELLEAIR BEACH,FL,1098,1268,170,0.5359256128486898
33786,BELLEAIR SHORES,FL,14,60,46,0.8108108108108109
33801,LAKELAND,FL,20939,20241,-698,0.49152501214181643
33802,LAKELAND,FL,1378,2422,1044,0.6373684210526316
33803,LAKELAND,FL,18248,17515,-733,0.4897519783015966
33804,LAKELAND,FL,2012,2759,747,0.5782854747432404
33805,LAKELAND,FL,16269,15973,-296,0.4954097140375907
33806,LAKELAND,FL,151,270,119,0.6413301662707839
33807,LAKELAND,FL,1446,1196,-250,0.45268735806207416
33809,LAKELAND,FL,15590,16055,465,0.5073471322483805
33810,LAKELAND,FL,24599,26160,1561,0.5153765834630312
33811,LAKELAND,FL,10566,13102,2536,0.5535744465100557
33812,LAKELAND,FL,5884,6706,822,0.5326449563145353
33813,LAKELAND,FL,14200,14954,754,0.5129313301776771
33815,LAKELAND,FL,9633,10008,375,0.5095463571101267
33823,AUBURNDALE,FL,17343,20284,2941,0.5390809790841683
33825,AVON PARK,FL,19272,17959,-1313,0.4823668448336064
33826,AVON PARK,FL,1144,1105,-39,0.4913294797687861
33827,BABSON PARK,FL,1362,1499,137,0.5239426773855296
33830,BARTOW,FL,12338,13002,664,0.51310181531176
33831,BARTOW,FL,423,664,241,0.6108555657773689
33834,BOWLING GREEN,FL,2546,3288,742,0.5635927322591704
33835,BRADLEY,FL,14,24,10,0.631578947368421
33836,DAVENPORT,FL,2884,1628,-1256,0.3608156028368794
33837,DAVENPORT,FL,20063,31147,11084,0.6082210505760594
33838,DUNDEE,FL,2844,3651,807,0.5621247113163972
33839,EAGLE LAKE,FL,2034,2628,594,0.5637065637065637
33840,EATON PARK,FL,346,513,167,0.5972060535506403
33840,LAKELAND,FL,0,17,17,1
33841,FORT MEADE,FL,3875,3560,-315,0.47881640887693344
33843,FROSTPROOF,FL,9098,10807,1709,0.5429289123335845
33844,HAINES CITY,FL,23748,29706,5958,0.555730160511842
33845,HAINES CITY,FL,1027,1814,787,0.6385075677578318
33846,HIGHLAND CITY,FL,518,690,172,0.5711920529801324
33848,INTERCESSION CITY,FL,710,939,229,0.569436021831413
33849,HAINES,FL,13,22,9,0.6285714285714286
33849,KATHLEEN,FL,621,834,213,0.5731958762886598
33849,LAKELAND,FL,20,14,-6,0.4117647058823529
33850,LAKE ALFRED,FL,5325,5753,428,0.5193175663477162
33851,LAKE HAMILTON,FL,181,356,175,0.6629422718808193
33852,LAKE PLACID,FL,16306,17714,1408,0.5206937095825984
33853,LAKE WALES,FL,6483,5493,-990,0.4586673346693387
33854,LAKE WALES,FL,52,16,-36,0.23529411764705882
33854,LAKESHORE,FL,551,394,-157,0.41693121693121693
33855,INDIAN LAKE ESTATES,FL,452,624,172,0.5799256505576208
33855,INDIAN LK EST,FL,58,24,-34,0.2926829268292683
33856,LAKE WALES,FL,46,17,-29,0.2698412698412698
33856,NALCREST,FL,713,671,-42,0.4848265895953757
33857,LORIDA,FL,1665,1759,94,0.5137266355140186
33858,LOUGHMAN,FL,792,1114,322,0.5844700944386149
33859,LAKE WALES,FL,8821,9630,809,0.5219229310064495
33860,MULBERRY,FL,10161,10186,25,0.5006143411805181
33862,LAKE PLACID,FL,783,943,160,0.5463499420625724
33865,ONA,FL,26,36,10,0.5806451612903226
33867,RIVER RANCH,FL,14,239,225,0.9446640316205533
33868,POLK CITY,FL,5679,7077,1398,0.5547977422389464
33870,SEBRING,FL,20009,21209,1200,0.5145567470522587
33871,SEBRING,FL,906,785,-121,0.46422235363690123
33872,SEBRING,FL,11809,13701,1892,0.5370834966679734
33873,WAUCHULA,FL,5625,5151,-474,0.4780066815144766
33875,SEBRING,FL,6675,7924,1249,0.5427769025275704
33876,SEBRING,FL,3938,4914,976,0.5551287844554903
33877,WAVERLY,FL,62,211,149,0.7728937728937729
33880,WINTER HAVEN,FL,19522,19749,227,0.5028901734104047
33881,WINTER HAVEN,FL,22616,26525,3909,0.5397733053865408
33882,WINTER HAVEN,FL,750,926,176,0.5525059665871122
33883,WINTER HAVEN,FL,368,615,247,0.6256358087487284
33884,WINTER HAVEN,FL,18875,21730,2855,0.5351557689939662
33885,FLORENCE VILL,FL,15,14,-1,0.4827586206896552
33885,WINTER HAVEN,FL,240,903,663,0.7900262467191601
33890,ZOLFO SPRINGS,FL,1892,2232,340,0.5412221144519883
33896,CHAMPIONS GATE,FL,369,523,154,0.5863228699551569
33896,CHAMPIONS GT,FL,366,398,32,0.5209424083769634
33896,DAVENPORT,FL,16208,19019,2811,0.5398983734067618
33897,DAVENPORT,FL,17523,20166,2643,0.5350632810634403
33898,LAKE WALES,FL,10710,11486,776,0.5174806271400252
33901,FORT MYERS,FL,17637,15347,-2290,0.4652861993693912
33902,FORT MYERS,FL,1287,1851,564,0.5898661567877629
33902,PORT CHARLOTTE,FL,23,49,26,0.6805555555555556
33903,N FORT MYERS,FL,858,290,-568,0.25261324041811845
33903,NO FORT MYERS,FL,1273,3454,2181,0.7306960016924053
33903,NORTH FORT MYERS,FL,19659,22231,2572,0.5306994509429458
33904,CAPE CORAL,FL,29689,29884,195,0.5016366474745271
33905,FORT MYERS,FL,22837,26332,3495,0.5355406862047225
33906,FORT MYERS,FL,2933,2465,-468,0.45665061133753243
33906,FT MYERS,FL,28,42,14,0.6
33907,FORT MYERS,FL,21206,21039,-167,0.4980234347260031
33908,FORT MYERS,FL,46984,56866,9882,0.5475782378430428
33909,CAPE CORAL,FL,19161,23359,4198,0.5493650047036689
33910,CAPE CORAL,FL,788,958,170,0.5486827033218786
33910,FORT MYERS,FL,18,14,-4,0.4375
33912,FORT MYERS,FL,18668,22148,3480,0.5426303410427283
33913,FORT MYERS,FL,22532,29890,7358,0.5701804585860898
33913,MIROMAR LAKES,FL,332,1291,959,0.7954405422057917
33914,CAPE CORAL,FL,30557,34466,3909,0.5300585946511235
33915,CAPE CORAL,FL,2268,2991,723,0.5687393040501997
33916,FORT MYERS,FL,18209,17863,-346,0.495204036371701
33917,N FT MYERS,FL,1056,1283,227,0.5485250106883284
33917,NORTH FORT MYERS,FL,26028,30865,4837,0.5425096233280017
33918,FORT MYERS,FL,29,30,1,0.5084745762711864
33918,N FORT MYERS,FL,103,118,15,0.5339366515837104
33918,NORTH FORT MYERS,FL,998,1367,369,0.5780126849894291
33919,FORT MYERS,FL,27032,30193,3161,0.5276190476190477
33920,ALVA,FL,3929,5409,1480,0.5792460912400942
33921,BOCA GRANDE,FL,4538,3307,-1231,0.4215423836838751
33922,BOKEELIA,FL,5393,5136,-257,0.4877956121189097
33924,CAPTIVA,FL,1007,716,-291,0.4155542658154382
33927,EL JOBEAN,FL,0,16,16,1
33928,ESTERO,FL,33644,38781,5137,0.5354642733862617
33929,ESTERO,FL,1429,1392,-37,0.4934420418291386
33930,FELDA,FL,14,68,54,0.8292682926829268
33930,LEHIGH ACRES,FL,16,0,-16,0
33931,FORT MYERS BEACH,FL,22513,22922,409,0.504500935402223
33932,FORT MYERS BEACH,FL,508,414,-94,0.4490238611713666
33932,FT MYERS BCH,FL,55,55,0,0.5
33935,FORT DENAUD,FL,485,1050,565,0.6840390879478827
33935,LA BELLE,FL,89,343,254,0.7939814814814815
33935,LABELLE,FL,6450,9568,3118,0.5973280059932576
33936,LEHIGH ACRES,FL,16061,15010,-1051,0.48308712304077756
33938,MURDOCK,FL,1296,1029,-267,0.4425806451612903
33938,PORT CHARLOTTE,FL,19,23,4,0.5476190476190477
33944,PALMDALE,FL,11,231,220,0.9545454545454546
33945,PINELAND,FL,106,170,64,0.6159420289855072
33946,CAPE HAZE,FL,50,229,179,0.8207885304659498
33946,PLACIDA,FL,4928,5431,503,0.5242784052514722
33947,ROTONDA WEST,FL,9883,11775,1892,0.5436790100655647
33948,PORT CHARLOTTE,FL,11857,13108,1251,0.5250550771079512
33948,PT CHARLOTTE,FL,741,426,-315,0.36503856041131105
33949,PORT CHARLOTTE,FL,901,1350,449,0.5997334517992003
33949,PT CHARLOTTE,FL,50,79,29,0.6124031007751938
33950,PUNTA GORDA,FL,29504,32954,3450,0.5276185596720997
33951,PUNTA GORDA,FL,1458,2091,633,0.5891800507185122
33952,PORT CHARLOTTE,FL,21188,21138,-50,0.4994093465009687
33952,PT CHARLOTTE,FL,2097,1716,-381,0.4500393391030684
33953,PORT CHARLOTTE,FL,6808,8755,1947,0.5625522071580029
33953,PT CHARLOTTE,FL,62,408,346,0.8680851063829788
33954,FORT PIERCE,FL,136,184,48,0.575
33954,PORT CHARLOTTE,FL,6573,7215,642,0.5232811140121845
33955,PUNTA GORDA,FL,10244,12589,2345,0.5513511146148119
33956,SAINT JAMES CITY,FL,6860,6643,-217,0.4919647485743909
33956,ST JAMES CITY,FL,459,885,426,0.6584821428571429
33957,SANIBEL,FL,16711,12719,-3992,0.4321780496092423
33960,PORT CHARLOTTE,FL,11,0,-11,0
33960,VENUS,FL,190,145,-45,0.43283582089552236
33966,FORT MYERS,FL,11823,15025,3202,0.5596320023837902
33967,ESTERO,FL,1965,1839,-126,0.4834384858044164
33967,FORT MYERS,FL,13732,13651,-81,0.4985209801701786
33970,LEHIGH ACRES,FL,2786,2188,-598,0.4398874145556896
33971,LEHIGH ACRES,FL,11399,12493,1094,0.5228946927841955
33972,LEHIGH ACRES,FL,6242,7382,1140,0.541837933059307
33973,LEHIGH ACRES,FL,7742,6860,-882,0.4697986577181208
33974,LEHIGH ACRES,FL,7866,7842,-24,0.4992360580595875
33975,LABELLE,FL,1292,1019,-273,0.4409346603202077
33976,LEHIGH ACRES,FL,7443,8293,850,0.52700813421454
33980,PORT CHARLES,FL,154,132,-22,0.46153846153846156
33980,PORT CHARLOTTE,FL,1746,2406,660,0.5794797687861272
33980,PUNTA GORDA,FL,7943,8589,646,0.519537865956932
33981,PORT CHARLOTTE,FL,9848,12739,2891,0.5639969894186921
33981,PT CHARLOTTE,FL,1131,1003,-128,0.4700093720712277
33982,BABCOCK RANCH,FL,96,199,103,0.6745762711864407
33982,PUNTA GORDA,FL,8060,13057,4997,0.6183169957853862
33983,PUNTA GORDA,FL,11366,12817,1451,0.5300004135136253
33990,CAPE CORAL,FL,20142,20798,656,0.5080117244748412
33991,CAPE CORAL,FL,15575,18737,3162,0.5460771741664724
33993,CAPE CORAL,FL,15649,20624,4975,0.5685771786177046
33993,MATLACHA,FL,967,1307,340,0.5747581354441513
33994,FORT MYERS,FL,979,1071,92,0.5224390243902439
34101,NAPLES,FL,1987,2633,646,0.5699134199134199
34102,NAPLES,FL,14994,14784,-210,0.49647390691114246
34103,NAPLES,FL,17041,16778,-263,0.4961116532126911
34104,NAPLES,FL,24874,27134,2260,0.5217274265497616
34105,NAPLES,FL,18280,18728,448,0.5060527453523562
34106,NAPLES,FL,1189,1438,249,0.5473924628854206
34107,NAPLES,FL,41,0,-41,0
34108,COCO RIVER,FL,318,803,485,0.7163247100802854
34108,NAPLES,FL,24912,25486,574,0.5056946704234295
34109,NAPLES,FL,23461,24666,1205,0.5125189602510025
34110,NAPLES,FL,25782,30239,4457,0.5397797254600953
34112,NAPLES,FL,30700,35462,4762,0.5359874248057798
34113,NAPLES,FL,23304,28261,4957,0.5480655483370503
34114,NAPLES,FL,24765,33820,9055,0.5772808739438423
34116,NAPLES,FL,14497,12934,-1563,0.4715103350224199
34117,NAPLES,FL,5881,6579,698,0.5280096308186196
34119,NAPLES,FL,29771,32224,2453,0.5197838535365755
34120,NAPLES,FL,21410,28323,6913,0.5695011360665956
34133,BONITA SPGS,FL,141,190,49,0.5740181268882175
34133,BONITA SPRINGS,FL,983,1302,319,0.5698030634573304
34134,BONITA SPGS,FL,1500,3491,1991,0.699459026247245
34134,BONITA SPRINGS,FL,21968,21543,-425,0.4951161775183287
34134,ESTERO,FL,2818,3945,1127,0.5833210113854799
34135,BONITA SPRINGS,FL,45134,58149,13015,0.563006496712915
34136,BONITA SPGS,FL,11,57,46,0.8382352941176471
34136,BONITA SPRINGS,FL,611,862,251,0.5852002715546504
34138,CHOKOLOSKEE,FL,533,500,-33,0.484027105517909
34139,EVERGLADES CITY,FL,533,651,118,0.549831081081081
34140,GOODLAND,FL,461,548,87,0.5431119920713577
34141,OCHOPEE,FL,0,11,11,1
34142,AVE MARIA,FL,2260,2529,269,0.5280851952390896
34142,IMMOKALEE,FL,4318,5017,699,0.5374397429030531
34143,IMMOKALEE,FL,996,744,-252,0.42758620689655175
34145,MARCO ISLAND,FL,27796,29955,2159,0.5186923170161556
34146,MARCO ISLAND,FL,1230,1452,222,0.5413870246085011
34201,BRADENTON,FL,1126,1231,105,0.522274077216801
34201,UNIVERSITY PARK,FL,2361,2960,599,0.5562864123285097
34202,BRADENTON,FL,4306,4802,496,0.5272288098375055
34202,LAKEWOOD RANCH,FL,12659,16234,3575,0.5618661959644204
34203,BRADENTON,FL,23450,26079,2629,0.5265400068646652
34204,BRADENTON,FL,774,1074,300,0.5811688311688312
34205,BRADENTON,FL,19631,19463,-168,0.49785133268532256
34206,BRADENTON,FL,1166,1528,362,0.5671863400148478
34207,BRADENTON,FL,23434,22480,-954,0.48961101189179773
34208,BRADENTON,FL,22552,21693,-859,0.4902926884393717
34209,BRADENTON,FL,23415,24315,900,0.5094280326838466
34210,BRADENTON,FL,17591,17899,308,0.5043392504930967
34211,BRADENTON,FL,10995,17623,6628,0.6158012439723252
34211,LAKEWOOD RANCH,FL,3244,4995,1751,0.6062628959825221
34211,ST CLOUD,FL,294,630,336,0.6818181818181818
34212,BRADENTON,FL,12301,15042,2741,0.5501225176461984
34212,LAKEWOOD RANCH,FL,427,788,361,0.648559670781893
34215,CORTEZ,FL,1625,1716,91,0.5136186770428015
34216,ANNA MARIA,FL,1667,1592,-75,0.48849340288432036
34217,BRADENTON BEACH,FL,587,257,-330,0.30450236966824645
34217,HOLMES BEACH,FL,5631,7355,1724,0.5663791775758509
34218,HOLMES BEACH,FL,50,73,23,0.5934959349593496
34219,PARRISH,FL,12605,19077,6472,0.6021400164131052
34220,LONGBOAT,FL,28,14,-14,0.3333333333333333
34220,PALMETTO,FL,967,1260,293,0.5657835653345308
34221,PALMETTO,FL,26205,33749,7544,0.5629149014244254
34222,ELLENTON,FL,11643,12331,688,0.5143488779511137
34223,ENGLEWOOD,FL,22821,27029,4208,0.5422066198595787
34224,ENGLEWOOD,FL,16908,19484,2576,0.5353923939327324
34228,LONGBOAT KEY,FL,14473,15378,905,0.5151586211517202
34229,OSPREY,FL,6931,7641,710,0.5243617897337359
34230,SARASOTA,FL,1997,2917,920,0.5936100936100936
34231,SARASOTA,FL,24003,24045,42,0.5004370629370629
34232,SARASOTA,FL,19987,21782,1795,0.5214872273695803
34233,SARASOTA,FL,10698,12067,1369,0.5300680869756205
34234,SARASOTA,FL,14977,12857,-2120,0.46191707983042324
34235,SARASOTA,FL,10711,11531,820,0.5184335941012499
34236,SARASOTA,FL,17801,18656,855,0.5117261431275201
34237,SARASOTA,FL,12027,10682,-1345,0.47038619049715974
34238,SARASOTA,FL,20252,24089,3837,0.5432669538350511
34239,SARASOTA,FL,10292,9982,-310,0.4923547400611621
34240,LAKEWOOD RANCH,FL,638,1140,502,0.641169853768279
34240,SARASOTA,FL,7003,13505,6502,0.6585235030232105
34241,SARASOTA,FL,7779,9764,1985,0.5565752721883372
34242,SARASOTA,FL,9955,12518,2563,0.5570239843367597
34242,SIESTA KEY,FL,496,932,436,0.6526610644257703
34243,SARASOTA,FL,21323,22907,1584,0.5179063983721456
34250,TERRA CEIA,FL,59,71,12,0.5461538461538461
34251,MYAKKA CITY,FL,2051,2442,391,0.5435121299799689
34264,ONECO,FL,341,480,139,0.584652862362972
34265,ARCADIA,FL,1066,901,-165,0.45805795627859686
34266,ARCADIA,FL,10052,13586,3534,0.5747525171334292
34267,FORT OGDEN,FL,204,74,-130,0.26618705035971224
34268,NOCATEE,FL,102,34,-68,0.25
34269,ARCADIA,FL,3075,4715,1640,0.6052631578947368
34269,LAKE SUZY,FL,1316,3391,2075,0.7204164011047376
34270,TALL,FL,0,17,17,1
34270,TALLEVAST,FL,611,839,228,0.5786206896551724
34272,LAUDERDALE,FL,15,0,-15,0
34272,LAUREL,FL,51,68,17,0.5714285714285714
34274,NOKOMIS,FL,612,964,352,0.6116751269035533
34275,NOKOMIS,FL,18625,23446,4821,0.5572959996196906
34275,NORTH VENICE,FL,829,1570,741,0.6544393497290538
34276,SARASOTA,FL,1077,1548,471,0.5897142857142857
34277,SARASOTA,FL,1003,1260,257,0.556783031374282
34280,BRADENTON,FL,322,674,352,0.6767068273092369
34281,BRADENTON,FL,1793,2203,410,0.5513013013013013
34281,TRAILER EST,FL,18,100,82,0.847457627118644
34281,TRAILER ESTATES,FL,230,0,-230,0
34282,BRADENTON,FL,1260,914,-346,0.4204231830726771
34284,VENICE,FL,1529,1849,320,0.5473653049141504
34285,VENICE,FL,25574,29848,4274,0.5385586951030277
34286,NORTH PORT,FL,9854,11469,1615,0.5378699057355907
34287,NORTH PORT,FL,23313,24508,1195,0.5124945107797829
34288,NORTH PORT,FL,7709,9638,1929,0.5556003919986164
34289,NORTH PORT,FL,2977,3499,522,0.5403026559604694
34290,NORTH PORT,FL,901,1166,265,0.5641025641025641
34291,NORTH PORT,FL,3751,4476,725,0.544062234107208
34292,VENICE,FL,17177,19929,2752,0.5370829515442247
34293,VENICE,FL,38296,47498,9202,0.5536284588665874
34295,ENGLEWOOD,FL,1223,1349,126,0.5244945567651633
34420,BELLEVIEW,FL,8521,9012,491,0.5140021673415844
34421,BELLEVIEW,FL,1120,1335,215,0.5437881873727087
34423,CRYSTAL RIVER,FL,978,1206,228,0.5521978021978022
34428,CRYSTAL RIVER,FL,6196,6502,306,0.5120491415971019
34429,CRYSTAL RIVER,FL,6276,7307,1031,0.5379518515791799
34430,DUNNELLON,FL,1291,1176,-115,0.47669233887312523
34431,DUNNELLON,FL,4125,4864,739,0.5411057959728557
34432,DUNNELLON,FL,6701,7585,884,0.5309393812123757
34433,CITRUS SPRINGS,FL,1066,1307,241,0.550779603876949
34433,DUNNELLON,FL,2271,3137,866,0.5800665680473372
34434,CITRUS SPGS,FL,76,112,36,0.5957446808510638
34434,CITRUS SPRINGS,FL,3846,4875,1029,0.5589955280357757
34434,DUNNELLON,FL,471,700,229,0.5977796754910333
34436,FLORAL CITY,FL,4863,5521,658,0.5316833590138675
34441,HERNANDO,FL,147,274,127,0.6508313539192399
34442,CITRUS HILLS,FL,388,193,-195,0.33218588640275387
34442,HERNANDO,FL,10257,12126,1869,0.5417504355984453
34445,HOLDER,FL,11,27,16,0.7105263157894737
34446,HOMOSASSA,FL,10990,12974,1984,0.541395426473043
34447,HOMOSASSA SPG,FL,46,43,-3,0.48314606741573035
34447,HOMOSASSA SPRINGS,FL,908,1054,146,0.5372069317023446
34448,HOMOSASSA,FL,6576,8213,1637,0.5553451889918183
34449,INGLIS,FL,2655,3087,432,0.5376175548589341
34450,INVERNESS,FL,7273,8000,727,0.5238001702350553
34451,INVERNESS,FL,670,1045,375,0.60932944606414
34452,INVERNESS,FL,5848,6570,722,0.5290707038170398
34453,INVERNESS,FL,6509,7174,665,0.5243002265585033
34460,LECANTO,FL,598,579,-19,0.491928632115548
34461,LECANTO,FL,5796,6563,767,0.5310300186099199
34464,BEVERLY HILLS,FL,255,470,215,0.6482758620689655
34465,BEVERLY HILLS,FL,10223,11437,1214,0.5280240073868883
34470,OCALA,FL,11101,11010,-91,0.49794220071457646
34471,OCALA,FL,15016,13509,-1507,0.4735845749342682
34472,OCALA,FL,14808,17162,2354,0.5368157647794808
34473,OCALA,FL,10954,13634,2680,0.5544981291687002
34474,OCALA,FL,13370,12070,-1300,0.4744496855345912
34475,OCALA,FL,5873,6022,149,0.5062631357713325
34476,OCALA,FL,12197,14996,2799,0.5514654506674512
34477,OCALA,FL,1847,2787,940,0.6014242555028053
34478,OCALA,FL,1978,2940,962,0.5978039853599024
34479,OCALA,FL,5645,5754,109,0.5047811211509782
34480,OCALA,FL,8213,10243,2030,0.5549956653662765
34481,OCALA,FL,13760,17819,4059,0.5642673928876785
34482,OCALA,FL,9672,10810,1138,0.5277804901865052
34483,OCALA,FL,750,1165,415,0.608355091383812
34484,OXFORD,FL,3893,4611,718,0.5422154280338665
34487,HOMOSASSA,FL,62,111,49,0.6416184971098265
34488,SILVER SPGS,FL,573,662,89,0.5360323886639676
34488,SILVER SPRINGS,FL,7548,8048,500,0.5160297512182611
34489,SILVER SPGS,FL,26,57,31,0.6867469879518072
34489,SILVER SPRINGS,FL,879,1262,383,0.5894441849602989
34491,SUMMERFIELD,FL,18352,19438,1086,0.5143688806562583
34492,SUMMERFIELD,FL,627,1095,468,0.6358885017421603
34498,YANKEETOWN,FL,299,460,161,0.6060606060606061
34601,BROOKSVILLE,FL,14112,15579,1467,0.524704455895726
34602,BROOKSVILLE,FL,3534,4975,1441,0.5846750499471148
34603,BROOKSVILLE,FL,630,981,351,0.6089385474860335
34604,BROOKSVILLE,FL,5463,6227,764,0.53267750213858
34605,BROOKSVILLE,FL,196,519,323,0.7258741258741259
34606,SPRING HILL,FL,19252,19280,28,0.5003633343714315
34607,HERNANDO BEACH,FL,759,1027,268,0.5750279955207167
34607,SPRING HILL,FL,3055,3683,628,0.5466013653903236
34607,WEEKI WACHEE,FL,1459,1407,-52,0.4909281228192603
34608,SPRING HILL,FL,15514,16320,806,0.5126594207451153
34609,SPRING HILL,FL,19444,22632,3188,0.5378838292613366
34610,SPRING HILL,FL,6324,7377,1053,0.5384278519816071
34611,SPRING HILL,FL,1942,1921,-21,0.49728190525498317
34613,BROOKSVILLE,FL,8937,9560,623,0.5168405687408769
34613,SPRING HILL,FL,191,454,263,0.703875968992248
34613,WEEKI WACHEE,FL,3077,5329,2252,0.6339519390911253
34614,BROOKSVILLE,FL,1057,1825,768,0.6332408049965302
34614,WEEKI WACHEE,FL,2309,3822,1513,0.6233893328983853
34637,LAND O LAKES,FL,3822,5004,1182,0.5669612508497621
34638,LAND O LAKES,FL,13058,16954,3896,0.5649073703851792
34639,LAND O LAKES,FL,14861,13143,-1718,0.46932581059848594
34652,NEW PORT RICHEY,FL,19780,19688,-92,0.4988344988344988
34653,NEW PORT RICHEY,FL,21486,22779,1293,0.5146052185699763
34654,NEW PORT RICHEY,FL,12289,13149,860,0.5169038446418743
34655,NEW PORT RICHEY,FL,18034,19470,1436,0.5191446245733788
34655,TRINITY,FL,4971,5651,680,0.5320090378459801
34656,NEW PORT RICHEY,FL,1390,1594,204,0.5341823056300268
34660,OZONA,FL,84,72,-12,0.46153846153846156
34661,NOBLETON,FL,54,116,62,0.6823529411764706
34667,HUDSON,FL,25315,28395,3080,0.5286725004654627
34668,PORT RICHEY,FL,37869,35348,-2521,0.4827840528838931
34668,PORTRICHEY,FL,677,603,-74,0.47109375
34669,HUDSON,FL,7969,9266,1297,0.5376269219611256
34673,PORT RICHEY,FL,705,1177,472,0.6253985122210415
34674,HUDSON,FL,952,1328,376,0.5824561403508772
34677,OLDSMAR,FL,12324,12479,155,0.5031246220215296
34679,ARIPEKA,FL,48,82,34,0.6307692307692307
34680,ELFERS,FL,1210,888,-322,0.4232602478551001
34681,CRYSTAL BEACH,FL,579,1497,918,0.7210982658959537
34682,NPR,FL,20,27,7,0.574468085106383
34682,PALM HARBOR,FL,780,1060,280,0.5760869565217391
34682,WPR,FL,0,21,21,1
34683,PALM HARBOR,FL,15356,16270,914,0.5144501359640802
34684,PALM HARBOR,FL,16723,17587,864,0.5125910813174002
34685,PALM HARBOR,FL,8983,9336,353,0.5096348053933075
34688,TARPON SPGS,FL,92,134,42,0.5929203539823009
34688,TARPON SPNGS,FL,110,101,-9,0.4786729857819905
34688,TARPON SPRINGS,FL,4445,5253,808,0.5416580738296556
34689,TARPON SPGS,FL,253,396,143,0.6101694915254238
34689,TARPON SPRINGS,FL,16358,17616,1258,0.5185141578854419
34690,HOLIDAY,FL,9129,9734,605,0.5160366855749351
34691,HOLIDAY,FL,15954,16740,786,0.5120205542301339
34692,HOLIDAY,FL,308,559,251,0.6447520184544406
34695,SAFETY HARBOR,FL,9790,9943,153,0.50387675467491
34697,DUNEDIN,FL,1172,1305,133,0.5268469923294308
34698,DUNEDIN,FL,28085,28991,906,0.5079367860396664
34705,ASTATULA,FL,1175,1304,129,0.5260185558693021
34711,CLERMONT,FL,31291,32945,1654,0.5128744006476119
34712,CLERMONT,FL,1354,1161,-193,0.46163021868787274
34713,CLERMONT,FL,1963,3010,1047,0.6052684496279912
34714,CLERMONT,FL,15354,19124,3770,0.554672544811184
34715,CLERMONT,FL,2824,4549,1725,0.6169808761698088
34715,MINNEOLA,FL,4666,7470,2804,0.6155240606460118
34731,FRUITLAND PARK,FL,6786,7375,589,0.5207965539156839
34734,GOTHA,FL,1673,1751,78,0.5113901869158879
34736,GROVELAND,FL,9249,12752,3503,0.579610017726467
34737,HOWEY IN HLS,FL,129,178,49,0.5798045602605864
34737,HOWEY IN THE HILLS,FL,1630,1993,363,0.5500966050234612
34739,KENANSVILLE,FL,478,749,271,0.6104319478402608
34741,KISSIMMEE,FL,41721,34195,-7526,0.4504320564834817
34742,KISSIMMEE,FL,2710,4750,2040,0.6367292225201072
34743,KISSIMMEE,FL,19786,16045,-3741,0.4477966007088834
34744,KISSIMMEE,FL,30949,33310,2361,0.5183709674909351
34745,KISSIMMEE,FL,1469,2388,919,0.6191340420015556
34745,LEESBURG,FL,29,50,21,0.6329113924050633
34746,KISSIMMEE,FL,33549,37135,3586,0.525366419557467
34747,CELEBRATION,FL,1430,1809,379,0.5585057116393949
34747,KISSIMMEE,FL,21853,24338,2485,0.5268991794938408
34747,REUNION,FL,637,797,160,0.5557880055788006
34748,LEESBURG,FL,29452,32327,2875,0.5232684245455576
34749,LEESBURG,FL,628,1186,558,0.6538037486218302
34753,MASCOTTE,FL,2711,3201,490,0.5414411366711772
34755,MINNEOLA,FL,665,860,195,0.5639344262295082
34756,BELLA COLLINA,FL,78,94,16,0.5465116279069767
34756,MONTVERDE,FL,1607,1935,328,0.5463015245623941
34758,KISSIMMEE,FL,21824,20812,-1012,0.48813209494324045
34758,POINCIANA,FL,470,441,-29,0.4840834248079034
34759,KISSIMMEE,FL,24833,28179,3346,0.5315588923262657
34760,OAKLAND,FL,641,445,-196,0.4097605893186004
34761,OCOEE,FL,19839,19815,-24,0.4996973823573914
34762,OKAHUMPKA,FL,335,370,35,0.524822695035461
34769,SAINT CLOUD,FL,14136,14533,397,0.5069238550350553
34770,SAINT CLOUD,FL,1408,2347,939,0.6250332889480692
34771,SAINT CLOUD,FL,10399,18194,7795,0.6363095862623719
34772,SAINT CLOUD,FL,12348,17419,5071,0.5851782174891659
34773,HARMONY,FL,1359,2158,799,0.6135911288029571
34773,SAINT CLOUD,FL,993,1437,444,0.591358024691358
34777,WINTER GARDEN,FL,75,360,285,0.8275862068965517
34778,WINTER GARDEN,FL,715,1102,387,0.6064942212438085
34785,WILDWOOD,FL,8309,10269,1960,0.552750565184627
34786,WINDERMERE,FL,27184,24233,-2951,0.47130326545695006
34787,OAKLAND,FL,2197,2914,717,0.5701428291919389
34787,WINTER GARDEN,FL,36180,46282,10102,0.561252455676554
34788,LEESBURG,FL,12309,14894,2585,0.547513141932875
34789,LEESBURG,FL,45,233,188,0.8381294964028777
34789,WINTER,FL,11,0,-11,0
34797,YALAHA,FL,634,678,44,0.5167682926829268
34945,FORT PIERCE,FL,1998,2941,943,0.5954646689613282
34946,FORT PIERCE,FL,3178,3729,551,0.5398870710873027
34947,FORT PIERCE,FL,5803,5806,3,0.5001292100956155
34947,KISSIMMEE,FL,108,94,-14,0.46534653465346537
34948,FORT PIERCE,FL,640,676,36,0.513677811550152
34949,FORT PIERCE,FL,5499,7976,2477,0.5919109461966605
34949,HUTCHINSON IS,FL,225,604,379,0.7285886610373945
34949,HUTCHINSON ISLAND,FL,4921,4205,-716,0.4607714223098838
34950,FORT PIERCE,FL,7725,6715,-1010,0.4650277008310249
34951,FORT PIERCE,FL,8422,10212,1790,0.5480304819147794
34952,PORT SAINT LUCIE,FL,28929,29782,853,0.5072643967910613
34953,PORT SAINT LUCIE,FL,28151,34931,6780,0.5537395770584319
34953,PORT ST LUCIE,FL,650,776,126,0.544179523141655
34954,FORT PIERCE,FL,1485,1306,-179,0.46793264063059836
34956,INDIANTOWN,FL,2294,2020,-274,0.46824292999536393
34957,JENSEN BEACH,FL,22418,26558,4140,0.542265599477295
34957,OCEAN BREEZE,FL,333,341,8,0.5059347181008902
34958,JENSEN BEACH,FL,805,705,-100,0.46688741721854304
34972,OKEECHOBEE,FL,5755,5974,219,0.5093358342569699
34973,OKEECHOBEE,FL,810,1151,341,0.5869454360020397
34974,OKEECHOBEE,FL,13993,18824,4831,0.5736051436755341
34979,FORT PIERCE,FL,698,1476,778,0.6789328426862925
34981,FORT PIERCE,FL,2193,2479,286,0.5306078767123288
34982,FORT PIERCE,FL,13495,12444,-1051,0.47974093064497475
34983,FORT PIERCE,FL,414,500,86,0.5470459518599562
34983,PORT SAINT LUCIE,FL,17691,19468,1777,0.5239107618611911
34983,PORT ST LUCIE,FL,388,399,11,0.5069885641677255
34984,PORT SAINT LUCIE,FL,6917,8448,1531,0.5498210218027986
34984,PORT ST LUCIE,FL,497,564,67,0.5315739868049011
34985,PORT SAINT LUCIE,FL,1115,1601,486,0.5894698085419735
34985,PORT ST LUCIE,FL,179,208,29,0.537467700258398
34986,PORT SAINT LUCIE,FL,20201,20592,391,0.5047924889074106
34987,PORT SAINT LUCIE,FL,7932,14762,6830,0.6504803031638319
34987,PORT ST LUCIE,FL,1347,2341,994,0.6347613882863341
34988,PORT SAINT LUCIE,FL,1180,1965,785,0.6248012718600954
34988,PORT ST LUCIE,FL,94,189,95,0.6678445229681979
34988,SAINT LUCIE WEST,FL,62,120,58,0.6593406593406593
34990,PALM CITY,FL,16082,17297,1215,0.5182000659097037
34991,PALM CITY,FL,847,1000,153,0.5414185165132648
34992,PORT SALERNO,FL,408,428,20,0.5119617224880383
34992,PORT ST LUCIE,FL,0,39,39,1
34994,STUART,FL,13024,13379,355,0.5067227209029277
34995,STUART,FL,998,1214,216,0.5488245931283906
34996,SEWALLS POINT,FL,105,195,90,0.65
34996,STUART,FL,11120,12487,1367,0.5289532765705087
34997,STUART,FL,25083,25946,863,0.5084559760136393
35004,MOODY,AL,4826,4525,-301,0.4839054646561865
35005,ADAMSVILLE,AL,2385,2244,-141,0.4847699287103046
35006,ADGER,AL,770,747,-23,0.4924192485168095
35007,ALABASTER,AL,7709,7659,-50,0.49837324310255077
35010,ALEXANDER CITY,AL,6892,6007,-885,0.465695015117451
35011,ALEX CITY,AL,89,33,-56,0.27049180327868855
35011,ALEXANDER CITY,AL,666,395,-271,0.37229029217719134
35014,ALPINE,AL,698,886,188,0.5593434343434344
35016,ARAB,AL,6820,6437,-383,0.4855548012370823
35019,BAILEYTON,AL,473,733,260,0.6077943615257048
35020,BESSEMER,AL,6919,6284,-635,0.47595243505263957
35020,BRIGHTON,AL,343,316,-27,0.4795144157814871
35021,BESSEMER,AL,130,445,315,0.7739130434782608
35022,BESSEMER,AL,6322,7004,682,0.5255890739906949
35022,HELENA,AL,124,144,20,0.5373134328358209
35023,BESSEMER,AL,5334,5023,-311,0.4849859998068939
35023,HUEYTOWN,AL,2114,2179,65,0.5075704635453063
35031,BLOUNTSVILLE,AL,2476,2278,-198,0.47917543121581824
35033,BREMEN,AL,858,1029,171,0.5453100158982512
35034,BRENT,AL,918,911,-7,0.4980863860032805
35035,BRIERFIELD,AL,159,163,4,0.5062111801242236
35040,CALERA,AL,7155,7536,381,0.5129671227282009
35042,CENTREVILLE,AL,1630,1561,-69,0.4891883422124726
35043,CHELSEA,AL,3900,5051,1151,0.5642944922355044
35044,CHILDERSBURG,AL,2641,2428,-213,0.47898993884395347
35045,CLANTON,AL,4740,4752,12,0.5006321112515802
35046,CLANTON,AL,1773,2032,259,0.5340341655716163
35049,CLEVELAND,AL,953,1065,112,0.5277502477700694
35051,COLUMBIANA,AL,3008,2777,-231,0.48003457216940365
35053,CRANE HILL,AL,962,1158,196,0.5462264150943397
35054,CROPWELL,AL,1419,1692,273,0.5438765670202508
35055,CULLMAN,AL,8258,8105,-153,0.49532481818737395
35056,CULLMAN,AL,687,905,218,0.5684673366834171
35057,CULLMAN,AL,3747,4270,523,0.5326181863539977
35058,CULLMAN,AL,2934,3427,493,0.5387517685898444
35060,DOCENA,AL,15,11,-4,0.4230769230769231
35061,DOLOMITE,AL,357,261,-96,0.4223300970873786
35062,DORA,AL,1998,2125,127,0.5154014067426631
35063,EMPIRE,AL,854,798,-56,0.4830508474576271
35063,RILEY,TN,17,17,0,0.5
35064,FAIRFIELD,AL,3425,2969,-456,0.4643415702220832
35068,FULTONDALE,AL,3670,3216,-454,0.46703456288120826
35071,GARDENDALE,AL,5559,5872,313,0.5136908406963521
35072,GOODWATER,AL,878,934,56,0.5154525386313465
35073,GRAYSVILLE,AL,940,825,-115,0.46742209631728043
35077,HANCEVILLE,AL,4832,4880,48,0.5024711696869851
35078,HARPERSVILLE,AL,533,630,97,0.5417024935511608
35079,HAYDEN,AL,2245,2521,276,0.528955098615191
35080,HELENA,AL,5085,5899,814,0.537053896576839
35080,HOOVER,AL,131,144,13,0.5236363636363637
35083,HOLLY POND,AL,1083,1020,-63,0.48502139800285304
35085,JEMISON,AL,2254,2443,189,0.5201192250372578
35087,JOPPA,AL,630,607,-23,0.49070331447049315
35089,KELLYTON,AL,422,282,-140,0.4005681818181818
35091,CARTHAGE,AL,25,28,3,0.5283018867924528
35091,KIMBERLY,AL,734,914,180,0.5546116504854369
35094,LEEDS,AL,4825,4994,169,0.5086057643344536
35096,LINCOLN,AL,3067,3550,483,0.5364969019192988
35097,LOCUST FORK,AL,394,332,-62,0.4573002754820937
35098,LOGAN,AL,63,183,120,0.7439024390243902
35111,LAKE VIEW,AL,89,124,35,0.5821596244131455
35111,MC CALLA,AL,4768,5583,815,0.5393681769877307
35114,ALABASTER,AL,1121,1181,60,0.5130321459600348
35114,MAYLENE,AL,610,660,50,0.5196850393700787
35115,MONTEVALLO,AL,4116,4469,353,0.5205591147350029
35116,MORRIS,AL,1174,1330,156,0.5311501597444089
35117,MOUNT OLIVE,AL,1381,1565,184,0.5312287847929396
35118,MULGA,AL,697,634,-63,0.4763335837716003
35118,SYLVAN SPGS,AL,0,18,18,1
35118,SYLVAN SPRINGS,AL,54,51,-3,0.4857142857142857
35120,ODENVILLE,AL,5083,5854,771,0.535247325592027
35121,HIGHLAND LAKE,AL,108,115,7,0.515695067264574
35121,ONEONTA,AL,4564,4785,221,0.511819445930046
35124,HOOVER,AL,136,108,-28,0.4426229508196721
35124,INDIAN SPRINGS,AL,104,113,9,0.5207373271889401
35124,PELHAM,AL,7575,8045,470,0.515044814340589
35125,PELL CITY,AL,4310,4243,-67,0.496083245644803
35126,PINSON,AL,6240,6704,464,0.5179233621755254
35127,PLEASANT GROVE,AL,2319,2332,13,0.501397548914212
35127,PLEASANT GRV,AL,427,473,46,0.5255555555555556
35128,PELL CITY,AL,3306,3447,141,0.5104398045313194
35130,QUINTON,AL,762,712,-50,0.4830393487109905
35130,W JEFFERSON,AL,16,16,0,0.5
35131,RAGLAND,AL,1587,1315,-272,0.4531357684355617
35133,REMLAP,AL,878,988,110,0.5294748124330118
35135,RIVERSIDE,AL,751,824,73,0.5231746031746032
35136,ROCKFORD,AL,433,339,-94,0.43911917098445596
35143,SHELBY,AL,1159,1186,27,0.5057569296375266
35146,SPRINGVILLE,AL,2854,3770,916,0.5691425120772947
35147,STERRETT,AL,1812,1580,-232,0.4658018867924528
35147,WESTOVER,AL,51,48,-3,0.48484848484848486
35148,SUMITON,AL,864,902,38,0.5107587768969423
35149,SYCAMORE,AL,19,13,-6,0.40625
35150,SYLACAUGA,AL,6836,6305,-531,0.47979605813865
35151,CHILDERSBURG,AL,244,231,-13,0.4863157894736842
35151,SYLACAUGA,AL,1497,1600,103,0.5166289958023894
35160,TALLADEGA,AL,7818,7363,-455,0.485014162439892
35161,TALLADEGA,AL,671,479,-192,0.4165217391304348
35171,THORSBY,AL,799,878,79,0.5235539654144306
35172,TRAFFORD,AL,512,619,107,0.5473032714412025
35173,TRUSSVILLE,AL,8056,9358,1302,0.5373837142529
35175,UNION GROVE,AL,1290,1511,221,0.5394501963584434
35176,VANDIVER,AL,11,26,15,0.7027027027027027
35178,VINCENT,AL,999,1092,93,0.5222381635581061
35179,SOUTH VINEMONT,AL,120,130,10,0.52
35179,VINEMONT,AL,2689,2971,282,0.5249116607773852
35180,WARRIOR,AL,3631,3776,145,0.5097880383421088
35182,WATTSVILLE,AL,0,11,11,1
35183,WEOGUFKA,AL,0,14,14,1
35184,WEST BLOCTON,AL,1707,1320,-387,0.4360753221010902
35186,WILSONVILLE,AL,1507,1627,120,0.5191448627951499
35188,WOODSTOCK,AL,1140,838,-302,0.4236602628918099
35201,BIRMINGHAM,AL,236,958,722,0.8023450586264657
35201,HOOVER,AL,17,25,8,0.5952380952380952
35202,BIRMINGHAM,AL,96,498,402,0.8383838383838383
35203,BIRMINGHAM,AL,3185,2953,-232,0.4811013359400456
35204,BIRMINGHAM,AL,3387,2974,-413,0.46753655085678353
35205,BIRMINGHAM,AL,11831,8546,-3285,0.4193944152721205
35206,BIRMINGHAM,AL,6597,5538,-1059,0.45636588380716936
35207,BIRMINGHAM,AL,2638,2262,-376,0.4616326530612245
35208,BIRMINGHAM,AL,5064,4643,-421,0.4783146183166787
35209,BIRMINGHAM,AL,13071,10348,-2723,0.44186344421196466
35209,HOMEWOOD,AL,1867,1580,-287,0.4583695967507978
35210,BIRMINGHAM,AL,1025,1118,93,0.5216985534297713
35210,IRONDALE,AL,4469,4566,97,0.5053680132816823
35211,BIRMINGHAM,AL,10794,9412,-1382,0.465802236959319
35212,BIRMINGHAM,AL,4839,3924,-915,0.44779185210544337
35213,BIRMINGHAM,AL,4152,3745,-407,0.47423072052678233
35213,MOUNTAIN BRK,AL,2108,2022,-86,0.48958837772397096
35214,BIRMINGHAM,AL,5067,4747,-320,0.4836967597309965
35214,FORESTDALE,AL,137,145,8,0.5141843971631206
35215,BIRMINGHAM,AL,9453,8247,-1206,0.4659322033898305
35215,CENTER POINT,AL,8826,7947,-879,0.47379717402969057
35216,BIRMINGHAM,AL,625,506,-119,0.4473916887709991
35216,HOOVER,AL,4230,3553,-677,0.45650777335217785
35216,VESTAVIA,AL,690,562,-128,0.4488817891373802
35216,VESTAVIA HILLS,AL,11501,9824,-1677,0.4606799531066823
35217,BIRMINGHAM,AL,4432,3907,-525,0.4685214054442979
35217,TARRANT,AL,160,171,11,0.5166163141993958
35218,BIRMINGHAM,AL,2643,2357,-286,0.4714
35218,ENSLEY,AL,103,71,-32,0.40804597701149425
35219,BIRMINGHAM,AL,97,138,41,0.5872340425531914
35219,HOMEWOOD,AL,23,92,69,0.8
35220,BIRMINGHAM,AL,172,488,316,0.7393939393939394
35220,CENTER POINT,AL,0,11,11,1
35221,BIRMINGHAM,AL,1317,1113,-204,0.4580246913580247
35222,BIRMINGHAM,AL,4356,3652,-704,0.45604395604395603
35223,BIRMINGHAM,AL,282,340,58,0.5466237942122186
35223,MOUNTAIN BRK,AL,1471,1518,47,0.5078621612579458
35223,MOUNTAIN BROOK,AL,1262,1337,75,0.5144286263947672
35223,VESTAVIA,AL,135,124,-11,0.47876447876447875
35224,BIRMINGHAM,AL,1812,1648,-164,0.47630057803468207
35226,BIRMINGHAM,AL,1015,1003,-12,0.49702675916749256
35226,HOOVER,AL,9041,8918,-123,0.4965755331588618
35226,VESTAVIA,AL,1195,1253,58,0.5118464052287581
35228,BIRMINGHAM,AL,2835,2592,-243,0.47761194029850745
35228,MIDFIELD,AL,592,566,-26,0.48877374784110533
35231,BIRMINGHAM,AL,92,86,-6,0.48314606741573035
35232,BIRMINGHAM,AL,23,120,97,0.8391608391608392
35233,BIRMINGHAM,AL,2747,2245,-502,0.44971955128205127
35234,BIRMINGHAM,AL,1811,1538,-273,0.45924156464616306
35235,BIRMINGHAM,AL,8101,6997,-1104,0.4634388660749768
35236,BIRMINGHAM,AL,295,622,327,0.678298800436205
35236,HOOVER,AL,188,369,181,0.6624775583482945
35238,BIRMINGHAM,AL,261,467,206,0.6414835164835165
35242,BIRMINGHAM,AL,21251,20772,-479,0.49430074007091357
35242,HOOVER,AL,2001,1900,-101,0.48705460138426043
35243,BIRMINGHAM,AL,9107,7927,-1180,0.4653633908653282
35243,MOUNTAIN BRK,AL,281,205,-76,0.4218106995884774
35243,MOUNTAIN BROOK,AL,919,721,-198,0.4396341463414634
35243,VESTAVIA,AL,1546,1349,-197,0.46597582037996543
35244,BIRMINGHAM,AL,923,971,48,0.5126715945089757
35244,HOOVER,AL,13465,14168,703,0.5127202981941881
35255,BIRMINGHAM,AL,24,56,32,0.7
35259,BIRMINGHAM,AL,18,31,13,0.6326530612244898
35260,BIRMINGHAM,AL,0,12,12,1
35261,BIRMINGHAM,AL,71,306,235,0.8116710875331565
35266,BIRMINGHAM,AL,57,39,-18,0.40625
35266,VESTAVIA HILLS,AL,0,13,13,1
35401,TUSCALOOSA,AL,13402,9345,-4057,0.4108234052842133
35402,TUSCALOOSA,AL,0,12,12,1
35403,TUSCALOOSA,AL,413,873,460,0.6788491446345256
35404,TUSCALOOSA,AL,8422,6405,-2017,0.43198219464490456
35405,TUSCALOOSA,AL,17078,14990,-2088,0.46744418111513036
35406,TUSCALOOSA,AL,5171,5380,209,0.509904274476353
35407,TUSCALOOSA,AL,338,696,358,0.6731141199226306
35441,AKRON,AL,80,119,39,0.5979899497487438
35442,ALICEVILLE,AL,1127,1108,-19,0.49574944071588367
35443,BOLIGEE,AL,51,41,-10,0.44565217391304346
35444,BROOKWOOD,AL,1657,1519,-138,0.4782745591939547
35446,BUHL,AL,510,450,-60,0.46875
35447,CARROLLTON,AL,296,282,-14,0.48788927335640137
35447,PICKENSVILLE,AL,139,117,-22,0.45703125
35452,COKER,AL,836,917,81,0.5231032515687393
35453,COTTONDALE,AL,3984,3574,-410,0.4728764223339508
35453,RUSSELLVILLE,AL,99,89,-10,0.4734042553191489
35456,DUNCANVILLE,AL,1228,1052,-176,0.4614035087719298
35458,ELROD,AL,42,12,-30,0.2222222222222222
35459,EMELLE,AL,0,13,13,1
35461,ETHELSVILLE,AL,114,156,42,0.5777777777777777
35462,EUTAW,AL,970,803,-167,0.45290468133107725
35463,FOSTERS,AL,273,382,109,0.583206106870229
35464,GAINESVILLE,AL,13,11,-2,0.4583333333333333
35466,GORDO,AL,1566,1444,-122,0.479734219269103
35470,COATOPA,AL,37,25,-12,0.4032258064516129
35470,LIVINGSTON,AL,835,697,-138,0.4549608355091384
35473,NORTHPORT,AL,5892,5502,-390,0.482885729331227
35474,MOUNDVILLE,AL,1917,2191,274,0.5333495618305745
35475,NORTHPORT,AL,4093,4750,657,0.5371480266877756
35476,NORTHPORT,AL,3347,2875,-472,0.46207007393121186
35480,RALPH,AL,23,84,61,0.7850467289719626
35481,REFORM,AL,755,746,-9,0.49700199866755496
35490,VANCE,AL,1530,1486,-44,0.4927055702917772
35501,JASPER,AL,3417,3269,-148,0.4889320969189351
35502,JASPER,AL,480,578,98,0.5463137996219282
35503,JASPER,AL,2690,2566,-124,0.4882039573820396
35504,JASPER,AL,3565,3650,85,0.5058905058905059
35540,ADDISON,AL,476,474,-2,0.49894736842105264
35541,ARLEY,AL,1205,1337,132,0.5259638080251771
35542,ADDISON,AL,11,0,-11,0
35542,BANKSTON,AL,49,40,-9,0.449438202247191
35543,BEAR CREEK,AL,163,142,-21,0.46557377049180326
35544,BEAVERTON,AL,23,11,-12,0.3235294117647059
35546,BERRY,AL,1061,1131,70,0.5159671532846716
35548,BRILLIANT,AL,235,224,-11,0.4880174291938998
35549,CARBON HILL,AL,1336,1322,-14,0.49736644093303234
35550,CORDOVA,AL,1576,1566,-10,0.49840865690642905
35552,DETROIT,AL,51,23,-28,0.3108108108108108
35553,DOUBLE SPRINGS,AL,1348,1336,-12,0.4977645305514158
35554,ELDRIDGE,AL,23,45,22,0.6617647058823529
35555,FAYETTE,AL,3084,3017,-67,0.49450909686936567
35563,GUIN,AL,1363,1344,-19,0.49649057997783524
35564,HACKLEBURG,AL,758,617,-141,0.44872727272727275
35565,HALEYVILLE,AL,4709,4179,-530,0.47018451845184517
35570,HAMILTON,AL,4358,3838,-520,0.46827720839433873
35571,HODGES,AL,103,90,-13,0.46632124352331605
35572,HOUSTON,AL,46,86,40,0.6515151515151515
35572,KANSAS,AL,0,14,14,1
35574,KENNEDY,AL,47,36,-11,0.43373493975903615
35575,LYNN,AL,106,73,-33,0.40782122905027934
35576,MILLPORT,AL,583,685,102,0.5402208201892744
35578,NAUVOO,AL,1593,1426,-167,0.4723418350447168
35579,OAKMAN,AL,733,698,-35,0.48777078965758214
35580,PARRISH,AL,1384,1210,-174,0.4664610639938319
35581,PHIL CAMPBELL,AL,1663,1480,-183,0.47088768692332167
35582,RED BAY,AL,1675,1451,-224,0.46417146513115803
35584,SIPSEY,AL,0,12,12,1
35585,SPRUCE PINE,AL,193,123,-70,0.38924050632911394
35586,SULLIGENT,AL,1364,1443,79,0.5140719629497684
35587,TOWNLEY,AL,11,0,-11,0
35592,VERNON,AL,1687,1562,-125,0.48076331178824255
35593,VINA,AL,285,304,19,0.5161290322580645
35594,WINFIELD,AL,2538,2518,-20,0.49802215189873417
35601,DECATUR,AL,12432,10857,-1575,0.4661857529305681
35602,DECATUR,AL,486,779,293,0.6158102766798419
35603,DECATUR,AL,10592,10766,174,0.5040734151137747
35610,ANDERSON,AL,408,275,-133,0.40263543191800877
35611,ATHENS,AL,9107,9225,118,0.5032184158847917
35612,ATHENS,AL,398,594,196,0.5987903225806451
35613,ATHENS,AL,6185,8876,2691,0.5893366974304495
35614,ATHENS,AL,1947,2085,138,0.5171130952380952
35616,CHEROKEE,AL,1157,1227,70,0.5146812080536913
35618,COURTLAND,AL,358,474,116,0.5697115384615384
35619,DANVILLE,AL,1803,1465,-338,0.4482864137086903
35620,ELKMONT,AL,2542,2681,139,0.5133065288148574
35621,EVA,AL,555,575,20,0.5088495575221239
35622,FALKVILLE,AL,2065,2141,76,0.5090347123157394
35630,FLORENCE,AL,15959,14481,-1478,0.4757227332457293
35631,FLORENCE,AL,249,256,7,0.5069306930693069
35633,FLORENCE,AL,5188,5189,1,0.5000481834827021
35634,FLORENCE,AL,2724,3035,311,0.5270012154888002
35640,HARTSELLE,AL,9091,8353,-738,0.47884659481770236
35643,HILLSBORO,AL,669,716,47,0.5169675090252708
35645,KILLEN,AL,3652,4265,613,0.5387141594038146
35646,LEIGHTON,AL,1104,1286,182,0.5380753138075314
35647,LESTER,AL,34,65,31,0.6565656565656566
35648,LEXINGTON,AL,801,856,55,0.5165962582981292
35650,MOULTON,AL,3693,3665,-28,0.49809730905137267
35651,MOUNT HOPE,AL,46,11,-35,0.19298245614035087
35652,ROGERSVILLE,AL,2440,2933,493,0.5458775358272846
35653,RUSSELLVILLE,AL,3740,2948,-792,0.4407894736842105
35654,RUSSELLVILLE,AL,2198,2081,-117,0.48632858144426266
35660,SHEFFIELD,AL,4648,3920,-728,0.45751633986928103
35661,MUSCLE SHOALS,AL,6470,6802,332,0.5125075346594334
35662,MUSCLE SHOALS,AL,89,287,198,0.7632978723404256
35670,SOMERVILLE,AL,2122,2268,146,0.516628701594533
35671,TANNER,AL,742,824,82,0.5261813537675607
35672,TOWN CREEK,AL,1637,1748,111,0.5163958641063515
35673,TRINITY,AL,1999,2118,119,0.5144522710711683
35674,TUSCUMBIA,AL,6504,6743,239,0.5090209103948063
35677,WATERLOO,AL,350,341,-9,0.4934876989869754
35739,ARDMORE,AL,1924,1807,-117,0.4843205574912892
35740,BRIDGEPORT,AL,1218,1003,-215,0.4515983791085097
35741,BROWNSBORO,AL,1427,1515,88,0.5149558123725357
35742,CAPSHAW,AL,12,23,11,0.6571428571428571
35744,DUTTON,AL,786,793,7,0.5022165927802407
35747,GRANT,AL,2089,2070,-19,0.49771579706660257
35748,GURLEY,AL,2007,2537,530,0.558318661971831
35749,HARVEST,AL,7831,9592,1761,0.5505366469609138
35750,HAZEL GREEN,AL,4248,5397,1149,0.5595645412130638
35752,HOLLYWOOD,AL,520,569,49,0.5224977043158862
35754,LACEYS SPRING,AL,1406,1359,-47,0.491500904159132
35755,LANGSTON,AL,85,191,106,0.6920289855072463
35756,MADISON,AL,7542,11294,3752,0.5995965173072839
35757,MADISON,AL,6194,7589,1395,0.5506058187622433
35758,MADISON,AL,20518,19712,-806,0.48998260004971417
35759,MERIDIANVILLE,AL,3441,5249,1808,0.6040276179516686
35760,NEW HOPE,AL,1625,1707,82,0.5123049219687875
35761,NEW MARKET,AL,4254,4680,426,0.5238415043653458
35762,NORMAL,AL,62,11,-51,0.1506849315068493
35763,OWENS CROSS ROADS,AL,5941,8188,2247,0.5795173048340293
35765,PISGAH,AL,949,1008,59,0.515074092999489
35768,SCOTTSBORO,AL,4170,4031,-139,0.4915254237288136
35769,SCOTTSBORO,AL,3622,3676,54,0.5036996437380105
35771,SECTION,AL,920,1020,100,0.5257731958762887
35772,STEVENSON,AL,2094,1445,-649,0.4083074314778186
35773,TONEY,AL,4454,4833,379,0.5204048670184128
35775,VALHERMOSO SP,AL,0,11,11,1
35775,VALHERMOSO SPG,AL,0,13,13,1
35775,VALHERMOSO SPRINGS,AL,0,11,11,1
35776,WOODVILLE,AL,979,1050,71,0.5174963035978315
35801,HUNTSVILLE,AL,10042,9483,-559,0.485685019206146
35802,HUNTSVILLE,AL,11815,10860,-955,0.478941565600882
35803,HUNTSVILLE,AL,9332,10369,1037,0.5263184609918278
35804,HUNTSVILLE,AL,351,812,461,0.6981943250214961
35805,HUNTSVILLE,AL,11371,8976,-2395,0.4411461149063744
35806,HUNTSVILLE,AL,16773,15897,-876,0.48659320477502294
35807,HUNTSVILLE,AL,96,328,232,0.7735849056603774
35808,HUNTSVILLE,AL,1116,986,-130,0.46907706945765937
35810,HSV,AL,293,268,-25,0.47771836007130125
35810,HUNTSVILLE,AL,12063,11143,-920,0.480177540291304
35811,HUNTSVILLE,AL,8433,9749,1316,0.536189638103619
35813,HUNTSVILLE,AL,53,77,24,0.5923076923076923
35814,HUNTSVILLE,AL,613,999,386,0.619727047146402
35815,HUNTSVILLE,AL,155,491,336,0.760061919504644
35816,HUNTSVILLE,AL,8691,6675,-2016,0.4344006247559547
35824,HUNTSVILLE,AL,5772,5524,-248,0.4890226628895184
35901,GADSDEN,AL,6336,6260,-76,0.49698316926008257
35902,GADSDEN,AL,259,364,105,0.5842696629213483
35903,EAST GADSDEN,AL,153,132,-21,0.4631578947368421
35903,GADSDEN,AL,5628,5585,-43,0.4980825827164898
35903,HOKES BLUFF,AL,251,236,-15,0.48459958932238195
35904,GADSDEN,AL,4472,4192,-280,0.4838411819021237
35905,GADSDEN,AL,943,1016,73,0.518631955079122
35905,GLENCOE,AL,740,728,-12,0.49591280653950953
35906,RAINBOW CITY,AL,4216,3832,-384,0.4761431411530815
35907,GADSDEN,AL,1189,1367,178,0.5348200312989045
35907,SOUTHSIDE,AL,959,1114,155,0.5373854317414375
35950,ALBERTVILLE,AL,5808,5743,-65,0.4971863907886763
35951,ALBERTVILLE,AL,3458,3210,-248,0.4814037192561488
35952,ALTOONA,AL,2022,2138,116,0.5139423076923076
35953,ASHVILLE,AL,2075,2230,155,0.5180023228803716
35954,ATTALLA,AL,3701,3672,-29,0.4980333649803336
35956,BOAZ,AL,2371,2463,92,0.5095159288374017
35957,BOAZ,AL,5121,4746,-375,0.48099726360595924
35958,BRYANT,AL,596,745,149,0.5555555555555556
35959,CEDAR BLUFF,AL,1626,1806,180,0.5262237762237763
35960,CENTRE,AL,3011,3574,563,0.5427486712224753
35961,COLLINSVILLE,AL,1214,1313,99,0.519588444796201
35962,CROSSVILLE,AL,1660,1606,-54,0.49173300673606857
35963,DAWSON,AL,183,272,89,0.5978021978021978
35966,FLAT ROCK,AL,850,891,41,0.5117748420448018
35967,FORT PAYNE,AL,5732,4712,-1020,0.4511681348142474
35968,FORT PAYNE,AL,2241,1734,-507,0.4362264150943396
35971,FYFFE,AL,1396,1421,25,0.5044373446929358
35971,LAKEVIEW,AL,34,26,-8,0.43333333333333335
35972,GALLANT,AL,52,18,-34,0.2571428571428571
35973,GAYLESVILLE,AL,406,507,101,0.5553121577217963
35974,GERALDINE,AL,917,586,-331,0.38988689288090483
35975,GROVEOAK,AL,51,32,-19,0.3855421686746988
35976,GUNTERSVILLE,AL,6679,6957,278,0.5101936051628043
35978,HENAGAR,AL,1906,1663,-243,0.4659568506584477
35979,HIGDON,AL,74,143,69,0.6589861751152074
35980,HORTON,AL,1149,1102,-47,0.48956019546868057
35981,IDER,AL,537,391,-146,0.4213362068965517
35983,LEESBURG,AL,1331,1309,-22,0.49583333333333335
35983,SAND ROCK,AL,66,47,-19,0.415929203539823
35984,MENTONE,AL,647,885,238,0.5776762402088773
35986,RAINSVILLE,AL,2698,2839,141,0.5127325266389742
35987,ALBERTVILLE,AL,13,12,-1,0.48
35987,STEELE,AL,674,547,-127,0.447993447993448
35988,SYLVANIA,AL,616,638,22,0.5087719298245614
35989,VALLEY HEAD,AL,777,742,-35,0.48847926267281105
36003,AUTAUGAVILLE,AL,176,234,58,0.5707317073170731
36005,BANKS,AL,153,318,165,0.6751592356687898
36006,BILLINGSLEY,AL,253,217,-36,0.46170212765957447
36009,BRANTLEY,AL,717,820,103,0.5335068314899154
36010,BRUNDIDGE,AL,1628,1638,10,0.5015309246785058
36016,CLAYTON,AL,707,770,63,0.5213270142180095
36017,CLIO,AL,250,192,-58,0.4343891402714932
36020,COOSADA,AL,188,142,-46,0.4303030303030303
36022,DEATSVILLE,AL,4024,4246,222,0.5134220072551391
36024,ECLECTIC,AL,1886,1961,75,0.5097478554717962
36025,ELMORE,AL,1644,1348,-296,0.4505347593582888
36026,EQUALITY,AL,26,90,64,0.7758620689655172
36027,EUFAULA,AL,4710,4349,-361,0.4800750634727895
36028,DOZIER,AL,235,370,135,0.6115702479338843
36029,FITZPATRICK,AL,12,0,-12,0
36032,FORT DEPOSIT,AL,1353,377,-976,0.21791907514450867
36033,GEORGIANA,AL,853,923,70,0.5197072072072072
36034,GLENWOOD,AL,38,23,-15,0.3770491803278688
36035,GOSHEN,AL,223,343,120,0.6060070671378092
36036,FORT DEPOSIT,AL,0,14,14,1
36036,GRADY,AL,146,201,55,0.579250720461095
36037,GREENVILLE,AL,4524,3945,-579,0.46581650726177826
36040,HAYNEVILLE,AL,550,513,-37,0.4825964252116651
36040,WHITE HALL,AL,29,34,5,0.5396825396825397
36041,HIGHLAND HOME,AL,171,221,50,0.5637755102040817
36042,HONORAVILLE,AL,205,153,-52,0.4273743016759777
36043,HOPE HULL,AL,1185,911,-274,0.43463740458015265
36046,LAPINE,AL,51,77,26,0.6015625
36047,LETOHATCHEE,AL,11,13,2,0.5416666666666666
36048,LOUISVILLE,AL,100,114,14,0.5327102803738317
36049,LUVERNE,AL,2071,1912,-159,0.48004017072558375
36051,MARBURY,AL,674,569,-105,0.4577634754625905
36052,MATHEWS,AL,0,46,46,1
36053,MIDWAY,AL,28,46,18,0.6216216216216216
36054,MILLBROOK,AL,6913,5877,-1036,0.4594996090695856
36064,PIKE ROAD,AL,3965,5102,1137,0.5626999007389434
36066,PRATTVILLE,AL,9971,9632,-339,0.4913533642809774
36067,PRATTVILLE,AL,8194,8061,-133,0.4959089510919717
36068,PRATTVILLE,AL,1209,939,-270,0.4371508379888268
36068,TITUS,AL,23,13,-10,0.3611111111111111
36069,RAMER,AL,272,304,32,0.5277777777777778
36071,RUTLEDGE,AL,116,11,-105,0.08661417322834646
36072,EUFAULA,AL,410,275,-135,0.40145985401459855
36075,SHORTER,AL,133,240,107,0.6434316353887399
36078,TALLASSEE,AL,4404,4723,319,0.5174756217815273
36079,TROY,AL,3549,3218,-331,0.47554307669572926
36080,TITUS,AL,431,681,250,0.612410071942446
36081,TROY,AL,6895,5232,-1663,0.43143399026964624
36083,TUSKEGEE,AL,2525,2191,-334,0.46458863443596266
36088,TUSKEGEE,AL,19,15,-4,0.4411764705882353
36088,TUSKEGEE INSTITUTE,AL,1175,459,-716,0.28090575275397794
36089,UNION SPRINGS,AL,1579,1462,-117,0.4807629069385071
36091,VERBENA,AL,1409,1192,-217,0.45828527489427145
36092,WETUMPKA,AL,7782,7101,-681,0.47712154807498486
36093,WETUMPKA,AL,3244,3780,536,0.5381548974943052
36103,MONTGOMERY,AL,0,53,53,1
36104,MONTGOMERY,AL,4302,3679,-623,0.46096980328279663
36105,MONTGOMERY,AL,4412,3367,-1045,0.43283198354544283
36106,MONTGOMERY,AL,7151,6439,-712,0.4738042678440029
36107,MONTGOMERY,AL,4061,3285,-776,0.4471821399401035
36108,MONTGOMERY,AL,6368,5676,-692,0.4712720026569246
36109,MONTGOMERY,AL,9868,9425,-443,0.48851915202405016
36110,MONTGOMERY,AL,4349,4099,-250,0.4852035984848485
36111,MONTGOMERY,AL,5216,4740,-476,0.47609481719566094
36113,MAXWELL AFB,AL,45,16,-29,0.26229508196721313
36113,MONTGOMERY,AL,510,344,-166,0.4028103044496487
36115,MONTGOMERY,AL,405,151,-254,0.2715827338129496
36116,MONTGOMERY,AL,21378,17124,-4254,0.4447561165653732
36117,MONTGGOMERY,AL,549,475,-74,0.4638671875
36117,MONTGOMERY,AL,22374,20032,-2342,0.4723859831155969
36120,MONTGOMERY,AL,82,496,414,0.8581314878892734
36121,MONTGOMERY,AL,53,267,214,0.834375
36123,MONTGOMERY,AL,185,638,453,0.7752126366950183
36124,MONTGOMERY,AL,938,1089,151,0.5372471632955106
36125,MONTGOMERY,AL,182,201,19,0.5248041775456919
36201,ANNISTON,AL,5670,5158,-512,0.4763575914296269
36201,HOBSON CITY,AL,115,89,-26,0.4362745098039216
36202,ANNISTON,AL,346,528,182,0.6041189931350115
36203,OXFORD,AL,6467,6609,142,0.505429795044356
36204,ANNISTON,AL,23,12,-11,0.34285714285714286
36204,BLUE MOUNTAIN,AL,11,0,-11,0
36205,ANNISTON,AL,216,258,42,0.5443037974683544
36206,ANNISTON,AL,3748,3779,31,0.5020592533545901
36207,ANNISTON,AL,6973,6820,-153,0.494453708402813
36250,ALEXANDRIA,AL,1210,1298,88,0.5175438596491229
36251,ASHLAND,AL,1989,1464,-525,0.42397914856646396
36255,CRAGFORD,AL,12,0,-12,0
36256,DAVISTON,AL,162,72,-90,0.3076923076923077
36256,NEW SITE,AL,38,36,-2,0.4864864864864865
36258,DELTA,AL,306,391,85,0.5609756097560976
36260,EASTABOGA,AL,1343,1124,-219,0.4556141062018646
36262,FRUITHURST,AL,302,150,-152,0.33185840707964603
36263,GRAHAM,AL,29,0,-29,0
36264,HEFLIN,AL,2393,2728,335,0.5327084553798086
36265,JACKSONVILLE,AL,7425,6384,-1041,0.4623071909624158
36266,LINEVILLE,AL,1923,1674,-249,0.4653878231859883
36268,MUNFORD,AL,1411,1474,63,0.5109185441941074
36269,MUSCADINE,AL,37,153,116,0.8052631578947368
36271,OHATCHEE,AL,1846,1794,-52,0.4928571428571429
36272,PIEDMONT,AL,3909,3605,-304,0.47977109395794515
36273,RANBURNE,AL,716,659,-57,0.4792727272727273
36274,ROANOKE,AL,3418,3359,-59,0.49564704146377453
36276,WADLEY,AL,348,409,61,0.5402906208718626
36277,WEAVER,AL,1733,1744,11,0.5015818234109864
36278,WEDOWEE,AL,1609,1783,174,0.5256485849056604
36279,WELLINGTON,AL,585,441,-144,0.4298245614035088
36280,NEWELL,AL,134,162,28,0.5472972972972973
36280,WOODLAND,AL,737,895,158,0.5484068627450981
36301,DOTHAN,AL,17045,15932,-1113,0.4831246019953301
36302,DOTHAN,AL,707,1390,683,0.6628516928946113
36303,DOTHAN,AL,13262,11750,-1512,0.4697745082360467
36303,KINSEY,AL,961,783,-178,0.44896788990825687
36304,DOTHAN,AL,296,685,389,0.6982670744138634
36305,DOTHAN,AL,6724,6664,-60,0.497759187331939
36305,TAYLOR,AL,148,116,-32,0.4393939393939394
36310,ABBEVILLE,AL,2118,2226,108,0.5124309392265194
36311,ARITON,AL,1063,940,-123,0.46929605591612583
36312,ASHFORD,AL,1910,2142,232,0.5286278381046396
36314,BLACK,AL,11,0,-11,0
36316,CHANCELLOR,AL,178,367,189,0.673394495412844
36317,CLOPTON,AL,11,0,-11,0
36318,COFFEE SPGS,AL,11,13,2,0.5416666666666666
36318,COFFEE SPRINGS,AL,105,141,36,0.573170731707317
36319,COLUMBIA,AL,720,700,-20,0.49295774647887325
36320,COTTONWOOD,AL,1926,1369,-557,0.41547799696509863
36321,COWARTS,AL,569,671,102,0.5411290322580645
36322,DALEVILLE,AL,5352,4547,-805,0.45933932720476817
36323,ELBA,AL,2627,2401,-226,0.4775258552108194
36330,ENTERPRISE,AL,17805,16807,-998,0.4855830347856235
36331,ENTERPRISE,AL,307,724,417,0.7022308438409312
36340,GENEVA,AL,2270,1940,-330,0.46080760095011875
36343,GORDON,AL,233,300,67,0.5628517823639775
36344,HARTFORD,AL,2095,2072,-23,0.4972402207823374
36345,HEADLAND,AL,2509,3043,534,0.5480907780979827
36346,JACK,AL,115,257,142,0.6908602150537635
36350,MIDLAND CITY,AL,3680,3182,-498,0.4637132031477703
36350,PINCKARD,AL,95,60,-35,0.3870967741935484
36351,NEW BROCKTON,AL,1180,1195,15,0.5031578947368421
36352,NEWTON,AL,2007,1849,-158,0.4795124481327801
36353,NEWVILLE,AL,234,280,46,0.5447470817120622
36360,OZARK,AL,7827,7617,-210,0.4932012432012432
36361,OZARK,AL,269,201,-68,0.4276595744680851
36362,FORT RUCKER,AL,4900,3386,-1514,0.4086410813420227
36370,PANSEY,AL,50,73,23,0.5934959349593496
36371,PINCKARD,AL,11,0,-11,0
36373,SHORTERVILLE,AL,0,12,12,1
36374,SKIPPERVILLE,AL,45,118,73,0.7239263803680982
36375,SLOCOMB,AL,3091,2867,-224,0.48120174555219875
36376,WEBB,AL,884,906,22,0.506145251396648
36401,EVERGREEN,AL,1888,1909,21,0.5027653410587306
36420,ANDALUSIA,AL,5235,4401,-834,0.4567247820672478
36421,ANDALUSIA,AL,2734,2952,218,0.5191698909602532
36421,ANDALUUA,AL,45,57,12,0.5588235294117647
36425,BEATRICE,AL,0,25,25,1
36426,BREWTON,AL,5129,4682,-447,0.4772194475588625
36427,BREWTON,AL,377,313,-64,0.45362318840579713
36432,CASTLEBERRY,AL,543,550,7,0.5032021957913998
36435,COY,AL,11,0,-11,0
36441,FLOMATON,AL,1411,1111,-300,0.44052339413164154
36442,FLORALA,AL,1347,1379,32,0.5058694057226706
36445,FRISCO CITY,AL,1127,939,-188,0.45450145208131654
36451,GROVE HILL,AL,940,1015,75,0.5191815856777494
36453,KINSTON,AL,763,826,63,0.5198237885462555
36456,MC KENZIE,AL,218,250,32,0.5341880341880342
36456,MCKENZIE,AL,38,49,11,0.5632183908045977
36460,MONROEVILLE,AL,2466,2309,-157,0.4835602094240838
36461,MONROEVILLE,AL,72,131,59,0.645320197044335
36467,OPP,AL,4255,4094,-161,0.4903581267217631
36471,PETERMAN,AL,0,11,11,1
36474,RED LEVEL,AL,787,840,53,0.5162876459741856
36475,REPTON,AL,163,248,85,0.6034063260340633
36477,SAMSON,AL,1581,1728,147,0.5222121486854034
36480,URIAH,AL,136,82,-54,0.3761467889908257
36482,WHATLEY,AL,0,11,11,1
36502,ATMORE,AL,4198,4049,-149,0.49096641202861646
36504,ATMORE,AL,0,181,181,1
36505,AXIS,AL,383,182,-201,0.32212389380530976
36507,BAY MINETTE,AL,5623,5786,163,0.5071434832150057
36509,BAYOU LA BATRE,AL,482,449,-33,0.4822771213748657
36509,BAYOU LABATRE,AL,13,0,-13,0
36511,BON SECOUR,AL,81,124,43,0.6048780487804878
36518,CHATOM,AL,271,232,-39,0.46123260437375746
36521,CHUNCHULA,AL,1248,1321,73,0.514207862981705
36522,CITRONELLE,AL,2179,2064,-115,0.4864482677350931
36523,CODEN,AL,907,865,-42,0.4881489841986456
36524,COFFEEVILLE,AL,0,11,11,1
36525,CREOLA,AL,778,437,-341,0.3596707818930041
36526,DAPHNE,AL,16064,18018,1954,0.528666158089314
36527,DAPHNE,AL,1716,2423,707,0.5854071031650157
36527,SPANISH FORT,AL,4583,5634,1051,0.5514338847019673
36528,DAUPHIN ISL,AL,15,32,17,0.6808510638297872
36528,DAUPHIN ISLAND,AL,957,1553,596,0.6187250996015936
36530,ELBERTA,AL,3323,3669,346,0.5247425629290617
36532,FAIRHOPE,AL,12882,15109,2227,0.5397806437783573
36533,FAIRHOPE,AL,1742,1186,-556,0.40505464480874315
36535,FOLEY,AL,15230,19451,4221,0.5608546466364869
36536,FOLEY,AL,2101,1401,-700,0.4000571102227299
36539,FRUITDALE,AL,0,23,23,1
36541,GRAND BAY,AL,4781,4515,-266,0.48569277108433734
36542,GULF SHORES,AL,11183,15153,3970,0.5753721142162819
36544,IRVINGTON,AL,3814,3498,-316,0.4783916849015317
36545,JACKSON,AL,2267,1916,-351,0.45804446569447765
36547,GULF SHORES,AL,4123,4832,709,0.5395868230039085
36548,LEROY,AL,12,0,-12,0
36549,LILLIAN,AL,2562,3373,811,0.5683235046335299
36551,LOXLEY,AL,3123,3527,404,0.5303759398496241
36553,MC INTOSH,AL,242,343,101,0.5863247863247864
36555,MAGNOLIA SPGS,AL,173,186,13,0.5181058495821727
36555,MAGNOLIA SPRINGS,AL,443,580,137,0.5669599217986315
36558,MILLRY,AL,439,471,32,0.5175824175824176
36559,MONTROSE,AL,14,91,77,0.8666666666666667
36560,MOUNT VERNON,AL,459,441,-18,0.49
36561,ORANGE BEACH,AL,9000,12751,3751,0.5862259206473266
36562,PERDIDO,AL,134,209,75,0.60932944606414
36564,POINT CLEAR,AL,182,270,88,0.5973451327433629
36567,ROBERTSDALE,AL,5147,5733,586,0.5269301470588236
36571,SARALAND,AL,5783,5775,-8,0.49965391936321163
36572,SATSUMA,AL,2026,2032,6,0.5007392804337112
36574,ROBERTSDALE,AL,0,13,13,1
36574,SEMINOLE,AL,217,360,143,0.6239168110918544
36575,SEMMES,AL,5584,6125,541,0.5231018874370142
36576,SILVERHILL,AL,1576,1942,366,0.5520181921546333
36577,SPANISH FORT,AL,684,11,-673,0.015827338129496403
36578,STAPLETON,AL,333,558,225,0.6262626262626263
36579,STOCKTON,AL,68,168,100,0.711864406779661
36580,SUMMERDALE,AL,2959,2863,-96,0.4917554105118516
36582,THEODORE,AL,8057,7266,-791,0.4741891274554591
36583,TIBBIE,AL,0,11,11,1
36585,WAGARVILLE,AL,12,0,-12,0
36587,WILMER,AL,3010,2962,-48,0.4959812458137977
36590,THEODORE,AL,266,434,168,0.62
36601,MOBILE,AL,13,279,266,0.9554794520547946
36602,MOBILE,AL,1158,1329,171,0.53437876960193
36603,MOBILE,AL,2297,2243,-54,0.49405286343612337
36604,MOBILE,AL,3888,3484,-404,0.4725990233315247
36605,MOBILE,AL,9129,8156,-973,0.47185420885160545
36606,MOBILE,AL,9144,7558,-1586,0.45252065620883725
36607,MOBILE,AL,2417,2090,-327,0.46372309740403816
36608,MOBILE,AL,15260,13846,-1414,0.4757094757094757
36609,MOBILE,AL,11362,9880,-1482,0.46511627906976744
36610,MOBILE,AL,2413,2199,-214,0.4767996530789245
36610,PRICHARD,AL,922,779,-143,0.45796590241034685
36611,CHICKASAW,AL,2496,2165,-331,0.4644925981549024
36612,MOBILE,AL,1186,922,-264,0.43738140417457305
36612,WHISTLER,AL,250,212,-38,0.4588744588744589
36613,EIGHT MILE,AL,3225,2986,-239,0.4807599420383191
36616,MOBILE,AL,71,194,123,0.7320754716981132
36617,MOBILE,AL,4087,3476,-611,0.459605976464366
36618,MOBILE,AL,5529,5205,-324,0.4849077697037451
36619,MOBILE,AL,4873,4824,-49,0.49747344539548316
36640,MOBILE,AL,23,79,56,0.7745098039215687
36652,MOBILE,AL,0,24,24,1
36660,MOBILE,AL,52,220,168,0.8088235294117647
36663,MOBILE,AL,0,27,27,1
36685,MOBILE,AL,388,482,94,0.5540229885057472
36688,MOBILE,AL,12,0,-12,0
36689,MOBILE,AL,142,402,260,0.7389705882352942
36691,MOBILE,AL,201,604,403,0.7503105590062111
36693,MOBILE,AL,6776,6586,-190,0.4928902858853465
36695,MOBILE,AL,18221,17764,-457,0.4936501319994442
36701,SELMA,AL,3394,3262,-132,0.49008413461538464
36701,VALLEY GRANDE,AL,1851,1705,-146,0.4794713160854893
36702,SELMA,AL,348,218,-130,0.38515901060070673
36703,SELMA,AL,1954,1536,-418,0.44011461318051576
36703,VALLEY GRANDE,AL,1073,883,-190,0.4514314928425358
36720,ALBERTA,AL,11,12,1,0.5217391304347826
36726,CAMDEN,AL,929,1035,106,0.5269857433808554
36732,DEMOPOLIS,AL,3083,2657,-426,0.46289198606271775
36736,DIXONS MILLS,AL,24,37,13,0.6065573770491803
36740,FORKLAND,AL,58,26,-32,0.30952380952380953
36742,GALLION,AL,260,264,4,0.5038167938931297
36744,GREENSBORO,AL,1490,1457,-33,0.49440108585001696
36748,LINDEN,AL,969,882,-87,0.47649918962722854
36749,JONES,AL,0,11,11,1
36750,MAPLESVILLE,AL,719,732,13,0.5044796691936595
36751,LOWER PEACH TREE,AL,12,0,-12,0
36752,BURKVILLE,AL,0,20,20,1
36752,LOWNDESBORO,AL,44,129,85,0.7456647398843931
36752,WHITE HALL,AL,11,39,28,0.78
36756,MARION,AL,1060,1087,27,0.5062878435025617
36758,PLANTERSVILLE,AL,46,142,96,0.7553191489361702
36759,MARION JUNCTION,AL,15,24,9,0.6153846153846154
36761,MINTER,AL,0,12,12,1
36765,NEWBERN,AL,0,13,13,1
36767,ORRVILLE,AL,150,105,-45,0.4117647058823529
36768,PINE APPLE,AL,12,11,-1,0.4782608695652174
36769,PINE HILL,AL,183,178,-5,0.4930747922437673
36775,SARDIS,AL,12,0,-12,0
36776,SAWYERVILLE,AL,26,65,39,0.7142857142857143
36782,SWEET WATER,AL,156,111,-45,0.4157303370786517
36784,THOMASVILLE,AL,2258,1896,-362,0.45642753972075106
36785,TYLER,AL,13,0,-13,0
36786,UNIONTOWN,AL,272,313,41,0.535042735042735
36790,STANTON,AL,0,11,11,1
36792,RANDOLPH,AL,11,13,2,0.5416666666666666
36793,LAWLEY,AL,0,11,11,1
36801,OPELIKA,AL,8307,8398,91,0.5027237354085603
36803,OPELIKA,AL,1199,805,-394,0.40169660678642716
36804,OPELIKA,AL,5442,6133,691,0.5298488120950324
36830,AUBURN,AL,18783,16586,-2197,0.46894172863241823
36831,AUBURN,AL,861,1115,254,0.5642712550607287
36832,AUBURN,AL,11818,8668,-3150,0.4231182270819096
36850,CAMP HILL,AL,309,461,152,0.5987012987012987
36852,CUSSETA,AL,643,661,18,0.5069018404907976
36853,DADEVILLE,AL,2835,3178,343,0.5285215366705471
36854,VALLEY,AL,5654,5026,-628,0.4705992509363296
36855,FIVE POINTS,AL,77,241,164,0.7578616352201258
36856,FORT MITCHELL,AL,3453,3669,216,0.5151642796967144
36860,HURTSBORO,AL,41,15,-26,0.26785714285714285
36861,JACKSONS GAP,AL,865,973,108,0.529379760609358
36862,LAFAYETTE,AL,1369,1439,70,0.5124643874643875
36863,LANETT,AL,3247,3262,15,0.5011522507297588
36866,NOTASULGA,AL,1004,994,-10,0.4974974974974975
36867,PHENIX CITY,AL,9818,9194,-624,0.48358931201346517
36868,PHENIX CITY,AL,724,776,52,0.5173333333333333
36869,PHENIX CITY,AL,7670,7186,-484,0.48371028540656974
36870,PHENIX CITY,AL,6636,6317,-319,0.48768625028950824
36871,PITTSVIEW,AL,59,103,44,0.6358024691358025
36874,SALEM,AL,2123,2819,696,0.5704168352893565
36875,SEALE,AL,1123,1260,137,0.5287452790600083
36877,SMITHS,AL,79,91,12,0.5352941176470588
36877,SMITHS STA,AL,105,96,-9,0.47761194029850745
36877,SMITHS STATION,AL,4074,4444,370,0.5217187133129843
36879,AUBURN,AL,445,781,336,0.6370309951060359
36879,WAVERLY,AL,12,84,72,0.875
36904,BUTLER,AL,1146,923,-223,0.4461092315128081
36907,CUBA,AL,105,111,6,0.5138888888888888
36908,GILBERTOWN,AL,327,419,92,0.561662198391421
36912,LISMAN,AL,116,81,-35,0.41116751269035534
36915,NEEDHAM,AL,0,13,13,1
36919,SILAS,AL,35,40,5,0.5333333333333333
36921,TOXEY,AL,35,0,-35,0
36925,YORK,AL,575,544,-31,0.48614834673815904
37010,ADAMS,TN,1491,1718,227,0.5353692739171081
37011,ANTIOCH,TN,1412,1409,-3,0.49946827366182206
37012,ALEXANDRIA,TN,793,926,133,0.5386852821407795
37013,ANTIOCH,TN,48776,42185,-6591,0.4637701872230956
37014,ARRINGTON,TN,588,1192,604,0.6696629213483146
37015,ASHLAND CITY,TN,7087,7958,871,0.528946493851778
37016,AUBURNTOWN,TN,62,66,4,0.515625
37018,BEECHGROVE,TN,1681,1062,-619,0.38716733503463363
37019,BELFAST,TN,243,207,-36,0.46
37019,KNOXVILLE,TN,0,13,13,1
37020,BELL BUCKLE,TN,1553,1812,259,0.538484398216939
37022,BETHPAGE,TN,1937,2047,110,0.5138052208835341
37023,BIG ROCK,TN,571,445,-126,0.43799212598425197
37024,BRENTWOOD,TN,996,1283,287,0.562966213251426
37025,BON AQUA,TN,2071,2257,186,0.5214879852125693
37026,BRADYVILLE,TN,777,755,-22,0.49281984334203655
37027,BRENTWOOD,TN,20327,22622,2295,0.526717734988009
37028,BUMPUS MILLS,TN,59,26,-33,0.3058823529411765
37029,BURNS,TN,1823,2373,550,0.565538608198284
37030,CARTHAGE,TN,2915,2930,15,0.5012831479897348
37031,CASTALIAN SPRINGS,TN,1410,1744,334,0.5529486366518707
37032,CEDAR HILL,TN,1364,1389,25,0.5045405012713403
37033,CENTERVILLE,TN,2869,2985,116,0.5099077553809361
37033,PLEASANTVILLE,TN,52,76,24,0.59375
37034,CHAPEL HILL,TN,2528,3146,618,0.5544589354952415
37035,CHAPMANSBORO,TN,1188,948,-240,0.4438202247191011
37036,CHARLOTTE,TN,1822,2138,316,0.5398989898989899
37037,CHRISTIANA,TN,2399,3422,1023,0.5878714997423123
37040,CLARKSVILLE,TN,35850,32767,-3083,0.47753472171619277
37041,CLARKSVILLE,TN,85,209,124,0.7108843537414966
37042,CLARKSVILLE,TN,55922,49954,-5968,0.47181608674298237
37043,CLARKSVILLE,TN,23723,26648,2925,0.5290345635385441
37046,COLLEGE GROVE,TN,1564,2869,1305,0.6471915181592601
37047,CORNERSVILLE,TN,717,935,218,0.5659806295399515
37048,COTTONTOWN,TN,1648,1893,245,0.5345947472465405
37049,CROSS PLAINS,TN,1209,1581,372,0.5666666666666667
37050,CUMBERLAND CITY,TN,662,541,-121,0.44970906068162925
37051,CMBRLND FRNCE,TN,26,40,14,0.6060606060606061
37051,CUMBERLAND FURNACE,TN,1090,1215,125,0.527114967462039
37052,CUNNINGHAM,TN,719,851,132,0.5420382165605095
37055,DICKSON,TN,11411,11030,-381,0.4915110734815739
37056,DICKSON,TN,243,398,155,0.6209048361934477
37057,DIXON SPRINGS,TN,554,376,-178,0.4043010752688172
37058,DOVER,TN,3117,2920,-197,0.4836839489812821
37059,DOWELLTOWN,TN,580,544,-36,0.48398576512455516
37060,EAGLEVILLE,TN,707,962,255,0.5763930497303775
37061,ERIN,TN,2422,1965,-457,0.44791429222703444
37062,FAIRVIEW,TN,3969,4542,573,0.5336623193514276
37064,FRANKLIN,TN,22227,25253,3026,0.5318660488626791
37065,FRANKLIN,TN,167,199,32,0.5437158469945356
37066,GALLATIN,TN,26795,29231,2436,0.5217399064719952
37067,FRANKLIN,TN,18685,19032,347,0.504600047723838
37068,FRANKLIN,TN,1214,1771,557,0.5932998324958124
37069,FRANKLIN,TN,5568,6535,967,0.5399487730314798
37070,GOODLETTSVILLE,TN,1251,858,-393,0.406827880512091
37071,GLADEVILLE,TN,0,11,11,1
37072,GOODLETTSVILLE,TN,12879,12923,44,0.5008526470816216
37073,GREENBRIER,TN,4227,4844,617,0.5340094807628707
37074,HARTSVILLE,TN,2974,3246,272,0.5218649517684888
37075,HENDERSONVILLE,TN,27702,29252,1550,0.5136074726972645
37076,HERMITAGE,TN,24064,22056,-2008,0.4782307025151778
37077,HENDERSONVILLE,TN,746,1084,338,0.5923497267759563
37078,HURRICANE MILLS,TN,120,49,-71,0.28994082840236685
37079,INDIAN MOUND,TN,838,933,95,0.5268210050818747
37080,JOELTON,TN,2427,2468,41,0.5041879468845761
37082,KINGSTON SPGS,TN,114,148,34,0.5648854961832062
37082,KINGSTON SPRINGS,TN,1672,1815,143,0.5205047318611987
37083,LAFAYETTE,TN,6098,6301,203,0.5081861440438745
37085,LASCASSAS,TN,1053,1476,423,0.5836298932384342
37086,LA VERGNE,TN,17995,14194,-3801,0.4409580912734164
37087,LEBANON,TN,20247,22857,2610,0.5302756124721604
37088,LEBANON,TN,2090,1333,-757,0.3894244814490213
37090,LEBANON,TN,7419,9584,2165,0.5636652355466683
37091,LEWISBURG,TN,8823,8731,-92,0.49737951464053776
37095,LIBERTY,TN,722,757,35,0.5118323191345504
37096,LINDEN,TN,3506,2266,-1240,0.3925848925848926
37097,LOBELVILLE,TN,943,898,-45,0.48777838131450296
37098,LYLES,TN,2229,2077,-152,0.48235020901068276
37101,MC EWEN,TN,2283,2357,74,0.5079741379310345
37110,MC MINNVILLE,TN,990,890,-100,0.4734042553191489
37110,MCMINNVILLE,TN,11887,11572,-315,0.4932861588302997
37111,MC MINNVILLE,TN,103,79,-24,0.4340659340659341
37111,MCMINNVILLE,TN,455,598,143,0.5679012345679012
37115,MADISON,TN,19998,16294,-3704,0.4489694698556156
37116,MADISON,TN,477,1001,524,0.6772665764546685
37118,MILTON,TN,124,288,164,0.6990291262135923
37121,MOUNT JULIET,TN,740,1022,282,0.5800227014755959
37122,MOUNT JULIET,TN,18334,22075,3741,0.5462891930015591
37122,MT JULIET,TN,4359,5333,974,0.5502476269087908
37127,MURFREESBORO,TN,8269,8107,-162,0.49505373717635565
37128,MURFREESBORO,TN,34627,37385,2758,0.5191495861800811
37129,MURFREESBORO,TN,24869,28183,3314,0.5312335067480962
37130,MURFREESBORO,TN,32622,27327,-5295,0.4558374618425662
37133,MURFREESBORO,TN,1283,1898,615,0.5966677145551713
37134,NEW JOHNSONVILLE,TN,1313,1177,-136,0.47269076305220886
37134,NEW JOHSONVLE,TN,20,34,14,0.6296296296296297
37135,NOLENSVILLE,TN,5492,8509,3017,0.6077423041211342
37137,NUNNELLY,TN,1116,1198,82,0.5177182368193605
37138,OLD HICKORY,TN,9153,9404,251,0.5067629465969715
37141,ORLINDA,TN,107,113,6,0.5136363636363637
37142,PALMYRA,TN,379,603,224,0.6140529531568228
37143,PEGRAM,TN,1098,1176,78,0.5171503957783641
37144,PETERSBURG,TN,927,1107,180,0.5442477876106194
37145,PLEASANT SHADE,TN,517,639,122,0.5527681660899654
37146,PLEASANT VIEW,TN,2531,3058,527,0.5471461799964216
37148,PORTLAND,TN,10690,9578,-1112,0.4725675942372212
37149,READYVILLE,TN,559,642,83,0.5345545378850958
37150,RED BLNG SPGS,TN,91,97,6,0.5159574468085106
37150,RED BOILING SPRINGS,TN,1692,1744,52,0.5075669383003493
37151,RIDDLETON,TN,12,0,-12,0
37153,ROCKVALE,TN,1586,1757,171,0.5255758300927311
37160,SHELBYVILLE,TN,14450,13281,-1169,0.47892250549926074
37162,SHELBYVILLE,TN,409,910,501,0.6899166034874905
37166,SMITHVILLE,TN,6560,6388,-172,0.493358047574915
37167,SMYRNA,TN,26989,27759,770,0.5070322203550814
37171,SOUTHSIDE,TN,109,276,167,0.7168831168831169
37172,SPRINGFIELD,TN,10352,10755,403,0.5095465959160468
37174,SPRING HILL,TN,19541,24828,5287,0.5595798868579414
37175,STEWART,TN,204,233,29,0.5331807780320366
37178,TENNESSEE RIDGE,TN,1032,720,-312,0.410958904109589
37179,THOMPSONS STATION,TN,4930,6027,1097,0.5500593228073378
37179,THOMPSONS STN,TN,291,405,114,0.5818965517241379
37180,UNIONVILLE,TN,986,1055,69,0.5169034786869182
37181,VANLEER,TN,289,331,42,0.5338709677419354
37183,WARTRACE,TN,1070,1203,133,0.5292564892212934
37184,WATERTOWN,TN,1846,2094,248,0.5314720812182742
37185,WAVERLY,TN,4297,4208,-89,0.49476778365667257
37186,WESTMORELAND,TN,3346,3918,572,0.5393722466960352
37187,WHITE BLUFF,TN,2727,2714,-13,0.4988053666605403
37188,WHITE HOUSE,TN,6693,7737,1044,0.5361746361746361
37189,WHITES CREEK,TN,1274,1397,123,0.5230250842381131
37190,WOODBURY,TN,3378,3308,-70,0.494765180975172
37191,WOODLAWN,TN,1574,1742,168,0.5253317249698432
37201,NASHVILLE,TN,2136,1979,-157,0.4809234507897934
37202,NASHVILLE,TN,537,636,99,0.5421994884910486
37203,NASHVILLE,TN,25982,22457,-3525,0.46361403001713497
37204,NASHVILLE,TN,10793,9137,-1656,0.4584545910687406
37205,NASHVILLE,TN,11307,11144,-163,0.4963698721660505
37206,NASHVILLE,TN,20876,17746,-3130,0.45947905338926
37207,NASHVILLE,TN,18934,17904,-1030,0.4860198707856018
37208,NASHVILLE,TN,16006,13867,-2139,0.4641984400629331
37209,NASHVILLE,TN,30021,28408,-1613,0.4861969227609577
37210,NASHVILLE,TN,10547,8725,-1822,0.4527293482772935
37211,NASHVILLE,TN,42040,32934,-9106,0.43927228105743327
37212,NASHVILLE,TN,11360,8048,-3312,0.41467436108821104
37214,NASHVILLE,TN,18952,16956,-1996,0.4722067505848279
37215,NASHVILLE,TN,11347,10801,-546,0.48767383059418457
37216,NASHVILLE,TN,11177,10771,-406,0.49075086568252235
37217,NASHVILLE,TN,18916,14122,-4794,0.4274471820328107
37218,NASHVILLE,TN,4615,4390,-225,0.4875069405885619
37219,MITCHELLVILLE,TN,40,54,14,0.574468085106383
37219,NASHVILLE,TN,3114,2485,-629,0.4438292552241472
37220,NASHVILLE,TN,1560,1687,127,0.5195565137049585
37220,OAK HILL,TN,115,117,2,0.5043103448275862
37221,NASHVILLE,TN,20710,20468,-242,0.4970615377143135
37222,NASHVILLE,TN,534,505,-29,0.48604427333974976
37222,PORTLAND,TN,0,11,11,1
37224,NASHVILLE,TN,46,149,103,0.764102564102564
37228,NASHVILLE,TN,3116,3448,332,0.5252894576477758
37229,NASHVILLE,TN,1192,1401,209,0.5403008098727343
37301,ALTAMONT,TN,435,641,206,0.595724907063197
37302,APISON,TN,1278,1954,676,0.6045792079207921
37303,ATHENS,TN,9727,10419,692,0.5171746252357788
37306,BELVIDERE,TN,592,620,28,0.5115511551155115
37307,BENTON,TN,1743,1783,40,0.5056721497447533
37308,BIRCHWOOD,TN,746,983,237,0.5685367264314632
37309,CALHOUN,TN,776,931,155,0.5454012888107791
37310,CHARLESTON,TN,1614,1549,-65,0.489724944672779
37311,CLEVELAND,TN,13056,12040,-1016,0.47975773031558816
37312,CLEVELAND,TN,13865,14718,853,0.5149214568099919
37313,COALMONT,TN,167,176,9,0.5131195335276968
37315,COLLEGEDALE,TN,531,196,-335,0.2696011004126547
37317,COPPERHILL,TN,648,816,168,0.5573770491803278
37318,COWAN,TN,720,774,54,0.5180722891566265
37320,CLEVELAND,TN,2908,1754,-1154,0.3762333762333762
37321,DAYTON,TN,7669,7617,-52,0.4982990972131362
37322,DECATUR,TN,3743,3883,140,0.509179124049305
37323,CLEVELAND,TN,9494,10032,538,0.5137765031240398
37324,DECHERD,TN,1951,2075,124,0.5153999006458023
37325,DELANO,TN,535,627,92,0.5395869191049913
37326,DUCKTOWN,TN,12,25,13,0.6756756756756757
37327,DUNLAP,TN,4862,5477,615,0.5297417545217139
37328,ELORA,TN,135,347,212,0.7199170124481328
37329,ENGLEWOOD,TN,2043,2113,70,0.5084215591915303
37330,ESTILL SPGS,TN,202,194,-8,0.4898989898989899
37330,ESTILL SPRINGS,TN,2256,2533,277,0.5289204426811442
37331,ETOWAH,TN,3368,3362,-6,0.49955423476968797
37332,EVENSVILLE,TN,794,920,126,0.5367561260210035
37334,FAYETTEVILLE,TN,9329,9089,-240,0.4934846345965903
37335,FLINTVILLE,TN,844,1009,165,0.5445223961144091
37336,GEORGETOWN,TN,1431,1633,202,0.5329634464751958
37337,GRANDVIEW,TN,98,331,233,0.7715617715617715
37338,GRAYSVILLE,TN,1122,1353,231,0.5466666666666666
37339,GRUETLI LAAGER,TN,266,413,147,0.6082474226804123
37340,GUILD,TN,87,75,-12,0.46296296296296297
37341,HARRISON,TN,4760,4507,-253,0.4863494118916586
37342,HILLSBORO,TN,1134,1285,151,0.531211244315833
37343,HIXSON,TN,16668,17305,637,0.5093750919848115
37345,HUNTLAND,TN,361,324,-37,0.472992700729927
37347,JASPER,TN,2884,2945,61,0.5052324583976668
37347,KIMBALL,TN,128,131,3,0.5057915057915058
37348,KELSO,TN,130,121,-9,0.4820717131474104
37349,MANCHESTER,TN,790,911,121,0.5355673133450911
37350,LOOKOUT MOUNTAIN,TN,475,591,116,0.5544090056285178
37350,LOOKOUT MTN,TN,45,35,-10,0.4375
37352,LYNCHBURG,TN,1007,1037,30,0.5073385518590998
37353,MC DONALD,TN,1481,1674,193,0.5305863708399366
37354,MADISONVILLE,TN,7110,7022,-88,0.4968864987262949
37355,MANCHESTER,TN,10500,11063,563,0.5130547697444697
37356,MONTEAGLE,TN,781,1017,236,0.5656284760845384
37357,MORRISON,TN,1765,1927,162,0.5219393282773565
37359,MULBERRY,TN,36,0,-36,0
37360,NORMANDY,TN,328,407,79,0.5537414965986395
37361,OCOEE,TN,308,529,221,0.6320191158900836
37362,OLD FORT,TN,1068,1246,178,0.5384615384615384
37363,OOLTEWAH,TN,15060,17221,2161,0.5334717016201481
37364,CLEVELAND,TN,37,61,24,0.6224489795918368
37365,PALMER,TN,221,233,12,0.513215859030837
37366,PELHAM,TN,53,27,-26,0.3375
37367,PIKEVILLE,TN,3136,3709,573,0.5418553688823959
37369,RELIANCE,TN,75,65,-10,0.4642857142857143
37370,RICEVILLE,TN,1435,1665,230,0.5370967741935484
37371,ATHENS,TN,342,571,229,0.6254107338444688
37373,SALE CREEK,TN,897,1205,308,0.5732635585156993
37374,SEQUATCHIE,TN,337,524,187,0.6085946573751452
37375,SEWANEE,TN,1062,991,-71,0.48270823185582074
37377,SIGNAL MOUNTAIN,TN,3891,4889,998,0.5568337129840547
37377,SIGNAL MTN,TN,473,525,52,0.5260521042084169
37379,SODDY DAISY,TN,7977,9107,1130,0.5330718801217513
37380,SOUTH PITTSBURG,TN,2513,2322,-191,0.48024819027921406
37381,SPRING CITY,TN,3472,3958,486,0.5327052489905787
37384,SODDY DAISY,TN,468,456,-12,0.4935064935064935
37385,TELLICO PLAINS,TN,2792,2902,110,0.5096592904812083
37385,TELLICO PLNS,TN,50,56,6,0.5283018867924528
37387,TRACY CITY,TN,1182,1038,-144,0.46756756756756757
37388,TULLAHOMA,TN,11038,11288,250,0.5055988533548329
37391,TURTLETOWN,TN,195,272,77,0.582441113490364
37397,POWELLS CROSSROADS,TN,93,88,-5,0.4861878453038674
37397,WHITWELL,TN,2646,2646,0,0.5
37398,WINCHESTER,TN,6097,6325,228,0.5091772661407181
37401,CHATTANOOGA,TN,272,615,343,0.6933483652762119
37401,COLUMBIA,TN,0,13,13,1
37402,CHATTANOOGA,TN,4447,3863,-584,0.4648616125150421
37403,CHATTANOOGA,TN,2563,2340,-223,0.47725882112992046
37404,CHATTANOOGA,TN,6906,5516,-1390,0.4440508774754468
37405,CHATTANOOGA,TN,12512,11635,-877,0.4818403942518739
37406,CHATTANOOGA,TN,7230,5623,-1607,0.437485411966078
37407,CHATTANOOGA,TN,3136,2034,-1102,0.3934235976789168
37408,CHATTANOOGA,TN,2939,2899,-40,0.49657416923603975
37409,CHATTANOOGA,TN,1847,1786,-61,0.49160473437930086
37410,CHATTANOOGA,TN,1857,1619,-238,0.46576524741081704
37411,CHATTANOOGA,TN,8500,6741,-1759,0.44229381274194607
37412,CHATTANOOGA,TN,10729,9338,-1391,0.4653411072905766
37412,EAST RIDGE,TN,271,189,-82,0.4108695652173913
37414,CHATTANOOGA,TN,257,700,443,0.7314524555903866
37415,CHATTANOOGA,TN,13332,12414,-918,0.4821719878816127
37416,CHATTANOOGA,TN,6612,6597,-15,0.49943220531455823
37419,CHATTANOOGA,TN,2337,2383,46,0.5048728813559322
37421,CHATTANOOGA,TN,26521,25067,-1454,0.48590757540513296
37422,CHATTANOOGA,TN,647,928,281,0.5892063492063492
37424,CHATTANOOGA,TN,350,412,62,0.5406824146981627
37601,JOHNSON CITY,TN,16829,15584,-1245,0.480794742850091
37602,JOHNSON CITY,TN,752,860,108,0.533498759305211
37604,JOHNSON CITY,TN,19088,17083,-2005,0.4722844267507119
37605,JOHNSON CITY,TN,918,671,-247,0.4222781623662681
37615,BLUFF CITY,TN,152,118,-34,0.43703703703703706
37615,GRAY,TN,3114,3408,294,0.5225390984360626
37615,JOHNSON CITY,TN,5085,5577,492,0.5230725942599888
37616,AFTON,TN,1308,1490,182,0.5325232308791994
37617,BLOUNTVILLE,TN,4542,4512,-30,0.4983432736911862
37618,BLUFF CITY,TN,3458,3983,525,0.535277516462841
37620,BRISTOL,TN,14348,13734,-614,0.4890677302186454
37621,BRISTOL,TN,140,368,228,0.7244094488188977
37625,BRISTOL,TN,12,13,1,0.52
37640,BUTLER,TN,1432,1432,0,0.5
37641,CHUCKEY,TN,2369,3047,678,0.5625923190546529
37642,CHURCH HILL,TN,5055,5173,118,0.5057684786859601
37643,ELIZABETHTON,TN,11148,11748,600,0.5131027253668763
37644,ELIZABETHTON,TN,519,601,82,0.5366071428571428
37645,MOUNT CARMEL,TN,1371,1437,66,0.5117521367521367
37645,MT CARMEL,TN,134,176,42,0.567741935483871
37650,ERWIN,TN,4165,4329,164,0.5096538733223451
37656,FALL BRANCH,TN,1126,1338,212,0.5430194805194806
37657,FLAG POND,TN,28,50,22,0.6410256410256411
37658,HAMPTON,TN,1248,1431,183,0.5341545352743561
37659,JONESBOROUGH,TN,8331,9799,1468,0.5404853833425262
37660,KINGSPORT,TN,16794,17063,269,0.5039725906016481
37662,KINGSPORT,TN,100,118,18,0.5412844036697247
37663,KINGSPORT,TN,4173,4595,422,0.5240647810218978
37664,KINGSPORT,TN,10484,11439,955,0.521780778178169
37665,KINGSPORT,TN,2145,2095,-50,0.49410377358490565
37680,LAUREL BLOOMERY,TN,38,0,-38,0
37681,LIMESTONE,TN,1648,1916,268,0.5375982042648709
37682,MILLIGAN,TN,12,0,-12,0
37682,MILLIGAN COLLEGE,TN,90,0,-90,0
37683,MOUNTAIN CITY,TN,4147,4464,317,0.5184066891185692
37684,MOUNTAIN HOME,TN,15,41,26,0.7321428571428571
37684,MTN HOME,TN,0,11,11,1
37686,PINEY FLATS,TN,2955,3593,638,0.5487171655467318
37687,ROAN MOUNTAIN,TN,1159,1311,152,0.5307692307692308
37688,SHADY VALLEY,TN,72,92,20,0.5609756097560976
37690,TELFORD,TN,1275,1532,257,0.5457784111150694
37691,TRADE,TN,54,110,56,0.6707317073170732
37692,UNICOI,TN,1521,1663,142,0.5222989949748744
37694,WATAUGA,TN,407,426,19,0.5114045618247299
37701,ALCOA,TN,3511,3767,256,0.5175872492442979
37705,ANDERSONVILLE,TN,1420,1585,165,0.5274542429284526
37708,BEAN STATION,TN,2375,2455,80,0.5082815734989649
37709,BLAINE,TN,1024,1234,210,0.5465013286093888
37710,BRICEVILLE,TN,64,34,-30,0.3469387755102041
37711,BULLS GAP,TN,1677,1896,219,0.5306465155331654
37713,BYBEE,TN,205,354,149,0.6332737030411449
37714,CARYVILLE,TN,1783,1650,-133,0.48062918729973786
37716,CLINTON,TN,8541,9004,463,0.5131946423482474
37717,CLINTON,TN,499,252,-247,0.3355525965379494
37719,COALFIELD,TN,0,12,12,1
37721,CORRYTON,TN,3588,3941,353,0.5234426882720149
37722,COSBY,TN,2273,2409,136,0.5145237078171722
37723,CRAB ORCHARD,TN,68,123,55,0.643979057591623
37724,CUMB GAP,TN,25,0,-25,0
37724,CUMBERLAND GAP,TN,859,666,-193,0.4367213114754098
37724,CUMBERLAND GP,TN,11,12,1,0.5217391304347826
37725,DANDRIDGE,TN,6639,7407,768,0.5273387441264417
37726,DEER LODGE,TN,481,807,326,0.6265527950310559
37727,DEL RIO,TN,733,791,58,0.5190288713910761
37729,DUFF,TN,106,71,-35,0.4011299435028249
37731,EIDSON,TN,11,47,36,0.8103448275862069
37737,FRIENDSVILLE,TN,2001,2185,184,0.521978021978022
37738,GATLINBURG,TN,3420,2825,-595,0.45236188951160927
37742,GREENBACK,TN,1707,2180,473,0.5608438384358116
37743,GREENEVILLE,TN,7881,8713,832,0.5250693021574063
37744,GREENEVILLE,TN,349,501,152,0.5894117647058823
37745,GREENEVILLE,TN,6093,6867,774,0.5298611111111111
37748,HARRIMAN,TN,6668,6421,-247,0.4905645962258385
37752,HARROGATE,TN,1962,1848,-114,0.48503937007874015
37753,HARTFORD,TN,74,131,57,0.6390243902439025
37754,HEISKELL,TN,1740,1864,124,0.5172031076581576
37755,HELENWOOD,TN,1095,1080,-15,0.496551724137931
37756,HUNTSVILLE,TN,899,763,-136,0.4590854392298436
37757,JACKSBORO,TN,3051,3367,316,0.5246182611405422
37760,JEFFERSON CITY,TN,5692,5720,28,0.5012267788293024
37762,JELLICO,TN,1106,969,-137,0.4669879518072289
37763,KINGSTON,TN,5572,5520,-52,0.4976559682654165
37764,KODAK,TN,4496,5356,860,0.5436459602111247
37766,LA FOLLETTE,TN,7536,7093,-443,0.4848588420261125
37769,LAKE CITY,TN,19,35,16,0.6481481481481481
37769,ROCKY TOP,TN,2132,2035,-97,0.48836093112550993
37770,LANCING,TN,557,616,59,0.525149190110827
37771,LENOIR CITY,TN,5458,6202,744,0.5319039451114923
37772,LENOIR CITY,TN,3995,4975,980,0.5546265328874025
37774,LOUDON,TN,7731,9727,1996,0.557165769274831
37777,LOUISVILLE,TN,5535,5451,-84,0.4961769524849809
37779,LUTTRELL,TN,1253,1169,-84,0.48265895953757226
37801,MARYVILLE,TN,12459,12727,268,0.5053204161041849
37802,MARYVILLE,TN,1165,1536,371,0.5686782673084043
37803,MARYVILLE,TN,9618,10754,1136,0.5278814058511683
37804,MARYVILLE,TN,8641,8989,348,0.5098695405558706
37806,MASCOT,TN,831,1020,189,0.5510534846029174
37807,MAYNARDVILLE,TN,3227,3894,667,0.5468333099283809
37809,MIDWAY,TN,636,660,24,0.5092592592592593
37810,MOHAWK,TN,424,433,9,0.5052508751458576
37811,MOORESBURG,TN,1249,1429,180,0.5336071695294996
37813,MORRISTOWN,TN,7522,6211,-1311,0.45226825893832373
37814,MORRISTOWN,TN,12508,12295,-213,0.4957061645768657
37815,MORRISTOWN,TN,343,318,-25,0.481089258698941
37816,MORRISTOWN,TN,49,62,13,0.5585585585585585
37818,MOSHEIM,TN,1594,1740,146,0.5218956208758249
37819,NEWCOMB,TN,0,11,11,1
37820,NEW MARKET,TN,2409,2572,163,0.5163621762698254
37821,NEWPORT,TN,8299,8590,291,0.508615074900823
37822,NEWPORT,TN,447,893,446,0.6664179104477612
37824,NEW TAZEWELL,TN,926,585,-341,0.3871608206485771
37825,NEW TAZEWELL,TN,3098,2941,-157,0.4870011591323067
37826,NIOTA,TN,1394,1675,281,0.5457803844900619
37828,NORRIS,TN,194,390,196,0.6678082191780822
37829,HARRIMAN,TN,19,18,-1,0.4864864864864865
37829,OAKDALE,TN,291,291,0,0.5
37830,OAK RIDGE,TN,13599,14268,669,0.5120034449348692
37831,OAK RIDGE,TN,302,535,233,0.6391875746714456
37840,OLIVER SPGS,TN,165,167,2,0.5030120481927711
37840,OLIVER SPRINGS,TN,2481,2639,158,0.5154296875
37841,ONEIDA,TN,3137,3152,15,0.5011925584353634
37843,PARROTTSVILLE,TN,1210,1234,24,0.5049099836333879
37846,PHILADELPHIA,TN,1256,1491,235,0.5427739352020385
37847,PIONEER,TN,547,461,-86,0.4573412698412698
37849,POWELL,TN,8695,9531,836,0.5229342697245692
37852,ROBBINS,TN,636,761,125,0.5447387258410881
37853,ROCKFORD,TN,1668,1129,-539,0.4036467643904183
37854,ROCKWOOD,TN,5113,5400,287,0.5136497669551984
37857,ROGERSVILLE,TN,7189,7802,613,0.5204456006937496
37860,RUSSELLVILLE,TN,1556,1429,-127,0.47872696817420435
37861,RUTLEDGE,TN,2426,2884,458,0.5431261770244821
37862,PIGEON FORGE,TN,199,185,-14,0.4817708333333333
37862,SEVIERVILLE,TN,8435,8244,-191,0.49427423706457224
37863,PIGEON FORGE,TN,3197,2757,-440,0.46305005038629493
37864,SEVIERVILLE,TN,1035,1194,159,0.5356662180349933
37865,SEYMOUR,TN,7842,8528,686,0.5209529627367135
37866,SHARPS CHAPEL,TN,608,880,272,0.5913978494623656
37868,PIGEON FORGE,TN,446,381,-65,0.4607013301088271
37869,SNEEDVILLE,TN,1591,1674,83,0.5127105666156202
37870,SPEEDWELL,TN,1360,1214,-146,0.4716394716394716
37871,STRAWBERRY PLAINS,TN,2616,3053,437,0.5385429529017464
37872,SUNBRIGHT,TN,646,938,292,0.5921717171717171
37873,SURGOINSVILLE,TN,1203,1396,193,0.5371296652558677
37874,SWEETWATER,TN,5897,6628,731,0.52918163672654694
37876,SEVIERVILLE,TN,11688,11394,-294,0.4936314010917598
37877,TALBOTT,TN,2516,3046,530,0.5476447321107515
37878,TALLASSEE,TN,0,40,40,1
37879,TAZEWELL,TN,3856,3312,-544,0.46205357142857145
37880,TEN MILE,TN,1289,1626,337,0.5578044596912521
37881,THORN HILL,TN,411,657,246,0.6151685393258427
37881,TREADWAY,TN,14,23,9,0.6216216216216216
37882,TOWNSEND,TN,1627,1726,99,0.5147628988965106
37885,VONORE,TN,2491,2863,372,0.5347403810235338
37886,WALLAND,TN,1244,1551,307,0.5549194991055456
37887,WARTBURG,TN,1575,1598,23,0.5036243302867949
37888,WASHBURN,TN,426,559,133,0.5675126903553299
37890,BANEBERRY,TN,169,208,39,0.5517241379310345
37890,WHITE PINE,TN,2296,2670,374,0.5376560612162706
37891,WHITESBURG,TN,1114,1252,138,0.5291631445477599
37892,WINFIELD,TN,458,467,9,0.5048648648648648
37901,KNOXVILLE,TN,251,275,24,0.5228136882129277
37902,KNOXVILLE,TN,2653,2047,-606,0.43553191489361703
37909,KNOXVILLE,TN,8859,8026,-833,0.47533313591945514
37912,KNOXVILLE,TN,12625,11022,-1603,0.4661056370786992
37914,KNOXVILLE,TN,10013,8617,-1396,0.46253354804079444
37915,KNOXVILLE,TN,3556,3173,-383,0.47154109080101053
37916,KNOXVILLE,TN,3017,1259,-1758,0.29443405051449956
37917,KNOXVILLE,TN,14060,12379,-1681,0.468209841521994
37918,KNOXVILLE,TN,17554,17581,27,0.5003842322470471
37919,KNOXVILLE,TN,16404,14926,-1478,0.4764123842962017
37920,KNOXVILLE,TN,17813,16626,-1187,0.48276663085455446
37921,KNOXVILLE,TN,11765,10943,-822,0.48190065175268626
37922,CONCORD,TN,289,356,67,0.5519379844961241
37922,CONCORD FARR,TN,297,342,45,0.5352112676056338
37922,KNOXVILLE,TN,11964,14292,2328,0.5443327239488117
37923,KNOXVILLE,TN,18056,15457,-2599,0.4612240026258467
37924,KNOXVILLE,TN,4312,4781,469,0.5257890685142417
37927,KNOXVILLE,TN,327,598,271,0.6464864864864864
37928,KNOXVILLE,TN,165,369,204,0.6910112359550562
37930,KNOXVILLE,TN,2644,1374,-1270,0.34196117471378795
37931,KNOXVILLE,TN,12030,13137,1107,0.521993086184289
37932,KNOXVILLE,TN,8794,11206,2412,0.5603
37933,FARRAGUT,TN,11,38,27,0.7755102040816326
37933,KNOXVILLE,TN,704,950,246,0.5743651753325272
37934,FARRAGUT,TN,5175,5929,754,0.5339517291066282
37934,KNOXVILLE,TN,2463,2903,440,0.5409988818486768
37938,KNOXVILLE,TN,5377,6154,777,0.5336917873558235
37939,KNOXVILLE,TN,758,335,-423,0.30649588289112534
37940,KNOXVILLE,TN,155,310,155,0.6666666666666666
37950,KNOXVILLE,TN,763,1129,366,0.596723044397463
38001,ALAMO,TN,1739,1528,-211,0.4677073767982859
38002,ARLINGTON,TN,3205,3717,512,0.5369835307714533
38002,BARTLETT,TN,1773,2130,357,0.5457340507302075
38002,LAKELAND,TN,6656,7305,649,0.5232433206790345
38004,ATOKA,TN,3021,3695,674,0.5501786777843954
38006,BELLS,TN,1506,1461,-45,0.4924165824064712
38008,BOLIVAR,TN,2580,2708,128,0.5121028744326778
38011,ALAMO,TN,66,73,7,0.5251798561151079
38011,BRIGHTON,TN,2556,2672,116,0.5110941086457537
38012,BROWNSVILLE,TN,5034,4784,-250,0.4872682827459768
38015,BURLISON,TN,564,650,86,0.5354200988467874
38016,CORDOVA,TN,22095,19432,-2663,0.46793652322585305
38017,COLLIERVILLE,TN,15638,17657,2019,0.5303198678480252
38017,PIPERTON,TN,370,354,-16,0.4889502762430939
38018,CORDOVA,TN,16283,14639,-1644,0.47341698467110793
38019,COVINGTON,TN,5002,5098,96,0.5047524752475248
38023,DRUMMONDS,TN,1460,1531,71,0.5118689401537947
38024,DYERSBURG,TN,11875,11179,-696,0.4849050056389347
38025,DYERSBURG,TN,112,276,164,0.711340206185567
38027,COLLIERVILLE,TN,198,591,393,0.7490494296577946
38028,EADS,TN,1465,1940,475,0.5697503671071953
38029,ELLENDALE,TN,14,0,-14,0
38030,FINLEY,TN,27,34,7,0.5573770491803278
38034,FRIENDSHIP,TN,730,841,111,0.5353278166772756
38037,GATES,TN,364,426,62,0.5392405063291139
38039,GRAND JCT,TN,0,11,11,1
38039,GRAND JUNCTION,TN,462,227,-235,0.32946298984034833
38040,HALLS,TN,1677,1693,16,0.502373887240356
38040,KNOXVILLE,TN,26,34,8,0.5666666666666667
38041,HENNING,TN,790,658,-132,0.4544198895027624
38042,HICKORY VALLEY,TN,11,0,-11,0
38044,HORNSBY,TN,38,45,7,0.54216867469879515
38049,MASON,TN,861,982,121,0.5328269126424309
38050,MAURY CITY,TN,0,12,12,1
38052,MIDDLETON,TN,1556,1097,-459,0.4134941575574821
38053,MILLINGTON,TN,8709,8749,40,0.501145606598694
38057,MOSCOW,TN,1027,988,-39,0.49032258064516127
38058,MUNFORD,TN,3414,3704,290,0.5203708906996347
38059,NEWBERN,TN,3859,2731,-1128,0.4144157814871017
38060,OAKLAND,TN,3746,5010,1264,0.5721790772042028
38061,POCAHONTAS,TN,108,116,8,0.5178571428571429
38063,RIPLEY,TN,5582,5413,-169,0.49231468849477034
38066,ROSSVILLE,TN,743,1129,386,0.6030982905982906
38067,SAULSBURY,TN,391,240,-151,0.3803486529318542
38068,SOMERVILLE,TN,2620,2971,351,0.5313897335002683
38069,STANTON,TN,385,481,96,0.5554272517321016
38075,TIPTONVILLE,TN,13,20,7,0.6060606060606061
38075,WHITEVILLE,TN,956,1018,62,0.5157041540020263
38076,WILLISTON,TN,23,70,47,0.7526881720430108
38079,TIPTONVILLE,TN,1702,1544,-158,0.47566235366605053
38080,RIDGELY,TN,1037,1146,109,0.5249656436097114
38083,MILLINGTON,TN,116,428,312,0.7867647058823529
38088,CORDOVA,TN,935,1820,885,0.6606170598911071
38101,MEMPHIS,TN,390,1092,702,0.7368421052631579
38103,MEMPHIS,TN,12881,9910,-2971,0.43482076258172087
38104,MEMPHIS,TN,13090,11071,-2019,0.4582177889987997
38105,MEMPHIS,TN,3474,2680,-794,0.4354891127721807
38106,MEMPHIS,TN,8401,7902,-499,0.48469606820830524
38107,MEMPHIS,TN,6927,6308,-619,0.47661503588968646
38108,MEMPHIS,TN,5623,5175,-448,0.4792554176699389
38109,MEMPHIS,TN,13198,13349,151,0.5028440125061212
38111,MEMPHIS,TN,17008,14254,-2754,0.4559529140809929
38112,MEMPHIS,TN,6309,5475,-834,0.4646130346232179
38114,MEMPHIS,TN,9749,8798,-951,0.47436243058176525
38115,HICKORY HILL,TN,391,314,-77,0.4453900709219858
38115,MEMPHIS,TN,20130,14945,-5185,0.4260869565217391
38116,MEMPHIS,TN,15976,13265,-2711,0.4536438562292671
38117,MEMPHIS,TN,8968,8697,-271,0.49232946504387204
38118,MEMPHIS,TN,14065,12261,-1804,0.46573729392995517
38119,MEMPHIS,TN,10965,9926,-1039,0.47513283232013787
38120,MEMPHIS,TN,5519,5247,-272,0.4873676388630875
38122,MEMPHIS,TN,9125,7714,-1411,0.4581032127798563
38125,MEMPHIS,TN,15925,14999,-926,0.4850278101151209
38126,MEMPHIS,TN,2325,2407,82,0.5086644125105664
38127,MEMPHIS,TN,16484,15206,-1278,0.47983591038182394
38128,MEMPHIS,TN,17608,15262,-2346,0.46431396410100395
38130,MEMPHIS,TN,0,34,34,1
38133,BARTLETT,TN,4293,4095,-198,0.48819742489270385
38133,MEMPHIS,TN,2232,2237,5,0.5005594092638174
38134,BARTLETT,TN,4431,3936,-495,0.47041950519899606
38134,MEMPHIS,TN,11185,9107,-2078,0.4487975556869702
38135,BARTLETT,TN,6833,7152,319,0.5114050768680729
38135,MEMPHIS,TN,1327,1383,56,0.5103321033210332
38138,GERMANTOWN,TN,7474,8524,1050,0.5328166020752594
38138,MEMPHIS,TN,193,232,39,0.5458823529411765
38139,GERMANTOWN,TN,2799,3590,791,0.5619032712474565
38141,MEMPHIS,TN,6914,6189,-725,0.472334579867206
38167,MEMPHIS,TN,241,716,475,0.7481713688610241
38168,MEMPHIS,TN,234,1005,771,0.8111380145278451
38173,MEMPHIS,TN,18,127,109,0.8758620689655172
38174,MEMPHIS,TN,75,733,658,0.9071782178217822
38175,MEMPHIS,TN,913,2083,1170,0.695260347129506
38177,MEMPHIS,TN,51,371,320,0.8791469194312796
38181,MEMPHIS,TN,211,1024,813,0.8291497975708502
38183,GERMANTOWN,TN,677,924,247,0.5771392879450343
38184,BARTLETT,TN,139,447,308,0.7627986348122867
38184,MEMPHIS,TN,354,886,532,0.714516129032258
38186,MEMPHIS,TN,51,502,451,0.9077757685352622
38187,MEMPHIS,TN,141,650,509,0.8217446270543616
38190,MEMPHIS,TN,158,579,421,0.7856173677069199
38201,MC KENZIE,TN,3501,3769,268,0.5184319119669876
38220,ATWOOD,TN,659,551,-108,0.4553719008264463
38221,BIG SANDY,TN,1362,1484,122,0.5214335910049192
38222,BUCHANAN,TN,1004,1192,188,0.5428051001821493
38224,COTTAGE GROVE,TN,99,38,-61,0.2773722627737226
38225,DRESDEN,TN,2655,2362,-293,0.470799282439705
38229,GLEASON,TN,1125,1009,-116,0.47282099343955014
38230,GREENFIELD,TN,1498,1376,-122,0.47877522616562285
38231,HENRY,TN,358,385,27,0.5181695827725438
38232,HORNBEAK,TN,655,563,-92,0.46223316912972084
38233,KENTON,TN,1019,881,-138,0.4636842105263158
38236,MANSFIELD,TN,11,11,0,0.5
38237,MARTIN,TN,7463,5724,-1739,0.4340638507621142
38240,OBION,TN,585,549,-36,0.48412698412698413
38241,PALMERSVILLE,TN,82,0,-82,0
38242,PARIS,TN,9493,8859,-634,0.4827266782911944
38251,PURYEAR,TN,1050,962,-88,0.47813121272365805
38253,RIVES,TN,72,100,28,0.5813953488372093
38254,SAMBURG,TN,15,0,-15,0
38255,SHARON,TN,862,687,-175,0.44351194318915427
38256,SPRINGVILLE,TN,1536,1537,1,0.5001627074520013
38257,SOUTH FULTON,TN,1773,1558,-215,0.4677274091864305
38258,TREZEVANT,TN,439,538,99,0.5506653019447287
38259,TRIMBLE,TN,70,48,-22,0.4067796610169492
38260,TROY,TN,1618,1504,-114,0.4817424727738629
38261,UNION CITY,TN,7037,6353,-684,0.4744585511575803
38281,UNION CITY,TN,155,129,-26,0.45422535211267606
38301,JACKSON,TN,14644,13852,-792,0.4861033127456485
38302,JACKSON,TN,448,756,308,0.627906976744186
38303,JACKSON,TN,256,51,-205,0.16612377850162866
38305,JACKSON,TN,20161,19594,-567,0.4928688215318828
38308,JACKSON,TN,1551,817,-734,0.3450168918918919
38310,ADAMSVILLE,TN,2245,2477,232,0.524565861922914
38311,BATH SPRINGS,TN,51,13,-38,0.203125
38313,BEECH BLUFF,TN,713,808,95,0.5312294543063774
38315,BETHEL SPRINGS,TN,1274,1227,-47,0.49060375849660137
38316,BRADFORD,TN,761,905,144,0.5432172869147659
38317,BRUCETON,TN,1014,1014,0,0.5
38320,CAMDEN,TN,5024,4535,-489,0.4744220106705722
38321,CEDAR GROVE,TN,701,818,117,0.5385121790651745
38326,COUNCE,TN,1149,1316,167,0.5338742393509128
38327,CRUMP,TN,22,59,37,0.7283950617283951
38328,DARDEN,TN,71,59,-12,0.45384615384615384
38329,DECATURVILLE,TN,1130,1113,-17,0.49621043245653146
38330,DYER,TN,1468,1324,-144,0.47421203438395415
38332,ENVILLE,TN,73,110,37,0.6010928961748634
38333,EVA,TN,0,25,25,1
38334,FINGER,TN,347,483,136,0.5819277108433735
38337,GADSDEN,TN,214,364,150,0.629757785467128
38340,HENDERSON,TN,4324,4174,-150,0.49117439397505297
38341,CAMDEN,TN,12,21,9,0.6363636363636364
38341,HOLLADAY,TN,988,961,-27,0.4930733709594664
38342,HOLLOW ROCK,TN,280,337,57,0.546191247974068
38343,HUMBOLDT,TN,5724,6027,303,0.5128925197855502
38343,THREE WAY,TN,142,165,23,0.5374592833876222
38344,HUNTINGDON,TN,3234,3516,282,0.5208888888888888
38345,HURON,TN,523,456,-67,0.46578140960163433
38348,LAVINIA,TN,36,35,-1,0.49295774647887325
38351,LEXINGTON,TN,6926,6728,-198,0.49274937747180314
38352,LURAY,TN,11,0,-11,0
38355,MEDINA,TN,2322,2677,355,0.535507101420284
38356,MEDON,TN,483,475,-8,0.49582463465553234
38357,MICHIE,TN,801,860,59,0.5177603853100542
38358,MILAN,TN,4594,4870,276,0.51458157227388
38361,MORRIS CHAPEL,TN,92,113,21,0.551219512195122
38362,OAKFIELD,TN,94,137,43,0.5930735930735931
38363,PARSONS,TN,2284,2351,67,0.50722761596548
38365,PICKWICK DAM,TN,26,0,-26,0
38366,PINSON,TN,514,625,111,0.5487269534679543
38367,RAMER,TN,565,737,172,0.5660522273425499
38368,REAGAN,TN,300,381,81,0.5594713656387665
38369,RUTHERFORD,TN,662,706,44,0.5160818713450293
38370,SALTILLO,TN,86,87,1,0.5028901734104047
38371,SARDIS,TN,110,257,147,0.7002724795640327
38371,SAVANNAH,TN,0,12,12,1
38372,SAVANNAH,TN,8838,7570,-1268,0.4613603120429059
38374,SCOTTS HILL,TN,736,631,-105,0.4615947329919532
38375,SELMER,TN,3405,3474,69,0.5050152638464893
38376,SHILOH,TN,0,13,13,1
38379,STANTONVILLE,TN,84,217,133,0.7209302325581395
38380,SUGAR TREE,TN,29,53,24,0.6463414634146342
38381,TOONE,TN,184,241,57,0.5670588235294117
38382,TRENTON,TN,3781,3448,-333,0.4769677687093651
38388,WILDERSVILLE,TN,239,215,-24,0.473568281938326
38390,YUMA,TN,47,25,-22,0.3472222222222222
38391,DENMARK,TN,117,150,33,0.5617977528089888
38392,MERCER,TN,39,45,6,0.5357142857142857
38401,COLUMBIA,TN,24739,25776,1037,0.5102642779372464
38402,COLUMBIA,TN,646,1141,495,0.6385002797985451
38425,CLIFTON,TN,569,690,121,0.5480540111199365
38449,ARDMORE,TN,1363,1149,-214,0.45740445859872614
38450,COLLINWOOD,TN,634,659,25,0.5096674400618716
38451,CULLEOKA,TN,1527,1747,220,0.5335980452046426
38452,CYPRESS INN,TN,57,24,-33,0.2962962962962963
38453,DELLROSE,TN,11,0,-11,0
38454,DUCK RIVER,TN,83,127,44,0.6047619047619047
38456,ETHRIDGE,TN,2423,1697,-726,0.41189320388349515
38457,FIVE POINTS,TN,11,11,0,0.5
38460,GOODSPRING,TN,244,247,3,0.5030549898167006
38461,HAMPSHIRE,TN,207,337,130,0.6194852941176471
38462,HOHENWALD,TN,4515,4279,-236,0.48658176029110756
38463,IRON CITY,TN,538,594,56,0.5247349823321554
38464,LAWRENCEBURG,TN,9805,9818,13,0.5003312439484279
38468,LEOMA,TN,1521,1709,188,0.5291021671826626
38469,LORETTO,TN,1305,1279,-26,0.494969040247678
38471,LUTTS,TN,0,25,25,1
38472,LYNNVILLE,TN,910,888,-22,0.4938820912124583
38473,MINOR HILL,TN,154,155,1,0.5016181229773463
38474,MOUNT PLEASANT,TN,2510,2512,2,0.5001991238550378
38474,MT PLEASANT,TN,503,514,11,0.5054080629301868
38475,OLIVEHILL,TN,35,48,13,0.5783132530120482
38476,PRIMM SPRINGS,TN,25,40,15,0.6153846153846154
38477,PROSPECT,TN,792,829,37,0.5114127082048119
38478,PULASKI,TN,8605,7521,-1084,0.4663896812600769
38481,SAINT JOSEPH,TN,135,58,-77,0.3005181347150259
38482,SANTA FE,TN,246,275,29,0.527831094049904
38483,SUMMERTOWN,TN,1847,2225,378,0.5464145383104125
38485,WAYNESBORO,TN,2253,2437,184,0.5196162046908316
38486,WESTPOINT,TN,47,107,60,0.6948051948051948
38487,WILLIAMSPORT,TN,129,87,-42,0.4027777777777778
38488,TAFT,TN,596,581,-15,0.49362786745964315
38501,COOKEVILLE,TN,19876,18008,-1868,0.47534579241896313
38502,COOKEVILLE,TN,934,1144,210,0.5505293551491819
38503,COOKEVILLE,TN,156,217,61,0.5817694369973191
38504,ALLARDT,TN,136,169,33,0.5540983606557377
38506,COOKEVILLE,TN,10806,11651,845,0.518813732911787
38541,ALLONS,TN,207,406,199,0.6623164763458401
38543,ALPINE,TN,12,11,-1,0.4782608695652174
38544,BAXTER,TN,2441,2854,413,0.5389990557129367
38545,BLOOMINGTON SPRINGS,TN,226,319,93,0.5853211009174312
38547,BRUSH CREEK,TN,404,509,105,0.5575027382256298
38548,BUFFALO VALLEY,TN,39,27,-12,0.4090909090909091
38549,BYRDSTOWN,TN,1607,1517,-90,0.485595390524968
38551,CELINA,TN,1912,1866,-46,0.4939121228163049
38552,CHESTNUT MOUND,TN,23,12,-11,0.34285714285714286
38553,CLARKRANGE,TN,906,1013,107,0.5278791036998437
38554,CRAWFORD,TN,83,341,258,0.8042452830188679
38555,CROSSVILLE,TN,8768,8919,151,0.5042686719059196
38556,JAMESTOWN,TN,4547,5312,765,0.5387970382391724
38557,CROSSVILLE,TN,1539,1304,-235,0.4586704185719311
38558,CROSSVILLE,TN,5608,6116,508,0.5216649607642443
38559,DOYLE,TN,246,396,150,0.616822429906542
38560,ELMWOOD,TN,325,275,-50,0.4583333333333333
38562,GAINESBORO,TN,2344,2498,154,0.5159025196199918
38563,GORDONSVILLE,TN,1013,916,-97,0.47485743908761013
38564,GRANVILLE,TN,26,24,-2,0.48
38565,GRIMSLEY,TN,252,421,169,0.62555720653789
38567,HICKMAN,TN,38,107,69,0.7379310344827587
38568,HILHAM,TN,823,776,-47,0.48530331457160725
38569,LANCASTER,TN,24,0,-24,0
38570,LIVINGSTON,TN,3574,3703,129,0.5088635426686822
38571,CROSSVILLE,TN,4593,5268,675,0.5342257377547917
38572,CROSSVILLE,TN,4915,5362,447,0.5217475917096429
38573,MONROE,TN,360,556,196,0.6069868995633187
38574,MONTEREY,TN,2859,3306,447,0.5362530413625304
38575,MOSS,TN,0,47,47,1
38577,PALL MALL,TN,25,33,8,0.5689655172413793
38579,QUEBECK,TN,241,154,-87,0.389873417721519
38580,RICKMAN,TN,525,773,248,0.5955315870570108
38581,ROCK ISLAND,TN,1442,1458,16,0.5027586206896552
38582,SILVER POINT,TN,275,447,172,0.6191135734072022
38583,SPARTA,TN,9163,9799,636,0.5167703828710052
38585,SPENCER,TN,1602,1665,63,0.509641873278237
38587,WALLING,TN,304,409,105,0.573632538569425
38588,WHITLEYVILLE,TN,92,312,220,0.7722772277227723
38589,WILDER,TN,14,26,12,0.65
38601,ABBEVILLE,MS,342,318,-24,0.4818181818181818
38603,ASHLAND,MS,663,704,41,0.514996342355523
38606,BATESVILLE,MS,4180,4130,-50,0.4969915764139591
38610,BLUE MOUNTAIN,MS,686,589,-97,0.4619607843137255
38611,BYHALIA,MS,3919,4672,753,0.5438249330694913
38614,CLARKSDALE,MS,6115,5390,-725,0.46849196001738375
38614,STOVALL,MS,105,89,-16,0.4587628865979381
38617,COAHOMA,MS,12,0,-12,0
38618,COLDWATER,MS,2617,2995,378,0.5336778332145403
38619,COMO,MS,954,1064,110,0.5272547076313181
38620,COURTLAND,MS,504,679,175,0.5739644970414202
38621,CRENSHAW,MS,150,191,41,0.5601173020527859
38625,DUMAS,MS,45,72,27,0.6153846153846154
38626,DUNDEE,MS,49,35,-14,0.4166666666666667
38627,ETTA,MS,48,128,80,0.7272727272727273
38629,FALKNER,MS,141,222,81,0.6115702479338843
38631,FRIARS POINT,MS,12,0,-12,0
38632,HERNANDO,MS,7639,9754,2115,0.5608003219686081
38633,HICKORY FLAT,MS,1016,669,-347,0.39703264094955487
38634,HOLLY SPRINGS,MS,12,35,23,0.7446808510638298
38635,HOLLY SPRINGS,MS,2968,3061,93,0.5077127218444186
38637,HORN LAKE,MS,11560,10378,-1182,0.4730604430668247
38641,LAKE CORMORANT,MS,552,553,1,0.5004524886877828
38642,LAMAR,MS,226,369,143,0.6201680672268908
38643,LAMBERT,MS,139,98,-41,0.41350210970464135
38645,LYON,MS,15,34,19,0.6938775510204082
38646,MARKS,MS,691,620,-71,0.47292143401983217
38647,MICHIGAN CITY,MS,11,0,-11,0
38650,MYRTLE,MS,987,1152,165,0.5385694249649369
38651,NESBIT,MS,2097,2933,836,0.5831013916500994
38652,NEW ALBANY,MS,6132,5103,-1029,0.4542056074766355
38654,OLIVE BRANCH,MS,16944,19692,2748,0.5375040943334425
38655,OXFORD,MS,22261,16891,-5370,0.43142112791172865
38658,POPE,MS,452,449,-3,0.4983351831298557
38659,POTTS CAMP,MS,523,585,62,0.5279783393501805
38661,RED BANKS,MS,161,284,123,0.6382022471910113
38663,RIPLEY,MS,3106,2988,-118,0.4903183459140138
38664,ROBINSONVILLE,MS,2027,1542,-485,0.43205379658167553
38665,SARAH,MS,349,545,196,0.6096196868008948
38666,SARDIS,MS,1561,1588,27,0.5042870752619879
38668,SENATOBIA,MS,3679,3871,192,0.5127152317880794
38670,SLEDGE,MS,36,0,-36,0
38671,SOUTHAVEN,MS,17646,16010,-1636,0.47569526978844784
38672,SOUTHAVEN,MS,4434,6339,1905,0.5884154831523253
38673,TAYLOR,MS,51,37,-14,0.42045454545454547
38674,TIPLERSVILLE,MS,36,0,-36,0
38676,TUNICA,MS,1540,1547,7,0.5011337868480725
38680,WALLS,MS,3139,2649,-490,0.4576710435383552
38683,WALNUT,MS,1411,1245,-166,0.46875
38685,WATERFORD,MS,24,47,23,0.6619718309859155
38701,GREENVILLE,MS,7105,6449,-656,0.47580050169691607
38702,GREENVILLE,MS,0,70,70,1
38703,GREENVILLE,MS,4079,3448,-631,0.45808423010495547
38704,GREENVILLE,MS,138,551,413,0.7997097242380261
38721,ANGUILLA,MS,86,88,2,0.5057471264367817
38725,BENOIT,MS,15,0,-15,0
38730,BOYLE,MS,200,109,-91,0.35275080906148865
38732,CLEVELAND,MS,5799,4924,-875,0.4591998507880257
38737,DREW,MS,688,554,-134,0.44605475040257647
38748,HOLLANDALE,MS,531,552,21,0.5096952908587258
38751,INDIANOLA,MS,3124,2835,-289,0.4757509649270012
38753,INVERNESS,MS,25,52,27,0.6753246753246753
38754,ISOLA,MS,112,124,12,0.5254237288135594
38756,LELAND,MS,1844,1711,-133,0.48129395218002813
38759,MERIGOLD,MS,22,76,54,0.7755102040816326
38760,METCALFE,MS,0,12,12,1
38761,MOORHEAD,MS,66,41,-25,0.38317757009345793
38762,MOUND BAYOU,MS,443,366,-77,0.45241038318912236
38769,ROSEDALE,MS,112,43,-69,0.27741935483870966
38771,RULEVILLE,MS,708,631,-77,0.47124719940253923
38773,SHAW,MS,350,230,-120,0.39655172413793105
38774,SHELBY,MS,72,81,9,0.5294117647058824
38778,SUNFLOWER,MS,71,81,10,0.5328947368421053
38801,TUPELO,MS,11145,9479,-1666,0.4596101629169899
38802,TUPELO,MS,133,275,142,0.6740196078431373
38803,TUPELO,MS,311,749,438,0.7066037735849057
38804,TUPELO,MS,6658,5878,-780,0.4688895979578813
38821,AMORY,MS,3626,3763,137,0.5092705372851536
38824,BALDWYN,MS,2023,2164,141,0.5168378313828517
38826,BELDEN,MS,2005,1856,-149,0.4807044807044807
38827,BELMONT,MS,969,1025,56,0.5140421263791374
38828,BLUE SPRINGS,MS,951,1029,78,0.5196969696969697
38828,SHERMAN,MS,62,70,8,0.5303030303030303
38829,BOONEVILLE,MS,5469,5261,-208,0.4903075489282386
38833,BURNSVILLE,MS,715,677,-38,0.4863505747126437
38834,CORINTH,MS,9285,8821,-464,0.4871865679885121
38835,CORINTH,MS,440,494,54,0.5289079229122056
38838,DENNIS,MS,163,83,-80,0.33739837398373984
38841,ECRU,MS,1412,1067,-345,0.43041549011698266
38843,FULTON,MS,3497,3597,100,0.5070482097547223
38846,GLEN,MS,321,369,48,0.5347826086956522
38847,GOLDEN,MS,800,784,-16,0.494949494949495
38848,GREENWOOD SPRINGS,MS,0,14,14,1
38849,GUNTOWN,MS,1616,1574,-42,0.4934169278996865
38850,HOULKA,MS,968,867,-101,0.47247956403269753
38851,HOUSTON,MS,2253,2206,-47,0.4947297600358825
38852,IUKA,MS,3350,3305,-45,0.4966190833959429
38855,MANTACHIE,MS,1311,1379,68,0.5126394052044609
38856,MARIETTA,MS,142,88,-54,0.3826086956521739
38857,MOOREVILLE,MS,1273,1416,143,0.5265898103384158
38858,NETTLETON,MS,2114,1690,-424,0.4442691903259727
38860,OKOLONA,MS,1489,1350,-139,0.4755195491370201
38862,PLANTERSVILLE,MS,542,616,74,0.531951640759931
38863,PONTOTOC,MS,8024,6283,-1741,0.4391556580694765
38864,RANDOLPH,MS,259,150,-109,0.36674816625916873
38865,RIENZI,MS,1013,1117,104,0.5244131455399061
38866,SALTILLO,MS,3985,3897,-88,0.4944176604922608
38868,SHANNON,MS,1628,1252,-376,0.43472222222222223
38870,SMITHVILLE,MS,529,586,57,0.525560538116592
38871,THAXTON,MS,371,333,-38,0.47301136363636365
38873,TISHOMINGO,MS,927,803,-124,0.4641618497109827
38876,TREMONT,MS,115,96,-19,0.4549763033175355
38878,VARDAMAN,MS,395,334,-61,0.45816186556927296
38879,VERONA,MS,106,640,534,0.8579088471849866
38901,GRENADA,MS,6597,5296,-1301,0.445303960312789
38902,GRENADA,MS,92,421,329,0.8206627680311891
38915,BRUCE,MS,967,894,-73,0.48038688876947877
38916,CALHOUN CITY,MS,1172,1155,-17,0.4963472281908036
38917,CARROLLTON,MS,288,442,154,0.6054794520547945
38921,CHARLESTON,MS,630,607,-23,0.49070331447049315
38922,COFFEEVILLE,MS,1086,887,-199,0.44956918398378104
38923,COILA,MS,12,11,-1,0.4782608695652174
38925,DUCK HILL,MS,416,418,2,0.5011990407673861
38927,ENID,MS,25,36,11,0.5901639344262295
38929,GORE SPRINGS,MS,65,62,-3,0.4881889763779528
38930,GREENWOOD,MS,7225,6048,-1177,0.45566186996157615
38935,GREENWOOD,MS,11,206,195,0.9493087557603687
38940,HOLCOMB,MS,292,265,-27,0.4757630161579892
38941,ITTA BENA,MS,1016,770,-246,0.4311310190369541
38946,MORGAN CITY,MS,11,0,-11,0
38948,OAKLAND,MS,221,436,215,0.6636225266362252
38949,PARIS,MS,0,14,14,1
38950,PHILIPP,MS,13,0,-13,0
38953,SCOBEY,MS,11,12,1,0.5217391304347826
38954,SIDON,MS,51,48,-3,0.48484848484848486
38961,TILLATOBA,MS,14,37,23,0.7254901960784313
38963,TUTWILER,MS,54,52,-2,0.49056603773584906
38965,WATER VALLEY,MS,2868,2630,-238,0.4783557657329938
38966,WEBB,MS,0,13,13,1
38967,WINONA,MS,1850,1695,-155,0.4781382228490832
39038,BELZONI,MS,1685,1390,-295,0.45203252032520325
39039,BENTON,MS,223,300,77,0.5736137667304015
39040,BENTONIA,MS,538,519,-19,0.4910122989593188
39041,BOLTON,MS,366,475,109,0.5648038049940547
39042,BRANDON,MS,9868,10820,952,0.5230085073472545
39043,BRANDON,MS,392,653,261,0.6248803827751196
39044,BRAXTON,MS,655,818,163,0.5553292600135777
39045,CAMDEN,MS,26,40,14,0.6060606060606061
39046,CANTON,MS,7286,7951,665,0.5218218809476931
39047,BRANDON,MS,12317,13182,865,0.5169614494686066
39051,CARTHAGE,MS,3382,3497,115,0.5083587730774822
39056,CLINTON,MS,8614,7360,-1254,0.46074871666457995
39057,CONEHATTA,MS,97,157,60,0.6181102362204725
39059,CRYSTAL SPRINGS,MS,2813,2846,33,0.5029157094893091
39060,CLINTON,MS,119,267,148,0.6917098445595855
39062,D LO,MS,12,0,-12,0
39063,DURANT,MS,920,778,-142,0.4581861012956419
39066,EDWARDS,MS,663,808,145,0.549286199864038
39067,ETHEL,MS,95,105,10,0.525
39069,FAYETTE,MS,249,315,66,0.5585106382978723
39071,FLORA,MS,1092,1344,252,0.5517241379310345
39073,FLORENCE,MS,5368,5509,141,0.5064815666084398
39074,FOREST,MS,3365,3121,-244,0.48119025593586184
39078,GEORGETOWN,MS,20,20,0,0.5
39079,GOODMAN,MS,23,93,70,0.8017241379310345
39082,HARRISVILLE,MS,44,34,-10,0.4358974358974359
39083,HAZLEHURST,MS,2174,2056,-118,0.48605200945626476
39086,HERMANVILLE,MS,15,39,24,0.7222222222222222
39090,KOSCIUSKO,MS,3288,3185,-103,0.49204387455584736
39092,LAKE,MS,650,650,0,0.5
39094,LENA,MS,645,735,90,0.532608695652174
39095,LEXINGTON,MS,1495,1435,-60,0.48976109215017066
39096,LORMAN,MS,64,61,-3,0.488
39108,MC COOL,MS,114,110,-4,0.49107142857142855
39110,MADISON,MS,10681,13769,3088,0.5631492842535787
39111,MAGEE,MS,2893,2830,-63,0.4944958937620129
39114,MENDENHALL,MS,2270,2237,-33,0.49633902817838915
39116,MIZE,MS,323,399,76,0.5526315789473685
39117,MORTON,MS,2328,2300,-28,0.4969749351771824
39119,MOUNT OLIVE,MS,993,1125,132,0.5311614730878187
39120,NATCHEZ,MS,7245,6819,-426,0.48485494880546076
39121,NATCHEZ,MS,244,487,243,0.6662106703146374
39122,NATCHEZ,MS,25,55,30,0.6875
39130,MADISON,MS,697,775,78,0.5264945652173914
39140,NEWHEBRON,MS,165,228,63,0.5801526717557252
39145,PELAHATCHIE,MS,1428,1365,-63,0.48872180451127817
39146,PICKENS,MS,214,200,-14,0.4830917874396135
39149,PINOLA,MS,34,38,4,0.5277777777777778
39150,PORT GIBSON,MS,1023,973,-50,0.4874749498997996
39152,PULASKI,MS,22,73,51,0.7684210526315789
39153,RALEIGH,MS,478,600,122,0.5565862708719852
39154,LEARNED,MS,34,40,6,0.5405405405405406
39154,RAYMOND,MS,1717,1922,205,0.5281670788678209
39157,RIDGELAND,MS,11923,10216,-1707,0.4614481232214644
39158,RIDGELAND,MS,894,928,34,0.5093304061470911
39159,ROLLING FORK,MS,546,422,-124,0.4359504132231405
39160,SALLIS,MS,141,278,137,0.6634844868735084
39168,TAYLORSVILLE,MS,1045,1096,51,0.5119103222793088
39169,TCHULA,MS,290,302,12,0.5101351351351351
39170,TERRY,MS,1847,2217,370,0.5455216535433071
39174,TOUGALOO,MS,0,12,12,1
39175,UTICA,MS,769,833,64,0.5199750312109863
39176,VAIDEN,MS,184,257,73,0.5827664399092971
39180,VICKSBURG,MS,9966,8960,-1006,0.47342280460741837
39181,VICKSBURG,MS,0,12,12,1
39182,VICKSBURG,MS,195,353,158,0.6441605839416058
39183,VICKSBURG,MS,4224,4038,-186,0.4887436456063907
39189,WALNUT GROVE,MS,861,739,-122,0.461875
39190,WASHINGTON,MS,15,27,12,0.6428571428571429
39191,WESSON,MS,1556,1639,83,0.5129890453834116
39192,WEST,MS,73,36,-37,0.3302752293577982
39194,YAZOO CITY,MS,4550,4393,-157,0.49122218494912223
39201,JACKSON,MS,563,163,-400,0.22451790633608815
39202,JACKSON,MS,3713,2766,-947,0.4269177342182436
39203,JACKSON,MS,2303,1598,-705,0.40963855421686746
39204,JACKSON,MS,7227,5937,-1290,0.45100273473108476
39205,JACKSON,MS,12,105,93,0.8974358974358975
39206,JACKSON,MS,9648,7581,-2067,0.44001393000174127
39207,JACKSON,MS,0,13,13,1
39208,PEARL,MS,10598,9667,-931,0.4770293609671848
39209,JACKSON,MS,9555,7653,-1902,0.4447350069735007
39211,JACKSON,MS,10610,9361,-1249,0.46872965800410593
39212,BYRAM,MS,239,189,-50,0.441588785046729
39212,JACKSON,MS,10968,8909,-2059,0.4482064697892036
39213,JACKSON,MS,6233,5189,-1044,0.4542987217650149
39215,JACKSON,MS,30,61,31,0.6703296703296703
39216,JACKSON,MS,2591,1806,-785,0.41073459176711397
39218,JACKSON,MS,54,54,0,0.5
39218,RICHLAND,MS,2659,2257,-402,0.45911310008136696
39225,JACKSON,MS,12,0,-12,0
39232,FLOWOOD,MS,4798,4596,-202,0.4892484564615712
39236,JACKSON,MS,408,771,363,0.6539440203562341
39272,BYRAM,MS,4668,4491,-177,0.4903373730756633
39272,JACKSON,MS,102,96,-6,0.48484848484848486
39282,JACKSON,MS,39,645,606,0.9429824561403509
39283,JACKSON,MS,85,58,-27,0.40559440559440557
39284,JACKSON,MS,22,170,148,0.8854166666666666
39286,JACKSON,MS,189,316,127,0.6257425742574257
39288,JACKSON,MS,0,15,15,1
39288,PEARL,MS,163,472,309,0.7433070866141732
39289,JACKSON,MS,31,454,423,0.9360824742268041
39296,JACKSON,MS,139,12,-127,0.07947019867549669
39301,MERIDIAN,MS,7303,6681,-622,0.47776029748283755
39302,MERIDIAN,MS,139,209,70,0.6005747126436781
39303,MERIDIAN,MS,99,274,175,0.7345844504021448
39304,MERIDIAN,MS,102,158,56,0.6076923076923076
39305,MERIDIAN,MS,6446,6347,-99,0.4961306964746346
39307,MERIDIAN,MS,5115,4430,-685,0.464117338920901
39320,BAILEY,MS,122,155,33,0.5595667870036101
39322,BUCKATUNNA,MS,53,139,86,0.7239583333333334
39323,CHUNKY,MS,48,50,2,0.5102040816326531
39325,COLLINSVILLE,MS,1191,1293,102,0.5205314009661836
39327,DECATUR,MS,1051,890,-161,0.4585265327150953
39328,DE KALB,MS,656,687,31,0.5115413253909159
39330,ENTERPRISE,MS,478,424,-54,0.4700665188470067
39332,HICKORY,MS,63,27,-36,0.3
39335,LAUDERDALE,MS,608,601,-7,0.49710504549214224
39336,LAWRENCE,MS,63,81,18,0.5625
39337,LITTLE ROCK,MS,108,126,18,0.5384615384615384
39338,LOUIN,MS,261,374,113,0.5889763779527559
39339,LOUISVILLE,MS,3427,3302,-125,0.4907118442562045
39341,MACON,MS,1269,1212,-57,0.48851269649334944
39342,MARION,MS,735,762,27,0.5090180360721442
39345,NEWTON,MS,1401,1340,-61,0.488872674206494
39346,NOXAPATER,MS,482,347,-135,0.41857659831121835
39347,PACHUTA,MS,36,186,150,0.8378378378378378
39350,PHILADELPHIA,MS,5409,5193,-216,0.4898132427843803
39354,PRESTON,MS,43,89,46,0.6742424242424242
39355,QUITMAN,MS,1919,1689,-230,0.46812638580931265
39359,SEBASTOPOL,MS,11,0,-11,0
39360,SHUBUTA,MS,533,543,10,0.5046468401486989
39360,WAYNESBORO,MS,15,16,1,0.5161290322580645
39361,SHUQUALAK,MS,60,48,-12,0.4444444444444444
39362,STATE LINE,MS,157,257,100,0.6207729468599034
39363,STONEWALL,MS,247,363,116,0.5950819672131148
39364,TOOMSUBA,MS,706,550,-156,0.43789808917197454
39365,UNION,MS,2182,1875,-307,0.46216416070988414
39366,VOSSBURG,MS,53,100,47,0.6535947712418301
39367,WAYNESBORO,MS,3736,3592,-144,0.490174672489083
39401,HATTIESBURG,MS,17776,14364,-3412,0.4469197261978843
39402,HATTIESBURG,MS,17769,15821,-1948,0.47100327478416193
39403,HATTIESBURG,MS,192,416,224,0.6842105263157895
39404,HATTIESBURG,MS,659,1221,562,0.649468085106383
39421,BASSFIELD,MS,267,410,143,0.6056129985228951
39422,BAY SPRINGS,MS,1045,974,-71,0.48241703813769193
39423,BEAUMONT,MS,207,275,68,0.5705394190871369
39425,BROOKLYN,MS,559,328,-231,0.3697857948139797
39426,CARRIERE,MS,4505,5259,754,0.5386112249078246
39427,CARSON,MS,36,99,63,0.7333333333333333
39428,COLLINS,MS,2422,1998,-424,0.45203619909502263
39429,COLUMBIA,MS,4926,4275,-651,0.4646234104988588
39437,ELLISVILLE,MS,3338,3308,-30,0.49774300331026183
39439,HEIDELBERG,MS,832,856,24,0.5071090047393365
39440,LAUREL,MS,7411,5954,-1457,0.44549195660306773
39441,LAUREL,MS,202,763,561,0.7906735751295336
39442,LAUREL,MS,11,72,61,0.8674698795180723
39443,LAUREL,MS,5157,4896,-261,0.4870188003581021
39451,LEAKESVILLE,MS,1166,1158,-8,0.49827882960413084
39452,LUCEDALE,MS,7981,7599,-382,0.4877406931964057
39455,LUMBERTON,MS,2869,2873,4,0.5003483106931382
39456,MC LAIN,MS,48,111,63,0.6981132075471698
39459,MOSELLE,MS,834,915,81,0.5231560891938251
39462,NEW AUGUSTA,MS,16,34,18,0.68
39463,NICHOLSON,MS,26,13,-13,0.3333333333333333
39464,OVETT,MS,303,349,46,0.5352760736196319
39465,PETAL,MS,7947,7421,-526,0.48288651743883393
39466,PICAYUNE,MS,10621,9509,-1112,0.47237953303527075
39470,POPLARVILLE,MS,3816,3718,-98,0.49349615078311654
39474,PRENTISS,MS,1206,1270,64,0.5129240710823909
39475,PURVIS,MS,4286,4202,-84,0.49505183788878415
39476,RICHTON,MS,1407,1521,114,0.5194672131147541
39477,SANDERSVILLE,MS,34,0,-34,0
39478,SANDY HOOK,MS,147,250,103,0.6297229219143576
39479,SEMINARY,MS,1347,1422,75,0.5135427952329361
39480,SOSO,MS,270,315,45,0.5384615384615384
39481,STRINGER,MS,43,71,28,0.6228070175438597
39482,SUMRALL,MS,2864,3211,347,0.528559670781893
39483,FOXWORTH,MS,1421,1464,43,0.5074523396880416
39483,MORGANTOWN,MS,23,33,10,0.5892857142857143
39501,GULFPORT,MS,11741,10687,-1054,0.4765025860531478
39502,BAY ST LOUIS,MS,0,23,23,1
39502,GULFPORT,MS,295,661,366,0.6914225941422594
39503,GULFPORT,MS,21052,22066,1014,0.5117584303539126
39505,GULFPORT,MS,781,1321,540,0.6284490960989534
39506,GULFPORT,MS,430,873,443,0.6699923254029163
39507,GULFPORT,MS,9522,8504,-1018,0.47176300898701873
39520,BAY SAINT LOUIS,MS,5493,5487,-6,0.4997267759562842
39520,BAY ST LOUIS,MS,464,476,12,0.5063829787234042
39520,PERKINSTON,MS,167,163,-4,0.49393939393939396
39521,BAY SAINT LOUIS,MS,468,940,472,0.6676136363636364
39521,BAY ST LOUIS,MS,29,61,32,0.6777777777777778
39525,DIAMONDHEAD,MS,3732,4256,524,0.5327991987981973
39530,BILOXI,MS,4712,3675,-1037,0.4381781328246095
39531,BILOXI,MS,15874,10881,-4993,0.4066903382545319
39532,BILOXI,MS,14836,14705,-131,0.49778274262888866
39533,BILOXI,MS,280,264,-16,0.4852941176470588
39534,BILOXI,MS,538,232,-306,0.3012987012987013
39534,KEESLER AFB,MS,590,213,-377,0.26525529265255293
39535,BILOXI,MS,377,754,377,0.6666666666666666
39540,DIBERVILLE,MS,6428,6393,-35,0.49863505186802903
39552,ESCATAWPA,MS,0,12,12,1
39553,GAUTIER,MS,7525,7405,-120,0.4959812458137977
39555,HURLEY,MS,96,14,-82,0.12727272727272726
39556,KILN,MS,2279,2427,148,0.5157246068848279
39560,LONG BEACH,MS,10835,8547,-2288,0.4409761634506243
39561,MC HENRY,MS,505,758,253,0.6001583531274742
39562,MOSS POINT,MS,4460,4155,-305,0.4822983168891468
39563,MOSS POINT,MS,4029,3743,-286,0.48160061760164696
39563,PASCAGOULA,MS,62,81,19,0.5664335664335665
39564,OCEAN SPRINGS,MS,16012,17086,1074,0.5162245452897456
39565,OCEAN SPRINGS,MS,400,484,84,0.5475113122171946
39565,VANCLEAVE,MS,4385,5050,665,0.5352411234764176
39566,OCEAN SPRINGS,MS,615,731,116,0.5430906389301634
39567,PASCAGOULA,MS,3865,3525,-340,0.4769959404600812
39568,PASCAGOULA,MS,168,351,183,0.6763005780346821
39571,PASS CHRISTIAN,MS,4887,5120,233,0.5116418507045069
39571,PASS CHRISTIN,MS,131,130,-1,0.49808429118773945
39572,PEARLINGTON,MS,59,68,9,0.5354330708661418
39573,PERKINSTON,MS,2755,2754,-1,0.49990923942639315
39574,SAUCIER,MS,4361,4267,-94,0.4945526193787668
39576,WAVELAND,MS,2660,2515,-145,0.4859903381642512
39577,WIGGINS,MS,4558,3624,-934,0.442923490589098
39581,PASCAGOULA,MS,5570,4637,-933,0.45429607132360145
39601,BROOKHAVEN,MS,6120,5736,-384,0.48380566801619435
39602,BROOKHAVEN,MS,15,34,19,0.6938775510204082
39603,BROOKHAVEN,MS,114,123,9,0.5189873417721519
39629,BOGUE CHITTO,MS,1491,1525,34,0.5056366047745358
39630,BUDE,MS,49,35,-14,0.4166666666666667
39631,CENTREVILLE,MS,194,223,29,0.5347721822541966
39638,GLOSTER,MS,352,468,116,0.5707317073170731
39641,JAYESS,MS,928,885,-43,0.4881412024269167
39643,KOKOMO,MS,59,47,-12,0.44339622641509435
39645,BERWICK,MS,12,19,7,0.6129032258064516
39645,LIBERTY,MS,1121,1099,-22,0.49504504504504504
39647,MC CALL CREEK,MS,12,0,-12,0
39648,MCCOMB,MS,7756,6094,-1662,0.44
39649,MCCOMB,MS,488,361,-127,0.425206124852768
39652,MAGNOLIA,MS,1982,2017,35,0.5043760940235059
39653,MEADVILLE,MS,305,348,43,0.5329249617151608
39654,MONTICELLO,MS,1462,1418,-44,0.49236111111111114
39656,OAK VALE,MS,11,23,12,0.6764705882352942
39657,OSYKA,MS,288,303,15,0.5126903553299492
39661,ROXIE,MS,252,293,41,0.5376146788990825
39662,RUTH,MS,38,22,-16,0.36666666666666664
39663,SILVER CREEK,MS,326,467,141,0.5889029003783102
39664,SMITHDALE,MS,211,169,-42,0.44473684210526315
39665,SONTAG,MS,13,23,10,0.6388888888888888
39666,SUMMIT,MS,3240,2895,-345,0.4718826405867971
39667,TYLERTOWN,MS,2545,2723,178,0.5168944570994685
39669,WOODVILLE,MS,566,590,24,0.5103806228373703
39701,COLUMBUS,MS,5188,4264,-924,0.4511214557765552
39702,COLUMBUS,MS,6169,6039,-130,0.494675622542595
39703,COLUMBUS,MS,22,67,45,0.7528089887640449
39704,COLUMBUS,MS,12,93,81,0.8857142857142857
39705,COLUMBUS,MS,7121,6281,-840,0.46866139382181765
39730,ABERDEEN,MS,2585,2635,50,0.5047892720306514
39735,ACKERMAN,MS,1111,1042,-69,0.4839758476544357
39739,BROOKSVILLE,MS,161,283,122,0.6373873873873874
39740,CALEDONIA,MS,1809,1774,-35,0.4951158247278817
39741,CEDARBLUFF,MS,24,53,29,0.6883116883116883
39743,CRAWFORD,MS,0,75,75,1
39744,EUPORA,MS,1491,1659,168,0.5266666666666666
39746,HAMILTON,MS,703,656,-47,0.48270787343635024
39747,KILMICHAEL,MS,89,147,58,0.6228813559322034
39750,MABEN,MS,394,560,166,0.5870020964360587
39751,MANTEE,MS,34,37,3,0.5211267605633803
39752,MATHISTON,MS,535,462,-73,0.4633901705115346
39755,PHEBA,MS,24,22,-2,0.4782608695652174
39756,PRAIRIE,MS,91,112,21,0.5517241379310345
39759,STARKVILLE,MS,16814,14167,-2647,0.45728026855169296
39760,STARKVILLE,MS,741,491,-250,0.398538961038961
39762,MISSISSIPPI STATE,MS,3916,199,-3717,0.04835965978128797
39762,MS STATE,MS,447,0,-447,0
39766,STEENS,MS,638,764,126,0.5449358059914408
39769,STURGIS,MS,109,103,-6,0.4858490566037736
39772,WEIR,MS,218,181,-37,0.45363408521303256
39773,WEST POINT,MS,4629,4332,-297,0.48342818881821226
39776,WOODLAND,MS,90,94,4,0.5108695652173914
39813,ARLINGTON,GA,180,230,50,0.5609756097560976
39815,ATTAPULGUS,GA,52,100,48,0.6578947368421053
39817,BAINBRIDGE,GA,4091,3523,-568,0.4627002889414237
39818,BAINBRIDGE,GA,374,750,376,0.6672597864768683
39819,BAINBRIDGE,GA,3901,3654,-247,0.48365320979483784
39823,BLAKELY,GA,2688,2437,-251,0.4755121951219512
39825,BRINSON,GA,354,356,2,0.5014084507042254
39826,BRONWOOD,GA,11,15,4,0.5769230769230769
39827,CAIRO,GA,1173,1129,-44,0.49044309296264116
39828,CAIRO,GA,5073,4478,-595,0.46885142916972045
39834,CLIMAX,GA,500,484,-16,0.491869918699187
39837,COLQUITT,GA,1828,1845,17,0.5023141845902532
39840,CUTHBERT,GA,1450,1360,-90,0.48398576512455516
39841,DAMASCUS,GA,22,0,-22,0
39842,DAWSON,GA,2970,2434,-536,0.45040710584752036
39845,DONALSONVILLE,GA,2884,2702,-182,0.48370927318295737
39846,EDISON,GA,231,247,16,0.5167364016736402
39851,FORT GAINES,GA,514,562,48,0.5223048327137546
39854,GEORGETOWN,GA,581,756,175,0.5654450261780105
39859,IRON CITY,GA,35,48,13,0.5783132530120482
39861,JAKIN,GA,67,39,-28,0.36792452830188677
39862,LEARY,GA,29,40,11,0.5797101449275363
39870,NEWTON,GA,371,344,-27,0.4811188811188811
39877,PARROTT,GA,12,0,-12,0
39886,SHELLMAN,GA,34,91,57,0.728
39897,WHIGHAM,GA,919,945,26,0.5069742489270386
40003,BAGDAD,KY,614,574,-40,0.4831649831649832
40004,BARDSTOWN,KY,12606,11750,-856,0.4824273279684677
40006,BEDFORD,KY,2129,2011,-118,0.4857487922705314
40008,BLOOMFIELD,KY,1442,1395,-47,0.4917166020444131
40009,BRADFORDSVILLE,KY,52,11,-41,0.1746031746031746
40010,BUCKNER,KY,38,98,60,0.7205882352941176
40011,CAMPBELLSBURG,KY,662,631,-31,0.4880123743232792
40011,TURNERS STATION,KY,20,19,-1,0.48717948717948717
40012,CHAPLIN,KY,0,23,23,1
40013,COXS CREEK,KY,1559,1769,210,0.5315504807692307
40014,CRESTWOOD,KY,5898,6386,488,0.5198632367307066
40014,ORCHARD GRASS HILLS,KY,105,108,3,0.5070422535211268
40019,EMINENCE,KY,1735,1603,-132,0.48022768124625526
40022,FINCHVILLE,KY,11,99,88,0.9
40023,FISHERVILLE,KY,1424,2018,594,0.5862870424171993
40025,GLENVIEW,KY,0,16,16,1
40026,GOSHEN,KY,1652,1703,51,0.5076005961251863
40027,HARRODS CREEK,KY,0,11,11,1
40031,LA GRANGE,KY,5471,5174,-297,0.4860497886331611
40031,LAGRANGE,KY,2189,2183,-6,0.4993138151875572
40033,LEBANON,KY,5645,4913,-732,0.4653343436256867
40037,LORETTO,KY,703,699,-4,0.4985734664764622
40040,MACKVILLE,KY,13,22,9,0.6285714285714286
40041,MASONIC HOME,KY,84,118,34,0.5841584158415841
40045,MILTON,KY,1355,1311,-44,0.49174793698424607
40046,MOUNT EDEN,KY,141,302,161,0.6817155756207675
40047,MOUNT WASHINGTON,KY,5856,5927,71,0.5030128150725621
40047,MT WASHINGTON,KY,2168,2250,82,0.5092802172928927
40050,NEW CASTLE,KY,767,667,-100,0.46513249651324967
40051,NEW HAVEN,KY,1409,1351,-58,0.4894927536231884
40055,PENDLETON,KY,358,485,127,0.575326215895611
40056,PEWEE VALLEY,KY,1056,1119,63,0.5144827586206897
40057,DEFOE,KY,24,22,-2,0.4782608695652174
40057,PLEASUREVILLE,KY,1274,1129,-145,0.4698293799417395
40059,PROSPECT,KY,7140,8348,1208,0.5389979338842975
40060,RAYWICK,KY,58,73,15,0.5572519083969466
40065,SHELBYVILLE,KY,12755,12271,-484,0.4903300567409894
40066,SHELBYVILLE,KY,218,448,230,0.6726726726726727
40067,SIMPSONVILLE,KY,1754,2102,348,0.5451244813278008
40068,SMITHFIELD,KY,793,923,130,0.5378787878787878
40069,SPRINGFIELD,KY,3316,3092,-224,0.48252184769038703
40070,SULPHUR,KY,22,11,-11,0.3333333333333333
40071,TAYLORSVILLE,KY,4210,4889,679,0.5373117925046709
40075,TURNERS STATION,KY,71,75,4,0.5136986301369864
40076,WADDY,KY,676,723,47,0.5167977126518942
40077,WESTPORT,KY,0,24,24,1
40078,WILLISBURG,KY,826,846,20,0.5059808612440191
40104,BATTLETOWN,KY,178,147,-31,0.4523076923076923
40107,BOSTON,KY,416,466,50,0.528344671201814
40108,BRANDENBURG,KY,5111,4966,-145,0.49280539843207305
40109,BROOKS,KY,753,767,14,0.5046052631578948
40111,CLOVERPORT,KY,476,433,-43,0.47634763476347636
40115,CUSTER,KY,25,40,15,0.6153846153846154
40117,EKRON,KY,962,973,11,0.5028423772609819
40118,FAIRDALE,KY,4396,3726,-670,0.4587540014774686
40119,FALLS OF ROUGH,KY,667,825,158,0.5529490616621984
40121,FORT KNOX,KY,7573,5274,-2299,0.4105238577099712
40129,HILLVIEW,KY,141,84,-57,0.37333333333333335
40140,GARFIELD,KY,70,47,-23,0.4017094017094017
40142,GUSTON,KY,565,665,100,0.540650406504065
40143,HARDINSBURG,KY,2064,1972,-92,0.4886025768087215
40144,HARNED,KY,394,348,-46,0.46900269541778977
40145,HUDSON,KY,45,46,1,0.5054945054945055
40146,IRVINGTON,KY,1673,1714,41,0.5060525538824919
40150,LEBANON JCT,KY,155,140,-15,0.4745762711864407
40150,LEBANON JUNCTION,KY,1262,1256,-6,0.4988085782366958
40152,MC DANIELS,KY,75,130,55,0.6341463414634146
40155,MULDRAUGH,KY,1172,931,-241,0.4427009034712316
40157,PAYNEVILLE,KY,166,97,-69,0.3688212927756654
40159,RADCLIFF,KY,114,90,-24,0.4411764705882353
40160,RADCLIFF,KY,16476,12947,-3529,0.44002990857492436
40162,RINEYVILLE,KY,2087,2126,39,0.5046285307381914
40165,SHEPHERDSVILLE,KY,14301,13446,-855,0.48459292896529355
40175,BIG SPRING,KY,132,151,19,0.5335689045936396
40175,VINE GROVE,KY,6270,6703,433,0.516688506898944
40176,WEBSTER,KY,101,137,36,0.5756302521008403
40177,WEST POINT,KY,647,653,6,0.5023076923076923
40178,WESTVIEW,KY,16,12,-4,0.42857142857142855
40201,LOUISVILLE,KY,615,1122,507,0.6459412780656304
40201,ROANOKE APTS,KY,13,20,7,0.6060606060606061
40202,LOUISVILLE,KY,5504,5094,-410,0.48065672768446877
40203,LOUISVILLE,KY,10911,8963,-1948,0.4509912448425078
40204,LOUISVILLE,KY,10696,8211,-2485,0.4342835986671603
40205,LOUISVILLE,KY,9011,8077,-934,0.47267088014981273
40206,LOUISVILLE,KY,12076,10211,-1865,0.45815946515906136
40207,LOUISVILLE,KY,14633,13584,-1049,0.4814119148031329
40208,LOUISVILLE,KY,7253,5442,-1811,0.428672705789681
40209,LOUISVILLE,KY,713,704,-9,0.49682427664079043
40210,LOUISVILLE,KY,6154,5349,-805,0.46500912805355127
40211,LOUISVILLE,KY,9850,8564,-1286,0.4650809166938199
40212,LOU,KY,361,294,-67,0.4488549618320611
40212,LOUISVILLE,KY,7276,6182,-1094,0.45935503046515086
40213,AUDUBON PARK,KY,165,118,-47,0.4169611307420495
40213,LOUISVILLE,KY,7343,6157,-1186,0.4560740740740741
40214,LOUISVILLE,KY,23467,18439,-5028,0.4400085906552761
40215,LOUISVILLE,KY,11253,9138,-2115,0.4481388848021186
40216,LOUISVILLE,KY,16894,16115,-779,0.4882001878275622
40217,LOUISVILLE,KY,6815,5546,-1269,0.44866920152091255
40218,LOUISVILLE,KY,20662,14951,-5711,0.4198186055653834
40219,LOUISVILLE,KY,19344,17268,-2076,0.4716486397902327
40220,LOUISVILLE,KY,16585,14307,-2278,0.46312961284474946
40221,LOUISVILLE,KY,308,201,-107,0.3948919449901768
40222,LOUISVILLE,KY,13141,11803,-1338,0.4731799230275818
40223,ANCHORAGE,KY,255,256,1,0.5009784735812133
40223,LOUISVILLE,KY,11102,11111,9,0.50020258407239
40228,LOUISVILLE,KY,7287,7781,494,0.5163923546588798
40229,LOUISVILLE,KY,16327,16221,-106,0.498371635737987
40232,LOUISVILLE,KY,292,756,464,0.7213740458015268
40233,LOUISVILLE,KY,64,0,-64,0
40241,LOUISVILLE,KY,14468,13889,-579,0.4897908805585922
40242,LOUISVILLE,KY,4289,4202,-87,0.49487692851254267
40242,ROLLING HILLS,KY,69,73,4,0.5140845070422535
40243,DOUGLASS HILLS,KY,101,125,24,0.5530973451327433
40243,DOUGLASS HLS,KY,120,132,12,0.5238095238095238
40243,LOUISVILLE,KY,4946,5123,177,0.5087893534611183
40243,MIDDLETOWN,KY,295,338,43,0.5339652448657188
40245,LOUISVILLE,KY,14575,16285,1710,0.5277057679844459
40250,LOUISVILLE,KY,568,289,-279,0.3372228704784131
40251,LOUISVILLE,KY,11,189,178,0.945
40251,MACDANLE,KY,11,0,-11,0
40251,SOMERSET,KY,0,14,14,1
40252,LOUISVILLE,KY,690,269,-421,0.2805005213764338
40253,LOUISVILLE,KY,239,625,386,0.7233796296296297
40253,MIDDLETOWN,KY,11,31,20,0.7380952380952381
40255,LOUISVILLE,KY,0,11,11,1
40256,LOUISVILLE,KY,487,652,165,0.57243195785777
40256,SHIVELY,KY,12,14,2,0.5384615384615384
40257,LOUISVILLE,KY,40,169,129,0.8086124401913876
40258,LOUISVILLE,KY,12362,9881,-2481,0.44422964528166164
40259,LOUISVILLE,KY,349,879,530,0.7157980456026058
40259,OKOLONA,KY,0,64,64,1
40268,LOUISVILLE,KY,236,683,447,0.7431991294885746
40268,PLEASURE RIDGE PARK,KY,0,21,21,1
40269,JEFFERSONTOWN,KY,11,27,16,0.7105263157894737
40269,LOUISVILLE,KY,69,338,269,0.8304668304668305
40270,LOUISVILLE,KY,0,33,33,1
40272,LOUISVILLE,KY,14756,13873,-883,0.48457857417304134
40291,LOUISVILLE,KY,16207,16017,-190,0.4970518867924528
40299,LOUISVILLE,KY,16467,17082,615,0.5091656979343646
40310,BURGIN,KY,26,38,12,0.59375
40311,CARLISLE,KY,2280,2429,149,0.5158207687407093
40312,CLAY CITY,KY,2571,2629,58,0.505576923076923
40313,CLEARFIELD,KY,1633,1516,-117,0.48142267386471893
40322,FRENCHBURG,KY,1102,1127,25,0.5056078959174518
40324,GEORGETOWN,KY,22327,22973,646,0.507130242825607
40328,GRAVEL SWITCH,KY,50,143,93,0.7409326424870466
40330,HARRODSBURG,KY,8877,8478,-399,0.488504753673293
40336,IRVINE,KY,3996,4077,81,0.5050167224080268
40337,JEFFERSONVILLE,KY,2275,2152,-123,0.4861079737971538
40340,NICHOLASVILLE,KY,144,266,122,0.6487804878048781
40342,LAWRENCEBURG,KY,8792,8521,-271,0.49217351123433256
40346,MEANS,KY,25,23,-2,0.4791666666666667
40347,MIDWAY,KY,1005,954,-51,0.4869831546707504
40348,MILLERSBURG,KY,41,72,31,0.6371681415929203
40351,MOREHEAD,KY,9126,8354,-772,0.47791762013729977
40353,MOUNT STERLING,KY,9814,9146,-668,0.48238396624472574
40353,MT STERLING,KY,214,220,6,0.5069124423963134
40355,NEW LIBERTY,KY,0,11,11,1
40356,NICHOLASVILLE,KY,18015,18524,509,0.506965160513424
40358,OLYMPIA,KY,11,34,23,0.7555555555555555
40359,GRATZ,KY,46,58,12,0.5576923076923077
40359,OWENTON,KY,2365,2405,40,0.5041928721174004
40360,OWINGSVILLE,KY,2468,2514,46,0.504616619831393
40361,PARIS,KY,7020,6806,-214,0.4922609576160856
40362,PARIS,KY,70,159,89,0.6943231441048034
40363,PERRY PARK,KY,0,12,12,1
40370,SADIEVILLE,KY,749,856,107,0.5333333333333333
40371,SALT LICK,KY,1042,1156,114,0.5259326660600546
40372,SALVISA,KY,592,689,97,0.5378610460577674
40374,SHARPSBURG,KY,344,439,95,0.5606641123882503
40379,STAMPING GRD,KY,32,86,54,0.7288135593220338
40379,STAMPING GROUND,KY,933,1082,149,0.5369727047146402
40380,PATSEY,KY,46,51,5,0.5257731958762887
40380,STANTON,KY,2617,2581,-36,0.49653712966525587
40383,VERSAILLES,KY,8724,8896,172,0.5048808172531215
40385,WACO,KY,931,975,44,0.5115424973767051
40387,WELLINGTON,KY,626,718,92,0.5342261904761905
40390,WILMORE,KY,2450,2380,-70,0.4927536231884058
40391,WINCHESTER,KY,15178,15018,-160,0.49735064246920124
40392,WINCHESTER,KY,359,345,-14,0.4900568181818182
40402,ANNVILLE,KY,447,616,169,0.5794920037629351
40403,BEREA,KY,11338,11256,-82,0.4981853589448526
40409,BRODHEAD,KY,1102,1184,82,0.5179352580927384
40419,CRAB ORCHARD,KY,1607,1506,-101,0.48377770639254736
40422,DANVILLE,KY,10949,10111,-838,0.4801044634377968
40423,DANVILLE,KY,746,393,-353,0.34503950834064967
40437,HUSTONVILLE,KY,1500,1417,-83,0.48577305450805625
40440,JUNCTION CITY,KY,951,947,-4,0.49894625922023184
40442,KINGS MOUNTAIN,KY,130,138,8,0.5149253731343284
40444,LANCASTER,KY,6467,5931,-536,0.4783836102597193
40445,LIVINGSTON,KY,0,26,26,1
40447,MC KEE,KY,1610,1659,49,0.5074946466809421
40447,MCKEE,KY,347,331,-16,0.4882005899705015
40456,MOUNT VERNON,KY,3068,2984,-84,0.4930601454064772
40460,ORLANDO,KY,11,11,0,0.5
40461,PAINT LICK,KY,554,655,101,0.5417700578990902
40464,PARKSVILLE,KY,137,116,-21,0.45849802371541504
40468,PERRYVILLE,KY,484,654,170,0.5746924428822495
40472,RAVENNA,KY,64,118,54,0.6483516483516484
40475,RICHMOND,KY,29346,28468,-878,0.4924066835022659
40476,RICHMOND,KY,856,827,-29,0.49138443256090314
40484,STANFORD,KY,4401,4475,74,0.5041685443893645
40486,TYNER,KY,238,278,40,0.5387596899224806
40489,WAYNESBURG,KY,1000,1091,91,0.5217599234815877
40502,LEXINGTON,KY,13811,12396,-1415,0.47300339603922614
40503,LEXINGTON,KY,13267,11104,-2163,0.4556234869311887
40504,LEXINGTON,KY,14418,11774,-2644,0.44952657299938914
40505,LEXINGTON,KY,12978,11182,-1796,0.46283112582781455
40507,LEXINGTON,KY,2789,2679,-110,0.4899414776883687
40508,LEXINGTON,KY,14257,9626,-4631,0.40304819327555164
40509,LEXINGTON,KY,22465,22101,-364,0.4959161692770273
40510,LEXINGTON,KY,103,68,-35,0.39766081871345027
40511,LEXINGTON,KY,16797,17694,897,0.5130033921892667
40512,LEXINGTON,KY,0,598,598,1
40513,LEXINGTON,KY,3643,3721,78,0.5052960347637153
40514,LEXINGTON,KY,5579,5549,-30,0.49865204888569375
40515,LEXINGTON,KY,16780,15755,-1025,0.48424773321038883
40516,LEXINGTON,KY,949,1093,144,0.5352595494613125
40517,LEXINGTON,KY,25471,20972,-4499,0.45156428309971364
40522,LEXINGTON,KY,92,36,-56,0.28125
40523,LEXINGTON,KY,389,188,-201,0.32582322357019067
40526,LEXINGTON,KY,0,13,13,1
40544,LEXINGTON,KY,46,0,-46,0
40555,LEXINGTON,KY,473,656,183,0.5810451727192205
40582,LEXINGTON,KY,0,13,13,1
40583,LEXINGTON,KY,12,294,282,0.9607843137254902
40588,LEXINGTON,KY,462,540,78,0.5389221556886228
40591,LEXINGTON,KY,92,263,171,0.7408450704225352
40601,FRANKFORT,KY,22845,22917,72,0.5007866789038941
40602,FRANKFORT,KY,456,636,180,0.5824175824175825
40604,FRANKFORT,KY,23,23,0,0.5
40621,FRANKFORT,KY,0,432,432,1
40621,LOUISVILLE,KY,0,53,53,1
40701,CORBIN,KY,10911,10360,-551,0.4870480936486296
40702,CORBIN,KY,633,1137,504,0.6423728813559322
40729,E BERNSTADT,KY,84,84,0,0.5
40729,EAST BERNSTADT,KY,1484,1635,151,0.5242064764347547
40734,GRAY,KY,1019,1173,154,0.5351277372262774
40737,KEAVY,KY,199,215,16,0.5193236714975845
40740,LILY,KY,980,995,15,0.5037974683544304
40741,LONDON,KY,6890,6797,-93,0.49660261562066194
40742,LONDON,KY,12,43,31,0.7818181818181819
40743,LONDON,KY,1237,933,-304,0.42995391705069125
40744,LONDON,KY,6083,5987,-96,0.496023198011599
40759,MEADOW CREEK,KY,11,13,2,0.5416666666666666
40759,ROCKHOLDS,KY,487,525,38,0.5187747035573123
40769,WILLIAMSBURG,KY,4954,4699,-255,0.48679167098311404
40771,WOODBINE,KY,126,320,194,0.7174887892376681
40806,BAXTER,KY,277,240,-37,0.46421663442940037
40807,BENHAM,KY,0,11,11,1
40813,CALVIN,KY,0,12,12,1
40815,CAWOOD,KY,38,23,-15,0.3770491803278688
40823,CUMBERLAND,KY,1070,969,-101,0.47523295733202553
40826,EOLIA,KY,0,12,12,1
40828,EVARTS,KY,660,679,19,0.5070948469006722
40829,GRAYS KNOB,KY,11,0,-11,0
40831,HARLAN,KY,1616,1481,-135,0.4782047142395867
40854,LOYALL,KY,61,50,-11,0.45045045045045046
40855,LYNCH,KY,0,22,22,1
40868,STINNETT,KY,12,0,-12,0
40873,WALLINS CREEK,KY,150,246,96,0.6212121212121212
40903,ARTEMUS,KY,0,11,11,1
40906,BARBOURVILLE,KY,2692,2590,-102,0.49034456645210145
40906,WOOLLUM,KY,103,105,2,0.5048076923076923
40915,BIMBLE,KY,43,12,-31,0.21818181818181817
40923,CANNON,KY,0,26,26,1
40935,FLAT LICK,KY,312,492,180,0.6119402985074627
40940,FRAKES,KY,0,13,13,1
40943,GIRDLER,KY,29,0,-29,0
40949,HEIDRICK,KY,22,0,-22,0
40962,MANCHESTER,KY,3460,3387,-73,0.49466919818898786
40965,MIDDLESBORO,KY,4860,4374,-486,0.47368421052631576
40972,ONEIDA,KY,56,27,-29,0.3253012048192771
40977,E PINEVILLE,KY,73,54,-19,0.4251968503937008
40977,PINEVILLE,KY,1701,1773,72,0.5103626943005182
41001,ALEXANDRIA,KY,5090,6114,1024,0.5456979650124956
41002,AUGUSTA,KY,1152,910,-242,0.44131910766246363
41003,BERRY,KY,681,728,47,0.5166784953867991
41004,BROOKSVILLE,KY,1412,1297,-115,0.47877445551864156
41005,BURLINGTON,KY,8546,8385,-161,0.49524540783178783
41006,BUTLER,KY,1290,1198,-92,0.4815112540192926
41007,CALIFORNIA,KY,730,884,154,0.5477075588599752
41008,CARROLLTON,KY,4143,3664,-479,0.4693224029716921
41010,CORINTH,KY,1010,1094,84,0.5199619771863118
41011,COVINGTON,KY,13538,12310,-1228,0.47624574435159395
41011,FT WRIGHT,KY,279,259,-20,0.48141263940520446
41012,COVINGTON,KY,112,362,250,0.7637130801687764
41012,FLORENCE,KY,0,11,11,1
41014,COVINGTON,KY,3530,2901,-629,0.4510962525268232
41015,COVINGTON,KY,5550,5506,-44,0.49801013024602026
41015,LATONIA,KY,705,711,6,0.5021186440677966
41015,RYLAND HGHT,KY,162,191,29,0.5410764872521246
41015,TAYLOR MILL,KY,915,883,-32,0.4911012235817575
41016,BROMLEY,KY,450,333,-117,0.42528735632183906
41016,COVINGTON,KY,472,411,-61,0.4654586636466591
41016,LUDLOW,KY,1446,1403,-43,0.49245349245349246
41017,COVINGTON,KY,320,310,-10,0.49206349206349204
41017,CRESCENT PARK,KY,260,281,21,0.5194085027726433
41017,CRESCENT SPGS,KY,1124,1223,99,0.5210907541542394
41017,CRESCENT SPRINGS,KY,1878,1983,105,0.5135975135975136
41017,CRESTVIEW HILLS,KY,278,276,-2,0.4981949458483754
41017,EDGEWOOD,KY,3893,3850,-43,0.49722329846312796
41017,FORT MITCHELL,KY,326,366,40,0.5289017341040463
41017,FT MITCHELL,KY,3779,3850,71,0.5046532966312754
41017,FT WRIGHT,KY,287,267,-20,0.48194945848375453
41017,VILLA HILLS,KY,1530,1385,-145,0.4751286449399657
41018,ELSMERE,KY,2942,2809,-133,0.48843679360111286
41018,ERLANGER,KY,8673,8285,-388,0.48855997169477533
41022,FLORENCE,KY,556,895,339,0.616815988973122
41030,CRITTENDEN,KY,3575,2502,-1073,0.41171630738851406
41031,CYNTHIANA,KY,6554,6374,-180,0.49303836633663367
41033,DE MOSSVILLE,KY,220,275,55,0.5555555555555556
41033,DEMOSSVILLE,KY,38,102,64,0.7285714285714285
41034,DOVER,KY,112,40,-72,0.2631578947368421
41035,DRY RIDGE,KY,4113,4381,268,0.5157758417706616
41039,EWING,KY,981,953,-28,0.49276111685625645
41040,FALMOUTH,KY,2697,2659,-38,0.4964525765496639
41040,PENDLETN CNTY,KY,48,53,5,0.5247524752475248
41041,FLEMINGSBURG,KY,2879,2833,-46,0.4959733893557423
41042,FLORENCE,KY,24075,22836,-1239,0.48679414209886807
41043,FOSTER,KY,108,215,107,0.6656346749226006
41044,GERMANTOWN,KY,24,60,36,0.7142857142857143
41045,GHENT,KY,192,285,93,0.5974842767295597
41046,GLENCOE,KY,714,541,-173,0.43107569721115535
41048,HEBRON,KY,4640,5089,449,0.5230753417617432
41049,HILLSBORO,KY,507,633,126,0.5552631578947368
41051,INDEPENDENCE,KY,9652,9959,307,0.5078272398143899
41055,MAYSLICK,KY,436,289,-147,0.3986206896551724
41056,MAYSVILLE,KY,5888,5857,-31,0.4986802894848872
41059,MELBOURNE,KY,588,567,-21,0.4909090909090909
41063,MORNING VIEW,KY,677,656,-21,0.49212303075768943
41064,MOUNT OLIVET,KY,489,561,72,0.5342857142857143
41071,NEWPORT,KY,9043,7877,-1166,0.4655437352245863
41071,SOUTHGATE,KY,2130,1723,-407,0.4471840124578251
41072,NEWPORT,KY,72,240,168,0.7692307692307693
41073,BELLEVUE,KY,2550,2325,-225,0.47692307692307695
41074,DAYTON,KY,2505,2500,-5,0.4995004995004995
41075,FORT THOMAS,KY,5975,4908,-1067,0.45097859046218874
41076,COLD SPRGS HIGHLAND HTS,KY,119,90,-29,0.430622009569378
41076,COLD SPRING,KY,1425,1312,-113,0.4793569601753745
41076,HIGHLAND HEIGHTS,KY,3360,2998,-362,0.4715319282793331
41076,HIGHLAND HGTS,KY,295,261,-34,0.4694244604316547
41076,WILDER,KY,1028,879,-149,0.4609334032511799
41080,PETERSBURG,KY,239,132,-107,0.3557951482479784
41083,SANDERS,KY,197,208,11,0.5135802469135803
41085,SILVER GROVE,KY,196,107,-89,0.35313531353135313
41086,SPARTA,KY,624,519,-105,0.4540682414698163
41091,UNION,KY,6273,8259,1986,0.5683319570602807
41092,VERONA,KY,858,911,53,0.5149802148106275
41093,WALLINGFORD,KY,574,749,175,0.5661375661375662
41094,WALTON,KY,5489,5422,-67,0.4969297039684722
41095,WARSAW,KY,1811,1541,-270,0.4597255369928401
41097,WILLIAMSTOWN,KY,2681,2412,-269,0.4735912036128019
41098,WORTHVILLE,KY,643,707,64,0.5237037037037037
41101,ASHLAND,KY,7906,7098,-808,0.47307384697414023
41102,ASHLAND,KY,5781,5570,-211,0.49070566469914545
41105,ASHLAND,KY,358,476,118,0.5707434052757794
41121,ARGILLITE,KY,191,147,-44,0.4349112426035503
41124,BLAINE,KY,12,22,10,0.6470588235294118
41129,CATLETTSBURG,KY,2415,2447,32,0.5032908268202386
41132,DENTON,KY,0,12,12,1
41139,FLATWOODS,KY,3125,2953,-172,0.4858506087528792
41141,GARRISON,KY,445,436,-9,0.4948921679909194
41143,GRAYSON,KY,4919,4431,-488,0.473903743315508
41144,GREENUP,KY,2821,2448,-373,0.46460428923894476
41144,WURTLAND,KY,279,243,-36,0.46551724137931033
41164,OLIVE HILL,KY,3214,3114,-100,0.4920986093552465
41166,QUINCY,KY,14,11,-3,0.44
41168,RUSH,KY,530,482,-48,0.4762845849802372
41169,RACELAND,KY,394,345,-49,0.4668470906630582
41169,RUSSELL,KY,1259,1292,33,0.506468051744414
41171,SANDY HOOK,KY,1069,1072,3,0.5007006071929005
41174,SOUTH PORTSMOUTH,KY,45,49,4,0.5212765957446809
41175,SOUTH SHORE,KY,1728,1680,-48,0.49295774647887325
41179,VANCEBURG,KY,2371,2389,18,0.501890756302521
41180,WEBBVILLE,KY,0,12,12,1
41183,WORTHINGTON,KY,286,339,53,0.5424
41189,TOLLESBORO,KY,964,875,-89,0.4758020663404024
41204,BOONS CAMP,KY,12,0,-12,0
41214,DEBORD,KY,11,0,-11,0
41216,EAST POINT,KY,25,108,83,0.8120300751879699
41219,FLATGAP,KY,215,269,54,0.5557851239669421
41222,DENVER,KY,11,12,1,0.5217391304347826
41222,HAGERHILL,KY,570,613,43,0.518174133558749
41224,INEZ,KY,1119,1075,-44,0.48997265268915224
41230,LOUISA,KY,4116,3978,-138,0.49147516679021497
41231,LOVELY,KY,45,38,-7,0.4578313253012048
41232,LOWMANSVILLE,KY,0,14,14,1
41238,OIL SPRINGS,KY,44,28,-16,0.3888888888888889
41240,NIPPA,KY,79,79,0,0.5
41240,OFFUTT,KY,48,43,-5,0.4725274725274725
41240,PAINTSVILLE,KY,2670,2679,9,0.5008412787436904
41240,THEALKA,KY,45,33,-12,0.4230769230769231
41240,WHITEHOUSE,KY,54,40,-14,0.425531914893617
41250,PILGRIM,KY,11,0,-11,0
41255,SITKA,KY,11,43,32,0.7962962962962963
41256,STAFFORDSVILLE,KY,426,351,-75,0.4517374517374517
41256,STAFFORDSVLLE,KY,35,67,32,0.6568627450980392
41260,THELMA,KY,208,156,-52,0.42857142857142855
41262,TOMAHAWK,KY,0,39,39,1
41265,VAN LEAR,KY,203,254,51,0.5557986870897156
41265,VANLEAR,KY,22,0,-22,0
41267,WARFIELD,KY,176,149,-27,0.4584615384615385
41268,WEST VAN LEAR,KY,52,71,19,0.5772357723577236
41274,WITTENSVILLE,KY,22,77,55,0.7777777777777778
41301,CAMPTON,KY,1568,1518,-50,0.49189889825016203
41311,BEATTYVILLE,KY,1894,1693,-201,0.4719821577920268
41314,BOONEVILLE,KY,777,889,112,0.5336134453781513
41317,CLAYHOLE,KY,15,0,-15,0
41332,HAZEL GREEN,KY,68,123,55,0.643979057591623
41339,JACKSON,KY,2531,2356,-175,0.48209535502353185
41348,LOST CREEK,KY,98,77,-21,0.44
41367,ROWDY,KY,15,0,-15,0
41385,VANCLEVE,KY,23,0,-23,0
41425,EZEL,KY,11,80,69,0.8791208791208791
41465,SALYERSVILLE,KY,2564,2581,17,0.5016520894071914
41472,WEST LIBERTY,KY,2726,2635,-91,0.4915127774668905
41501,META,KY,105,90,-15,0.46153846153846156
41501,PIKEVILLE,KY,6541,5950,-591,0.47634296693619405
41502,PIKEVILLE,KY,610,561,-49,0.47907771135781385
41503,SOUTH WILLIAMSON,KY,11,0,-11,0
41512,ASHCAMP,KY,23,37,14,0.6166666666666667
41513,BELCHER,KY,15,0,-15,0
41514,BELFRY,KY,931,891,-40,0.48902305159165754
41514,BURNWELL,KY,16,22,6,0.5789473684210527
41514,TURKEY CREEK,KY,39,41,2,0.5125
41519,CANADA,KY,27,14,-13,0.34146341463414637
41522,DRAFFIN,KY,18,13,-5,0.41935483870967744
41522,ELKHORN CITY,KY,953,975,22,0.5057053941908713
41527,FOREST HILLS,KY,11,0,-11,0
41528,FREEBURN,KY,140,0,-140,0
41531,HARDY,KY,47,0,-47,0
41537,JENKINS,KY,1293,1198,-95,0.4809313528703332
41539,KIMPER,KY,271,147,-124,0.35167464114832536
41543,MC ANDREWS,KY,26,0,-26,0
41544,MC CARR,KY,24,13,-11,0.35135135135135137
41547,MAJESTIC,KY,11,0,-11,0
41548,MOUTHCARD,KY,0,11,11,1
41553,PAW PAW,KY,12,11,-1,0.4782608695652174
41553,PHELPS,KY,621,518,-103,0.4547848990342406
41555,PINSONFORK,KY,14,0,-14,0
41557,RACCOON,KY,136,211,75,0.6080691642651297
41558,RANSOM,KY,0,13,13,1
41559,REGINA,KY,11,11,0,0.5
41560,ROBINSON CREEK,KY,11,0,-11,0
41562,SHELBIANA,KY,243,169,-74,0.41019417475728154
41564,SIDNEY,KY,0,36,36,1
41568,STOPOVER,KY,26,0,-26,0
41572,VIRGIE,KY,907,866,-41,0.4884376762549351
41601,ALLEN,KY,504,129,-375,0.2037914691943128
41602,AUXIER,KY,23,79,56,0.7745098039215687
41603,BANNER,KY,211,121,-90,0.3644578313253012
41605,BETSY LAYNE,KY,0,22,22,1
41615,DANA,KY,11,0,-11,0
41616,DAVID,KY,35,14,-21,0.2857142857142857
41621,DWALE,KY,0,14,14,1
41630,GARRETT,KY,138,101,-37,0.4225941422594142
41631,GRETHEL,KY,11,24,13,0.6857142857142857
41635,HAROLD,KY,923,714,-209,0.436163714111179
41636,HI HAT,KY,46,39,-7,0.4588235294117647
41640,HUEYSVILLE,KY,39,62,23,0.6138613861386139
41642,IVEL,KY,98,40,-58,0.2898550724637681
41645,LANGLEY,KY,45,93,48,0.6739130434782609
41647,MC DOWELL,KY,246,222,-24,0.47435897435897434
41649,MARTIN,KY,818,590,-228,0.4190340909090909
41650,MELVIN,KY,40,48,8,0.5454545454545454
41651,MINNIE,KY,0,25,25,1
41653,PRESTONSBURG,KY,4096,3616,-480,0.46887966804979253
41655,PRINTER,KY,23,25,2,0.5208333333333334
41659,STANVILLE,KY,11,0,-11,0
41660,TEABERRY,KY,19,15,-4,0.4411764705882353
41663,TRAM,KY,11,0,-11,0
41666,ESTILL,KY,13,0,-13,0
41666,WAYLAND,KY,37,45,8,0.5487804878048781
41667,WEEKSBURY,KY,0,23,23,1
41669,WHEELWRIGHT,KY,22,11,-11,0.3333333333333333
41701,HAZARD,KY,3722,3387,-335,0.47643831762554506
41702,HAZARD,KY,372,419,47,0.5297092288242731
41719,BONNYMAN,KY,34,85,51,0.7142857142857143
41722,BULAN,KY,98,97,-1,0.49743589743589745
41723,BUSY,KY,67,28,-39,0.29473684210526313
41727,CHAVIES,KY,38,26,-12,0.40625
41729,COMBS,KY,0,11,11,1
41731,CORNETTSVILLE,KY,0,25,25,1
41740,EMMALENA,KY,11,49,38,0.8166666666666667
41749,DRYHILL,KY,17,27,10,0.6136363636363636
41749,HYDEN,KY,378,375,-3,0.49800796812749004
41773,VICCO,KY,12,28,16,0.7
41774,VIPER,KY,309,331,22,0.5171875
41776,WOOTON,KY,35,12,-23,0.2553191489361702
41804,BLACKEY,KY,0,13,13,1
41812,DEANE,KY,14,0,-14,0
41822,HINDMAN,KY,513,444,-69,0.46394984326018807
41824,ISOM,KY,23,51,28,0.6891891891891891
41826,JEREMIAH,KY,18,11,-7,0.3793103448275862
41831,LEBURN,KY,0,40,40,1
41835,MC ROBERTS,KY,0,11,11,1
41837,MAYKING,KY,12,39,27,0.7647058823529411
41839,MOUSIE,KY,11,0,-11,0
41840,NEON,KY,119,77,-42,0.39285714285714285
41858,WHITESBURG,KY,1775,1824,49,0.5068074465129202
41862,TOPMOST,KY,13,11,-2,0.4583333333333333
42001,PADUCAH,KY,14513,13205,-1308,0.4764052240421387
42002,PADUCAH,KY,912,1345,433,0.5959237926451041
42003,PADUCAH,KY,13073,11440,-1633,0.4666911434748909
42020,ALMO,KY,626,609,-17,0.4931174089068826
42021,ARLINGTON,KY,343,350,7,0.5050505050505051
42021,MURRAY,KY,17,0,-17,0
42023,BARDWELL,KY,938,881,-57,0.48433205057724027
42024,BARLOW,KY,449,347,-102,0.435929648241206
42025,BENTON,KY,7188,7185,-3,0.49989563765393447
42027,BOAZ,KY,540,468,-72,0.4642857142857143
42028,BURNA,KY,12,11,-1,0.4782608695652174
42029,CALVERT CITY,KY,2760,2330,-430,0.4577603143418468
42031,CLINTON,KY,1506,1271,-235,0.45768815268275115
42035,CUNNINGHAM,KY,155,70,-85,0.3111111111111111
42036,DEXTER,KY,180,145,-35,0.4461538461538462
42038,EDDYVILLE,KY,2499,2277,-222,0.47675879396984927
42039,FANCY FARM,KY,320,271,-49,0.45854483925549916
42040,FARMINGTON,KY,111,79,-32,0.41578947368421054
42041,FULTON,KY,2398,1956,-442,0.4492420762517226
42044,GILBERTSVILLE,KY,1676,1491,-185,0.470792548152826
42045,GRAND RIVERS,KY,945,983,38,0.5098547717842323
42048,HARDIN,KY,1093,1150,57,0.5127061970575123
42049,HAZEL,KY,471,420,-51,0.4713804713804714
42050,HICKMAN,KY,1181,1160,-21,0.49551473729175566
42051,HICKORY,KY,1120,1066,-54,0.4876486733760293
42053,KEVIL,KY,1549,1512,-37,0.4939562234563868
42054,KIRKSEY,KY,53,25,-28,0.32051282051282054
42055,KUTTAWA,KY,1146,968,-178,0.45789971617786185
42056,LA CENTER,KY,849,677,-172,0.4436435124508519
42058,LEDBETTER,KY,1077,862,-215,0.444559051057246
42064,MARION,KY,3824,3175,-649,0.45363623374767825
42066,MAYFIELD,KY,12101,9015,-3086,0.42692744838037505
42069,MELBER,KY,39,30,-9,0.43478260869565216
42071,MURRAY,KY,16845,13544,-3301,0.4456875843232749
42076,NEW CONCORD,KY,268,372,104,0.58125
42078,SALEM,KY,746,636,-110,0.4602026049204052
42079,SEDALIA,KY,114,126,12,0.525
42081,CARRSVILLE,KY,29,16,-13,0.35555555555555557
42081,SMITHLAND,KY,719,760,41,0.5138607167004733
42082,SYMSONIA,KY,330,347,17,0.5125553914327917
42083,TILINE,KY,0,22,22,1
42085,WATER VALLEY,KY,64,79,15,0.5524475524475524
42086,WEST PADUCAH,KY,1490,1395,-95,0.48353552859618715
42087,WICKLIFFE,KY,674,768,94,0.5325936199722607
42088,WINGO,KY,1119,1024,-95,0.47783481101259917
42101,BOWLING GREEN,KY,28541,26398,-2143,0.48049655071988934
42102,BOWLING GREEN,KY,1137,1757,620,0.6071181755355909
42103,BOWLING GREEN,KY,11140,10881,-259,0.4941192498070024
42104,BOWLING GREEN,KY,15741,16873,1132,0.5173545103329859
42120,ADOLPHUS,KY,1018,848,-170,0.45444801714898175
42122,ALVATON,KY,1345,1911,566,0.586916461916462
42123,AUSTIN,KY,61,14,-47,0.18666666666666668
42127,CAVE CITY,KY,2809,2908,99,0.5086583872660486
42129,EDMONTON,KY,2294,2481,187,0.5195811518324608
42133,FOUNTAIN RUN,KY,296,256,-40,0.463768115942029
42134,FRANKLIN,KY,8414,8008,-406,0.4876385336743393
42135,FRANKLIN,KY,228,554,326,0.7084398976982097
42140,GAMALIEL,KY,148,101,-47,0.40562248995983935
42141,GLASGOW,KY,13263,13083,-180,0.4965839216579367
42142,GLASGOW,KY,407,296,-111,0.42105263157894735
42154,KNOB LICK,KY,13,0,-13,0
42156,LUCAS,KY,15,11,-4,0.4230769230769231
42157,MOUNT HERMON,KY,11,12,1,0.5217391304347826
42159,OAKLAND,KY,256,140,-116,0.35353535353535354
42160,PARK CITY,KY,749,834,85,0.5268477574226152
42164,SCOTTSVILLE,KY,6810,6979,169,0.5061280731017478
42166,SUMMER SHADE,KY,472,610,138,0.5637707948243993
42167,TOMPKINSVILLE,KY,2952,2610,-342,0.4692556634304207
42170,WOODBURN,KY,198,208,10,0.5123152709359606
42171,SMITHS GROVE,KY,2628,2753,125,0.5116149414606951
42202,ADAIRVILLE,KY,558,424,-134,0.4317718940936864
42204,ALLENSVILLE,KY,12,0,-12,0
42206,AUBURN,KY,1930,1950,20,0.5025773195876289
42207,BEE SPRING,KY,218,133,-85,0.3789173789173789
42210,BROWNSVILLE,KY,1815,1472,-343,0.44782476422269546
42211,CADIZ,KY,5720,5619,-101,0.49554634447482143
42214,CENTER,KY,12,11,-1,0.4782608695652174
42215,CERULEAN,KY,0,63,63,1
42217,CROFTON,KY,1163,1138,-25,0.494567579313342
42220,ELKTON,KY,2169,2180,11,0.5012646585421936
42223,FORT CAMPBELL,KY,13604,8555,-5049,0.3860733787625795
42223,FT CAMPBELL,KY,191,130,-61,0.40498442367601245
42232,GRACEY,KY,0,59,59,1
42234,GUTHRIE,KY,885,680,-205,0.43450479233226835
42236,HERNDON,KY,50,47,-3,0.4845360824742268
42240,HOPKINSVILLE,KY,17959,17344,-615,0.4912896920941563
42241,HOPKINSVILLE,KY,312,627,315,0.6677316293929713
42256,LEWISBURG,KY,1539,1624,85,0.5134366108125198
42256,QUALITY,KY,58,54,-4,0.48214285714285715
42259,MAMMOTH CAVE,KY,117,89,-28,0.4320388349514563
42261,MORGANTOWN,KY,4026,3777,-249,0.48404459823144946
42262,OAK GROVE,KY,6908,5760,-1148,0.45468898010735714
42265,OLMSTEAD,KY,11,0,-11,0
42266,PEMBROKE,KY,607,625,18,0.5073051948051948
42274,ROCKFIELD,KY,495,600,105,0.547945205479452
42275,ROUNDHILL,KY,12,58,46,0.8285714285714286
42276,RUSSELLVILLE,KY,6972,6251,-721,0.4727368978295394
42280,SHARON GROVE,KY,12,11,-1,0.4782608695652174
42286,TRENTON,KY,353,103,-250,0.22587719298245615
42301,OWENSBORO,KY,18745,17201,-1544,0.47852334056640516
42302,OWENSBORO,KY,625,542,-83,0.4644387317909169
42303,OWENSBORO,KY,18576,16362,-2214,0.46831530139103555
42304,OWENSBORO,KY,235,108,-127,0.31486880466472306
42320,BEAVER DAM,KY,3229,3064,-165,0.48689019545526774
42321,BEECH CREEK,KY,22,0,-22,0
42323,BEECHMONT,KY,327,154,-173,0.3201663201663202
42324,BELTON,KY,97,11,-86,0.10185185185185185
42325,BREMEN,KY,445,328,-117,0.4243208279430789
42326,BROWDER,KY,11,0,-11,0
42327,CALHOUN,KY,1177,1149,-28,0.4939810834049871
42328,CENTERTOWN,KY,298,193,-105,0.39307535641547864
42330,CENTRAL CITY,KY,3290,3326,36,0.502720677146312
42333,CROMWELL,KY,142,120,-22,0.4580152671755725
42337,DRAKESBORO,KY,1195,844,-351,0.4139283962726827
42339,DUNMOR,KY,37,58,21,0.6105263157894737
42343,FORDSVILLE,KY,609,472,-137,0.4366327474560592
42344,GRAHAM,KY,40,35,-5,0.4666666666666667
42345,GREENVILLE,KY,4020,3712,-308,0.4800827728918779
42347,HARTFORD,KY,2332,2422,90,0.509465713083719
42348,HAWESVILLE,KY,1361,1456,95,0.5168619098331558
42349,HORSE BRANCH,KY,87,139,52,0.6150442477876106
42350,ISLAND,KY,75,138,63,0.647887323943662
42351,LEWISPORT,KY,1680,1518,-162,0.474671669793621
42352,LIVERMORE,KY,661,564,-97,0.46040816326530615
42355,MACEO,KY,570,428,-142,0.4288577154308617
42356,MAPLE MOUNT,KY,11,12,1,0.5217391304347826
42366,PHILPOT,KY,1265,1409,144,0.5269259536275243
42367,POWDERLY,KY,104,106,2,0.5047619047619047
42368,REYNOLDS STATION,KY,39,90,51,0.6976744186046512
42372,SACRAMENTO,KY,396,336,-60,0.45901639344262296
42376,UTICA,KY,1973,2271,298,0.5351083883129123
42378,WHITESVILLE,KY,741,747,6,0.5020161290322581
42404,CLAY,KY,836,738,-98,0.46886912325285895
42406,CORYDON,KY,856,702,-154,0.45057766367137353
42408,DAWSON SPRINGS,KY,2901,2549,-352,0.4677064220183486
42409,DIXON,KY,611,540,-71,0.46915725456125107
42410,EARLINGTON,KY,546,549,3,0.5013698630136987
42411,FREDONIA,KY,186,217,31,0.5384615384615384
42413,HANSON,KY,767,860,93,0.5285802089735709
42419,HENDERSON,KY,501,257,-244,0.3390501319261214
42420,HENDERSON,KY,19864,15977,-3887,0.44577439245556766
42431,MADISONVILLE,KY,12738,11703,-1035,0.47882656192463485
42436,MANITOU,KY,34,92,58,0.7301587301587301
42437,MORGANFIELD,KY,2894,2624,-270,0.4755346139905763
42440,MORTONS GAP,KY,85,51,-34,0.375
42441,NEBO,KY,222,317,95,0.588126159554731
42442,NORTONVILLE,KY,1014,953,-61,0.48449415353329944
42445,PRINCETON,KY,4406,4355,-51,0.49708937335920556
42450,PROVIDENCE,KY,1824,1812,-12,0.49834983498349833
42451,REED,KY,66,37,-29,0.3592233009708738
42452,ROBARDS,KY,500,466,-34,0.4824016563146998
42455,SEBREE,KY,954,876,-78,0.4786885245901639
42456,SLAUGHTERS,KY,103,179,76,0.6347517730496454
42458,SPOTTSVILLE,KY,12,22,10,0.6470588235294118
42459,STURGIS,KY,2027,1554,-473,0.4339569952527227
42461,UNIONTOWN,KY,447,428,-19,0.48914285714285716
42462,WAVERLY,KY,89,105,16,0.5412371134020618
42463,WHEATCROFT,KY,11,0,-11,0
42464,WHITE PLAINS,KY,217,361,144,0.6245674740484429
42501,SOMERSET,KY,7762,7288,-474,0.48425249169435214
42502,SOMERSET,KY,317,627,310,0.6641949152542372
42503,SOMERSET,KY,8757,9251,494,0.5137161261661484
42518,BRONSTON,KY,1314,1459,145,0.5261449693472773
42519,BURNSIDE,KY,1555,1464,-91,0.484928784365684
42528,DUNNVILLE,KY,111,68,-43,0.37988826815642457
42533,FERGUSON,KY,337,341,4,0.5029498525073747
42539,LIBERTY,KY,2893,3057,164,0.513781512605042
42541,MIDDLEBURG,KY,0,11,11,1
42544,NANCY,KY,2251,2341,90,0.5097996515679443
42553,SCIENCE HILL,KY,2028,1950,-78,0.49019607843137253
42564,WEST SOMERSET,KY,158,114,-44,0.41911764705882354
42566,YOSEMITE,KY,0,23,23,1
42567,EUBANK,KY,1778,1707,-71,0.4898134863701578
42602,ALBANY,KY,2933,2992,59,0.5049789029535865
42629,JAMESTOWN,KY,1968,1847,-121,0.48414154652686764
42633,MONTICELLO,KY,7294,6980,-314,0.48900098080425947
42634,PARKERS LAKE,KY,47,23,-24,0.32857142857142857
42635,PINE KNOT,KY,1039,1007,-32,0.4921798631476051
42642,RUSSELL SPGS,KY,653,593,-60,0.47592295345104335
42642,RUSSELL SPRINGS,KY,4922,4246,-676,0.4631326352530541
42647,STEARNS,KY,803,765,-38,0.48788265306122447
42649,STRUNK,KY,90,156,66,0.6341463414634146
42653,WHITLEY CITY,KY,1254,1148,-106,0.47793505412156534
42701,ELIZABETHTOWN,KY,23873,23618,-255,0.49731528079004444
42702,E TOWN,KY,13,34,21,0.723404255319149
42702,ELIZABETHTOWN,KY,963,992,29,0.5074168797953964
42712,BIG CLIFTY,KY,541,619,78,0.5336206896551724
42713,BONNIEVILLE,KY,361,415,54,0.5347938144329897
42715,BREEDING,KY,0,24,24,1
42716,BUFFALO,KY,419,428,9,0.5053128689492326
42717,BURKESVILLE,KY,2410,2162,-248,0.47287839020122485
42718,CAMPBELLSVILLE,KY,10741,9692,-1049,0.4743307394900406
42718,CAMPBELLSVLLE,KY,265,250,-15,0.4854368932038835
42719,CAMPBELLSVILLE,KY,165,443,278,0.7286184210526315
42721,CANEYVILLE,KY,1067,1082,15,0.5034899953466728
42722,CANMER,KY,14,34,20,0.7083333333333334
42724,CECILIA,KY,1596,1728,132,0.51985559566787
42726,CLARKSON,KY,1788,1939,151,0.5202575798229139
42726,HODGENVILLE,KY,41,50,9,0.5494505494505495
42728,COLUMBIA,KY,6483,6297,-186,0.49272300469483565
42729,CUB RUN,KY,205,321,116,0.6102661596958175
42732,EASTVIEW,KY,412,460,48,0.5275229357798165
42733,ELK HORN,KY,229,106,-123,0.3164179104477612
42740,GLENDALE,KY,609,456,-153,0.428169014084507
42741,GLENS FORK,KY,11,0,-11,0
42743,GREENSBURG,KY,3526,3171,-355,0.4734955950425564
42746,HARDYVILLE,KY,573,518,-55,0.4747937671860678
42748,HODGENVILLE,KY,3571,3482,-89,0.4936906281015171
42749,HORSE CAVE,KY,1940,1999,59,0.5074892104595075
42753,KNIFLEY,KY,50,22,-28,0.3055555555555556
42754,LEITCHFIELD,KY,5904,5950,46,0.5019402733254598
42755,LEITCHFIELD,KY,34,74,40,0.6851851851851852
42757,MAGNOLIA,KY,699,862,163,0.5522101217168481
42758,MANNSVILLE,KY,11,0,-11,0
42762,MILLWOOD,KY,11,12,1,0.5217391304347826
42765,MUNFORDVILLE,KY,2274,2111,-163,0.4814139110604333
42776,SONORA,KY,866,816,-50,0.48513674197384066
42782,SUMMERSVILLE,KY,46,116,70,0.7160493827160493
42784,UPTON,KY,924,856,-68,0.48089887640449436
43001,ALEX,OH,18,13,-5,0.41935483870967744
43001,ALEXANDRIA,OH,509,633,124,0.5542907180385289
43003,ASHLEY,OH,960,842,-118,0.4672586015538291
43004,BLACKLICK,OH,12552,13463,911,0.5175091293484528
43006,BRINKHAVEN,OH,16,0,-16,0
43008,BUCKEYE LAKE,OH,1256,1222,-34,0.49313962873284906
43009,CABLE,OH,211,297,86,0.5846456692913385
43010,CATAWBA,OH,23,0,-23,0
43011,CENTERBURG,OH,2033,2163,130,0.515490943755958
43013,CROTON,OH,103,77,-26,0.42777777777777776
43014,DANVILLE,OH,1068,901,-167,0.457592686642966
43015,DELAWARE,OH,20679,24070,3391,0.5378891148405551
43016,DUBLIN,OH,24493,22857,-1636,0.4827243928194298
43017,DANVILLE,OH,378,371,-7,0.4953271028037383
43017,DUBLIN,OH,17754,17624,-130,0.4981626999830403
43018,ETNA,OH,37,25,-12,0.4032258064516129
43019,FREDERICKTOWN,OH,2493,2606,113,0.5110806040400079
43021,GALENA,OH,2720,4041,1321,0.5976926490164177
43022,GAMBIER,OH,4466,663,-3803,0.12926496393059075
43023,GRANVILLE,OH,3601,4401,800,0.549987503124219
43025,HEBRON,OH,2004,2331,327,0.5377162629757786
43026,HILLIARD,OH,26824,25911,-913,0.49134351000284443
43027,HOMER,OH,60,0,-60,0
43028,HOWARD,OH,2771,2757,-14,0.49873371924746746
43029,IRWIN,OH,12,0,-12,0
43031,JOHNSTOWN,OH,4289,4395,106,0.5061031782588669
43033,KIRKERSVILLE,OH,57,0,-57,0
43035,LEWIS CENTER,OH,11926,12670,744,0.5151244104732476
43036,MAGNETIC SPRINGS,OH,17,0,-17,0
43037,MARTINSBURG,OH,25,37,12,0.5967741935483871
43040,MARYSVILLE,OH,13292,14977,1685,0.5298029643779405
43044,MARYSVILLE,OH,29,23,-6,0.4423076923076923
43044,MECHANICSBURG,OH,1443,1352,-91,0.48372093023255813
43045,MILFORD CENTER,OH,299,302,3,0.502495840266223
43045,MILFORD CTR,OH,25,19,-6,0.4318181818181818
43046,MILLERSPORT,OH,1369,1353,-16,0.497060984570169
43050,MOUNT VERNON,OH,12197,11964,-233,0.49517817971110467
43054,NEW ALBANY,OH,12986,12971,-15,0.49971106060022347
43055,NEWARK,OH,27833,24886,-2947,0.4720499250744513
43056,HEATH,OH,6420,6038,-382,0.48466848611334085
43056,NEWARK,OH,142,115,-27,0.4474708171206226
43058,NEWARK,OH,950,910,-40,0.489247311827957
43060,N LEWISBURG,OH,98,113,15,0.5355450236966824
43060,NORTH LEWISBURG,OH,892,918,26,0.507182320441989
43061,OSTRANDER,OH,979,1357,378,0.5809075342465754
43062,ETNA,OH,3481,4044,563,0.5374086378737541
43062,PATASKALA,OH,7094,8221,1127,0.5367939928174992
43064,PLAIN CITY,OH,4253,6680,2427,0.610994237629196
43065,POWELL,OH,12423,15381,2958,0.5531937850668969
43066,RADNOR,OH,218,96,-122,0.3057324840764331
43067,BROADWAY,OH,11,0,-11,0
43067,RAYMOND,OH,156,290,134,0.6502242152466368
43068,ETNA,OH,558,635,77,0.5322715842414082
43068,REYNOLDSBURG,OH,28034,26489,-1545,0.4858316673697339
43071,SAINT LOUISVILLE,OH,483,537,54,0.5264705882352941
43071,ST LOUISVILLE,OH,19,60,41,0.759493670886076
43072,SAINT PARIS,OH,1739,1664,-75,0.4889803114898619
43074,SUNBURY,OH,4899,6311,1412,0.5629794826048171
43076,THORNVILLE,OH,3026,3164,138,0.5111470113085622
43078,URBANA,OH,7213,7290,77,0.5026546231814107
43080,UTICA,OH,1866,1705,-161,0.477457294875385
43081,WESTERVILLE,OH,29219,29720,501,0.504250156941923
43082,WESTERVILLE,OH,9118,10074,956,0.5249062109212171
43084,WOODSTOCK,OH,33,47,14,0.5875
43085,COLUMBUS,OH,1384,1446,62,0.5109540636042402
43085,WORTHINGTON,OH,8013,8100,87,0.5026996834853845
43086,WESTERVILLE,OH,1345,1099,-246,0.44967266775777415
43101,ADELPHI,OH,0,11,11,1
43102,AMANDA,OH,1476,1332,-144,0.47435897435897434
43103,ASHVILLE,OH,4739,5074,335,0.5170691939264241
43103,SOUTH BLOOMFIELD,OH,91,100,9,0.5235602094240838
43105,BALTIMORE,OH,2359,2631,272,0.527254509018036
43106,BLOOMINGBURG,OH,292,378,86,0.564179104477612
43107,BREMEN,OH,1026,1114,88,0.5205607476635514
43109,BRICE,OH,145,417,272,0.7419928825622776
43110,CANAL WINCHESTER,OH,21780,20524,-1256,0.4851550680786687
43112,CARROLL,OH,1271,1394,123,0.5230769230769231
43113,CIRCLEVILLE,OH,9632,9288,-344,0.4909090909090909
43115,CLARKSBURG,OH,389,245,-144,0.3864353312302839
43116,COMMERCIAL POINT,OH,510,1114,604,0.6859605911330049
43116,COMMERCIAL PT,OH,21,61,40,0.7439024390243902
43119,GALLOWAY,OH,12990,11152,-1838,0.4619335597713528
43123,GROVE CITY,OH,26042,26994,952,0.5089750358247228
43125,GROVEPORT,OH,6395,6441,46,0.501791835462761
43127,HAYDENVILLE,OH,18,0,-18,0
43128,JEFFERSONVILLE,OH,943,826,-117,0.46693046919163367
43130,LANCASTER,OH,25121,24605,-516,0.4948115673892933
43135,LAURELVILLE,OH,1609,1311,-298,0.448972602739726
43136,LITHOPOLIS,OH,630,703,73,0.5273818454613654
43137,LOCKBOURNE,OH,1048,1195,147,0.5327686134641105
43138,LOGAN,OH,6523,6253,-270,0.48943331246086413
43140,LONDON,OH,6994,7015,21,0.5007495181668927
43143,MOUNT STERLING,OH,1853,1935,82,0.5108236536430835
43143,MT STERLING,OH,117,146,29,0.5551330798479087
43144,MURRAY CITY,OH,0,13,13,1
43145,NEW HOLLAND,OH,469,403,-66,0.46215596330275227
43146,ORIENT,OH,2713,2645,-68,0.4936543486375513
43147,PICKERINGTON,OH,13755,16536,2781,0.5459047241754976
43148,PLEASANTVILLE,OH,770,738,-32,0.48938992042440316
43149,ROCKBRIDGE,OH,699,512,-187,0.4227910817506193
43150,NEWARK,OH,0,13,13,1
43150,RUSHVILLE,OH,480,510,30,0.5151515151515151
43150,W RUSHVILLE,OH,0,13,13,1
43150,WEST RUSHVILLE,OH,20,11,-9,0.3548387096774194
43152,S BLOOMINGVIL,OH,13,11,-2,0.4583333333333333
43152,S BLOOMINGVILLE,OH,51,14,-37,0.2153846153846154
43152,SOUTH BLOOMINGVILLE,OH,135,13,-122,0.08783783783783784
43153,SOUTH SOLON,OH,100,38,-62,0.2753623188405797
43154,STOUTSVILLE,OH,912,780,-132,0.46099290780141844
43155,SUGAR GROVE,OH,635,686,51,0.5193035579106737
43157,THURSTON,OH,71,50,-21,0.4132231404958678
43160,WASHINGTON CH,OH,199,202,3,0.5037406483790524
43160,WASHINGTON COURT HOUSE,OH,9102,8904,-198,0.49450183272242587
43160,WSHNGTN CT HS,OH,173,174,1,0.5014409221902018
43162,WEST JEFFERSON,OH,2335,2252,-83,0.4909526923915413
43164,WILLIAMSPORT,OH,709,720,11,0.5038488453463961
43201,COLUMBUS,OH,23329,14957,-8372,0.39066499503735047
43202,COLUMBUS,OH,13754,9854,-3900,0.41740088105726875
43203,COLUMBUS,OH,5474,5062,-412,0.4804479878511769
43204,COLUMBUS,OH,21519,19524,-1995,0.47569622103647397
43205,COLUMBUS,OH,7979,7324,-655,0.478598967522708
43206,COLUMBUS,OH,15491,13625,-1866,0.46795576315427945
43207,COLUMBUS,OH,18532,18353,-179,0.49757353937915144
43207,OBETZ,OH,752,773,21,0.5068852459016393
43209,BEXLEY,OH,2379,2523,144,0.51468788249694
43209,COLUMBUS,OH,8595,8505,-90,0.49736842105263157
43210,COLUMBUS,OH,394,90,-304,0.1859504132231405
43211,COLUMBUS,OH,10638,9673,-965,0.476244399586431
43212,COLUMBUS,OH,16373,12846,-3527,0.43964543618878127
43212,GRANDVIEW,OH,620,521,-99,0.4566170026292726
43212,GRANDVIEW HEIGHTS,OH,623,461,-162,0.4252767527675277
43213,COLUMBUS,OH,16577,15441,-1136,0.48225997876194643
43213,WHITEHALL,OH,2088,1930,-158,0.4803384768541563
43214,COLUMBUS,OH,13487,12441,-1046,0.47982875655661833
43215,COLUMBUS,OH,22260,18704,-3556,0.45659603554340394
43216,COLUMBUS,OH,534,1412,878,0.7255909558067831
43217,COLUMBUS,OH,1517,1298,-219,0.461101243339254
43217,ERLANGER,OH,23,28,5,0.5490196078431373
43218,COLUMBUS,OH,148,926,778,0.8621973929236499
43219,COLUMBUS,OH,13678,12787,-891,0.48316644624976385
43220,COLUMBUS,OH,13317,12484,-833,0.48385721483663424
43220,UPPER ARLINGTON,OH,1517,1359,-158,0.47253129346314326
43221,COLUMBUS,OH,10282,9825,-457,0.4886357984781419
43221,UPPER ARLINGTON,OH,2026,2062,36,0.5044031311154599
43221,UPPER ARLNGTN,OH,352,397,45,0.5300400534045394
43222,COLUMBUS,OH,2288,1984,-304,0.46441947565543074
43223,COLUMBUS,OH,12120,10718,-1402,0.4693055433925913
43224,COLUMBUS,OH,19373,16743,-2630,0.4635895448000886
43227,COLUMBUS,OH,11458,10371,-1087,0.47510192862705575
43228,COLUMBUS,OH,31780,27152,-4628,0.46073440575578634
43229,COLUMBUS,OH,27278,22468,-4810,0.45165440437422105
43230,COLUMBUS,OH,21133,19725,-1408,0.4827695922463165
43230,GAHANNA,OH,6034,5724,-310,0.4868174859670012
43231,COLUMBUS,OH,8837,8372,-465,0.48648962752048347
43232,COLUMBUS,OH,23080,21329,-1751,0.4802855277083474
43234,COLUMBUS,OH,0,70,70,1
43235,COLUMBUS,OH,23722,21842,-1880,0.4793696778158195
43236,COLUMBUS,OH,0,106,106,1
43240,COLUMBUS,OH,5645,5553,-92,0.4958921235934988
43301,MARION,OH,463,608,145,0.5676937441643324
43302,MARION,OH,21383,20303,-1080,0.4870460106510579
43310,BELLE CENTER,OH,972,968,-4,0.49896907216494846
43311,BELLEFONTAINE,OH,7969,7811,-158,0.4949936628643853
43314,CALEDONIA,OH,1126,951,-175,0.4578719306692345
43315,CARDINGTON,OH,2555,2302,-253,0.4739551163269508
43316,CAREY,OH,2175,1874,-301,0.46283032847616695
43318,DE GRAFF,OH,1008,822,-186,0.4491803278688525
43319,EAST LIBERTY,OH,40,70,30,0.6363636363636364
43320,EDISON,OH,250,248,-2,0.4979919678714859
43323,HARPSTER,OH,15,0,-15,0
43324,HUNTSVILLE,OH,1079,1052,-27,0.4936649460347255
43326,KENTON,OH,5037,4873,-164,0.4917255297679112
43331,LAKEVIEW,OH,2549,2099,-450,0.451592082616179
43332,LA RUE,OH,421,403,-18,0.4890776699029126
43333,LEWISTOWN,OH,28,43,15,0.6056338028169014
43334,MARENGO,OH,2275,2204,-71,0.49207412368832326
43337,MORRAL,OH,63,14,-49,0.18181818181818182
43338,MOUNT GILEAD,OH,4009,3862,-147,0.4906619235167069
43340,MOUNT VICTORY,OH,281,243,-38,0.4637404580152672
43341,NEW BLOOMINGTON,OH,26,17,-9,0.3953488372093023
43342,PROSPECT,OH,960,945,-15,0.49606299212598426
43343,QUINCY,OH,68,42,-26,0.38181818181818183
43344,RICHWOOD,OH,2221,1931,-290,0.4650770712909441
43345,RIDGEWAY,OH,12,0,-12,0
43347,RUSHSYLVANIA,OH,92,78,-14,0.4588235294117647
43348,RUSSELLS POINT,OH,1346,1182,-164,0.4675632911392405
43351,UPPER SANDUSKY,OH,4347,3608,-739,0.4535512256442489
43356,WALDO,OH,27,37,10,0.578125
43357,W LBRTY,OH,26,20,-6,0.43478260869565216
43357,WEST LIBERTY,OH,1515,1333,-182,0.46804775280898875
43358,WEST MANSFIELD,OH,721,719,-2,0.49930555555555556
43359,WHARTON,OH,50,23,-27,0.3150684931506849
43360,ZANESFIELD,OH,529,486,-43,0.47881773399014776
43402,BOWLING GREEN,OH,16088,12255,-3833,0.43238189323642523
43406,BRADNER,OH,482,440,-42,0.4772234273318872
43410,CLYDE,OH,3698,3352,-346,0.4754609929078014
43412,CURTICE,OH,1085,971,-114,0.4722762645914397
43413,CYGNET,OH,192,145,-47,0.43026706231454004
43416,ELMORE,OH,870,757,-113,0.46527350952673635
43420,FREMONT,OH,10146,9630,-516,0.4869538834951456
43430,GENOA,OH,1199,1264,65,0.5131952902963866
43431,GIBSONBURG,OH,1292,1341,49,0.5093049753133309
43432,GRAYTOWN,OH,204,155,-49,0.43175487465181056
43435,HELENA,OH,180,101,-79,0.3594306049822064
43437,JERRY CITY,OH,14,0,-14,0
43438,KELLEYS ISLAND,OH,515,241,-274,0.3187830687830688
43440,LAKESIDE,OH,476,744,268,0.6098360655737705
43440,LAKESIDE MARBLEHEAD,OH,2746,2374,-372,0.463671875
43440,LKSID MARBLHD,OH,56,50,-6,0.4716981132075472
43440,MARBLEHEAD,OH,661,643,-18,0.49309815950920244
43442,LINDSEY,OH,48,15,-33,0.23809523809523808
43443,LUCKEY,OH,207,190,-17,0.47858942065491183
43445,MARTIN,OH,12,12,0,0.5
43447,MILLBURY,OH,1005,986,-19,0.49522852837769965
43449,OAK HARBOR,OH,2994,2770,-224,0.48056904927133937
43450,PEMBERVILLE,OH,1015,936,-79,0.4797539723218862
43451,PORTAGE,OH,173,132,-41,0.43278688524590164
43452,PORT CLINTON,OH,8076,7397,-679,0.4780585536095133
43456,PUT IN BAY,OH,833,435,-398,0.3430599369085173
43457,RISINGSUN,OH,189,209,20,0.5251256281407035
43460,ROSSFORD,OH,2331,2118,-213,0.476062036412677
43462,RUDOLPH,OH,194,176,-18,0.4756756756756757
43464,VICKERY,OH,208,141,-67,0.4040114613180516
43465,WALBRIDGE,OH,2031,1988,-43,0.494650410549888
43466,WAYNE,OH,524,457,-67,0.4658511722731906
43469,WOODVILLE,OH,886,850,-36,0.48963133640552997
43501,ALVORDTON,OH,42,26,-16,0.38235294117647056
43502,ARCHBOLD,OH,2302,2091,-211,0.47598452082859094
43504,BERKEY,OH,0,13,13,1
43506,BRYAN,OH,6934,6126,-808,0.4690658499234303
43511,CUSTAR,OH,17,56,39,0.7671232876712328
43512,DEFIANCE,OH,11226,10094,-1132,0.47345215759849907
43515,DELTA,OH,2506,2302,-204,0.47878535773710484
43516,DESHLER,OH,750,780,30,0.5098039215686274
43517,EDGERTON,OH,1140,1122,-18,0.4960212201591512
43518,EDON,OH,785,654,-131,0.45448227936066715
43521,FAYETTE,OH,1168,842,-326,0.41890547263681593
43522,GRAND RAPIDS,OH,921,953,32,0.508537886872999
43524,HAMLER,OH,291,143,-148,0.3294930875576037
43525,HASKINS,OH,139,67,-72,0.32524271844660196
43526,HICKSVILLE,OH,2351,1999,-352,0.4595402298850575
43527,HOLGATE,OH,586,483,-103,0.45182413470533206
43528,HOLLAND,OH,6626,6281,-345,0.4866351592159293
43531,KUNKLE,OH,12,0,-12,0
43532,LIBERTY CENTER,OH,1101,978,-123,0.4704184704184704
43533,LYONS,OH,155,169,14,0.5216049382716049
43534,GRELTON,OH,0,12,12,1
43534,MC CLURE,OH,357,262,-95,0.42326332794830374
43535,MALINTA,OH,38,0,-38,0
43537,MAUMEE,OH,11041,11185,144,0.5032394492936201
43540,METAMORA,OH,100,70,-30,0.4117647058823529
43542,MONCLOVA,OH,964,1210,246,0.5565777368905244
43543,MONTPELIER,OH,3190,2761,-429,0.46395563770794823
43545,NAPOLEON,OH,5083,4763,-320,0.48374974608978266
43549,NEY,OH,207,67,-140,0.24452554744525548
43551,PERRYSBURG,OH,17508,17178,-330,0.49524303753675836
43552,PERRYSBURG,OH,68,96,28,0.5853658536585366
43554,PIONEER,OH,1020,931,-89,0.47719118400820093
43555,RIDGEVILLE CORNERS,OH,11,0,-11,0
43556,SHERWOOD,OH,765,507,-258,0.39858490566037735
43557,STRYKER,OH,714,675,-39,0.48596112311015116
43558,SWANTON,OH,3788,3823,35,0.5022993036394692
43560,SYLVANIA,OH,10588,11489,901,0.5204058522444173
43565,TONTOGANY,OH,51,0,-51,0
43566,WATERVILLE,OH,2552,2928,376,0.5343065693430656
43567,WAUSEON,OH,5178,4403,-775,0.4595553700031312
43569,WESTON,OH,910,917,7,0.5019157088122606
43570,WEST UNITY,OH,1075,941,-134,0.466765873015873
43571,WHITEHOUSE,OH,2032,2267,235,0.5273319376599209
43601,TOLEDO,OH,0,11,11,1
43604,TOLEDO,OH,6351,5996,-355,0.4856240382279096
43605,TOLEDO,OH,12316,10725,-1591,0.4654745887765288
43606,OTTAWA HILLS,OH,1150,1089,-61,0.48637784725323807
43606,TOLEDO,OH,9420,8654,-766,0.47880933938253845
43607,TOLEDO,OH,11053,8649,-2404,0.43899096538422494
43608,TOLEDO,OH,5998,5157,-841,0.46230389959659346
43609,TOLEDO,OH,10464,8658,-1806,0.4527769061813618
43610,TOLEDO,OH,2167,1885,-282,0.46520236920039487
43611,TOLEDO,OH,7848,6693,-1155,0.4602847121931091
43612,TOLEDO,OH,14739,12934,-1805,0.4673869837025259
43613,TOLEDO,OH,13919,12565,-1354,0.4744373961637215
43614,TOLEDO,OH,13810,12628,-1182,0.4776458128451471
43615,OTTAWA HILLS,OH,408,351,-57,0.4624505928853755
43615,TOLEDO,OH,20111,18151,-1960,0.4743871203805342
43616,OREGON,OH,7599,6953,-646,0.477803738317757
43617,SYLVANIA TOWNSHIP,OH,196,230,34,0.539906103286385
43617,TOLEDO,OH,2115,2433,318,0.5349604221635884
43619,NORTHWOOD,OH,2496,2261,-235,0.47529955854530165
43620,TOLEDO,OH,3275,2449,-826,0.4278476589797344
43623,TOLEDO,OH,8986,7707,-1279,0.4616905289642365
43635,TOLEDO,OH,147,411,264,0.7365591397849462
43697,TOLEDO,OH,26,415,389,0.9410430839002267
43701,ZANESVILLE,OH,22544,21923,-621,0.49301729372343533
43702,S ZANESVILLE,OH,16,20,4,0.5555555555555556
43702,SOUTH ZANESVILLE,OH,24,31,7,0.5636363636363636
43702,ZANESVILLE,OH,896,791,-105,0.46887966804979253
43713,BARNESVILLE,OH,2428,2225,-203,0.47818611648398884
43716,BEALLSVILLE,OH,246,202,-44,0.45089285714285715
43717,BELLE VALLEY,OH,13,27,14,0.675
43718,BELMONT,OH,908,772,-136,0.4595238095238095
43719,BETHESDA,OH,761,637,-124,0.45565092989985695
43720,BLUE ROCK,OH,176,59,-117,0.251063829787234
43722,BUFFALO,OH,13,11,-2,0.4583333333333333
43723,BYESVILLE,OH,2371,1941,-430,0.450139146567718
43723,CAMBRIDGE,OH,58,32,-26,0.35555555555555557
43724,CALDWELL,OH,2063,2047,-16,0.49805352798053526
43725,CAMBRIDGE,OH,9193,7953,-1240,0.46383996267350985
43727,CHANDLERSVILLE,OH,127,142,15,0.5278810408921933
43728,CHESTERHILL,OH,109,108,-1,0.4976958525345622
43730,CORNING,OH,659,601,-58,0.476984126984127
43730,HEMLOCK,OH,27,29,2,0.5178571428571429
43731,CROOKSVILLE,OH,1468,1608,140,0.5227568270481144
43732,CUMBERLAND,OH,319,343,24,0.5181268882175226
43734,DUNCAN FALLS,OH,332,224,-108,0.4028776978417266
43735,EAST FULTONHAM,OH,47,0,-47,0
43739,GLENFORD,OH,389,404,15,0.5094577553593947
43746,HOPEWELL,OH,106,129,23,0.548936170212766
43747,JERUSALEM,OH,26,11,-15,0.2972972972972973
43748,JUNCTION CITY,OH,971,873,-98,0.4734273318872017
43749,KIMBOLTON,OH,587,633,46,0.5188524590163934
43754,LEWISVILLE,OH,107,93,-14,0.465
43755,LORE CITY,OH,447,453,6,0.5033333333333333
43756,MCCONNELSVILLE,OH,2402,1999,-403,0.45421495114746646
43758,MALTA,OH,985,1015,30,0.5075
43760,MOUNT PERRY,OH,365,430,65,0.5408805031446541
43762,NEW CONCORD,OH,1406,1311,-95,0.4825174825174825
43764,NEW LEXINGTON,OH,2948,2927,-21,0.4982127659574468
43766,NEW STRAITSVILLE,OH,301,337,36,0.5282131661442007
43766,NEW STRAITSVL,OH,18,13,-5,0.41935483870967744
43767,NORWICH,OH,203,87,-116,0.3
43771,PHILO,OH,524,471,-53,0.4733668341708543
43772,PLEASANT CITY,OH,426,388,-38,0.47665847665847666
43773,QUAKER CITY,OH,1002,681,-321,0.40463458110516937
43777,ROSEVILLE,OH,1827,1563,-264,0.46106194690265484
43778,SALESVILLE,OH,155,91,-64,0.3699186991869919
43779,SARAHSVILLE,OH,59,13,-46,0.18055555555555555
43780,SENECAVILLE,OH,937,794,-143,0.4586943963027152
43782,SHAWNEE,OH,67,36,-31,0.34951456310679613
43783,SOMERSET,OH,1321,1324,3,0.5005671077504726
43787,PENNSVILLE,OH,18,12,-6,0.4
43787,STOCKPORT,OH,803,734,-69,0.47755367599219256
43788,SUMMERFIELD,OH,48,38,-10,0.4418604651162791
43793,WOODSFIELD,OH,1663,1620,-43,0.4934511117879988
43802,ADAMSVILLE,OH,26,44,18,0.6285714285714286
43804,BALTIC,OH,516,376,-140,0.42152466367713004
43811,CONESVILLE,OH,36,22,-14,0.3793103448275862
43812,COSHOCTON,OH,8324,8317,-7,0.49978967610119585
43821,DRESDEN,OH,1823,1590,-233,0.4658658072077351
43822,FRAZEYSBURG,OH,1454,1446,-8,0.4986206896551724
43824,FRESNO,OH,661,636,-25,0.49036237471087124
43830,NASHPORT,OH,2177,2094,-83,0.49028330601732617
43832,NEWCOMERSTOWN,OH,2620,2621,1,0.5000954016409083
43837,PORT WASHINGTON,OH,218,169,-49,0.43669250645994834
43840,STONE CREEK,OH,23,12,-11,0.34285714285714286
43842,TRINWAY,OH,12,0,-12,0
43843,WALHONDING,OH,85,72,-13,0.4585987261146497
43844,WARSAW,OH,1211,1159,-52,0.4890295358649789
43845,WEST LAFAYETTE,OH,1544,1554,10,0.5016139444803098
43901,ADENA,OH,229,241,12,0.5127659574468085
43903,AMSTERDAM,OH,244,270,26,0.5252918287937743
43903,CADIZ,OH,0,11,11,1
43906,BELLAIRE,OH,3362,2614,-748,0.43741633199464525
43907,CADIZ,OH,1770,1766,-4,0.4994343891402715
43907,ST CLAIRSVILLE,OH,41,38,-3,0.4810126582278481
43908,BERGHOLZ,OH,118,78,-40,0.3979591836734694
43910,BLOOMINGDALE,OH,630,674,44,0.5168711656441718
43912,BRIDGEPORT,OH,2371,1886,-485,0.44303500117453604
43913,BRILLIANT,OH,203,209,6,0.5072815533980582
43915,CLARINGTON,OH,171,145,-26,0.4588607594936709
43917,DILLONVALE,OH,569,576,7,0.503056768558952
43920,E LIVERPOOL,OH,173,143,-30,0.4525316455696203
43920,EAST LIVERPOOL,OH,8588,7666,-922,0.4716377507075181
43930,HAMMONDSVILLE,OH,24,11,-13,0.3142857142857143
43932,IRONDALE,OH,23,47,24,0.6714285714285714
43933,JACOBSBURG,OH,191,88,-103,0.3154121863799283
43935,MARTINS FERRY,OH,3752,3028,-724,0.44660766961651915
43938,MINGO JCT,OH,26,22,-4,0.4583333333333333
43938,MINGO JUNCTION,OH,1913,1511,-402,0.4412967289719626
43939,MOUNT PLEASANT,OH,11,0,-11,0
43942,POWHATAN POINT,OH,494,459,-35,0.48163693599160545
43942,POWHATAN PT,OH,0,21,21,1
43943,RAYLAND,OH,716,744,28,0.5095890410958904
43944,RICHMOND,OH,405,416,11,0.5066991473812423
43945,SALINEVILLE,OH,1061,986,-75,0.48168050806057644
43946,SARDIS,OH,360,334,-26,0.4812680115273775
43946,TORONTO,OH,16,0,-16,0
43947,SHADYSIDE,OH,1780,1501,-279,0.4574824748552271
43948,SMITHFIELD,OH,12,11,-1,0.4782608695652174
43950,SAINT CLAIRSVILLE,OH,4716,4453,-263,0.48565819609553934
43950,ST CLAIRSVLE,OH,215,165,-50,0.4342105263157895
43952,STEUBENVILLE,OH,7550,6788,-762,0.4734272562421537
43953,STEUBENVILLE,OH,2954,2889,-65,0.49443778880711964
43953,WINTERSVILLE,OH,904,893,-11,0.4969393433500278
43963,TILTONSVILLE,OH,436,214,-222,0.3292307692307692
43964,TORONTO,OH,3721,3139,-582,0.4575801749271137
43968,WELLSVILLE,OH,2440,2222,-218,0.4766194766194766
43971,YORKVILLE,OH,437,155,-282,0.26182432432432434
43973,FREEPORT,OH,376,384,8,0.5052631578947369
43976,HOPEDALE,OH,369,320,-49,0.4644412191582003
43977,FLUSHING,OH,433,382,-51,0.4687116564417178
43983,PIEDMONT,OH,13,0,-13,0
43986,JEWETT,OH,544,493,-51,0.47540983606557374
43988,SCIO,OH,833,734,-99,0.46841097638800255
44001,AMHERST,OH,5941,6540,599,0.523996474641455
44001,SOUTH AMHERST,OH,127,124,-3,0.4940239043824701
44003,ANDOVER,OH,2165,1999,-166,0.48006724303554277
44004,ASHTABULA,OH,14354,13197,-1157,0.47900257703894594
44005,ASHTABULA,OH,191,642,451,0.7707082833133253
44010,AUSTINBURG,OH,415,363,-52,0.4665809768637532
44011,AVON,OH,6306,7429,1123,0.5408809610484164
44012,AVON LAKE,OH,8094,8456,362,0.5109365558912387
44017,BEREA,OH,6782,6046,-736,0.4713127533520424
44021,BURTON,OH,1609,1333,-276,0.4530931339225017
44022,BENTLEYVILLE,OH,92,206,114,0.6912751677852349
44022,CHAGRIN FALLS,OH,5627,6265,638,0.5268247561385806
44022,MORELAND HILLS,OH,159,127,-32,0.44405594405594406
44023,AUBURN TOWNSHIP,OH,205,192,-13,0.4836272040302267
44023,CHAGRIN FALLS,OH,4742,5351,609,0.5301694243535123
44024,CHARDON,OH,6527,6949,422,0.515657465123182
44024,CONCORD TOWNSHIP,OH,144,117,-27,0.4482758620689655
44026,CHESTERLAND,OH,2534,2733,199,0.5188912094171255
44028,COLUMBIA STA,OH,52,55,3,0.514018691588785
44028,COLUMBIA STATION,OH,2028,2697,669,0.5707936507936507
44030,CONNEAUT,OH,5951,5486,-465,0.4796712424586867
44032,DORSET,OH,269,247,-22,0.4786821705426357
44035,ELYRIA,OH,25154,24069,-1085,0.4889787294557422
44036,ELYRIA,OH,802,417,-385,0.3420836751435603
44039,NORTH RIDGEVILLE,OH,10209,11629,1420,0.5325121348108801
44040,GATES MILLS,OH,971,1202,231,0.55315232397607
44041,GENEVA,OH,6036,5360,-676,0.47034047034047033
44044,GRAFTON,OH,2862,3418,556,0.5442675159235669
44045,GRAND RIVER,OH,22,11,-11,0.3333333333333333
44046,HUNTSBURG,OH,147,96,-51,0.3950617283950617
44047,JEFFERSON,OH,3119,3087,-32,0.49742184982275217
44048,KINGSVILLE,OH,631,643,12,0.5047095761381476
44049,KIPTON,OH,11,0,-11,0
44050,LAGRANGE,OH,1885,2029,144,0.5183955033214103
44052,LORAIN,OH,13104,11958,-1146,0.47713670098156574
44053,LORAIN,OH,7965,8166,201,0.5062302399107309
44054,SHEFFIELD LAKE,OH,3680,3832,152,0.5101171458998935
44054,SHEFFIELD VILLAGE,OH,612,642,30,0.5119617224880383
44054,WLBY,OH,99,133,34,0.5732758620689655
44055,LORAIN,OH,10055,7663,-2392,0.43249802460774356
44056,MACEDONIA,OH,2829,3187,358,0.5297539893617021
44057,MADISON,OH,6863,6286,-577,0.47805916799756637
44060,CONCORD TOWNSHIP,OH,647,751,104,0.5371959942775394
44060,MENTOR,OH,15845,16326,481,0.507475676851823
44060,MENTOR ON THE LAKE,OH,701,710,9,0.5031892274982283
44061,MENTOR,OH,108,376,268,0.7768595041322314
44062,MIDDLEFIELD,OH,2904,2630,-274,0.4752439465124684
44064,MONTVILLE,OH,159,154,-5,0.49201277955271566
44065,NEWARK,OH,41,46,5,0.5287356321839081
44065,NEWBURY,OH,1199,1119,-80,0.4827437446074202
44067,MACEDONIA,OH,192,253,61,0.5685393258426966
44067,NORTHFIELD,OH,4700,4791,91,0.5047940153829944
44067,SAGAMORE HILLS,OH,678,658,-20,0.49251497005988026
44068,NORTH KINGSVILLE,OH,28,12,-16,0.3
44070,NORTH OLMSTED,OH,10954,10562,-392,0.4908905000929541
44072,NOVELTY,OH,1035,1246,211,0.5462516440157825
44072,RUSSELL,OH,75,93,18,0.5535714285714286
44074,OBERLIN,OH,3271,3119,-152,0.48810641627543033
44076,ORWELL,OH,1669,1356,-313,0.44826446280991733
44077,CONCORD TOWNSHIP,OH,873,760,-113,0.46540110226576853
44077,FAIRPORT HARBOR,OH,3970,3903,-67,0.4957449510986917
44077,PAINESVILLE,OH,15012,15598,586,0.5095720352825874
44081,PERRY,OH,1669,1830,161,0.523006573306659
44082,PIERPONT,OH,185,137,-48,0.4254658385093168
44084,ROAMING SHORES,OH,320,321,1,0.500780031201248
44084,ROCK CREEK,OH,810,867,57,0.516994633273703
44085,ROAMING SHORES,OH,118,96,-22,0.4485981308411215
44085,ROME,OH,697,584,-113,0.4558938329430133
44086,THOMPSON,OH,407,377,-30,0.48086734693877553
44087,TWINSBURG,OH,6479,7239,760,0.5277008310249307
44089,VERMILION,OH,6116,6335,219,0.5087944743394105
44090,WELLINGTON,OH,3762,3351,-411,0.4711092366090257
44092,WICKLIFFE,OH,6335,5939,-396,0.4838683395795991
44092,WILLOUGHBY HILLS,OH,236,230,-6,0.49356223175965663
44093,WILLIAMSFIELD,OH,322,293,-29,0.4764227642276423
44094,KIRTLAND,OH,322,295,-27,0.47811993517017826
44094,WILLOUGHBY,OH,11846,11378,-468,0.4899242163279366
44094,WILLOUGHBY HILLS,OH,2384,2330,-54,0.4942723801442512
44095,EASTLAKE,OH,4585,4488,-97,0.49465446930452994
44095,WILLOWICK,OH,6179,5941,-238,0.49018151815181515
44096,WILLOUGHBY,OH,50,233,183,0.823321554770318
44099,W LBRTY,OH,16,0,-16,0
44099,WINDSOR,OH,183,206,23,0.5295629820051414
44101,BEDFORD,OH,14,0,-14,0
44101,CLEVELAND,OH,410,958,548,0.7002923976608187
44102,CLEVELAND,OH,23833,20183,-3650,0.458537804434751
44103,CLEVELAND,OH,6227,5625,-602,0.4746034424569693
44104,CLEVELAND,OH,7034,5677,-1357,0.4466210368971757
44105,CLEVELAND,OH,13446,11208,-2238,0.454611827695303
44105,GARFIELD HEIGHTS,OH,535,496,-39,0.481086323957323
44105,NEWBURGH HEIGHTS,OH,336,293,-43,0.465818759936407
44106,CLEVELAND,OH,8417,6629,-1788,0.44058221454207097
44106,CLEVELAND HEIGHTS,OH,4552,3514,-1038,0.4356558393255641
44107,CLEVELAND,OH,721,542,-179,0.42913697545526525
44107,LAKEWOOD,OH,29251,22901,-6350,0.4391202638441479
44108,BRATENAHL,OH,876,757,-119,0.46356399265156156
44108,CLEVELAND,OH,7559,6691,-868,0.4695438596491228
44109,CLEVELAND,OH,18538,15728,-2810,0.45899725675596803
44110,CLEVELAND,OH,8131,7023,-1108,0.4634419955127359
44111,CLEVELAND,OH,16457,14758,-1699,0.472785519782156
44112,CLEVELAND,OH,4792,4095,-697,0.4607854169010915
44112,CLEVELAND HEIGHTS,OH,941,843,-98,0.4725336322869955
44112,CLEVELAND HTS,OH,110,132,22,0.5454545454545454
44112,E CLEVELAND,OH,762,587,-175,0.4351371386212009
44112,EAST CLEVELAND,OH,1727,1477,-250,0.46098626716604246
44113,CLEVELAND,OH,14837,12565,-2272,0.4585431720312386
44114,CLEVELAND,OH,6489,5407,-1082,0.45452252858103565
44115,CLEVELAND,OH,5425,4685,-740,0.46340257171117705
44116,ROCKY RIVER,OH,7935,7714,-221,0.4929388459326475
44117,EUCLID,OH,4440,4316,-124,0.4929191411603472
44118,CLEVELAND,OH,7317,6907,-410,0.4855877390326209
44118,CLEVELAND HEIGHTS,OH,6120,5650,-470,0.4800339847068819
44118,CLEVELAND HTS,OH,579,495,-84,0.46089385474860334
44118,UNIVERSITY HEIGHTS,OH,1624,1445,-179,0.4708374063212773
44118,UNIVERSITY HTS,OH,346,398,52,0.5349462365591398
44119,CLEVELAND,OH,3699,3536,-163,0.48873531444367657
44119,EUCLID,OH,1122,1073,-49,0.4888382687927107
44120,CLEVELAND,OH,12080,11094,-986,0.47872615862604645
44120,SHAKER HEIGHTS,OH,3362,3181,-181,0.48616842427021245
44121,CLEVELAND,OH,7838,7477,-361,0.4882141691152465
44121,CLEVELAND HEIGHTS,OH,921,756,-165,0.45080500894454384
44121,SOUTH EUCLID,OH,3661,3381,-280,0.4801192842942346
44122,BEACHWOOD,OH,7478,7544,66,0.502196778058847
44122,SHAKER HEIGHTS,OH,9292,9620,328,0.5086717428087987
44123,EUCLID,OH,7491,6991,-500,0.4827371909957188
44124,CLEVELAND,OH,7347,7242,-105,0.4964013983137981
44124,LYNDHURST,OH,1532,1685,153,0.5237799191793596
44124,MAYFIELD HEIGHTS,OH,5148,5356,208,0.5099009900990099
44124,MAYFIELD HTS,OH,1591,1389,-202,0.46610738255033557
44124,PEPPER PIKE,OH,634,527,-107,0.45391903531438416
44125,CLEVELAND,OH,7765,7492,-273,0.49105328701579604
44125,GARFIELD,OH,260,287,27,0.5246800731261426
44125,GARFIELD HEIGHTS,OH,2713,2723,10,0.5009197939661516
44125,GARFIELD HTS,OH,473,456,-17,0.4908503767491927
44126,CLEVELAND,OH,2990,2831,-159,0.48634255282597494
44126,FAIRVIEW PARK,OH,2969,2923,-46,0.49609640190088256
44127,CLEVELAND,OH,1912,1529,-383,0.44434757337983144
44128,BEDFORD HEIGHTS,OH,337,315,-22,0.4831288343558282
44128,CLEVELAND,OH,9866,9035,-831,0.4780170361356542
44128,WARRENSVILLE HEIGHTS,OH,1285,1154,-131,0.47314473144731445
44129,CLEVELAND,OH,6279,5626,-653,0.4725745485090298
44129,PARMA,OH,4675,4483,-192,0.4895173618694038
44130,CLEVELAND,OH,19608,18040,-1568,0.4791755206119847
44130,MIDDLEBURG HEIGHTS,OH,459,390,-69,0.45936395759717313
44130,PARMA,OH,334,294,-40,0.4681528662420382
44131,BROOKLYN HEIGHTS,OH,72,84,12,0.5384615384615384
44131,BROOKLYN HTS,OH,280,379,99,0.575113808801214
44131,INDEPENDENCE,OH,2335,2623,288,0.5290439693424768
44131,SEVEN HILLS,OH,2346,2913,567,0.553907586993725
44132,EUCLID,OH,6794,6397,-397,0.48495186111742855
44133,N ROYALTON,OH,929,908,-21,0.49428415895481764
44133,NORTH ROYALTON,OH,9595,9247,-348,0.4907653115380533
44134,CLEVELAND,OH,6188,5967,-221,0.4909090909090909
44134,PARMA,OH,6210,5945,-265,0.4890991361579597
44135,CLEVELAND,OH,11731,10277,-1454,0.46696655761541256
44136,STRONGSVILLE,OH,9168,8935,-233,0.4935646025520632
44137,MAPLE HEIGHTS,OH,8750,8368,-382,0.4888421544572964
44138,CLEVELAND,OH,124,119,-5,0.4897119341563786
44138,OLMSTED FALLS,OH,3028,3337,309,0.5242733699921446
44138,OLMSTED TWP,OH,3862,4079,217,0.5136632665911094
44139,SOLON,OH,6975,7844,869,0.5293204669680815
44140,BAY VILLAGE,OH,3625,4355,730,0.5457393483709273
44141,BRECKSVILLE,OH,3569,4206,637,0.5409646302250803
44142,BROOK PARK,OH,1148,1192,44,0.5094017094017094
44142,BROOKPARK,OH,4404,4378,-26,0.4985196993851059
44143,CLEVELAND,OH,4965,5481,516,0.5246984491671454
44143,HIGHLAND HEIGHTS,OH,387,396,9,0.5057471264367817
44143,HIGHLAND HTS,OH,218,199,-19,0.47721822541966424
44143,MAYFIELD VILLAGE,OH,160,187,27,0.5389048991354467
44143,RICHMOND HEIGHTS,OH,558,620,62,0.5263157894736842
44143,RICHMOND HTS,OH,2180,1888,-292,0.464110127826942
44144,BROOKLYN,OH,2885,2837,-48,0.49580566235581963
44144,CLEVELAND,OH,5534,5269,-265,0.4877348884569101
44145,WESTLAKE,OH,13661,13651,-10,0.4998169302870533
44146,BEDFORD,OH,11560,10573,-987,0.47770297745447976
44146,BEDFORD HEIGHTS,OH,312,267,-45,0.46113989637305697
44146,WALTON HILLS,OH,551,454,-97,0.45174129353233833
44147,BROADVIEW HEIGHTS,OH,4708,4657,-51,0.4972770955686065
44147,BROADVIEW HTS,OH,1245,1177,-68,0.48596201486374896
44147,BRODVIEW HTS,OH,142,134,-8,0.4855072463768116
44149,STRONGSVILLE,OH,5156,5557,401,0.5187155792028377
44181,CLEVELAND,OH,16,1401,1385,0.9887085391672548
44194,CLEVELAND,OH,11,0,-11,0
44201,ATWATER,OH,1452,1500,48,0.508130081300813
44202,AURORA,OH,6702,7335,633,0.5225475528959179
44202,REMINDERVILLE,OH,294,228,-66,0.4367816091954023
44203,BARBERTON,OH,8799,8659,-140,0.495990376904571
44203,NEW FRANKLIN,OH,321,316,-5,0.49607535321821034
44203,NORTON,OH,4125,4047,-78,0.49522760646108666
44210,BATH,OH,51,46,-5,0.4742268041237113
44212,BRUNSWICK,OH,13325,13290,-35,0.4993424760473417
44214,BURBANK,OH,263,335,72,0.560200668896321
44215,CHIPPEWA LAKE,OH,676,878,202,0.564993564993565
44216,CLINTON,OH,1351,1344,-7,0.4987012987012987
44216,NEW FRANKLIN,OH,1004,952,-52,0.4867075664621677
44217,CRESTON,OH,1208,1013,-195,0.45610085547050877
44221,CUYAHOGA FALLS,OH,13505,11941,-1564,0.4692682543425293
44221,CUYAHOGA FLS,OH,242,223,-19,0.47956989247311826
44223,CUYAHOGA FALLS,OH,5489,5047,-442,0.47902429764616555
44223,CUYAHOGA FLS,OH,1659,1321,-338,0.44328859060402687
44224,SILVER LAKE,OH,306,315,9,0.5072463768115942
44224,STOW,OH,14539,13769,-770,0.4863996043521266
44230,DOYLESTOWN,OH,2188,2242,54,0.5060948081264108
44231,GARRETTSVILLE,OH,2237,2436,199,0.5212925315643056
44232,GREEN,OH,0,96,96,1
44233,HINCKLEY,OH,1642,2190,548,0.5715031315240083
44234,HIRAM,OH,1031,926,-105,0.4731732243229433
44235,HOMERVILLE,OH,189,114,-75,0.37623762376237624
44236,BOSTON HTS,OH,105,233,128,0.6893491124260355
44236,HUDSON,OH,6715,7731,1016,0.5351654437214454
44240,KENT,OH,15791,13811,-1980,0.4665563137625836
44241,STREETSBORO,OH,6875,6997,122,0.5043973471741637
44250,LAKEMORE,OH,479,233,-246,0.32724719101123595
44251,WESTFIELD CENTER,OH,128,174,46,0.5761589403973509
44251,WESTFIELD CTR,OH,27,0,-27,0
44253,LITCHFIELD,OH,616,760,144,0.5523255813953488
44254,LODI,OH,1850,1664,-186,0.4735344336937962
44255,MANSFIELD,OH,44,53,9,0.5463917525773195
44255,MANTUA,OH,2268,2034,-234,0.47280334728033474
44256,MEDINA,OH,19437,20466,1029,0.5128937673859109
44258,MEDINA,OH,246,218,-28,0.4698275862068966
44260,MOGADORE,OH,3569,3346,-223,0.4838756326825741
44262,MUNROE FALLS,OH,1437,1457,20,0.5034554250172771
44264,BOSTON HTS,OH,48,42,-6,0.4666666666666667
44264,PENINSULA,OH,870,1002,132,0.5352564102564102
44266,RAVENNA,OH,11812,11519,-293,0.4937208006514937
44270,RITTMAN,OH,3290,2796,-494,0.45941505093657575
44272,ROOTSTOWN,OH,1739,1505,-234,0.46393341553637485
44273,SEVILLE,OH,2001,2081,80,0.5097991180793728
44274,SHARON CENTER,OH,11,13,2,0.5416666666666666
44275,SPENCER,OH,709,736,27,0.5093425605536333
44276,STERLING,OH,230,100,-130,0.30303030303030304
44278,TALLMADGE,OH,5244,5728,484,0.5220561429092235
44280,VALLEY CITY,OH,1529,1742,213,0.5325588505044329
44281,WADSWORTH,OH,10286,10565,279,0.5066903266030406
44282,WADSWORTH,OH,68,15,-53,0.18072289156626506
44286,RICHFIELD,OH,1696,1953,257,0.5352151274321731
44287,WEST SALEM,OH,2044,2061,17,0.5020706455542022
44288,WINDHAM,OH,1234,1170,-64,0.48668885191347755
44301,AKRON,OH,6135,5655,-480,0.4796437659033079
44302,AKRON,OH,2647,2311,-336,0.4661153691004437
44302,CANTON,OH,43,48,5,0.5274725274725275
44303,AKRON,OH,3378,3200,-178,0.486470051687443
44304,AKRON,OH,1929,1470,-459,0.4324801412180053
44305,AKRON,OH,9148,8040,-1108,0.4677682103793344
44306,AKRON,OH,11193,9661,-1532,0.46326843770979187
44307,AKRON,OH,3234,2862,-372,0.46948818897637795
44308,AKRON,OH,1048,1040,-8,0.49808429118773945
44309,AKRON,OH,259,839,580,0.7641165755919854
44310,AKRON,OH,13397,10865,-2532,0.4478196356442173
44311,AKRON,OH,3936,3598,-338,0.47756835678258563
44312,AKRON,OH,11640,11279,-361,0.49212443823901564
44313,AKRON,OH,12875,11915,-960,0.48063735377168215
44313,FAIRLAWN,OH,327,284,-43,0.46481178396072015
44314,AKRON,OH,8623,7392,-1231,0.46156728067436775
44319,AKRON,OH,4365,4578,213,0.5119087554511909
44319,COVENTRY TOWNSHIP,OH,2725,2368,-357,0.4649518947575103
44319,NEW FRANKLIN,OH,704,568,-136,0.44654088050314467
44320,AKRON,OH,7355,6899,-456,0.4840044899677284
44321,COPLEY,OH,5483,5606,123,0.5055460366128596
44333,AKRON,OH,1799,2040,241,0.5313883823912477
44333,FAIRLAWN,OH,4429,4807,378,0.5204634040710264
44334,AKRON,OH,15,68,53,0.8192771084337349
44334,FAIRLAWN,OH,62,214,152,0.7753623188405797
44401,BERLIN CENTER,OH,641,543,-98,0.45861486486486486
44402,BRISTOLVILLE,OH,770,848,78,0.5241038318912238
44403,BROOKFIELD,OH,1309,1146,-163,0.46680244399185333
44403,MASURY,OH,27,31,4,0.5344827586206896
44404,BURGHILL,OH,84,69,-15,0.45098039215686275
44405,CAMPBELL,OH,2990,2868,-122,0.4895868897234551
44406,CANFIELD,OH,6967,7205,238,0.5083968388371437
44408,COLUMBIANA,OH,3702,3828,126,0.5083665338645418
44410,CORTLAND,OH,5493,5637,144,0.5064690026954178
44411,DEERFIELD,OH,732,737,5,0.5017018379850239
44412,DIAMOND,OH,664,684,20,0.5074183976261127
44413,E PALESTINE,OH,143,136,-7,0.4874551971326165
44413,EAST PALESTINE,OH,2116,2169,53,0.5061843640606768
44417,FARMDALE,OH,95,90,-5,0.4864864864864865
44418,FOWLER,OH,128,193,65,0.6012461059190031
44420,GIRARD,OH,7125,5483,-1642,0.43488261421319796
44423,HANOVERTON,OH,623,499,-124,0.4447415329768271
44425,HUBBARD,OH,4598,4373,-225,0.487459592018727
44427,KENSINGTON,OH,103,91,-12,0.4690721649484536
44428,KINSMAN,OH,817,757,-60,0.4809402795425667
44429,LAKE MILTON,OH,1150,979,-171,0.4598403006106153
44430,LEAVITTSBURG,OH,987,1011,24,0.506006006006006
44431,LEETONIA,OH,1388,1324,-64,0.4882005899705015
44432,LISBON,OH,3397,3348,-49,0.49636767976278723
44436,LOWELLVILLE,OH,809,961,152,0.5429378531073447
44437,MC DONALD,OH,1076,1139,63,0.5142212189616253
44438,MASURY,OH,1699,1557,-142,0.4781941031941032
44440,MINERAL RIDGE,OH,1213,1224,11,0.50225687320476
44441,NEGLEY,OH,261,230,-31,0.4684317718940937
44442,NEW MIDDLETOWN,OH,1193,1111,-82,0.4822048611111111
44443,NEW SPRINGFIELD,OH,409,403,-6,0.4963054187192118
44444,NEWTON FALLS,OH,3964,3548,-416,0.47231096911608095
44445,NEW WATERFORD,OH,852,808,-44,0.4867469879518072
44446,NILES,OH,10134,8492,-1642,0.4559218297004188
44449,NORTH BENTON,OH,235,171,-64,0.4211822660098522
44450,N BLOOMFIELD,OH,14,15,1,0.5172413793103449
44450,NORTH BLOOMFIELD,OH,223,133,-90,0.37359550561797755
44451,NORTH JACKSON,OH,858,853,-5,0.49853886616014026
44452,NORTH LIMA,OH,894,940,46,0.5125408942202835
44454,PETERSBURG,OH,12,14,2,0.5384615384615384
44455,ROGERS,OH,337,233,-104,0.4087719298245614
44460,SALEM,OH,9956,9071,-885,0.47674357491985075
44470,SOUTHINGTON,OH,959,980,21,0.5054151624548736
44471,STRUTHERS,OH,3960,3665,-295,0.48065573770491804
44473,VIENNA,OH,1383,1474,91,0.5159257962898145
44481,WARREN,OH,3084,3432,348,0.5267034990791897
44482,WARREN,OH,49,413,364,0.8939393939393939
44483,WARREN,OH,9922,9181,-741,0.48060514055383974
44484,WARREN,OH,8977,8167,-810,0.476376574895007
44485,WARREN,OH,7089,6416,-673,0.47508330248056274
44490,WASHINGTONVILLE,OH,178,79,-99,0.30739299610894943
44491,W FARMINGTON,OH,58,73,15,0.5572519083969466
44491,WEST FARMINGTON,OH,738,650,-88,0.46829971181556196
44493,WINONA,OH,0,24,24,1
44501,YOUNGSTOWN,OH,196,547,351,0.7362045760430687
44502,YOUNGSTOWN,OH,4002,3436,-566,0.4619521376714171
44503,YOUNGSTOWN,OH,354,252,-102,0.4158415841584158
44504,YOUNGSTOWN,OH,2270,2053,-217,0.47490168864214666
44505,YOUNGSTOWN,OH,7096,6402,-694,0.47429248777596683
44506,YOUNGSTOWN,OH,789,649,-140,0.4513212795549374
44507,YOUNGSTOWN,OH,2186,1934,-252,0.46941747572815534
44509,YOUNGSTOWN,OH,4828,4496,-332,0.4821964821964822
44510,YOUNGSTOWN,OH,937,779,-158,0.45396270396270394
44511,YOUNGSTOWN,OH,6580,6422,-158,0.49392401169050915
44512,BOARDMAN,OH,3269,2865,-404,0.46706879686990543
44512,YOUNGSTOWN,OH,10828,9767,-1061,0.47424132070890995
44513,BOARDMAN,OH,12,24,12,0.6666666666666666
44513,YOUNGSTOWN,OH,50,208,158,0.8062015503875969
44514,POLAND,OH,1474,1779,305,0.5468798032585306
44514,YOUNGSTOWN,OH,5494,5353,-141,0.49350050705264126
44515,AUSTINTOWN,OH,508,457,-51,0.47357512953367875
44515,YOUNGSTOWN,OH,10569,9996,-573,0.48606856309263313
44601,ALLIANCE,OH,14511,12156,-2355,0.45584430194622566
44606,APPLE CREEK,OH,1342,1141,-201,0.459524768425292
44608,BEACH CITY,OH,566,505,-61,0.4715219421101774
44609,ALLIANCE,OH,0,15,15,1
44609,BELOIT,OH,1088,986,-102,0.47540983606557374
44610,BERLIN,OH,13,0,-13,0
44611,BIG PRAIRIE,OH,150,170,20,0.53125
44612,BOLIVAR,OH,1765,1682,-83,0.4879605454017987
44613,BREWSTER,OH,715,617,-98,0.46321321321321324
44614,CANAL FULTON,OH,3602,3676,74,0.5050838142346799
44615,CARROLLTON,OH,3714,3520,-194,0.4865910975946917
44618,DALTON,OH,1564,1472,-92,0.48484848484848486
44619,DAMASCUS,OH,93,0,-93,0
44620,DELLROY,OH,247,164,-83,0.39902676399026765
44621,DENNISON,OH,1627,1667,40,0.5060716454159077
44622,DOVER,OH,6687,5890,-797,0.4683151785004373
44624,DUNDEE,OH,757,605,-152,0.44419970631424377
44625,EAST ROCHESTER,OH,178,197,19,0.5253333333333333
44626,EAST SPARTA,OH,1320,847,-473,0.39086294416243655
44627,FREDERICKSBRG,OH,33,12,-21,0.26666666666666666
44627,FREDERICKSBURG,OH,647,503,-144,0.4373913043478261
44628,GLENMONT,OH,64,72,8,0.5294117647058824
44629,GNADENHUTTEN,OH,593,575,-18,0.4922945205479452
44632,HARTVILLE,OH,3048,2903,-145,0.48781717358427157
44633,HOLMESVILLE,OH,220,213,-7,0.49191685912240185
44634,HOMEWORTH,OH,301,410,109,0.5766526019690577
44637,KILLBUCK,OH,656,571,-85,0.46536267318663405
44638,LAKEVILLE,OH,141,231,90,0.6209677419354839
44638,WOOSTER,OH,0,11,11,1
44641,LOUISVILLE,OH,6640,6263,-377,0.485390994342401
44643,MAGNOLIA,OH,1115,982,-133,0.4682880305197902
44644,MALVERN,OH,2346,1834,-512,0.438755980861244
44645,MARION,OH,14,11,-3,0.44
44645,MARSHALLVILLE,OH,683,478,-205,0.4117140396210164
44646,MASSILLON,OH,16988,15837,-1151,0.48246763137852244
44647,MASSILLON,OH,5513,5526,13,0.5005888214512184
44648,MASSILLON,OH,86,180,94,0.6766917293233082
44651,MECHANICSTOWN,OH,23,12,-11,0.34285714285714286
44653,MIDVALE,OH,55,0,-55,0
44654,MILLERSBURG,OH,4209,3726,-483,0.46956521739130436
44656,MINERAL CITY,OH,859,759,-100,0.46909765142150806
44656,ZOARVILLE,OH,42,36,-6,0.46153846153846156
44657,MINERVA,OH,3619,3226,-393,0.4712929145361578
44659,MOUNT EATON,OH,12,0,-12,0
44661,NASHVILLE,OH,0,13,13,1
44662,NAVARRE,OH,2779,2658,-121,0.4888725400036785
44663,NEW PHILADELPHIA,OH,10772,9397,-1375,0.46591303485547125
44666,NORTH LAWRENCE,OH,605,564,-41,0.48246364414029086
44667,ORRVILLE,OH,4873,4684,-189,0.4901119598200272
44669,PARIS,OH,123,106,-17,0.462882096069869
44672,SEBRING,OH,1828,1782,-46,0.4936288088642659
44675,SHERRODSVILLE,OH,535,507,-28,0.4865642994241843
44676,SHREVE,OH,1457,1193,-264,0.450188679245283
44677,SMITHVILLE,OH,947,806,-141,0.4597832287507131
44680,STRASBURG,OH,1426,1397,-29,0.4948636202621325
44681,SUGARCREEK,OH,1599,1392,-207,0.4653961885656971
44682,TUSCARAWAS,OH,70,38,-32,0.35185185185185186
44683,UHRICHSVILLE,OH,3211,3105,-106,0.49160861304623177
44685,UNIONTOWN,OH,7995,8185,190,0.5058714462299134
44688,WAYNESBURG,OH,996,843,-153,0.45840130505709625
44691,WOOSTER,OH,16369,15280,-1089,0.48279566494991943
44695,BOWERSTON,OH,167,134,-33,0.44518272425249167
44699,TIPPECANOE,OH,47,50,3,0.5154639175257731
44701,CANTON,OH,0,351,351,1
44702,CANTON,OH,899,806,-93,0.4727272727272727
44703,CANTON,OH,4812,4102,-710,0.46017500560915414
44704,CANTON,OH,1832,1646,-186,0.4732604945370903
44705,CANTON,OH,7102,6442,-660,0.47563496751329004
44705,SOMERDALE,OH,147,133,-14,0.475
44706,CANTON,OH,5931,5491,-440,0.48073892488180703
44707,CANTON,OH,5045,3609,-1436,0.41703258608735844
44708,CANTON,OH,10588,9692,-896,0.4779092702169625
44709,CANTON,OH,7576,6968,-608,0.4790979097909791
44709,NORTH CANTON,OH,125,152,27,0.5487364620938628
44710,CANTON,OH,4018,3423,-595,0.46001881467544686
44711,CANTON,OH,361,1027,666,0.7399135446685879
44714,CANTON,OH,3723,3523,-200,0.48619928236268284
44718,CANTON,OH,5360,6727,1367,0.5565483577397203
44718,JACKSON BELDEN,OH,121,145,24,0.5451127819548872
44720,NORTH CANTON,OH,14527,14183,-344,0.4940090560780216
44721,CANTON,OH,3538,3988,450,0.5298963592878023
44721,N CANTON,OH,73,90,17,0.5521472392638037
44730,EAST CANTON,OH,1523,1557,34,0.5055194805194805
44735,CANTON,OH,63,88,25,0.5827814569536424
44802,ALVADA,OH,11,24,13,0.6857142857142857
44804,ARCADIA,OH,78,40,-38,0.3389830508474576
44805,ASHLAND,OH,11844,11247,-597,0.4870728855398207
44807,ALLIANCE,OH,20,15,-5,0.42857142857142855
44807,ATTICA,OH,647,528,-119,0.4493617021276596
44809,BASCOM,OH,13,0,-13,0
44811,BELLEVUE,OH,4431,4122,-309,0.4819361627499123
44813,BELLVILLE,OH,2299,2225,-74,0.4918213969938108
44814,BERLIN HEIGHTS,OH,565,632,67,0.5279866332497911
44814,BERLIN HTS,OH,15,17,2,0.53125
44815,BETTSVILLE,OH,80,28,-52,0.25925925925925924
44817,BLOOMDALE,OH,166,90,-76,0.3515625
44818,BLOOMVILLE,OH,657,642,-15,0.4942263279445728
44820,BUCYRUS,OH,6781,6577,-204,0.4923641263662225
44822,BUTLER,OH,930,827,-103,0.4706886738759249
44824,CASTALIA,OH,1224,1211,-13,0.4973305954825462
44825,CHATFIELD,OH,11,0,-11,0
44826,COLLINS,OH,195,195,0,0.5
44827,CRESTLINE,OH,2707,2579,-128,0.487892546348846
44830,FOSTORIA,OH,8114,7392,-722,0.47671868953953306
44833,GALION,OH,7671,6789,-882,0.4695020746887967
44836,GREEN SPRINGS,OH,573,523,-50,0.4771897810218978
44837,GREENWICH,OH,1423,1237,-186,0.4650375939849624
44839,HURON,OH,5707,4917,-790,0.46282003012048195
44840,JEROMESVILLE,OH,659,688,29,0.5107646622123236
44841,KANSAS,OH,0,12,12,1
44842,LOUDONVILLE,OH,2109,1823,-286,0.4636317395727365
44843,LUCAS,OH,704,676,-28,0.48985507246376814
44844,MC CUTCHENVILLE,OH,37,24,-13,0.39344262295081966
44846,MILAN,OH,1356,1045,-311,0.4352353186172428
44847,MONROEVILLE,OH,1055,904,-151,0.4614599285349668
44849,NEVADA,OH,332,382,50,0.5350140056022409
44850,NEW HAVEN,OH,11,0,-11,0
44851,NEW LONDON,OH,1908,1826,-82,0.48901981788966253
44853,NEW RIEGEL,OH,12,49,37,0.8032786885245902
44854,NEW WASHINGTON,OH,454,370,-84,0.44902912621359226
44855,NORTH FAIRFIELD,OH,106,129,23,0.548936170212766
44857,NORWALK,OH,10562,9264,-1298,0.4672652073035408
44859,NOVA,OH,263,283,20,0.5183150183150184
44864,PERRYSVILLE,OH,968,752,-216,0.4372093023255814
44865,PLYMOUTH,OH,1561,1124,-437,0.4186219739292365
44866,POLK,OH,243,268,25,0.5244618395303327
44867,REPUBLIC,OH,351,399,48,0.532
44870,SANDUSKY,OH,19694,16297,-3397,0.45280764635603343
44871,SANDUSKY,OH,1247,859,-388,0.40788224121557454
44875,SHELBY,OH,5013,4652,-361,0.48132436627004654
44878,SHILOH,OH,678,516,-162,0.4321608040201005
44880,SULLIVAN,OH,486,636,150,0.5668449197860963
44881,SULPHUR SPRINGS,OH,11,14,3,0.56
44882,SYCAMORE,OH,719,654,-65,0.4763292061179898
44883,TIFFIN,OH,10663,9507,-1156,0.4713435795736242
44887,TIRO,OH,36,11,-25,0.23404255319148937
44889,WAKEMAN,OH,2084,2190,106,0.5124005615348619
44890,WILLARD,OH,4451,3918,-533,0.4681562910742024
44901,MANSFIELD,OH,243,451,208,0.6498559077809798
44902,MANSFIELD,OH,2947,2527,-420,0.4616368286445013
44903,MANSFIELD,OH,9028,8971,-57,0.4984165786988166
44903,ONTARIO,OH,579,547,-32,0.4857904085257549
44904,LEXINGTON,OH,1566,1456,-110,0.4818001323626737
44904,MANSFIELD,OH,3587,3349,-238,0.48284313725490197
44905,MANSFIELD,OH,4518,4412,-106,0.4940649496080627
44906,MANSFIELD,OH,6267,5235,-1032,0.4551382368283777
44906,ONTARIO,OH,1867,1576,-291,0.4577403427243683
44907,MANSFIELD,OH,7659,6779,-880,0.4695248649397423
45001,ADDYSTON,OH,201,122,-79,0.37770897832817335
45002,CLEVE,OH,91,65,-26,0.4166666666666667
45002,CLEVES,OH,4597,4757,160,0.5085524909129784
45003,COLLEGE CORNER,OH,112,38,-74,0.25333333333333335
45005,CARLISLE,OH,855,888,33,0.5094664371772806
45005,FRANKLIN,OH,9321,9883,562,0.5146323682566132
45011,FAIRFIELD TOWNSHIP,OH,4719,4834,115,0.506019051606825
45011,HAMILTON,OH,12470,13138,668,0.5130427991252734
45011,LIBERTY TWP,OH,2783,2856,73,0.5064727788615002
45011,WEST CHESTER,OH,715,731,16,0.5055325034578146
45012,HAMILTON,OH,763,209,-554,0.21502057613168724
45013,HAMILTON,OH,18065,17287,-778,0.48899637927132833
45014,FAIRFIELD,OH,19534,17615,-1919,0.47417157931572856
45014,HAMILTON,OH,367,289,-78,0.4405487804878049
45015,FAIRFIELD TOWNSHIP,OH,412,397,-15,0.4907292954264524
45015,HAMILTON,OH,3701,3326,-375,0.4733172050661733
45015,VILLAGE OF INDIAN SPRINGS,OH,69,58,-11,0.4566929133858268
45018,FAIRFIELD,OH,415,823,408,0.6647819063004846
45030,HARRISON,OH,6583,7379,796,0.528505944707062
45034,KINGS ISLAND,OH,0,16,16,1
45034,KINGS MILLS,OH,135,243,108,0.6428571428571429
45036,LEBANON,OH,11673,13066,1393,0.5281539269978577
45039,MAINEVILLE,OH,9152,10506,1354,0.534438905280293
45040,MASON,OH,19189,20595,1406,0.5176704202694551
45041,MIAMITOWN,OH,12,0,-12,0
45042,MIDDLETOWN,OH,9269,9818,549,0.514381516215225
45044,LIBERTY TOWNSHIP,OH,2086,1895,-191,0.47601105249937203
45044,MIDDLETOWN,OH,17755,17176,-579,0.4917122326872978
45050,MONROE,OH,3722,3971,249,0.5161835434810867
45052,NORTH BEND,OH,1138,1096,-42,0.4905998209489705
45053,OKEANA,OH,305,484,179,0.6134347275031685
45054,OREGONIA,OH,383,473,90,0.552570093457944
45056,OXFORD,OH,7848,5800,-2048,0.4249706916764361
45061,ROSS,OH,0,11,11,1
45062,SEVEN MILE,OH,109,11,-98,0.09166666666666666
45064,MIDDLETOWN,OH,14,13,-1,0.48148148148148145
45064,SOMERVILLE,OH,483,537,54,0.5264705882352941
45065,SOUTH LEBANON,OH,2629,3114,485,0.5422253177781647
45066,SPRINGBORO,OH,7272,8177,905,0.5292899216777786
45067,TRENTON,OH,5702,4807,-895,0.45741745170805975
45068,WAYNESVILLE,OH,2955,3240,285,0.5230024213075061
45069,LIBERTY TOWNSHIP,OH,2854,2668,-186,0.48315827598696126
45069,LIBERTY TOWNSHP,OH,444,534,90,0.5460122699386503
45069,WEST CHESTER,OH,15640,15594,-46,0.4992636229749632
45071,WEST CHESTER,OH,223,834,611,0.7890255439924314
45101,ABERDEEN,OH,1152,1011,-141,0.46740638002773927
45102,AMELIA,OH,9971,9783,-188,0.4952414700820087
45103,BATAVIA,OH,13317,13192,-125,0.497642310158814
45106,BETHEL,OH,3916,3757,-159,0.4896389938746253
45107,BLANCHESTER,OH,2852,2815,-37,0.49673548614787366
45111,CAMP DENNISON,OH,11,0,-11,0
45113,CLARKSVILLE,OH,1096,1277,181,0.5381373788453434
45118,FAYETTEVILLE,OH,1015,1064,49,0.5117845117845118
45118,MARATHON,OH,15,12,-3,0.4444444444444444
45120,FELICITY,OH,1289,1234,-55,0.48910027744748313
45121,GEORGETOWN,OH,4190,3448,-742,0.45142707515056296
45122,GOSHEN,OH,3104,3107,3,0.5002415070037031
45123,GREENFIELD,OH,2904,2902,-2,0.49982776438167414
45130,HAMERSVILLE,OH,1024,1011,-13,0.4968058968058968
45131,HIGGINSPORT,OH,35,11,-24,0.2391304347826087
45133,HILLSBORO,OH,8569,8281,-288,0.4914540059347181
45135,HGLND COUNTY,OH,43,61,18,0.5865384615384616
45135,HIGHLAND COUNTY,OH,47,34,-13,0.41975308641975306
45135,LEESBURG,OH,1257,1276,19,0.503750493485985
45140,LOVELAND,OH,17114,17232,118,0.5017178128457462
45142,LYNCHBURG,OH,1298,1118,-180,0.46274834437086093
45144,ADAMS COUNTY,OH,37,38,1,0.5066666666666667
45144,MANCHESTER,OH,1665,1662,-3,0.4995491433724076
45146,MARTINSVILLE,OH,286,294,8,0.506896551724138
45147,MIAMIVILLE,OH,11,13,2,0.5416666666666666
45148,MIDDLETOWN,OH,11,0,-11,0
45148,MIDLAND,OH,105,171,66,0.6195652173913043
45150,MILFORD,OH,11000,11265,265,0.5059510442398383
45152,MORROW,OH,3794,4943,1149,0.5657548357559803
45153,MOSCOW,OH,171,285,114,0.625
45153,POINT PLEASANT,OH,14,16,2,0.5333333333333333
45154,MOUNT ORAB,OH,3299,3330,31,0.5023382108915372
45157,NEW RICHMOND,OH,2901,3208,307,0.5251268620068751
45158,NEWTONSVILLE,OH,11,11,0,0.5
45159,NEW VIENNA,OH,1087,1066,-21,0.4951230840687413
45160,OWENSVILLE,OH,422,198,-224,0.3193548387096774
45162,PLEASANT PLAIN,OH,424,480,56,0.5309734513274337
45162,PLEASANT PLN,OH,24,29,5,0.5471698113207547
45164,PORT WILLIAM,OH,11,0,-11,0
45167,RIPLEY,OH,1433,1385,-48,0.4914833215046132
45168,RUSSELLVILLE,OH,180,157,-23,0.4658753709198813
45169,SABINA,OH,1787,1624,-163,0.476106713573732
45171,LAKE WAYNOKA,OH,145,154,9,0.5150501672240803
45171,SARDINIA,OH,1897,1799,-98,0.48674242424242425
45174,TERRACE PARK,OH,469,607,138,0.5641263940520446
45176,WILLIAMSBURG,OH,2874,2964,90,0.5077081192189106
45177,WILMINGTON,OH,8002,7614,-388,0.4875768442622951
45201,CINCINNATI,OH,11,209,198,0.95
45202,CINCINNATI,OH,16579,14120,-2459,0.45994983549952767
45203,CINCINNATI,OH,1283,1027,-256,0.4445887445887446
45204,CINCINNATI,OH,2815,2348,-467,0.4547743559945768
45204,QUEEN CITY,OH,62,88,26,0.5866666666666667
45205,CINCINNATI,OH,8238,6984,-1254,0.45880961765865197
45206,CINCINNATI,OH,7475,6667,-808,0.47143261207749965
45206,WALNUT HILLS,OH,193,191,-2,0.4973958333333333
45207,CINCINNATI,OH,2517,2130,-387,0.45836023240800516
45208,CINCINNATI,OH,8998,8157,-841,0.47548819586126495
45209,CINCINNATI,OH,8742,6856,-1886,0.43954353122195156
45211,CHEVIOT,OH,705,647,-58,0.47855029585798814
45211,CINCINNATI,OH,15018,13852,-1166,0.4798060270176654
45212,CINCINNATI,OH,7542,6444,-1098,0.46074646074646075
45212,NORWOOD,OH,3169,2816,-353,0.4705096073517126
45213,CINCINNATI,OH,4710,4389,-321,0.4823606989779097
45214,CINCINNATI,OH,3888,3346,-542,0.4625380149294996
45215,CINCINNATI,OH,10796,10492,-304,0.4928598271326569
45215,LOCKLAND,OH,288,289,1,0.5008665511265165
45215,READING,OH,306,324,18,0.5142857142857142
45215,WYOMING,OH,1371,1265,-106,0.4798937784522003
45216,CINCINNATI,OH,3450,3201,-249,0.4812810103743798
45217,CINCINNATI,OH,2260,2272,12,0.501323918799647
45217,SAINT BERNARD,OH,214,179,-35,0.455470737913486
45218,CINCINNATI,OH,1282,1271,-11,0.49784567175871525
45219,CINCINNATI,OH,8329,5168,-3161,0.38289990368229976
45220,CINCINNATI,OH,8717,6263,-2454,0.41809078771695596
45222,CINCINNATI,OH,125,34,-91,0.2138364779874214
45223,CINCINNATI,OH,6497,5744,-753,0.46924270892900904
45224,CINCINNATI,OH,7222,7231,9,0.5003113540441431
45225,CINCINNATI,OH,3753,3003,-750,0.44449378330373
45226,CINCINNATI,OH,3362,2952,-410,0.4675324675324675
45227,CINCINNATI,OH,8916,8292,-624,0.4818688981868898
45229,CINCINNATI,OH,6166,5609,-557,0.47634819532908707
45230,ANDERSON TOWNSHIP,OH,656,584,-72,0.47096774193548385
45230,CINCINNATI,OH,8921,8731,-190,0.4946181735780648
45230,MOUNT WASHINGTON,OH,200,250,50,0.5555555555555556
45231,CINCINNATI,OH,14310,14355,45,0.5007849293563579
45231,MOUNT HEALTHY,OH,602,692,90,0.5347758887171561
45232,CINCINNATI,OH,2755,2268,-487,0.45152299422655784
45233,CINCINNATI,OH,3470,3817,347,0.5238095238095238
45236,BLUE ASH,OH,1165,1124,-41,0.491044124071647
45236,CINCINNATI,OH,8309,8312,3,0.5000902472775405
45236,DEER PARK,OH,190,180,-10,0.4864864864864865
45236,SILVERTON,OH,183,150,-33,0.45045045045045046
45237,AMBERLEY,OH,195,204,9,0.5112781954887218
45237,CINCINNATI,OH,8419,7799,-620,0.48088543593538047
45238,CINCINNATI,OH,16724,14866,-1858,0.47059195948084837
45239,CINCINNATI,OH,9981,9364,-617,0.48405272680279143
45239,COLERAIN TOWNSHIP,OH,249,245,-4,0.4959514170040486
45239,GROESBECK,OH,178,168,-10,0.48554913294797686
45240,CINCINNATI,OH,10127,9490,-637,0.48376408217362493
45240,PARKDALE,OH,456,403,-53,0.4691501746216531
45241,BLUE ASH,OH,2351,1995,-356,0.4590427979751496
45241,CINCINNATI,OH,3240,3057,-183,0.48546927108146737
45241,SHARONVILLE,OH,400,334,-66,0.4550408719346049
45241,WEST CHESTER,OH,3343,3306,-37,0.49721762671078357
45242,BLUE ASH,OH,5681,5901,220,0.5094974961146607
45242,CINCINNATI,OH,2111,2501,390,0.5422810060711188
45242,MONTGOMERY,OH,1594,1757,163,0.5243210981796479
45243,CINCINNATI,OH,3836,4767,931,0.5541090317331163
45243,COLUMBIA TOWNSHIP,OH,152,242,90,0.6142131979695431
45243,MADEIRA,OH,81,81,0,0.5
45244,ANDERSON,OH,169,193,24,0.5331491712707183
45244,CINCINNATI,OH,7169,7410,241,0.5082653131216133
45244,NEWTOWN,OH,353,320,-33,0.475482912332838
45245,CINCINNATI,OH,8637,8613,-24,0.49930434782608696
45246,CINCINNATI,OH,5231,4902,-329,0.4837659133524129
45246,GLENDALE,OH,547,572,25,0.5111706881143878
45246,SPRINGDALE,OH,121,129,8,0.516
45246,WEST CHESTER,OH,557,526,-31,0.4856879039704525
45247,CINCINNATI,OH,6511,6472,-39,0.49849803589309094
45248,CINCINNATI,OH,6003,6020,17,0.5007069782916077
45249,CINCINNATI,OH,5834,5284,-550,0.47526533549199496
45249,MONTGOMERY,OH,916,891,-25,0.4930824571112341
45250,CINCINNATI,OH,146,726,580,0.8325688073394495
45251,CINCINNATI,OH,6964,6674,-290,0.489367942513565
45251,COLERAIN TOWNSHIP,OH,112,133,21,0.5428571428571428
45252,CINCINNATI,OH,1233,1281,48,0.5095465393794749
45252,COLERAIN TOWNSHIP,OH,30,26,-4,0.4642857142857143
45253,CINCINNATI,OH,136,474,338,0.7770491803278688
45253,GROESBECK,OH,0,63,63,1
45254,ANDERSON,OH,24,24,0,0.5
45254,CINCINNATI,OH,121,206,85,0.6299694189602446
45255,ANDERSON,OH,636,635,-1,0.4996066089693155
45255,CINCINNATI,OH,7679,7778,99,0.5032024325548295
45258,CINCINNATI,OH,35,64,29,0.6464646464646465
45262,CINCINNATI,OH,42,105,63,0.7142857142857143
45274,CINCINNATI,OH,0,67,67,1
45302,ANNA,OH,1447,1143,-304,0.4413127413127413
45303,ANSONIA,OH,1247,1002,-245,0.4455313472654513
45304,ARCANUM,OH,2068,2061,-7,0.4991523371276338
45304,CASTINE,OH,51,49,-2,0.49
45305,BELLBROOK,OH,3378,3651,273,0.5194195475885617
45306,BOTKINS,OH,370,338,-32,0.4774011299435028
45307,BOWERSVILLE,OH,11,0,-11,0
45308,BRADFORD,OH,1291,1163,-128,0.473920130399348
45309,BROOKVILLE,OH,3553,3617,64,0.5044630404463041
45311,CAMDEN,OH,1651,1431,-220,0.4643088903309539
45312,CASSTOWN,OH,119,96,-23,0.44651162790697674
45314,CEDARVILLE,OH,1006,753,-253,0.4280841387151791
45315,CLAYTON,OH,1165,1153,-12,0.497411561691113
45315,ENGLEWOOD,OH,384,415,31,0.5193992490613266
45317,CONOVER,OH,0,57,57,1
45318,COVINGTON,OH,1432,1482,50,0.5085792724776939
45320,EATON,OH,5367,5033,-334,0.48394230769230767
45321,ELDORADO,OH,81,23,-58,0.22115384615384615
45322,ENGLEWOOD,OH,7076,7147,71,0.5024959572523378
45322,UNION,OH,147,157,10,0.5164473684210527
45323,ENON,OH,1922,1737,-185,0.47471986881661654
45324,BEAVERCREEK,OH,514,454,-60,0.4690082644628099
45324,FAIRBORN,OH,22623,18351,-4272,0.4478693805828086
45325,FARMERSVILLE,OH,425,433,8,0.5046620046620046
45325,GERMANTOWN,OH,0,13,13,1
45326,FLETCHER,OH,57,68,11,0.544
45327,GERMANTOWN,OH,2930,2936,6,0.5005114217524719
45328,GETTYSBURG,OH,96,35,-61,0.26717557251908397
45330,GRATIS,OH,63,11,-52,0.14864864864864866
45331,GREENVILLE,OH,9963,9114,-849,0.4777480735964774
45332,HOLLANSBURG,OH,11,22,11,0.6666666666666666
45333,HOUSTON,OH,60,39,-21,0.3939393939393939
45334,JACKSON CENTER,OH,673,325,-348,0.3256513026052104
45334,JACKSON CTR,OH,185,72,-113,0.2801556420233463
45335,JAMESTOWN,OH,1990,1898,-92,0.4881687242798354
45337,LAURA,OH,341,208,-133,0.3788706739526412
45338,LEWISBURG,OH,1693,1536,-157,0.47568906782285536
45339,LUDLOW FALLS,OH,71,48,-23,0.40336134453781514
45340,MAPLEWOOD,OH,24,23,-1,0.48936170212765956
45341,MEDWAY,OH,1161,1215,54,0.5113636363636364
45342,MIAMISBURG,OH,18489,16509,-1980,0.4717126692953883
45343,MIAMISBURG,OH,174,227,53,0.5660847880299252
45344,NEW CARLISLE,OH,5059,4753,-306,0.48440684875662454
45345,NEW LEBANON,OH,2054,1929,-125,0.48430831031885513
45346,NEW MADISON,OH,504,419,-85,0.4539544962080173
45347,NEW PARIS,OH,1602,1296,-306,0.4472049689440994
45352,PALESTINE,OH,13,0,-13,0
45354,PHILLIPSBURG,OH,68,0,-68,0
45356,PIQUA,OH,10799,10087,-712,0.4829550895336589
45358,PITSBURG,OH,47,0,-47,0
45359,PLEASANT HILL,OH,555,371,-184,0.4006479481641469
45360,PORT JEFFERSON,OH,39,0,-39,0
45362,ROSSBURG,OH,37,44,7,0.5432098765432098
45363,RUSSIA,OH,87,23,-64,0.20909090909090908
45365,SIDNEY,OH,12919,11560,-1359,0.47224151313370644
45368,S CHARLESTON,OH,92,73,-19,0.44242424242424244
45368,SOUTH CHARLESTON,OH,1275,1345,70,0.5133587786259542
45369,SOUTH VIENNA,OH,1088,1021,-67,0.48411569464201043
45370,SPRING VALLEY,OH,432,503,71,0.5379679144385027
45371,TIPP,OH,150,151,1,0.5016611295681063
45371,TIPP CITY,OH,7126,8249,1123,0.536520325203252
45372,TREMONT CITY,OH,11,0,-11,0
45373,TROY,OH,13410,13430,20,0.5003725782414307
45377,VANDALIA,OH,6222,5456,-766,0.4672032882342867
45380,VERSAILLES,OH,1160,1100,-60,0.48672566371681414
45381,W ALEXANDRIA,OH,87,99,12,0.532258064516129
45381,WEST ALEXANDRIA,OH,1293,1351,58,0.5109682299546142
45382,WEST MANCHESTER,OH,92,154,62,0.6260162601626016
45383,WEST MILTON,OH,2367,2272,-95,0.4897607242940289
45384,WILBERFORCE,OH,12,0,-12,0
45385,XENIA,OH,13323,13560,237,0.5044079901796674
45387,YELLOW SPGS,OH,202,234,32,0.536697247706422
45387,YELLOW SPRINGS,OH,1812,1826,14,0.5019241341396372
45390,UNION CITY,OH,1265,1133,-132,0.4724770642201835
45401,DAYTON,OH,554,1142,588,0.6733490566037735
45402,DAYTON,OH,7679,7010,-669,0.4772278575805024
45403,DAYTON,OH,7027,6085,-942,0.46407870652837097
45404,DAYTON,OH,4741,4306,-435,0.4759588813971482
45404,RIVERSIDE,OH,115,102,-13,0.4700460829493088
45405,DAYTON,OH,10883,9497,-1386,0.4659960745829244
45406,DAYTON,OH,10322,10020,-302,0.49257693442139416
45409,DAYTON,OH,1821,1826,5,0.5006854949273375
45409,KETTERING,OH,709,718,9,0.5031534688156972
45409,OAKWOOD,OH,216,234,18,0.52
45410,DAYTON,OH,7591,6663,-928,0.4674477339694121
45413,DAYTON,OH,57,102,45,0.6415094339622641
45414,DAYTON,OH,8349,7611,-738,0.4768796992481203
45415,DAYTON,OH,4645,4523,-122,0.49334642233856896
45416,DAYTON,OH,1714,1900,186,0.5257332595462092
45416,TROTWOOD,OH,289,296,7,0.505982905982906
45417,DAYTON,OH,11127,10913,-214,0.4951451905626134
45419,DAYTON,OH,2340,2125,-215,0.47592385218365063
45419,KETTERING,OH,227,215,-12,0.48642533936651583
45419,OAKWOOD,OH,3425,3347,-78,0.49424099232132307
45420,DAYTON,OH,7475,7054,-421,0.48551173515038887
45420,KETTERING,OH,3155,2950,-205,0.4832104832104832
45424,DAYTON,OH,17819,16997,-822,0.48819508272058826
45424,HUBER HEIGHTS,OH,2238,2067,-171,0.4801393728222996
45426,DAYTON,OH,4764,4266,-498,0.47242524916943524
45426,TROTWOOD,OH,2448,2376,-72,0.4925373134328358
45429,CENTERVILLE,OH,461,536,75,0.5376128385155466
45429,DAYTON,OH,4685,4712,27,0.5014366287112908
45429,KETTERING,OH,4830,4799,-31,0.49839027936442
45430,BEAVERCREEK,OH,2297,2338,41,0.5044228694714131
45430,DAYTON,OH,167,181,14,0.5201149425287356
45431,BEAVERCREEK,OH,7969,7301,-668,0.47812704649639814
45431,DAYTON,OH,5217,4764,-453,0.4773068830778479
45432,BEAVERCREEK,OH,2532,2291,-241,0.4750155504872486
45432,DAYTON,OH,2534,2419,-115,0.4883908742176459
45433,DAYTON,OH,634,529,-105,0.4548581255374033
45433,WP AIR BASE,OH,80,78,-2,0.4936708860759494
45433,WPAFB,OH,120,107,-13,0.4713656387665198
45434,BEAVERCREEK,OH,2820,3351,531,0.5430238210986874
45434,BEAVERCREEK TOWNSHIP,OH,307,396,89,0.5633001422475107
45434,DAYTON,OH,207,215,8,0.509478672985782
45439,DAYTON,OH,1878,1838,-40,0.4946178686759957
45439,KETTERING,OH,465,495,30,0.515625
45439,MORAINE,OH,2468,2426,-42,0.4957090314671026
45440,BEAVERCREEK,OH,3989,3863,-126,0.49197656647987775
45440,BEAVERCREEK TOWNSHIP,OH,866,952,86,0.5236523652365237
45440,CENTERVILLE,OH,142,167,25,0.540453074433657
45440,DAYTON,OH,2961,2885,-76,0.4934998289428669
45440,KETTERING,OH,1219,1200,-19,0.49607275733774286
45449,DAYTON,OH,8138,7113,-1025,0.46639564618713525
45449,WEST CARROLLTON,OH,601,569,-32,0.4863247863247863
45449,WEST CARROLLTON CITY,OH,400,371,-29,0.48119325551232167
45458,CENTERVILLE,OH,685,759,74,0.525623268698061
45458,DAYTON,OH,12794,13324,530,0.5101462592847844
45459,CENTERVILLE,OH,912,1006,94,0.5245046923879041
45459,DAYTON,OH,11740,11798,58,0.5012320503016399
45475,DAYTON,OH,268,406,138,0.6023738872403561
45501,SPRINGFIELD,OH,458,646,188,0.5851449275362319
45502,SPRINGFIELD,OH,4109,4491,382,0.5222093023255814
45503,SPRINGFIELD,OH,12430,11106,-1324,0.47187287559483343
45504,SPRINGFIELD,OH,5726,5494,-232,0.4896613190730838
45505,SPRINGFIELD,OH,7514,6891,-623,0.4783755640402638
45506,SPRINGFIELD,OH,4324,4103,-221,0.4868873857837902
45601,CHILLICOTHE,OH,21453,19144,-2309,0.47156193807424196
45612,BAINBRIDGE,OH,1342,1209,-133,0.4739317914543316
45613,BEAVER,OH,1215,977,-238,0.44571167883211676
45614,BIDWELL,OH,1582,1465,-117,0.48080078765999346
45616,BLUE CREEK,OH,207,122,-85,0.3708206686930091
45619,CHESAPEAKE,OH,2280,2131,-149,0.48311040580367265
45620,CHESHIRE,OH,64,36,-28,0.36
45621,COALTON,OH,13,0,-13,0
45623,CROWN CITY,OH,876,787,-89,0.47324113048707156
45628,FRANKFORT,OH,1514,1489,-25,0.4958374958374958
45629,FRANKLIN FURNACE,OH,916,909,-7,0.4980821917808219
45631,GALLIPOLIS,OH,5936,5604,-332,0.4856152512998267
45634,HAMDEN,OH,392,380,-12,0.49222797927461137
45638,COAL GROVE,OH,661,555,-106,0.4564144736842105
45638,IRONTON,OH,6436,5807,-629,0.47431185167034223
45640,JACKSON,OH,5427,5450,23,0.5010572768226533
45644,KINGSTON,OH,1069,1180,111,0.5246776345042241
45645,KITTS HILL,OH,298,380,82,0.56047197640118
45646,LATHAM,OH,0,25,25,1
45647,LONDONDERRY,OH,630,621,-9,0.49640287769784175
45648,LUCASVILLE,OH,3309,3136,-173,0.48657874321179206
45650,LYNX,OH,11,0,-11,0
45651,MC ARTHUR,OH,2020,1807,-213,0.4721714136399268
45652,LUCASVILLE,OH,15,19,4,0.5588235294117647
45652,MC DERMOTT,OH,730,678,-52,0.4815340909090909
45653,MINFORD,OH,1236,1080,-156,0.46632124352331605
45654,NEW PLYMOUTH,OH,51,37,-14,0.42045454545454547
45656,OAK HILL,OH,2025,1795,-230,0.4698952879581152
45657,OTWAY,OH,623,485,-138,0.43772563176895307
45658,PATRIOT,OH,346,380,34,0.5234159779614325
45659,PEDRO,OH,359,404,45,0.5294888597640891
45660,PEEBLES,OH,3287,3010,-277,0.478005399396538
45661,PIKETON,OH,3042,2920,-122,0.48976853404897686
45662,PORTSMOUTH,OH,11871,11007,-864,0.481117230527144
45663,PORTSMOUTH,OH,57,40,-17,0.41237113402061853
45663,W PORTSMOUTH,OH,85,98,13,0.5355191256830601
45663,WEST PORTSMOUTH,OH,1568,1498,-70,0.4885844748858447
45669,PROCTORVILLE,OH,3435,2979,-456,0.4644527595884004
45672,RAY,OH,135,204,69,0.6017699115044248
45673,RICHMOND DALE,OH,13,0,-13,0
45674,RIO GRANDE,OH,0,11,11,1
45678,SCOTTOWN,OH,0,35,35,1
45679,SEAMAN,OH,812,829,17,0.5051797684338818
45680,SOUTH POINT,OH,4253,4020,-233,0.48591804665780247
45681,SOUTH SALEM,OH,162,233,71,0.589873417721519
45682,SOUTH WEBSTER,OH,477,391,-86,0.4504608294930876
45684,STOUT,OH,115,176,61,0.6048109965635738
45685,THURMAN,OH,253,244,-9,0.4909456740442656
45686,VINTON,OH,884,979,95,0.5254965110037574
45690,WAVERLY,OH,6119,5450,-669,0.4710865243322673
45692,WELLSTON,OH,2773,2814,41,0.5036692321460533
45693,WEST UNION,OH,4281,3379,-902,0.4411227154046997
45694,WHEELERSBURG,OH,3651,3574,-77,0.4946712802768166
45695,WILKESVILLE,OH,32,19,-13,0.37254901960784315
45696,WILLOW WOOD,OH,0,12,12,1
45697,WINCHESTER,OH,1535,1311,-224,0.460646521433591
45701,ATHENS,OH,12432,9627,-2805,0.4364205086359309
45710,ALBANY,OH,1603,1543,-60,0.49046408137317227
45711,AMESVILLE,OH,48,63,15,0.5675675675675675
45714,BELPRE,OH,3946,3813,-133,0.49142930790050265
45715,BEVERLY,OH,918,752,-166,0.4502994011976048
45716,BUCHTEL,OH,12,0,-12,0
45719,CHAUNCEY,OH,215,135,-80,0.38571428571428573
45723,COOLVILLE,OH,1081,972,-109,0.47345348270823184
45724,CUTLER,OH,126,144,18,0.5333333333333333
45727,DEXTER CITY,OH,53,47,-6,0.47
45729,FLEMING,OH,175,197,22,0.5295698924731183
45732,GLOUSTER,OH,1717,1661,-56,0.4917110716400237
45734,GRAYSVILLE,OH,14,11,-3,0.44
45735,GUYSVILLE,OH,190,222,32,0.5388349514563107
45740,JACKSONVILLE,OH,47,14,-33,0.22950819672131148
45741,LANGSVILLE,OH,14,11,-3,0.44
45742,LITTLE HOCKING,OH,730,665,-65,0.4767025089605735
45743,LONG BOTTOM,OH,124,82,-42,0.39805825242718446
45744,LOWELL,OH,795,577,-218,0.4205539358600583
45745,LOWER SALEM,OH,69,35,-34,0.33653846153846156
45750,MARIETTA,OH,10549,9493,-1056,0.47365532381997805
45760,MIDDLEPORT,OH,1679,1348,-331,0.4453254046911133
45761,MILLFIELD,OH,265,295,30,0.5267857142857143
45764,NELSONVILLE,OH,4290,3423,-867,0.44379618825359785
45766,NEW MARSHFIELD,OH,184,73,-111,0.2840466926070039
45767,NEW MATAMORAS,OH,813,606,-207,0.427061310782241
45768,NEWPORT,OH,450,235,-215,0.34306569343065696
45769,POMEROY,OH,2364,1990,-374,0.45705098759761137
45770,PORTLAND,OH,11,0,-11,0
45771,RACINE,OH,976,1030,54,0.5134596211365903
45772,REEDSVILLE,OH,214,229,15,0.5169300225733634
45773,RENO,OH,39,13,-26,0.25
45775,RUTLAND,OH,419,191,-228,0.31311475409836065
45778,STEWART,OH,72,39,-33,0.35135135135135137
45779,SYRACUSE,OH,34,23,-11,0.40350877192982454
45780,THE PLAINS,OH,1780,1800,20,0.5027932960893855
45784,VINCENT,OH,1026,908,-118,0.46949327817993797
45786,WATERFORD,OH,736,640,-96,0.46511627906976744
45788,WHIPPLE,OH,58,35,-23,0.3763440860215054
45801,LIMA,OH,9161,7910,-1251,0.46335891277605296
45802,BR,OH,12,14,2,0.5384615384615384
45802,LIMA,OH,252,451,199,0.6415362731152204
45804,LIMA,OH,6494,5845,-649,0.4737012723883621
45805,LIMA,OH,9328,8963,-365,0.49002241539554975
45806,CRIDERSVILLE,OH,650,699,49,0.5181616011860638
45806,FORT SHAWNEE,OH,149,146,-3,0.49491525423728816
45806,LIMA,OH,2523,2655,132,0.5127462340672074
45807,ELIDA,OH,636,559,-77,0.46778242677824267
45807,LIMA,OH,3020,2962,-58,0.495152123035774
45810,ADA,OH,2858,2191,-667,0.43394731630025746
45812,ALGER,OH,753,482,-271,0.3902834008097166
45813,ANTWERP,OH,1204,941,-263,0.4386946386946387
45814,ARLINGTON,OH,786,752,-34,0.4889466840052016
45817,BLUFFTON,OH,1722,1557,-165,0.47483989021043
45820,CAIRO,OH,72,12,-60,0.14285714285714285
45821,CECIL,OH,87,111,24,0.5606060606060606
45822,CELINA,OH,6931,6746,-185,0.49323682094026466
45827,CLOVERDALE,OH,194,92,-102,0.32167832167832167
45828,COLDWATER,OH,1661,1272,-389,0.4336856460961473
45830,COLUMBUS GROVE,OH,1318,1081,-237,0.45060441850771155
45830,COLUMBUS GRV,OH,35,37,2,0.5138888888888888
45831,CONTINENTAL,OH,625,666,41,0.5158791634391944
45832,CONVOY,OH,707,633,-74,0.47238805970149256
45833,DELPHOS,OH,3459,2940,-519,0.45944678856071264
45836,DUNKIRK,OH,190,129,-61,0.4043887147335423
45839,FINDLAY,OH,259,324,65,0.5557461406518011
45840,FINDLAY,OH,25698,22552,-3146,0.46739896373056994
45841,JENERA,OH,39,11,-28,0.22
45843,FOREST,OH,986,894,-92,0.475531914893617
45844,FORT JENNINGS,OH,447,397,-50,0.4703791469194313
45845,FORT LORAMIE,OH,604,398,-206,0.3972055888223553
45846,FORT RECOVERY,OH,722,463,-259,0.39071729957805906
45849,GROVER HILL,OH,173,178,5,0.5071225071225072
45850,HARROD,OH,817,698,-119,0.46072607260726073
45853,KALIDA,OH,37,14,-23,0.27450980392156865
45854,LAFAYETTE,OH,12,0,-12,0
45855,LATTY,OH,29,11,-18,0.275
45856,LEIPSIC,OH,1237,1071,-166,0.46403812824956675
45858,MC COMB,OH,922,680,-242,0.42446941323345816
45859,MC GUFFEY,OH,102,55,-47,0.3503184713375796
45860,MARIA STEIN,OH,35,38,3,0.5205479452054794
45862,MENDON,OH,390,204,-186,0.3434343434343434
45863,MIDDLE POINT,OH,178,92,-86,0.34074074074074073
45865,MINSTER,OH,1199,1114,-85,0.4816255944660614
45866,MONTEZUMA,OH,16,12,-4,0.42857142857142855
45867,MOUNT BLANCHARD,OH,136,99,-37,0.42127659574468085
45867,MT BLANCHARD,OH,31,35,4,0.5303030303030303
45869,NEW BREMEN,OH,909,790,-119,0.4649793996468511
45871,NEW KNOXVILLE,OH,144,223,79,0.6076294277929155
45872,NORTH BALTIMORE,OH,1805,1521,-284,0.45730607336139506
45873,MELROSE,OH,15,30,15,0.6666666666666666
45873,OAKWOOD,OH,660,548,-112,0.45364238410596025
45874,OHIO CITY,OH,463,373,-90,0.4461722488038278
45875,OTTAWA,OH,2655,2257,-398,0.4594869706840391
45876,OTTOVILLE,OH,70,12,-58,0.14634146341463414
45877,PANDORA,OH,462,316,-146,0.40616966580976865
45879,PAULDING,OH,2483,2340,-143,0.48517520215633425
45880,PAYNE,OH,681,643,-38,0.48564954682779454
45881,RAWSON,OH,238,146,-92,0.3802083333333333
45882,ROCKFORD,OH,736,649,-87,0.46859205776173285
45883,SAINT HENRY,OH,561,415,-146,0.42520491803278687
45885,SAINT MARYS,OH,5348,4859,-489,0.4760458508866464
45886,SCOTT,OH,36,13,-23,0.2653061224489796
45887,SPENCERVILLE,OH,1535,1294,-241,0.4574054436196536
45888,UNIOPOLIS,OH,14,0,-14,0
45889,VAN BUREN,OH,185,207,22,0.5280612244897959
45890,VANLUE,OH,0,12,12,1
45891,VAN WERT,OH,6508,6266,-242,0.4905276342570847
45894,VENEDOCIA,OH,11,0,-11,0
45895,WAPAKONETA,OH,5623,5461,-162,0.4926921688920967
45896,WAYNESFIELD,OH,477,385,-92,0.4466357308584687
45898,WILLSHIRE,OH,121,58,-63,0.3240223463687151
46001,ALEXANDRIA,IN,4460,3947,-513,0.4694897109551564
46011,ANDERSON,IN,6804,6177,-627,0.4758493182343425
46012,ANDERSON,IN,8216,8036,-180,0.4944622200344573
46013,ANDERSON,IN,9731,8064,-1667,0.4531610002809778
46015,ANDERSON,IN,11,27,16,0.7105263157894737
46016,ANDERSON,IN,11857,9714,-2143,0.45032682768531823
46017,ANDERSON,IN,2312,2190,-122,0.4864504664593514
46017,CHESTERFIELD,IN,285,285,0,0.5
46018,ANDERSON,IN,93,257,164,0.7342857142857143
46030,ARCADIA,IN,907,876,-31,0.4913067863151991
46031,ATLANTA,IN,448,577,129,0.5629268292682926
46032,CARMEL,IN,26231,26146,-85,0.49918857513794224
46033,CARMEL,IN,11476,12822,1346,0.5276977529014734
46034,CICERO,IN,2659,2832,173,0.5157530504461847
46035,COLFAX,IN,209,252,43,0.5466377440347071
46036,ELWOOD,IN,5460,5122,-338,0.48402948402948404
46037,FISHERS,IN,16207,18520,2313,0.5333026175598238
46038,FISHERS,IN,19534,19332,-202,0.497401327638553
46039,FOREST,IN,13,13,0,0.5
46040,FISHERS,IN,363,556,193,0.6050054406964092
46040,FORTVILLE,IN,4365,5997,1632,0.5787492762015055
46041,FRANKFORT,IN,9477,8626,-851,0.47649560846268574
46044,FRANKTON,IN,849,784,-65,0.48009797917942437
46048,INGALLS,IN,730,755,25,0.5084175084175084
46049,KEMPTON,IN,35,25,-10,0.4166666666666667
46050,KIRKLIN,IN,280,331,51,0.5417348608837971
46051,LAPEL,IN,1309,969,-340,0.4253731343283582
46052,LEBANON,IN,10383,9789,-594,0.4852766210588935
46055,FISHERS,IN,381,491,110,0.5630733944954128
46055,MCCORDSVILLE,IN,4111,5529,1418,0.5735477178423236
46056,MARKLEVILLE,IN,507,554,47,0.5221489161168709
46057,MICHIGANTOWN,IN,248,117,-131,0.32054794520547947
46058,MULBERRY,IN,796,713,-83,0.47249834327369117
46060,NOBLESVILLE,IN,19913,20003,90,0.5011273674716905
46061,NOBLESVILLE,IN,249,400,151,0.6163328197226502
46062,NOBLESVILLE,IN,10373,12390,2017,0.5443043535562097
46062,WESTFIELD,IN,2657,3406,749,0.561768101599868
46063,ORESTES,IN,59,0,-59,0
46064,PENDLETON,IN,5536,6396,860,0.5360375460945357
46065,ROSSVILLE,IN,940,903,-37,0.4899620184481823
46068,SHARPSVILLE,IN,534,581,47,0.5210762331838565
46069,SHERIDAN,IN,2234,2538,304,0.5318524727577536
46070,SUMMITVILLE,IN,587,596,9,0.503803888419273
46071,THORNTOWN,IN,1263,1189,-74,0.48491027732463293
46072,TIPTON,IN,3281,3305,24,0.501822046765867
46074,CARMEL,IN,4043,5909,1866,0.59375
46074,WESTFIELD,IN,9713,14139,4426,0.5927804796243502
46075,WHITESTOWN,IN,3481,5002,1521,0.5896498880113168
46076,WINDFALL,IN,317,279,-38,0.46812080536912754
46077,ZIONSVILLE,IN,12065,13035,970,0.5193227091633467
46082,CARMEL,IN,515,835,320,0.6185185185185185
46102,ADVANCE,IN,0,12,12,1
46103,AMO,IN,11,0,-11,0
46104,ARLINGTON,IN,73,57,-16,0.43846153846153846
46105,BAINBRIDGE,IN,576,687,111,0.5439429928741093
46106,BARGERSVILLE,IN,3152,4029,877,0.5610639186742793
46107,BEECH GROVE,IN,8390,6649,-1741,0.44211716204534873
46111,BROOKLYN,IN,62,24,-38,0.27906976744186046
46112,BROWNSBURG,IN,14705,16668,1963,0.5312848627800976
46113,CAMBY,IN,8253,7941,-312,0.49036680251945164
46115,CARTHAGE,IN,427,527,100,0.5524109014675053
46118,CLAYTON,IN,1505,1595,90,0.5145161290322581
46120,CLOVERDALE,IN,2359,2307,-52,0.4944277753964852
46121,COATESVILLE,IN,1723,1953,230,0.5312840043525572
46122,DANVILLE,IN,5958,6567,609,0.524311377245509
46123,AVON,IN,16396,17265,869,0.5129081132467841
46124,EDINBURGH,IN,2831,2796,-35,0.49688999466856226
46126,FAIRLAND,IN,1551,1483,-68,0.488793671720501
46127,FALMOUTH,IN,11,0,-11,0
46128,FILLMORE,IN,620,667,47,0.5182595182595182
46130,FOUNTAINTOWN,IN,734,641,-93,0.4661818181818182
46131,FRANKLIN,IN,15489,14514,-975,0.48375162483751627
46133,GLENWOOD,IN,27,25,-2,0.4807692307692308
46135,GREENCASTLE,IN,7778,7107,-671,0.47746053073563993
46140,GREENFIELD,IN,17296,18046,750,0.5106106049459567
46142,GREENWOOD,IN,14407,13915,-492,0.4913141727279147
46143,GREENWOOD,IN,28280,29240,960,0.5083449235048678
46147,JAMESTOWN,IN,717,749,32,0.5109140518417462
46148,KNIGHTSTOWN,IN,1817,1661,-156,0.4775733179988499
46149,LIZTON,IN,460,427,-33,0.4813979706877114
46150,MANILLA,IN,52,33,-19,0.38823529411764707
46151,MARTINSVILLE,IN,14961,12870,-2091,0.462433976501024
46156,MILROY,IN,474,256,-218,0.3506849315068493
46157,MONROVIA,IN,1158,1405,247,0.5481857198595396
46158,MOORESVILLE,IN,8972,8977,5,0.5001392835255446
46160,MORGANTOWN,IN,1899,2085,186,0.5233433734939759
46160,NEW PALESTINE,IN,41,53,12,0.5638297872340425
46161,MORRISTOWN,IN,888,733,-155,0.4521900061690315
46162,NEEDHAM,IN,0,12,12,1
46163,NEW PALESTINE,IN,3533,4447,914,0.5572681704260651
46164,NINEVEH,IN,1731,1700,-31,0.49548236665695133
46165,NORTH SALEM,IN,262,215,-47,0.45073375262054505
46166,PARAGON,IN,710,789,79,0.5263509006004002
46167,PITTSBORO,IN,2053,2512,459,0.5502738225629792
46168,PLAINFIELD,IN,17117,18240,1123,0.5158808722459485
46171,REELSVILLE,IN,286,471,185,0.6221928665785997
46172,ROACHDALE,IN,800,781,-19,0.4939911448450348
46173,RUSHVILLE,IN,4987,4338,-649,0.46520107238605896
46175,RUSSELLVILLE,IN,11,0,-11,0
46176,SHELBYVILLE,IN,14286,13082,-1204,0.47800350774627304
46180,STILESVILLE,IN,75,62,-13,0.45255474452554745
46181,TRAFALGAR,IN,1650,1741,91,0.513417870834562
46182,WALDRON,IN,424,326,-98,0.43466666666666665
46184,NEW WHITELAND,IN,367,382,15,0.5100133511348465
46184,WHITELAND,IN,4110,4506,396,0.5229805013927576
46186,WILKINSON,IN,348,212,-136,0.37857142857142856
46201,INDIANAPOLIS,IN,21031,18659,-2372,0.4701184177374654
46202,INDIANAPOLIS,IN,17671,14995,-2676,0.45903998040776345
46203,INDIANAPOLIS,IN,23874,20533,-3341,0.4623820568829239
46204,INDIANAPOLIS,IN,12212,9828,-2384,0.4459165154264973
46205,INDIANAPOLIS,IN,17628,16011,-1617,0.47596539730669757
46206,INDIANAPOLIS,IN,1703,1669,-34,0.49495848161328587
46208,INDIANAPOLIS,IN,12691,11681,-1010,0.47927950106679795
46214,INDIANAPOLIS,IN,19536,15277,-4259,0.43883032200614713
46216,INDIANAPOLIS,IN,2355,2064,-291,0.46707399864222676
46217,INDIANAPOLIS,IN,16394,15831,-563,0.4912645461598138
46218,INDIANAPOLIS,IN,16833,15770,-1063,0.4836978192190903
46219,INDIANAPOLIS,IN,20031,17208,-2823,0.46209618947877223
46220,INDIANAPOLIS,IN,21443,19179,-2264,0.472133326768746
46221,INDIANAPOLIS,IN,13534,12301,-1233,0.47613702341784403
46222,INDIANAPOLIS,IN,19566,16705,-2861,0.4605607785834413
46224,INDIANAPOLIS,IN,23129,19519,-3610,0.457676796098293
46224,SPEEDWAY,IN,903,818,-85,0.47530505520046484
46225,INDIANAPOLIS,IN,4621,3905,-716,0.4580107905231058
46226,INDIANAPOLIS,IN,23362,21135,-2227,0.47497584106793717
46227,INDIANAPOLIS,IN,39761,32880,-6881,0.45263694057075204
46228,INDIANAPOLIS,IN,6221,5617,-604,0.4744889339415442
46229,INDIANAPOLIS,IN,17011,13684,-3327,0.4458055057827008
46230,INDIANAPOLIS,IN,0,23,23,1
46231,INDIANAPOLIS,IN,3928,3969,41,0.5025959225022161
46234,CLERMONT,IN,410,467,57,0.5324971493728621
46234,INDIANAPOLIS,IN,11039,11565,526,0.5116351088302955
46235,INDIANAPOLIS,IN,18124,14093,-4031,0.43743986094298043
46235,INDPLS,IN,297,197,-100,0.39878542510121456
46236,INDIANAPOLIS,IN,8665,9254,589,0.5164350689212568
46237,INDIANAPOLIS,IN,22121,21005,-1116,0.4870611695960673
46239,INDIANAPOLIS,IN,12527,13707,1180,0.522489898604864
46239,WANAMAKER,IN,259,288,29,0.526508226691042
46240,INDIANAPOLIS,IN,15900,13561,-2339,0.46030345202131634
46241,INDIANAPOLIS,IN,17790,14809,-2981,0.45427773858093806
46242,INDIANAPOLIS,IN,298,705,407,0.7028913260219342
46244,INDIANAPOLIS,IN,170,655,485,0.793939393939394
46244,SPEEDWAY,IN,13,16,3,0.5517241379310345
46247,INDIANAPOLIS,IN,36,306,270,0.8947368421052632
46250,INDIANAPOLIS,IN,16328,13411,-2917,0.45095665624264436
46253,EAGLE CREEK,IN,22,32,10,0.5925925925925926
46253,INDIANAPOLIS,IN,401,1078,677,0.7288708586883029
46254,INDIANAPOLIS,IN,25143,20401,-4742,0.44794045318812575
46256,CASTLETON,IN,194,167,-27,0.4626038781163435
46256,INDIANAPOLIS,IN,10604,9975,-629,0.4847174303902036
46259,INDIANAPOLIS,IN,3375,4201,826,0.5545142555438226
46260,INDIANAPOLIS,IN,20092,17717,-2375,0.4685921341479542
46268,INDIANAPOLIS,IN,15411,14262,-1149,0.48063896471539785
46278,INDIANAPOLIS,IN,3121,3091,-30,0.4975853187379266
46280,CARMEL,IN,4177,4126,-51,0.49692882090810553
46280,INDIANAPOLIS,IN,320,306,-14,0.48881789137380194
46290,CARMEL,IN,146,99,-47,0.40408163265306124
46290,INDIANAPOLIS,IN,11,50,39,0.819672131147541
46301,BEVERLY SHORES,IN,278,277,-1,0.4990990990990991
46303,CEDAR LAKE,IN,5336,6416,1080,0.5459496255956433
46304,CHESTERTON,IN,10614,10753,139,0.5032526793653765
46307,CROWN POINT,IN,20181,21180,999,0.5120765938927976
46308,CROWN POINT,IN,572,644,72,0.5296052631578947
46310,DEMOTTE,IN,5325,4789,-536,0.4735020763298398
46311,DYER,IN,5279,6390,1111,0.5476047647613335
46312,EAST CHICAGO,IN,9161,7963,-1198,0.4650198551740248
46312,GRIFFITH,IN,196,153,-43,0.4383954154727794
46319,GRIFFITH,IN,8925,6032,-2893,0.4032894296984689
46320,HAMMOND,IN,5389,4825,-564,0.4723908361073037
46321,MUNCIE,IN,100,143,43,0.588477366255144
46321,MUNSTER,IN,6133,6315,182,0.507310411311054
46322,HAMMOND,IN,182,187,5,0.5067750677506775
46322,HIGHLAND,IN,7444,6852,-592,0.47929490766648014
46323,HAMMOND,IN,7919,6808,-1111,0.4622801656820805
46324,HAMMOND,IN,7674,6573,-1101,0.4613602863760792
46325,HAMMOND,IN,432,293,-139,0.40413793103448276
46327,HAMMOND,IN,2872,2465,-407,0.46186996439947536
46340,HANNA,IN,248,91,-157,0.26843657817109146
46341,HEBRON,IN,2910,2863,-47,0.4959293261735666
46342,HOBART,IN,12105,10792,-1313,0.47132812158798093
46346,KINGSFORD HEIGHTS,IN,448,357,-91,0.4434782608695652
46346,KINGSFORD HTS,IN,25,15,-10,0.375
46347,KOUTS,IN,1322,1248,-74,0.4856031128404669
46348,LA CROSSE,IN,155,62,-93,0.2857142857142857
46349,LAKE VILLAGE,IN,1049,1078,29,0.5068171133051246
46350,LA PORTE,IN,15112,14517,-595,0.48995916163218467
46350,LAPORTE,IN,265,256,-9,0.491362763915547
46352,LA PORTE,IN,232,568,336,0.71
46356,LOWELL,IN,5565,5767,202,0.5089128132721497
46360,MICHIGAN CITY,IN,22268,17504,-4764,0.4401086191290355
46361,MICHIGAN CITY,IN,662,1279,617,0.6589386913961875
46365,MILL CREEK,IN,11,37,26,0.7708333333333334
46366,NORTH JUDSON,IN,2121,1991,-130,0.48419260700389105
46368,PORTAGE,IN,19751,16242,-3509,0.45125441057983495
46371,ROLLING PR,IN,67,57,-10,0.4596774193548387
46371,ROLLING PRAIRIE,IN,883,879,-4,0.4988649262202043
46372,ROSELAWN,IN,11,14,3,0.56
46373,SAINT JOHN,IN,3669,5382,1713,0.5946304275770633
46374,SAN PIERRE,IN,167,130,-37,0.4377104377104377
46375,SCHERERVILLE,IN,7295,7623,328,0.5109934307547929
46376,SCHNEIDER,IN,12,11,-1,0.4782608695652174
46381,THAYER,IN,11,0,-11,0
46382,UNION MILLS,IN,439,462,23,0.5127635960044395
46383,VALPARAISO,IN,18566,16677,-1889,0.47320035184291914
46384,VALPARAISO,IN,466,760,294,0.6199021207177814
46385,VALPARAISO,IN,12372,12928,556,0.5109881422924901
46385,VALPO,IN,601,691,90,0.5348297213622291
46390,WANATAH,IN,703,605,-98,0.4625382262996942
46391,WESTVILLE,IN,2327,2276,-51,0.4944601346947643
46392,WHEATFIELD,IN,2538,2681,143,0.5136999425177237
46394,WHITING,IN,3540,3231,-309,0.4771821001329198
46401,GARY,IN,217,1002,785,0.8219852337981952
46402,GARY,IN,2361,1924,-437,0.4490081680280047
46403,GARY,IN,5033,4794,-239,0.4878396255215223
46404,GARY,IN,6331,5939,-392,0.48402607986960067
46405,LAKE STATION,IN,3953,3900,-53,0.4966254934419967
46406,GARY,IN,3342,3101,-241,0.4812975322054943
46407,GARY,IN,4647,3897,-750,0.45610955056179775
46408,GARY,IN,5736,5390,-346,0.4844508358799209
46409,GARY,IN,2905,2952,47,0.5040122929827556
46410,GARY,IN,306,276,-30,0.4742268041237113
46410,MERRILLVILLE,IN,16280,15572,-708,0.4888860982041944
46411,MERRILLVILLE,IN,636,1096,460,0.6327944572748267
46501,ARGOS,IN,1400,1330,-70,0.48717948717948717
46504,BOURBON,IN,923,974,51,0.5134422772799156
46506,BREMEN,IN,3005,2914,-91,0.4923128906909951
46507,BRISTOL,IN,3536,3513,-23,0.49836856291672577
46510,CLARKSVILLE,IN,14,27,13,0.6585365853658537
46510,CLAYPOOL,IN,1104,1008,-96,0.4772727272727273
46511,CULVER,IN,1881,1720,-161,0.4776450985837267
46514,ELKHART,IN,19615,16971,-2644,0.4638659596566993
46515,ELKHART,IN,990,1700,710,0.6319702602230484
46516,ELKHART,IN,17854,12871,-4983,0.41890968266883644
46517,ELKHART,IN,8354,7137,-1217,0.46071912723516883
46524,ETNA GREEN,IN,534,362,-172,0.40401785714285715
46526,GOSHEN,IN,13046,10758,-2288,0.45194085027726433
46527,GOSHEN,IN,312,139,-173,0.3082039911308204
46528,GOSHEN,IN,8430,6967,-1463,0.452490744950315
46530,GRANGER,IN,10669,10925,256,0.5059275724738354
46531,GROVERTOWN,IN,240,241,1,0.501039501039501
46532,HAMLET,IN,577,629,52,0.521558872305141
46534,KNOX,IN,5265,4377,-888,0.45395146235220907
46536,LAKEVILLE,IN,1315,1321,6,0.5011380880121397
46536,WARSAW,IN,43,27,-16,0.38571428571428573
46537,LAPAZ,IN,50,58,8,0.5370370370370371
46538,LEESBURG,IN,1853,1731,-122,0.4829799107142857
46539,MENTONE,IN,815,699,-116,0.4616908850726552
46540,MIDDLEBURY,IN,3559,3531,-28,0.49802538787023976
46542,MILFORD,IN,1378,1345,-33,0.4939405067939772
46543,GOSHEN,IN,14,0,-14,0
46543,MILLERSBURG,IN,687,504,-183,0.42317380352644834
46544,MISHAWAKA,IN,16415,13347,-3068,0.4484577649351522
46545,MISHAWAKA,IN,16589,12624,-3965,0.4321363776400917
46546,MISHAWAKA,IN,1050,469,-581,0.3087557603686636
46550,NAPPANEE,IN,4612,3900,-712,0.4581766917293233
46552,NEW CARLISLE,IN,2113,2080,-33,0.4960648700214643
46553,NEW PARIS,IN,961,1061,100,0.5247279920870426
46554,NORTH LIBERTY,IN,1758,1540,-218,0.46694966646452396
46555,NORTH WEBSTER,IN,2082,1779,-303,0.46076146076146074
46556,NOTRE DAME,IN,135,330,195,0.7096774193548387
46561,OSCEOLA,IN,4694,4656,-38,0.4979679144385027
46562,PIERCETON,IN,1942,1806,-136,0.4818569903948773
46563,PLYMOUTH,IN,9877,8566,-1311,0.4644580599685518
46565,SHIPSHEWANA,IN,1958,1741,-217,0.4706677480400108
46567,SYRACUSE,IN,5221,4515,-706,0.46374281018898933
46570,TIPPECANOE,IN,11,34,23,0.7555555555555555
46571,TOPEKA,IN,1344,1050,-294,0.43859649122807015
46573,WAKARUSA,IN,862,852,-10,0.4970828471411902
46574,ELKHART,IN,122,134,12,0.5234375
46574,WALKERTON,IN,2704,2443,-261,0.4746454245191374
46580,WARSAW,IN,9764,9229,-535,0.48591586373927237
46581,WARSAW,IN,430,464,34,0.5190156599552572
46582,WARSAW,IN,6152,6000,-152,0.4937458854509546
46590,WINONA LAKE,IN,1939,1806,-133,0.4822429906542056
46601,SOUTH BEND,IN,5452,3482,-1970,0.3897470338034475
46613,SOUTH BEND,IN,6921,4732,-2189,0.4060756886638634
46614,SOUTH BEND,IN,12798,10506,-2292,0.45082389289392377
46615,SOUTH BEND,IN,7808,6299,-1509,0.4465159140852059
46616,SOUTH BEND,IN,3389,2701,-688,0.4435139573070608
46617,SOUTH BEND,IN,6012,4488,-1524,0.42742857142857144
46619,SOUTH BEND,IN,7956,6515,-1441,0.4502107663603068
46624,SOUTH BEND,IN,973,1020,47,0.5117912694430506
46628,SOUTH BEND,IN,11987,10417,-1570,0.46496161399750047
46634,SOUTH BEND,IN,240,67,-173,0.2182410423452769
46635,SOUTH BEND,IN,2299,1896,-403,0.45196662693682954
46637,SOUTH BEND,IN,8521,6263,-2258,0.423633658008658
46660,SOUTH BEND,IN,485,202,-283,0.2940320232896652
46680,SOUTH BEND,IN,387,111,-276,0.22289156626506024
46701,ALBION,IN,2811,2645,-166,0.4847873900293255
46702,ANDREWS,IN,813,703,-110,0.4637203166226913
46703,ANGOLA,IN,11593,8772,-2821,0.4307390130125215
46704,ARCOLA,IN,12,0,-12,0
46705,ASHLEY,IN,748,624,-124,0.45481049562682213
46706,AUBURN,IN,8355,7940,-415,0.48726603252531453
46710,AVILLA,IN,1750,1756,6,0.5008556759840274
46711,BERNE,IN,2231,2107,-124,0.48570769940064545
46714,BLUFFTON,IN,7483,6644,-839,0.47030508954484324
46721,BUTLER,IN,2474,1920,-554,0.4369594902139281
46723,CHURUBUSCO,IN,2276,2304,28,0.503056768558952
46725,COLUMBIA CITY,IN,10314,8889,-1425,0.4628964224339947
46730,CORUNNA,IN,359,128,-231,0.26283367556468173
46732,CROMWELL,IN,1709,1179,-530,0.4082409972299169
46733,DECATUR,IN,7061,6170,-891,0.4663290756556572
46737,FREMONT,IN,3627,3467,-160,0.48872286439244433
46738,GARRETT,IN,3774,3452,-322,0.47771934680321065
46740,GENEVA,IN,1053,829,-224,0.4404888416578108
46741,GRABILL,IN,660,647,-13,0.495026778882938
46742,HAMILTON,IN,1596,1521,-75,0.4879692011549567
46743,HARLAN,IN,529,518,-11,0.49474689589302767
46745,HOAGLAND,IN,280,192,-88,0.4067796610169492
46746,HOWE,IN,1541,1250,-291,0.44786814761734145
46747,HUDSON,IN,1097,981,-116,0.4720885466794995
46748,HUNTERTOWN,IN,2539,2815,276,0.5257751214045573
46750,HUNTINGTON,IN,13313,10524,-2789,0.4414985107186307
46755,KENDALLVILLE,IN,7625,6549,-1076,0.4620431776492169
46759,KEYSTONE,IN,12,0,-12,0
46760,KIMMELL,IN,270,148,-122,0.35406698564593303
46761,LAGRANGE,IN,3945,3198,-747,0.44771104577908444
46763,LAOTTO,IN,168,236,68,0.5841584158415841
46764,LARWILL,IN,96,37,-59,0.2781954887218045
46765,LEO,IN,1285,1400,115,0.521415270018622
46765,LEO CEDARVILLE,IN,118,158,40,0.572463768115942
46767,LIGONIER,IN,2767,2370,-397,0.46135876970994744
46770,MARKLE,IN,832,771,-61,0.4809731752963194
46772,MONROE,IN,480,228,-252,0.3220338983050847
46773,MONROEVILLE,IN,909,887,-22,0.4938752783964365
46774,NEW HAVEN,IN,7238,6209,-1029,0.46173867777199373
46776,ORLAND,IN,623,557,-66,0.47203389830508474
46777,OSSIAN,IN,2299,2164,-135,0.4848756441855254
46779,PLEASANT LAKE,IN,774,625,-149,0.44674767691208006
46781,PONETO,IN,52,49,-3,0.48514851485148514
46783,ROANOKE,IN,2337,2587,250,0.5253858651502843
46784,ROME CITY,IN,847,777,-70,0.47844827586206895
46785,SAINT JOE,IN,346,227,-119,0.3961605584642234
46787,SOUTH WHITLEY,IN,1365,1226,-139,0.4731763797761482
46788,SPENCERVILLE,IN,663,512,-151,0.4357446808510638
46791,UNIONDALE,IN,46,58,12,0.5576923076923077
46792,WARREN,IN,1146,1156,10,0.5021720243266724
46793,WATERLOO,IN,1905,1520,-385,0.44379562043795623
46794,WAWAKA,IN,160,137,-23,0.4612794612794613
46795,WOLCOTTVILLE,IN,2363,2341,-22,0.4976615646258503
46796,WOLFLAKE,IN,14,0,-14,0
46797,NEW HAVEN,IN,20,30,10,0.6
46797,WOODBURN,IN,1251,1107,-144,0.46946564885496184
46798,YODER,IN,398,364,-34,0.4776902887139108
46799,ZANESVILLE,IN,14,11,-3,0.44
46802,FORT WAYNE,IN,7680,6542,-1138,0.459991562368162
46803,FORT WAYNE,IN,5312,4495,-817,0.45834607933109006
46804,FORT WAYNE,IN,13876,12327,-1549,0.4704423157653704
46805,FORT WAYNE,IN,13134,10058,-3076,0.4336840289755088
46806,FORT WAYNE,IN,14551,11088,-3463,0.4324661648270213
46807,FORT WAYNE,IN,7917,6773,-1144,0.46106194690265484
46808,FORT WAYNE,IN,10824,9138,-1686,0.45776976254884283
46809,FORT WAYNE,IN,4780,3808,-972,0.4434094084769446
46814,FORT WAYNE,IN,4765,6085,1320,0.5608294930875576
46815,FORT WAYNE,IN,10976,9424,-1552,0.4619607843137255
46816,FORT WAYNE,IN,10558,8906,-1652,0.45756267981915333
46818,FORT WAYNE,IN,8891,9332,441,0.5121000932887011
46819,FORT WAYNE,IN,4684,3450,-1234,0.4241455618391935
46825,FORT WAYNE,IN,17692,14386,-3306,0.44846935594488435
46835,FORT WAYNE,IN,16071,14485,-1586,0.4740476502159969
46835,FT WAYNE,IN,340,283,-57,0.45425361155698235
46845,FORT WAYNE,IN,8612,10337,1725,0.5455169138213098
46850,FORT WAYNE,IN,0,12,12,1
46852,FORT WAYNE,IN,12,0,-12,0
46853,FORT WAYNE,IN,0,37,37,1
46885,FORT WAYNE,IN,403,220,-183,0.35313001605136435
46895,FORT WAYNE,IN,193,12,-181,0.05853658536585366
46896,FORT WAYNE,IN,111,11,-100,0.09016393442622951
46898,FORT WAYNE,IN,348,324,-24,0.48214285714285715
46899,FORT WAYNE,IN,41,11,-30,0.21153846153846154
46901,KOKOMO,IN,26473,16970,-9503,0.39062679833344843
46902,KOKOMO,IN,20583,16498,-4085,0.44491788247350395
46903,KOKOMO,IN,142,76,-66,0.3486238532110092
46904,KOKOMO,IN,640,191,-449,0.22984356197352587
46910,AKRON,IN,937,747,-190,0.44358669833729214
46911,AMBOY,IN,160,154,-6,0.49044585987261147
46913,BRINGHURST,IN,140,110,-30,0.44
46914,BUNKER HILL,IN,559,481,-78,0.4625
46915,BURLINGTON,IN,129,58,-71,0.31016042780748665
46917,CAMDEN,IN,375,404,29,0.5186136071887034
46919,CONVERSE,IN,725,630,-95,0.46494464944649444
46923,DELPHI,IN,2983,2941,-42,0.49645509790681974
46926,DENVER,IN,116,155,39,0.5719557195571956
46928,FAIRMOUNT,IN,1653,1622,-31,0.4952671755725191
46929,FLORA,IN,1632,1288,-344,0.4410958904109589
46931,FULTON,IN,13,0,-13,0
46932,GALVESTON,IN,1136,1157,21,0.5045791539467946
46933,GAS CITY,IN,2934,2932,-2,0.49982952608250936
46936,GREENTOWN,IN,1978,1812,-166,0.47810026385224275
46938,JONESBORO,IN,1076,940,-136,0.4662698412698413
46939,KEWANNA,IN,646,637,-9,0.49649259547934527
46940,LA FONTAINE,IN,593,563,-30,0.4870242214532872
46941,LAGRO,IN,103,114,11,0.5253456221198156
46947,LOGANSPORT,IN,15031,11278,-3753,0.42867459804629593
46950,LUCERNE,IN,13,12,-1,0.48
46951,MACY,IN,563,416,-147,0.424923391215526
46952,MARION,IN,10012,9204,-808,0.4789758534554538
46953,MARION,IN,12285,9412,-2873,0.43379269023367284
46957,MATTHEWS,IN,26,15,-11,0.36585365853658536
46960,MONTEREY,IN,299,292,-7,0.494077834179357
46962,N MANCHESTER,IN,51,66,15,0.5641025641025641
46962,N MANHESTER,IN,46,63,17,0.5779816513761468
46962,NORTH MAMCHESTER,IN,71,37,-34,0.3425925925925926
46962,NORTH MANCHESTER,IN,2810,2607,-203,0.4812626915266753
46962,NPRTH MANCHESTER,IN,61,45,-16,0.42452830188679247
46970,PERU,IN,13179,10499,-2680,0.4434073823802686
46974,ROANN,IN,151,218,67,0.5907859078590786
46975,ROCHESTER,IN,6578,6062,-516,0.4795886075949367
46978,ROYAL CENTER,IN,570,506,-64,0.47026022304832715
46979,RUSSIAVILLE,IN,1276,1409,133,0.5247672253258845
46982,SILVER LAKE,IN,961,861,-100,0.4725576289791438
46985,STAR CITY,IN,256,292,36,0.5328467153284672
46986,SIMS,IN,47,42,-5,0.47191011235955055
46986,SWAYZEE,IN,457,353,-104,0.43580246913580245
46987,SWEETSER,IN,233,133,-100,0.3633879781420765
46988,TWELVE MILE,IN,77,67,-10,0.4652777777777778
46989,UPLAND,IN,1192,1141,-51,0.48906986712387485
46990,URBANA,IN,40,0,-40,0
46991,VAN BUREN,IN,434,221,-213,0.3374045801526718
46992,WABASH,IN,6331,6168,-163,0.49347947835826866
46994,WALTON,IN,858,816,-42,0.4874551971326165
46996,WINAMAC,IN,2795,2679,-116,0.489404457435148
47001,AURORA,IN,4005,3726,-279,0.4819557625145518
47003,WEST COLLEGE CORNER,IN,254,78,-176,0.23493975903614459
47006,BATESVILLE,IN,3619,3830,211,0.5141629748959592
47011,BENNINGTON,IN,24,17,-7,0.4146341463414634
47012,BROOKVILLE,IN,2703,2920,217,0.5192957495998577
47012,SAINT LEON,IN,54,54,0,0.5
47016,CEDAR GROVE,IN,11,24,13,0.6857142857142857
47018,DILLSBORO,IN,1656,1526,-130,0.4795725958516656
47020,FLORENCE,IN,152,269,117,0.6389548693586699
47022,GUILFORD,IN,433,560,127,0.5639476334340383
47023,HOLTON,IN,391,362,-29,0.4807436918990704
47024,LAUREL,IN,927,830,-97,0.4723961297666477
47025,GREENDALE,IN,333,393,60,0.5413223140495868
47025,LAWRENCEBURG,IN,7109,7551,442,0.515075034106412
47030,METAMORA,IN,299,219,-80,0.42277992277992277
47030,NEWBURGH,IN,0,14,14,1
47031,MILAN,IN,1552,1660,108,0.5168119551681195
47032,MOORES HILL,IN,1107,916,-191,0.4527928818586258
47036,OLDENBURG,IN,13,58,45,0.8169014084507042
47037,OSGOOD,IN,1456,1389,-67,0.4882249560632689
47038,PATRIOT,IN,228,198,-30,0.4647887323943662
47040,RISING SUN,IN,1898,1874,-24,0.4968186638388123
47041,SUNMAN,IN,1791,1480,-311,0.4524610210944665
47042,VERSAILLES,IN,1572,1695,123,0.5188246097337006
47043,VEVAY,IN,2134,2175,41,0.5047574843351126
47060,WEST HARRISON,IN,1454,1662,208,0.5333761232349166
47102,AUSTIN,IN,4220,3516,-704,0.4544984488107549
47106,BORDEN,IN,1273,1409,136,0.5253542132736764
47106,NEW ALBANY,IN,20,24,4,0.5454545454545454
47108,CAMPBELLSBURG,IN,973,737,-236,0.43099415204678365
47110,CENTRAL,IN,25,0,-25,0
47111,CHARLESTOWN,IN,6925,7311,386,0.5135571789828604
47112,CORYDON,IN,6783,6406,-377,0.48570778679202364
47114,CRANDALL,IN,27,11,-16,0.2894736842105263
47115,DEPAUW,IN,724,710,-14,0.49511854951185497
47116,ECKERTY,IN,11,28,17,0.717948717948718
47117,ELIZABETH,IN,1498,1302,-196,0.465
47118,ENGLISH,IN,1354,1265,-89,0.48300878197785413
47119,FLOYDS KNOBS,IN,2799,3146,347,0.529184188393608
47120,FREDERICKSBRG,IN,13,17,4,0.5666666666666667
47120,FREDERICKSBURG,IN,140,80,-60,0.36363636363636365
47120,JEFFERSONVILLE,IN,16,11,-5,0.4074074074074074
47122,GEORGETOWN,IN,3121,3390,269,0.5206573491015205
47124,GREENVILLE,IN,1572,1357,-215,0.46329805394332535
47125,HARDINSBURG,IN,629,474,-155,0.42973708068902994
47126,HENRYVILLE,IN,1706,1840,134,0.5188945290468133
47129,CLARKSVILLE,IN,10447,9610,-837,0.47913446676970634
47130,JEFFERSONVILLE,IN,23024,23565,541,0.5058060915666789
47131,CLARKSVILLE,IN,1329,890,-439,0.40108156827399727
47131,JEFFERSONVILLE,IN,736,459,-277,0.38410041841004183
47135,LACONIA,IN,392,241,-151,0.3807266982622433
47136,LANESVILLE,IN,1329,1414,85,0.5154939846882974
47137,LEAVENWORTH,IN,229,297,68,0.564638783269962
47138,LEXINGTON,IN,1601,1491,-110,0.4822121604139715
47140,MARENGO,IN,1207,1106,-101,0.47816688283614356
47141,MARYSVILLE,IN,136,196,60,0.5903614457831325
47142,MAUCKPORT,IN,80,102,22,0.5604395604395604
47143,MEMPHIS,IN,1141,1252,111,0.523192645215211
47145,MILLTOWN,IN,509,666,157,0.5668085106382978
47147,NABB,IN,59,121,62,0.6722222222222223
47150,NEW ALBANY,IN,25654,21569,-4085,0.45674777121318
47151,NEW ALBANY,IN,724,649,-75,0.4726875455207575
47160,NEW MIDDLETOWN,IN,0,11,11,1
47161,NEW SALISBURY,IN,1406,1307,-99,0.4817545152967195
47162,NEW WASHINGTN,IN,12,0,-12,0
47162,NEW WASHINGTON,IN,63,58,-5,0.4793388429752066
47163,OTISCO,IN,225,291,66,0.563953488372093
47164,PALMYRA,IN,1354,1368,14,0.5025716385011021
47165,PEKIN,IN,2376,2176,-200,0.4780316344463972
47166,RAMSEY,IN,518,413,-105,0.44360902255639095
47167,SALEM,IN,6403,6170,-233,0.49073411278135687
47170,SCOTTSBURG,IN,7565,7092,-473,0.4838643651497578
47172,SELLERSBURG,IN,7515,7490,-25,0.4991669443518827
47175,TASWELL,IN,75,39,-36,0.34210526315789475
47177,UNDERWOOD,IN,145,162,17,0.5276872964169381
47201,COLUMBUS,IN,24498,21327,-3171,0.4654009819967267
47202,COLUMBUS,IN,887,822,-65,0.4809830310122879
47203,COLUMBUS,IN,11826,9733,-2093,0.4514587875133355
47220,BROWNSTOWN,IN,2145,1998,-147,0.4822592324402607
47223,BUTLERVILLE,IN,277,275,-2,0.49818840579710144
47224,CANAAN,IN,15,14,-1,0.4827586206896552
47226,CLIFFORD,IN,26,0,-26,0
47227,COMMISKEY,IN,102,82,-20,0.44565217391304346
47227,CROTHERSVILLE,IN,14,14,0,0.5
47229,CROTHERSVILLE,IN,1338,1227,-111,0.4783625730994152
47230,DEPUTY,IN,426,493,67,0.5364526659412405
47231,DUPONT,IN,111,107,-4,0.4908256880733945
47232,ELIZABETHTOWN,IN,810,703,-107,0.4646397884996695
47234,FLAT ROCK,IN,170,250,80,0.5952380952380952
47235,FREETOWN,IN,483,522,39,0.5194029850746269
47240,GREENSBURG,IN,10538,8930,-1608,0.4587014588041915
47243,HANOVER,IN,2194,2127,-67,0.49224716500809995
47244,HARTSVILLE,IN,29,54,25,0.6506024096385542
47246,HOPE,IN,1553,1404,-149,0.4748055461616503
47250,MADISON,IN,10518,9386,-1132,0.4715635048231511
47260,MEDORA,IN,750,748,-2,0.4993324432576769
47263,NEW POINT,IN,27,0,-27,0
47264,NORMAN,IN,198,302,104,0.604
47265,NORTH VERNON,IN,8825,8122,-703,0.4792588658759662
47270,PARIS CROSSING,IN,11,0,-11,0
47272,SAINT PAUL,IN,621,551,-70,0.47013651877133106
47273,SCIPIO,IN,228,292,64,0.5615384615384615
47274,SEYMOUR,IN,14812,12875,-1937,0.46501968432838514
47280,TAYLORSVILLE,IN,101,165,64,0.6203007518796992
47281,VALLONIA,IN,323,192,-131,0.37281553398058254
47282,VERNON,IN,37,0,-37,0
47283,WESTPORT,IN,1283,1029,-254,0.44506920415224915
47302,MUNCIE,IN,13526,11794,-1732,0.46579778830963664
47303,MUNCIE,IN,12102,9067,-3035,0.42831498889886155
47304,MUNCIE,IN,13920,11917,-2003,0.46123775980183457
47305,MUNCIE,IN,3023,2568,-455,0.45930960472187443
47307,MUNCIE,IN,442,269,-173,0.37834036568213786
47308,MUNCIE,IN,277,111,-166,0.2860824742268041
47320,ALBANY,IN,1417,1399,-18,0.4968039772727273
47325,BROWNSVILLE,IN,66,12,-54,0.15384615384615385
47326,BRYANT,IN,188,139,-49,0.42507645259938837
47327,CAMBRIDGE CITY,IN,1700,1363,-337,0.44498857329415603
47330,CENTERVILLE,IN,2211,2073,-138,0.4838935574229692
47331,CONNERSVILLE,IN,12970,10379,-2591,0.4445158250888689
47334,DALEVILLE,IN,1006,1109,103,0.5243498817966903
47335,DUBLIN,IN,152,62,-90,0.2897196261682243
47336,DUNKIRK,IN,1866,1511,-355,0.4474385549304116
47338,EATON,IN,1044,842,-202,0.44644750795334043
47339,ECONOMY,IN,0,11,11,1
47340,FARMLAND,IN,1108,873,-235,0.44068652195860675
47341,FOUNTAIN CITY,IN,576,504,-72,0.4666666666666667
47342,GASTON,IN,969,763,-206,0.4405311778290993
47345,GREENS FORK,IN,179,227,48,0.5591133004926109
47346,HAGERSTOWN,IN,1334,1156,-178,0.4642570281124498
47348,HARTFORD CITY,IN,4091,3715,-376,0.47591596208045095
47351,KENNARD,IN,0,17,17,1
47352,LEWISVILLE,IN,35,67,32,0.6568627450980392
47353,LIBERTY,IN,1998,1799,-199,0.4737951013958388
47354,LOSANTVILLE,IN,69,77,8,0.5273972602739726
47355,LYNN,IN,1069,803,-266,0.42895299145299143
47356,MIDDLETOWN,IN,2110,1842,-268,0.4660931174089069
47357,MILTON,IN,132,98,-34,0.4260869565217391
47358,MODOC,IN,83,33,-50,0.28448275862068967
47359,MONTPELIER,IN,1153,1012,-141,0.4674364896073903
47360,MOORELAND,IN,179,205,26,0.5338541666666666
47362,NEW CASTLE,IN,12748,11950,-798,0.4838448457364969
47367,OAKVILLE,IN,14,0,-14,0
47368,PARKER CITY,IN,1060,800,-260,0.43010752688172044
47369,PENNVILLE,IN,387,233,-154,0.3758064516129032
47370,PERSHING,IN,50,0,-50,0
47371,PORTLAND,IN,5154,4425,-729,0.46194801127466334
47373,REDKEY,IN,1067,712,-355,0.40022484541877457
47374,RICHMOND,IN,27028,19767,-7261,0.4224169248851373
47375,RICHMOND,IN,807,361,-446,0.3090753424657534
47380,RIDGEVILLE,IN,517,477,-40,0.4798792756539235
47383,PAXTON,IN,25,19,-6,0.4318181818181818
47383,SELMA,IN,782,738,-44,0.4855263157894737
47384,SHIRLEY,IN,576,462,-114,0.44508670520231214
47385,SPICELAND,IN,400,271,-129,0.4038748137108793
47386,SPRINGPORT,IN,194,160,-34,0.4519774011299435
47387,STRAUGHN,IN,26,0,-26,0
47388,SULPHUR SPRINGS,IN,41,0,-41,0
47390,UNION CITY,IN,2205,1996,-209,0.47512497024517975
47393,WILLIAMSBURG,IN,142,115,-27,0.4474708171206226
47394,WINCHESTER,IN,3923,3465,-458,0.4690037899296156
47396,YORKTOWN,IN,2479,2374,-105,0.4891819493097053
47401,BLOOMINGTON,IN,38129,20755,-17374,0.35247265810746553
47402,BLOOMINGTON,IN,1454,1049,-405,0.41909708349980024
47403,BLOOMINGTON,IN,31058,15643,-15415,0.33496070747949724
47404,BLOOMINGTON,IN,15906,10453,-5453,0.3965628438104632
47406,BLOOMINGTON,IN,136,33,-103,0.1952662721893491
47407,BLOOMINGTON,IN,800,386,-414,0.3254637436762226
47408,BLOOMINGTON,IN,23302,8687,-14615,0.2715620994716934
47421,BEDFORD,IN,12775,11215,-1560,0.46748645268862027
47424,BLOOMFIELD,IN,3265,3436,171,0.51275928965826
47427,COAL CITY,IN,104,111,7,0.5162790697674419
47429,ELLETTSVILLE,IN,2810,3174,364,0.5304144385026738
47431,FREEDOM,IN,180,248,68,0.5794392523364486
47432,FRENCH LICK,IN,1929,1755,-174,0.4763843648208469
47433,GOSPORT,IN,1374,1287,-87,0.4836527621195039
47436,HELTONVILLE,IN,301,187,-114,0.3831967213114754
47438,JASONVILLE,IN,1841,1860,19,0.502566873817887
47441,LINTON,IN,4735,4090,-645,0.4634560906515581
47443,LYONS,IN,377,276,-101,0.4226646248085758
47446,MITCHELL,IN,4170,3794,-376,0.4763937719738825
47448,NASHVILLE,IN,3298,3262,-36,0.4972560975609756
47449,NEWBERRY,IN,24,34,10,0.5862068965517241
47451,OOLITIC,IN,294,226,-68,0.4346153846153846
47452,ORLEANS,IN,1734,1679,-55,0.49194257251684737
47454,PAOLI,IN,3105,2880,-225,0.48120300751879697
47456,QUINCY,IN,40,117,77,0.7452229299363057
47459,SOLSBERRY,IN,1103,1046,-57,0.4867380176826431
47460,SPENCER,IN,4116,3883,-233,0.4854356794599325
47462,SPRINGVILLE,IN,1393,1449,56,0.5098522167487685
47465,SWITZ CITY,IN,86,61,-25,0.41496598639455784
47468,UNIONVILLE,IN,446,274,-172,0.38055555555555554
47469,WEST BADEN SPRINGS,IN,590,599,9,0.503784693019344
47470,WILLIAMS,IN,140,201,61,0.5894428152492669
47471,WORTHINGTON,IN,884,882,-2,0.49943374858437145
47501,WASHINGTON,IN,9904,7964,-1940,0.4457130064920528
47512,BICKNELL,IN,2566,1941,-625,0.4306634124694919
47513,BIRDSEYE,IN,446,498,52,0.527542372881356
47516,BRUCEVILLE,IN,195,78,-117,0.2857142857142857
47520,CANNELTON,IN,1456,1449,-7,0.4987951807228916
47520,MAGNET,IN,32,32,0,0.5
47521,CELESTINE,IN,11,12,1,0.5217391304347826
47522,CRANE,IN,36,0,-36,0
47523,DALE,IN,1069,1086,17,0.5039443155452437
47525,DERBY,IN,0,11,11,1
47527,DUBOIS,IN,474,319,-155,0.40226986128625475
47528,EDWARDSPORT,IN,75,0,-75,0
47529,ELNORA,IN,342,142,-200,0.29338842975206614
47531,EVANSTON,IN,24,11,-13,0.3142857142857143
47532,FERDINAND,IN,976,1064,88,0.5215686274509804
47535,FREELANDVILLE,IN,42,23,-19,0.35384615384615387
47537,GENTRYVILLE,IN,94,73,-21,0.437125748502994
47541,HOLLAND,IN,197,129,-68,0.39570552147239263
47542,HUNTINGBURG,IN,3918,3514,-404,0.47282023681377827
47546,JASPER,IN,8323,7952,-371,0.4886021505376344
47547,JASPER,IN,88,33,-55,0.2727272727272727
47550,LAMAR,IN,34,11,-23,0.24444444444444444
47551,LEOPOLD,IN,0,12,12,1
47553,LOOGOOTEE,IN,2366,2243,-123,0.486656541549143
47557,MONROE CITY,IN,299,152,-147,0.3370288248337029
47558,MONTGOMERY,IN,644,596,-48,0.4806451612903226
47561,OAKTOWN,IN,465,464,-1,0.49946178686759957
47561,OTWELL,IN,20,14,-6,0.4117647058823529
47562,ODON,IN,1119,1068,-51,0.4883401920438957
47564,OTWELL,IN,372,399,27,0.5175097276264592
47567,PETERSBURG,IN,2290,2176,-114,0.4872369010300045
47568,PLAINVILLE,IN,34,54,20,0.6136363636363636
47575,SAINT ANTHONY,IN,63,0,-63,0
47577,SAINT MEINRAD,IN,28,58,30,0.6744186046511628
47578,SANDBORN,IN,60,69,9,0.5348837209302325
47579,SANTA CLAUS,IN,1158,1021,-137,0.46856356126663606
47581,SHOALS,IN,1343,1243,-100,0.48066511987625676
47586,TELL CITY,IN,4994,4469,-525,0.4722603825425341
47588,TROY,IN,36,0,-36,0
47590,VELPEN,IN,22,25,3,0.5319148936170213
47591,VINCENNES,IN,13877,12753,-1124,0.47889598197521593
47596,WESTPHALIA,IN,26,0,-26,0
47597,WHEATLAND,IN,187,92,-95,0.32974910394265233
47598,WINSLOW,IN,1235,1057,-178,0.46116928446771377
47601,BOONVILLE,IN,4679,4777,98,0.5051818950930627
47610,CHANDLER,IN,2318,2308,-10,0.4989191526156507
47611,CHRISNEY,IN,186,125,-61,0.40192926045016075
47612,CYNTHIANA,IN,51,23,-28,0.3108108108108108
47613,ELBERFELD,IN,590,647,57,0.52303961196443
47615,GRANDVIEW,IN,334,409,75,0.550471063257066
47619,LYNNVILLE,IN,423,312,-111,0.42448979591836733
47620,MOUNT VERNON,IN,4864,4438,-426,0.47710169855944956
47629,NEWBURGH,IN,524,266,-258,0.3367088607594937
47630,NEWBURGH,IN,15018,15222,204,0.5033730158730159
47631,NEW HARMONY,IN,630,552,-78,0.467005076142132
47633,POSEYVILLE,IN,736,663,-73,0.4739099356683345
47634,RICHLAND,IN,395,447,52,0.5308788598574822
47635,ROCKPORT,IN,2130,1986,-144,0.48250728862973763
47637,TENNYSON,IN,264,150,-114,0.36231884057971014
47638,WADESVILLE,IN,944,873,-71,0.48046230049532196
47639,HAUBSTADT,IN,937,1026,89,0.5226693835965359
47640,HAZLETON,IN,44,36,-8,0.45
47648,FORT BRANCH,IN,1718,1648,-70,0.48960190136660725
47649,FRANCISCO,IN,139,122,-17,0.4674329501915709
47660,OAKLAND CITY,IN,1793,1711,-82,0.4882990867579909
47665,OWENSVILLE,IN,1429,1184,-245,0.4531190202831994
47666,PATOKA,IN,217,222,5,0.5056947608200456
47670,PRINCETON,IN,5712,5460,-252,0.48872180451127817
47708,EVANSVILLE,IN,1103,1230,127,0.5272181740248607
47710,EVANSVILLE,IN,10053,9162,-891,0.47681498829039815
47711,EVANSVILLE,IN,12986,12201,-785,0.484416564100528
47712,EVANSVILLE,IN,10344,8632,-1712,0.4548903878583474
47713,EVANSVILLE,IN,7129,6378,-751,0.4721996002072999
47714,EVANSVILLE,IN,18926,16615,-2311,0.46748825300357333
47715,EVANSVILLE,IN,18374,16766,-1608,0.4771200910643142
47716,EVANSVILLE,IN,173,316,143,0.6462167689161554
47719,EVANSVILLE,IN,38,29,-9,0.43283582089552236
47720,EVANSVILLE,IN,5046,5047,1,0.5000495392846527
47724,EVANSVILLE,IN,192,89,-103,0.3167259786476868
47725,DARMSTADT,IN,196,245,49,0.5555555555555556
47725,EVANSVILLE,IN,4743,5728,985,0.5470346671760099
47728,EVANSVILLE,IN,75,370,295,0.8314606741573034
47801,TERRE HAUTE,IN,343,138,-205,0.2869022869022869
47802,TERRE HAUTE,IN,16169,15004,-1165,0.48131395759150547
47803,TERRE HAUTE,IN,11188,9743,-1445,0.46548182122211074
47804,TERRE HAUTE,IN,4967,4761,-206,0.48941200657894735
47805,TERRE HAUTE,IN,4810,4351,-459,0.47494814976530947
47807,TERRE HAUTE,IN,8078,6938,-1140,0.46204049014384657
47832,BLOOMINGDALE,IN,83,91,8,0.5229885057471264
47833,BOWLING GREEN,IN,194,125,-69,0.39184952978056425
47834,BRAZIL,IN,7576,7580,4,0.5001319609395619
47837,CARBON,IN,151,161,10,0.5160256410256411
47838,CARLISLE,IN,510,417,-93,0.44983818770226536
47840,CENTER POINT,IN,29,51,22,0.6375
47840,CENTERPOINT,IN,205,238,33,0.5372460496613995
47841,CLAY CITY,IN,691,742,51,0.5177948360083741
47842,CLINTON,IN,4128,3863,-265,0.4834188462019772
47845,COALMONT,IN,23,0,-23,0
47847,DANA,IN,298,151,-147,0.3363028953229399
47848,DUGGER,IN,463,346,-117,0.4276885043263288
47849,FAIRBANKS,IN,11,0,-11,0
47850,FARMERSBURG,IN,984,951,-33,0.49147286821705427
47853,HARMONY,IN,0,11,11,1
47855,HYMERA,IN,87,49,-38,0.3602941176470588
47858,LEWIS,IN,0,25,25,1
47859,MARSHALL,IN,62,26,-36,0.29545454545454547
47861,MEROM,IN,11,22,11,0.6666666666666666
47862,MONTEZUMA,IN,523,387,-136,0.42527472527472526
47868,POLAND,IN,993,1041,48,0.5117994100294986
47870,PRAIRIETON,IN,11,0,-11,0
47871,RILEY,IN,41,0,-41,0
47872,ROCKVILLE,IN,2884,2871,-13,0.4988705473501303
47874,ROSEDALE,IN,1029,1006,-23,0.49434889434889434
47876,SAINT MARY OF THE WOODS,IN,0,39,39,1
47878,SEELYVILLE,IN,15,0,-15,0
47879,SHELBURN,IN,1114,1033,-81,0.48113646949231487
47881,STAUNTON,IN,23,14,-9,0.3783783783783784
47882,SULLIVAN,IN,3953,3947,-6,0.49962025316455694
47885,W TERRE HAUTE,IN,171,163,-8,0.4880239520958084
47885,WEST TERRE HAUTE,IN,2819,2677,-142,0.4870815138282387
47901,LAFAYETTE,IN,9271,3515,-5756,0.27491005787580164
47902,LAFAYETTE,IN,37,167,130,0.8186274509803921
47903,LA FAYETTE,IN,95,108,13,0.5320197044334976
47903,LAFAYETTE,IN,894,1148,254,0.5621939275220372
47904,LAFAYETTE,IN,13149,9022,-4127,0.40692796896847233
47905,LA FAYETTE,IN,525,450,-75,0.46153846153846156
47905,LAFAYETTE,IN,26083,18828,-7255,0.41922914208100465
47906,WEST LAFAYETTE,IN,30100,23185,-6915,0.43511307122079385
47909,LAFAYETTE,IN,25616,18665,-6951,0.4215126126329577
47917,AMBIA,IN,23,0,-23,0
47918,ATTICA,IN,2796,2447,-349,0.4667175281327484
47920,BATTLE GROUND,IN,795,710,-85,0.4717607973421927
47921,BOSWELL,IN,257,155,-102,0.3762135922330097
47922,BROOK,IN,438,340,-98,0.4370179948586118
47923,BROOKSTON,IN,1456,1228,-228,0.45752608047690013
47925,BUFFALO,IN,13,0,-13,0
47926,BURNETTSVILLE,IN,110,11,-99,0.09090909090909091
47928,CAYUGA,IN,459,546,87,0.5432835820895522
47929,CHALMERS,IN,60,38,-22,0.3877551020408163
47930,CLARKS HILL,IN,160,176,16,0.5238095238095238
47932,COVINGTON,IN,2058,2017,-41,0.4949693251533742
47933,CRAWFORDSVILLE,IN,14182,12267,-1915,0.46379825324208857
47940,DARLINGTON,IN,543,471,-72,0.46449704142011833
47941,DAYTON,IN,608,365,-243,0.3751284686536485
47942,EARL PARK,IN,34,28,-6,0.45161290322580644
47943,FAIR OAKS,IN,35,39,4,0.527027027027027
47944,FOWLER,IN,1288,1322,34,0.5065134099616858
47946,FRANCESVILLE,IN,801,476,-325,0.3727486296006265
47948,GOODLAND,IN,456,314,-142,0.4077922077922078
47949,HILLSBORO,IN,356,383,27,0.5182679296346414
47950,IDAVILLE,IN,71,66,-5,0.48175182481751827
47951,KENTANF,IN,19,20,1,0.5128205128205128
47951,KENTLAND,IN,1185,1091,-94,0.47934973637961337
47952,KINGMAN,IN,884,819,-65,0.48091603053435117
47952,TANGIER,IN,23,11,-12,0.3235294117647059
47954,LADOGA,IN,878,714,-164,0.4484924623115578
47955,LINDEN,IN,206,273,67,0.569937369519833
47957,MEDARYVILLE,IN,735,539,-196,0.4230769230769231
47959,MONON,IN,953,739,-214,0.4367612293144208
47960,MONTICELLO,IN,7771,7563,-208,0.49321768618755707
47963,MOROCCO,IN,769,740,-29,0.49039098740888004
47965,NEW MARKET,IN,23,0,-23,0
47966,NEWPORT,IN,15,0,-15,0
47967,NEW RICHMOND,IN,11,24,13,0.6857142857142857
47968,NEW ROSS,IN,74,74,0,0.5
47969,NEWTOWN,IN,52,0,-52,0
47970,OTTERBEIN,IN,673,675,2,0.5007418397626113
47971,OXFORD,IN,539,596,57,0.5251101321585903
47974,PERRYSVILLE,IN,183,195,12,0.5158730158730159
47975,PINE VILLAGE,IN,11,24,13,0.6857142857142857
47977,REMINGTON,IN,1036,918,-118,0.46980552712384854
47978,RENSSELAER,IN,4977,4299,-678,0.46345407503234154
47980,REYNOLDS,IN,330,184,-146,0.35797665369649806
47981,ROMNEY,IN,24,51,27,0.68
47983,STOCKWELL,IN,0,11,11,1
47987,VEEDERSBURG,IN,1515,1412,-103,0.4824051930304066
47989,WAVELAND,IN,202,148,-54,0.4228571428571429
47990,WAYNETOWN,IN,480,436,-44,0.4759825327510917
47991,WEST LEBANON,IN,196,138,-58,0.41317365269461076
47992,WESTPOINT,IN,98,133,35,0.5757575757575758
47993,WILLIAMSPORT,IN,1334,1262,-72,0.4861325115562404
47994,WINGATE,IN,63,33,-30,0.34375
47995,WOLCOTT,IN,450,364,-86,0.44717444717444715
47996,W LAFAYETTE,IN,11,0,-11,0
47996,WEST LAFAYETTE,IN,140,245,105,0.6363636363636364
48001,ALGONAC,MI,2604,2171,-433,0.45465968586387434
48001,CLAY,MI,2620,2398,-222,0.47787963332004785
48002,ALLENTON,MI,438,511,73,0.5384615384615384
48002,BERLIN,MI,172,176,4,0.5057471264367817
48002,BERVILLE,MI,16,0,-16,0
48003,ALMONT,MI,1799,1815,16,0.5022136137244051
48005,ARMADA,MI,1459,1354,-105,0.48133665126199787
48006,AVOCA,MI,247,237,-10,0.4896694214876033
48006,GREENWOOD,MI,376,356,-20,0.48633879781420764
48006,KENOCKEE,MI,395,340,-55,0.46258503401360546
48007,TROY,MI,30,0,-30,0
48009,BIRMINGHAM,MI,10622,9894,-728,0.48225775004874244
48012,BIRMINGHAM,MI,571,773,202,0.5751488095238095
48014,CAPAC,MI,960,752,-208,0.4392523364485981
48014,MUSSEY,MI,696,586,-110,0.45709828393135726
48015,CENTER LINE,MI,3557,3272,-285,0.47913310880070287
48017,CLAWSON,MI,4933,3941,-992,0.4441063781834573
48021,EASTPOINTE,MI,19145,13722,-5423,0.4175008367055101
48022,EMMETT,MI,431,441,10,0.5057339449541285
48023,FAIR HAVEN,MI,173,180,7,0.509915014164306
48023,IRA,MI,2034,1925,-109,0.4862338974488507
48025,BEVERLY HILLS,MI,2724,2661,-63,0.49415041782729807
48025,BINGHAM FARMS,MI,894,944,50,0.5136017410228509
48025,FRANKLIN,MI,1226,1189,-37,0.49233954451345757
48026,FRASER,MI,5450,4641,-809,0.45991477554256266
48027,GOODELLS,MI,186,159,-27,0.4608695652173913
48027,WALES,MI,545,553,8,0.5036429872495446
48028,HARSENS IS,MI,11,0,-11,0
48028,HARSENS ISLAND,MI,837,537,-300,0.39082969432314413
48030,HAZEL PARK,MI,7384,6314,-1070,0.46094320338735584
48032,GRANT TOWNSHIP,MI,367,337,-30,0.4786931818181818
48032,GRANT TWP,MI,0,13,13,1
48032,JEDDO,MI,55,70,15,0.56
48033,SOUTHFIELD,MI,7988,6988,-1000,0.46661324786324787
48034,SOUTHFIELD,MI,9113,7488,-1625,0.4510571652310102
48035,CLINTON TOWNSHIP,MI,13270,10963,-2307,0.452399620352412
48035,CLINTON TWP,MI,796,652,-144,0.45027624309392267
48036,CLINTON TOWNSHIP,MI,8701,7712,-989,0.4698714433680619
48036,CLINTON TWP,MI,338,275,-63,0.44861337683523655
48037,SOUTHFIELD,MI,964,2175,1211,0.6928958266964002
48038,CLINTON TOWNSHIP,MI,21021,18346,-2675,0.46602484314273374
48039,COTTRELLVILLE,MI,496,380,-116,0.4337899543378995
48039,MARINE CITY,MI,2727,2440,-287,0.4722275982194697
48040,MARYSVILLE,MI,4377,4008,-369,0.4779964221824687
48041,MEMPHIS,MI,791,618,-173,0.43860894251242016
48041,RILEY,MI,481,412,-69,0.46136618141097424
48042,MACOMB,MI,6971,8792,1821,0.5577618473640804
48043,MOUNT CLEMENS,MI,6326,5441,-885,0.4623948330075635
48044,MACOMB,MI,13268,14171,903,0.51645468129305
48045,HARRISON TOWNSHIP,MI,10885,9663,-1222,0.4702647459606774
48045,HARRISON TWP,MI,307,203,-104,0.3980392156862745
48046,MOUNT CLEMENS,MI,1701,1323,-378,0.4375
48047,CHESTERFIELD,MI,4990,4626,-364,0.4810732113144759
48047,NEW BALTIMORE,MI,8310,7636,-674,0.47886617333500564
48048,LENOX,MI,410,410,0,0.5
48048,NEW HAVEN,MI,3086,3336,250,0.5194643413266895
48049,CLYDE,MI,1235,1344,109,0.521132221791392
48049,NORTH STREET,MI,212,212,0,0.5
48049,RUBY,MI,24,43,19,0.6417910447761194
48050,LENOX,MI,84,171,87,0.6705882352941176
48051,CHESTERFIELD,MI,5345,5577,232,0.5106207654275774
48051,NEW BALTIMORE,MI,329,414,85,0.5572005383580081
48054,CHINA,MI,651,596,-55,0.47794707297514033
48054,EAST CHINA,MI,1625,1510,-115,0.48165869218500795
48059,BURTCHVILLE,MI,265,265,0,0.5
48059,FORT GRATIOT,MI,6433,5910,-523,0.47881390261686785
48059,LAKEPORT,MI,98,186,88,0.6549295774647887
48060,PORT HURON,MI,22592,18470,-4122,0.44980760800740344
48061,PORT HURON,MI,1212,981,-231,0.4473324213406293
48062,RICHMOND,MI,2990,2897,-93,0.4921012400203839
48063,COLUMBUS,MI,1113,1410,297,0.558858501783591
48064,CASCO,MI,896,1086,190,0.5479313824419778
48065,BRUCE TOWNSHIP,MI,577,609,32,0.5134907251264755
48065,BRUCE TWP,MI,1107,1258,151,0.531923890063425
48065,ROMEO,MI,1763,1961,198,0.5265843179377014
48066,ROSEVILLE,MI,19513,17564,-1949,0.4737168595085902
48067,ROYAL OAK,MI,14407,11711,-2696,0.4483880848457003
48068,ROYAL OAK,MI,379,621,242,0.621
48069,PLEASANT RDG,MI,33,52,19,0.611764705882353
48069,PLEASANT RIDGE,MI,621,568,-53,0.47771236333052985
48070,HUNTINGTN WDS,MI,65,124,59,0.656084656084656
48070,HUNTINGTON WOODS,MI,1322,1548,226,0.5393728222996516
48071,MADISON HEIGHTS,MI,11526,9636,-1890,0.45534448539835554
48071,MADISON HTS,MI,2014,1702,-312,0.4580193756727664
48072,BERKLEY,MI,5407,4938,-469,0.4773320444659256
48072,WRN,MI,101,108,7,0.5167464114832536
48073,ROYAL OAK,MI,15764,13399,-2365,0.4594520453999931
48074,KIMBALL,MI,3132,3161,29,0.5023041474654378
48075,SOUTHFIELD,MI,8739,7212,-1527,0.45213466240361105
48076,LATHRUP VILLAGE,MI,579,558,-21,0.49076517150395776
48076,SOUTHFIELD,MI,8209,8924,715,0.5208661647113757
48079,SAINT CLAIR,MI,4776,4657,-119,0.4936923566203753
48080,SAINT CLAIR SHORES,MI,8392,7875,-517,0.4841089321940124
48080,ST CLAIR SHRS,MI,524,438,-86,0.4553014553014553
48081,SAINT CLAIR SHORES,MI,5665,5820,155,0.5067479320853286
48081,ST CLAIR SHORES,MI,130,114,-16,0.4672131147540984
48081,ST CLAIR SHRS,MI,113,117,4,0.508695652173913
48081,ST CLR SHORES,MI,240,269,29,0.5284872298624754
48082,SAINT CLAIR SHORES,MI,4836,4519,-317,0.48305718866916086
48082,ST CLAIR SHORES,MI,67,79,12,0.541095890410959
48082,ST CLAIR SHRS,MI,288,259,-29,0.473491773308958
48083,TROY,MI,9384,8675,-709,0.48036989866548535
48084,TROY,MI,10131,8436,-1695,0.4543544999192115
48085,TROY,MI,5880,6387,507,0.520665199315236
48085,WARREN,MI,87,95,8,0.521978021978022
48088,WARREN,MI,6379,6220,-159,0.4936899753948726
48089,WARREN,MI,15143,12609,-2534,0.45434563274718937
48090,WARREN,MI,2385,1625,-760,0.40523690773067333
48091,WARREN,MI,13109,10769,-2340,0.4510009213501968
48092,WARREN,MI,9359,7975,-1384,0.46007845852082613
48093,WARREN,MI,8516,7549,-967,0.4699035169623405
48094,WASHINGTN TWP,MI,801,849,48,0.5145454545454545
48094,WASHINGTON,MI,5703,6014,311,0.5132713151830673
48094,WASHINGTON TOWNSHIP,MI,113,183,70,0.6182432432432432
48094,WASHINGTON TWP,MI,193,154,-39,0.4438040345821326
48095,WASHINGTN TWP,MI,144,187,43,0.5649546827794562
48095,WASHINGTON,MI,1004,1182,178,0.5407136322049405
48095,WASHINGTON TOWNSHIP,MI,106,139,33,0.5673469387755102
48095,WASHINGTON TWP,MI,20,36,16,0.6428571428571429
48096,RAY,MI,652,791,139,0.5481635481635482
48096,RAY TWP,MI,47,124,77,0.7251461988304093
48097,BROCKWAY,MI,286,262,-24,0.4781021897810219
48097,LYNN,MI,125,113,-12,0.47478991596638653
48097,YALE,MI,1224,1194,-30,0.49379652605459057
48098,TROY,MI,5232,5825,593,0.5268155919327123
48099,TROY,MI,704,1045,341,0.5974842767295597
48101,ALLEN PARK,MI,8044,7489,-555,0.4821348097598661
48103,ANN ARBOR,MI,26986,24523,-2463,0.47609155681531384
48104,ANN ARBOR,MI,25912,14738,-11174,0.36255842558425583
48105,ANN ARBOR,MI,19889,15832,-4057,0.44321267601690884
48106,ANN ARBOR,MI,724,918,194,0.559074299634592
48107,ANN ARBOR,MI,228,423,195,0.6497695852534562
48108,ANN ARBOR,MI,13233,12165,-1068,0.4789747224190881
48109,ANN ARBOR,MI,0,42,42,1
48111,BELLEVILLE,MI,9228,8336,-892,0.4746071509906627
48111,VAN BUREN TWP,MI,9198,8258,-940,0.4730751604032997
48112,BELLEVILLE,MI,1677,949,-728,0.3613861386138614
48113,ANN ARBOR,MI,24,165,141,0.873015873015873
48114,BRIGHTON,MI,5565,6164,599,0.5255349987211186
48116,BRIGHTON,MI,10948,10681,-267,0.49382773128669843
48117,CARLETON,MI,3141,3292,151,0.5117363593968599
48118,CHELSEA,MI,4536,4738,202,0.510890662065991
48120,DEARBORN,MI,3138,2328,-810,0.42590559824368823
48121,DEARBORN,MI,517,1019,502,0.6634114583333334
48122,MELVINDALE,MI,4182,3401,-781,0.44850323091124883
48123,DEARBORN,MI,30,257,227,0.8954703832752613
48124,DEARBORN,MI,10695,9546,-1149,0.4716170149696161
48125,DEARBORN,MI,178,126,-52,0.4144736842105263
48125,DEARBORN HEIGHTS,MI,7498,6627,-871,0.46916814159292036
48125,DEARBORN HTS,MI,182,109,-73,0.3745704467353952
48126,DEARBORN,MI,13834,9589,-4245,0.4093839388635102
48127,DEARBORN HEIGHTS,MI,11380,9913,-1467,0.4655520593622317
48127,DEARBORN HTS,MI,997,911,-86,0.47746331236897277
48128,DEARBORN,MI,3066,2536,-530,0.4526954659050339
48130,DEXTER,MI,4239,4519,280,0.5159853847910482
48131,DUNDEE,MI,3157,3264,107,0.5083320355084878
48133,ERIE,MI,1646,1606,-40,0.49384993849938497
48134,BROWNSTOWN,MI,497,500,3,0.5015045135406219
48134,FLAT ROCK,MI,7176,7003,-173,0.49389942873263276
48135,GARDEN CITY,MI,7895,7416,-479,0.48435765136176606
48135,GROSSE ILE,MI,144,137,-7,0.4875444839857651
48136,GARDEN CITY,MI,204,514,310,0.7158774373259053
48137,GREGORY,MI,1413,1374,-39,0.4930032292787944
48138,GROSSE ILE,MI,3452,3515,63,0.5045213147696282
48139,HAMBURG,MI,27,29,2,0.5178571428571429
48140,IDA,MI,767,612,-155,0.4437998549673677
48141,INKSTER,MI,13145,10371,-2774,0.4410188807620344
48143,LAKELAND,MI,97,0,-97,0
48144,LAMBERTVILLE,MI,2903,3159,256,0.5211151435169911
48145,LA SALLE,MI,876,1003,127,0.533794571580628
48146,LINCOLN PARK,MI,15357,11910,-3447,0.4367917262625151
48150,LIVONIA,MI,7151,7136,-15,0.49947504724574787
48150,OSCODA,MI,176,159,-17,0.4746268656716418
48151,LIVONIA,MI,237,590,353,0.713422007255139
48152,LIVONIA,MI,9438,9177,-261,0.49298952457695405
48153,LIVONIA,MI,855,196,-659,0.18648905803996194
48154,LIVONIA,MI,8595,9195,600,0.5168634064080945
48157,LUNA PIER,MI,594,405,-189,0.40540540540540543
48158,MANCHESTER,MI,1974,2025,51,0.5063765941485371
48159,MAYBEE,MI,487,379,-108,0.4376443418013857
48160,MILAN,MI,4030,3768,-262,0.48320082072326237
48161,MONROE,MI,11356,10417,-939,0.4784365957837689
48162,MONROE,MI,11173,10043,-1130,0.47336915535444946
48164,BROWNSTOWN,MI,58,58,0,0.5
48164,BROWNSTOWN TOWNSHIP,MI,59,64,5,0.5203252032520326
48164,NEW BOSTON,MI,2586,2620,34,0.5032654629273915
48165,NEW HUDSON,MI,3104,3056,-48,0.4961038961038961
48166,NEWPORT,MI,5149,5367,218,0.5103651578546976
48167,NORTHVILLE,MI,10398,9565,-833,0.479136402344337
48168,NORTHVILLE,MI,6872,7423,551,0.5192724728926198
48169,PINCKNEY,MI,6525,6524,-1,0.4999616828875776
48170,PLYMOUTH,MI,14946,14655,-291,0.49508462551940813
48173,BROWNSTOWN,MI,107,80,-27,0.42780748663101603
48173,GIBRALTAR,MI,1797,1512,-285,0.45693563009972804
48173,ROCKWOOD,MI,2748,2237,-511,0.44874623871614844
48174,ROMULUS,MI,11968,10993,-975,0.4787683463263795
48176,SALINE,MI,6669,7044,375,0.5136731568584555
48178,SOUTH LYON,MI,10082,11339,1257,0.5293403669296485
48179,S ROCKWOOD,MI,202,148,-54,0.4228571428571429
48179,SOUTH ROCKWOOD,MI,915,755,-160,0.45209580838323354
48180,TAYLOR,MI,25475,20434,-5041,0.44509791108497243
48182,TEMPERANCE,MI,6285,6270,-15,0.4994026284348865
48183,BROWNSTOWN,MI,273,353,80,0.5638977635782748
48183,BROWNSTOWN TOWNSHIP,MI,1778,1838,60,0.5082964601769911
48183,TRENTON,MI,6545,6075,-470,0.48137876386687795
48183,WOODHAVEN,MI,5637,5423,-214,0.4903254972875226
48184,WAYNE,MI,6758,6227,-531,0.47955333076626877
48185,WESTLAND,MI,23460,19897,-3563,0.45891090250709227
48186,WESTLAND,MI,13538,11458,-2080,0.45839334293486955
48187,CANTON,MI,18028,18019,-9,0.49987516298166285
48188,CANTON,MI,14084,14973,889,0.5152975186701999
48189,HAMBURG TWP,MI,117,91,-26,0.4375
48189,WHITMORE LAKE,MI,4852,4588,-264,0.4860169491525424
48190,WHITTAKER,MI,62,90,28,0.5921052631578947
48191,WILLIS,MI,982,1133,151,0.5356973995271868
48192,WYANDOTTE,MI,9295,7845,-1450,0.45770128354725786
48193,BROWNSTOWN,MI,1172,879,-293,0.42857142857142855
48193,RIVERVIEW,MI,5630,4338,-1292,0.43519261637239165
48195,SOUTHGATE,MI,14286,11222,-3064,0.43994041085149754
48197,YPSILANTI,MI,33609,26309,-7300,0.43908341399913214
48198,YPSILANTI,MI,20687,16458,-4229,0.4430744380131916
48201,DETROIT,MI,7499,6063,-1436,0.4470579560536794
48202,DETROIT,MI,8325,7061,-1264,0.45892369686728196
48203,DETROIT,MI,1936,1742,-194,0.47362697117998914
48203,HIGHLAND PARK,MI,6415,5820,-595,0.4756845116469146
48204,DETROIT,MI,8537,7989,-548,0.48342006535156723
48205,DETROIT,MI,12875,12331,-544,0.48920891851146553
48206,DETROIT,MI,5907,5336,-571,0.474606421773548
48207,DETROIT,MI,9889,8539,-1350,0.46337095723898414
48208,DETROIT,MI,3264,2912,-352,0.47150259067357514
48209,DETROIT,MI,5880,4580,-1300,0.4378585086042065
48210,DETROIT,MI,5507,4490,-1017,0.44913474042212664
48211,DETROIT,MI,1233,1017,-216,0.452
48211,HAMTRAMCK,MI,111,100,-11,0.47393364928909953
48212,DETROIT,MI,1907,1495,-412,0.43944738389182836
48212,HAMTRAMCK,MI,8848,6694,-2154,0.4307038991120834
48213,DETROIT,MI,6742,6461,-281,0.48935847913353026
48214,DETROIT,MI,7577,7120,-457,0.48445260937606316
48215,CENTERLINE,MI,43,40,-3,0.4819277108433735
48215,DETROIT,MI,3887,3525,-362,0.47558014031300594
48215,GROSSE POINTE,MI,63,74,11,0.5401459854014599
48216,DETROIT,MI,2089,1964,-125,0.4845793239575623
48217,DETROIT,MI,2071,1894,-177,0.4776796973518285
48217,DEYRPIT,MI,58,53,-5,0.4774774774774775
48218,DETROIT,MI,108,111,3,0.5068493150684932
48218,RIVER ROUGE,MI,2601,2269,-332,0.4659137577002053
48219,DETROIT,MI,16729,15635,-1094,0.48309850451118524
48220,FERNDALE,MI,11103,9774,-1329,0.46817071418307227
48221,DETROIT,MI,12046,12107,61,0.5012627830911274
48223,DETROIT,MI,8037,7727,-310,0.49016747018523216
48224,DETROIT,MI,15059,14176,-883,0.4848982384128613
48225,HARPER WOODS,MI,6058,5344,-714,0.4686897035607788
48226,DETROIT,MI,6223,4731,-1492,0.4318970239182034
48227,DETROIT,MI,14603,14075,-528,0.49079433712253295
48228,DETROIT,MI,19851,17788,-2063,0.4725949148489599
48229,ECORSE,MI,3032,2967,-65,0.4945824304050675
48230,GROSSE POINTE,MI,1793,1850,57,0.5078232226187208
48230,GROSSE POINTE FARMS,MI,165,157,-8,0.48757763975155277
48230,GROSSE POINTE PARK,MI,3327,3363,36,0.5026905829596413
48232,DETROIT,MI,49,330,281,0.8707124010554089
48234,DETROIT,MI,11061,10816,-245,0.49440051195319284
48234,WARREN,MI,180,185,5,0.5068493150684932
48235,DETROIT,MI,15681,14833,-848,0.4861047388084158
48236,DETROIT,MI,183,148,-35,0.4471299093655589
48236,GROSSE POINTE,MI,1303,1427,124,0.5227106227106227
48236,GROSSE POINTE FARMS,MI,3011,3728,717,0.5531978038284612
48236,GROSSE POINTE SHORES,MI,652,766,114,0.5401974612129761
48236,GROSSE POINTE WOODS,MI,3071,3367,296,0.5229885057471264
48237,OAK PARK,MI,11487,10794,-693,0.48444863336475025
48238,DETROIT,MI,10381,9389,-992,0.47491148204350025
48239,DETROIT,MI,249,216,-33,0.4645161290322581
48239,REDFORD,MI,10641,10241,-400,0.49042237333588734
48240,REDFORD,MI,6541,6301,-240,0.49065566111197634
48243,DETROIT,MI,49,29,-20,0.3717948717948718
48244,DETROIT,MI,49,631,582,0.9279411764705883
48301,BLOOMFIELD,MI,80,120,40,0.6
48301,BLOOMFIELD HILLS,MI,3841,4208,367,0.5227978630885824
48301,BLOOMFIELD TOWNSHIP,MI,359,488,129,0.5761511216056671
48302,BLOOMFIELD,MI,230,266,36,0.5362903225806451
48302,BLOOMFIELD HILLS,MI,5391,5598,207,0.5094185094185094
48302,BLOOMFIELD TOWNSHIP,MI,893,1127,234,0.557920792079208
48303,BLOOMFIELD HILLS,MI,351,217,-134,0.38204225352112675
48304,BLOOMFIELD HILLS,MI,6070,5975,-95,0.49605645496056455
48304,BLOOMFIELD TOWNSHIP,MI,580,568,-12,0.49477351916376305
48306,OAKLAND TOWNSHIP,MI,1086,1186,100,0.5220070422535211
48306,ROCHESTER,MI,2902,3009,107,0.5090509220098122
48306,ROCHESTER HILLS,MI,3113,3559,446,0.5334232613908872
48307,ROCHESTER,MI,8546,7373,-1173,0.4631572334945662
48307,ROCHESTER HILLS,MI,11197,10064,-1133,0.47335496919241804
48308,ROCHESTER,MI,379,514,135,0.5755879059350504
48308,ROCHESTER HILLS,MI,11,16,5,0.5925925925925926
48309,ROCHESTER,MI,212,233,21,0.5235955056179775
48309,ROCHESTER HILLS,MI,9267,8905,-362,0.4900396213955536
48310,STERLING HEIGHTS,MI,12621,11010,-1611,0.4659134188142694
48310,STERLING HTS,MI,729,655,-74,0.47326589595375723
48311,STERLING HEIGHTS,MI,998,577,-421,0.36634920634920637
48312,STERLING HEIGHTS,MI,12032,10730,-1302,0.4713997012564801
48313,STERLING HEIGHTS,MI,10761,9032,-1729,0.4563229424544031
48313,STERLING HTS,MI,826,722,-104,0.4664082687338501
48314,STERLING HEIGHTS,MI,6754,6440,-314,0.4881006518114294
48314,STERLING HTS,MI,574,470,-104,0.4501915708812261
48315,SHELBY TOWNSHIP,MI,4943,5261,318,0.5155821246569973
48315,SHELBY TWP,MI,3010,3547,537,0.5409486045447613
48315,UTICA,MI,677,518,-159,0.43347280334728033
48316,SHELBY TOWNSHIP,MI,5967,6223,256,0.5105004101722723
48316,SHELBY TWP,MI,2571,2699,128,0.5121442125237191
48316,UTICA,MI,412,388,-24,0.485
48317,SHELBY TOWNSHIP,MI,9423,8115,-1308,0.462709544988026
48317,SHELBY TWP,MI,929,872,-57,0.4841754580788451
48317,STERLING HEIGHTS,MI,280,239,-41,0.4605009633911368
48317,UTICA,MI,1427,1250,-177,0.4669406051550243
48318,SHELBY TOWNSHIP,MI,12,28,16,0.7
48318,SHELBY TWP,MI,647,403,-244,0.3838095238095238
48318,UTICA,MI,530,455,-75,0.4619289340101523
48320,KEEGO HARBOR,MI,1928,1778,-150,0.47976254722072315
48320,SYLVAN LAKE,MI,373,313,-60,0.45626822157434405
48321,AUBURN HILLS,MI,255,571,316,0.6912832929782082
48322,WEST BLOOMFIELD,MI,12244,11719,-525,0.4890456119851438
48323,ORCHARD LAKE,MI,284,226,-58,0.44313725490196076
48323,W BLOOMFIELD,MI,464,591,127,0.5601895734597157
48323,WEST BLOOMFIELD,MI,4425,4687,262,0.5143766461808604
48324,ORCHARD LAKE,MI,605,569,-36,0.4846678023850085
48324,W BLOOMFIELD,MI,487,349,-138,0.41746411483253587
48324,WEST BLOOMFIELD,MI,3967,4124,157,0.5097021381782227
48325,W BLOOMFIELD,MI,17,86,69,0.8349514563106796
48325,WEST BLOOMFIELD,MI,318,790,472,0.7129963898916968
48326,AUBURN HILLS,MI,14805,12423,-2382,0.45625826355222565
48327,WATERFORD,MI,8783,8136,-647,0.4808794846031089
48328,WATERFORD,MI,11516,9000,-2516,0.4386820042893351
48329,WATERFORD,MI,7912,7283,-629,0.4793024021059559
48330,DRAYTON PLAINS,MI,14,51,37,0.7846153846153846
48330,WATERFORD,MI,0,61,61,1
48331,FARMINGTON HILLS,MI,7816,7458,-358,0.48828073850988607
48331,FARMINGTON HLS,MI,954,960,6,0.5015673981191222
48332,FARMINGTN HLS,MI,12,22,10,0.6470588235294118
48332,FARMINGTON,MI,88,167,79,0.6549019607843137
48332,FARMINGTON HILLS,MI,0,13,13,1
48333,FARMINGTON,MI,51,154,103,0.751219512195122
48333,FARMINGTON HILLS,MI,201,603,402,0.75
48333,FARMINGTON HLS,MI,0,12,12,1
48334,FARMINGTON,MI,362,320,-42,0.46920821114369504
48334,FARMINGTON HILLS,MI,7678,6905,-773,0.4734965370637043
48334,FARMINGTON HLS,MI,220,179,-41,0.44862155388471175
48335,FARMINGTON,MI,2888,2329,-559,0.4464251485528081
48335,FARMINGTON HILLS,MI,12330,10369,-1961,0.4568042645050443
48336,FARMINGTON,MI,3080,2674,-406,0.46472019464720193
48336,FARMINGTON HILLS,MI,5539,4790,-749,0.4637428599089941
48336,FARMINGTON HLS,MI,985,852,-133,0.4637996733805117
48340,PONTIAC,MI,12862,8866,-3996,0.40804491899852724
48341,PONTIAC,MI,6452,5734,-718,0.47053996389299196
48342,PONTIAC,MI,8397,6323,-2074,0.4295516304347826
48343,PONTIAC,MI,471,1112,641,0.7024636765634871
48346,CLARKSTON,MI,8940,8537,-403,0.4884705613091492
48347,CLARKSTON,MI,184,319,135,0.6341948310139165
48348,CLARKSTON,MI,6892,7189,297,0.5105461259853703
48350,DAVISBURG,MI,1980,2129,149,0.5181309321002677
48350,SPRINGFIELD TOWNSHIP,MI,134,144,10,0.5179856115107914
48350,SPRINGFLD TWP,MI,41,47,6,0.5340909090909091
48353,HARTLAND,MI,2265,2181,-84,0.49055330634278005
48356,HIGHLAND,MI,2341,2343,2,0.5002134927412468
48357,HIGHLAND,MI,3066,3064,-2,0.499836867862969
48359,LAKE ORION,MI,2845,3070,225,0.5190194420963652
48359,ORION,MI,890,965,75,0.5202156334231806
48360,LAKE ORION,MI,3616,3902,286,0.5190210162277201
48360,ORION,MI,68,71,3,0.5107913669064749
48361,LAKE ORION,MI,39,37,-2,0.4868421052631579
48362,LAKE ORION,MI,5396,4990,-406,0.4804544579241286
48363,OAKLAND,MI,1417,1859,442,0.5674603174603174
48367,ADDISON TOWNSHIP,MI,74,76,2,0.5066666666666667
48367,ADDISON TWP,MI,45,25,-20,0.35714285714285715
48367,LAKEVILLE,MI,119,151,32,0.5592592592592592
48367,LEONARD,MI,888,949,61,0.5166031573217202
48370,OXFORD,MI,442,306,-136,0.4090909090909091
48371,OXFORD,MI,9640,8423,-1217,0.46631235121519127
48374,NOVI,MI,4613,5377,764,0.5382382382382382
48375,NOVI,MI,10118,9321,-797,0.47949997427851226
48376,NOVI,MI,1053,553,-500,0.3443337484433375
48377,NOVI,MI,12305,9364,-2941,0.4321380774378144
48380,MILFORD,MI,1906,2205,299,0.5363658477256142
48381,MILFORD,MI,5889,5203,-686,0.469076812116841
48382,COMMERCE TOWNSHIP,MI,5988,6010,22,0.5009168194699116
48382,COMMERCE TWP,MI,139,100,-39,0.41841004184100417
48383,WHITE LAKE,MI,4140,4276,136,0.5080798479087453
48386,WHITE LAKE,MI,5404,5541,137,0.506258565555048
48387,UNION LAKE,MI,166,110,-56,0.39855072463768115
48390,COMMERCE TOWNSHIP,MI,3356,3041,-315,0.4753790839455995
48390,WALLED LAKE,MI,6727,6377,-350,0.48664529914529914
48390,WOLVERINE LAKE,MI,214,248,34,0.5367965367965368
48393,WIXOM,MI,7996,7104,-892,0.4704635761589404
48401,APPLEGATE,MI,423,302,-121,0.416551724137931
48412,ATTICA,MI,1802,1750,-52,0.49268018018018017
48413,BAD AXE,MI,3001,2718,-283,0.4752579122224165
48414,BANCROFT,MI,761,723,-38,0.4871967654986523
48415,BIRCH RUN,MI,2989,2678,-311,0.4725604376213164
48416,BROWN CITY,MI,1760,1551,-209,0.4684385382059801
48417,BURT,MI,668,600,-68,0.47318611987381703
48418,BYRON,MI,1382,1278,-104,0.48045112781954885
48419,CARSONVILLE,MI,929,793,-136,0.4605110336817654
48420,CLIO,MI,8344,7780,-564,0.4825105432895063
48421,COLUMBIAVILLE,MI,2109,2038,-71,0.49143959488787076
48422,CROSWELL,MI,2362,2196,-166,0.4817902588854761
48423,DAVISON,MI,17022,14576,-2446,0.46129501867206785
48426,DECKER,MI,76,0,-76,0
48427,DECKERVILLE,MI,1361,1074,-287,0.44106776180698154
48428,DRYDEN,MI,1452,1486,34,0.505786249149081
48429,DURAND,MI,4283,3684,-599,0.4624074306514372
48430,FENTON,MI,17087,15743,-1344,0.4795309168443497
48433,FLUSHING,MI,9174,9171,-3,0.4999182338511856
48435,FOSTORIA,MI,532,509,-23,0.48895292987512007
48436,GAINES,MI,952,910,-42,0.48872180451127817
48437,GENESEE,MI,445,99,-346,0.18198529411764705
48438,GOODRICH,MI,2056,1903,-153,0.48067693862086386
48439,GRAND BLANC,MI,21652,20433,-1219,0.4855174052512772
48440,HADLEY,MI,0,11,11,1
48441,HARBOR BEACH,MI,1593,1379,-214,0.4639973082099596
48442,HOLLY,MI,8088,8322,234,0.5071297989031078
48444,IMLAY CITY,MI,3461,3069,-392,0.46998468606431854
48445,KINDE,MI,431,168,-263,0.28046744574290483
48446,LAPEER,MI,13261,11315,-1946,0.4604085286458333
48449,LENNON,MI,1186,1156,-30,0.4935952177625961
48450,LEXINGTON,MI,3198,2743,-455,0.4617067833698031
48451,LINDEN,MI,5582,5299,-283,0.48699568054406767
48453,MARLETTE,MI,2262,1965,-297,0.46486870120652946
48454,MELVIN,MI,168,160,-8,0.4878048780487805
48455,METAMORA,MI,2481,2667,186,0.5180652680652681
48456,MINDEN CITY,MI,11,0,-11,0
48457,MONTROSE,MI,3010,2687,-323,0.47165174653326314
48458,MOUNT MORRIS,MI,10703,8371,-2332,0.4388696655132641
48458,MT MORRIS,MI,217,174,-43,0.44501278772378516
48460,NEW LOTHROP,MI,613,475,-138,0.4365808823529412
48461,NORTH BRANCH,MI,2660,2500,-160,0.4844961240310077
48462,ORTONVILLE,MI,3898,3941,43,0.5027426967725476
48463,OTISVILLE,MI,1522,1355,-167,0.47097671185262424
48464,OTTER LAKE,MI,654,652,-2,0.4992343032159265
48465,PALMS,MI,0,11,11,1
48466,PECK,MI,357,295,-62,0.45245398773006135
48467,PORT AUSTIN,MI,2238,1675,-563,0.428060311781242
48468,PORT HOPE,MI,326,274,-52,0.45666666666666667
48469,PORT SANILAC,MI,805,634,-171,0.4405837387074357
48470,RUTH,MI,0,25,25,1
48471,PORT HURON,MI,38,39,1,0.5064935064935064
48471,SANDUSKY,MI,2392,2360,-32,0.49663299663299665
48472,SNOVER,MI,373,248,-125,0.3993558776167472
48473,SWARTZ CREEK,MI,8061,7493,-568,0.4817410312459817
48475,UBLY,MI,827,636,-191,0.43472317156527684
48476,VERNON,MI,59,76,17,0.562962962962963
48480,GRAND BLANC,MI,1041,403,-638,0.2790858725761773
48501,FLINT,MI,1125,1138,13,0.5028722934158197
48502,FLINT,MI,917,868,-49,0.48627450980392156
48503,FLINT,MI,11979,10508,-1471,0.4672922132787833
48504,FLINT,MI,11886,10357,-1529,0.46562963629006876
48505,FLINT,MI,7875,6160,-1715,0.4389027431421446
48505,GRAND RAPIDS,MI,977,849,-128,0.4649507119386637
48506,FLINT,MI,11325,9889,-1436,0.46615442632224
48507,FLINT,MI,16088,13741,-2347,0.4606590901471722
48509,BURTON,MI,4064,3736,-328,0.47897435897435897
48519,BURTON,MI,3464,3737,273,0.5189557005971392
48529,BURTON,MI,4854,4602,-252,0.4866751269035533
48529,FLINT,MI,78,81,3,0.5094339622641509
48531,FLINT,MI,672,252,-420,0.2727272727272727
48532,FLINT,MI,10523,8253,-2270,0.43955048998721774
48601,SAGINAW,MI,14876,13352,-1524,0.47300552642766047
48602,SAGINAW,MI,13441,11716,-1725,0.46571530786659776
48603,SAGINAW,MI,14263,12003,-2260,0.4569786035178558
48604,SAGINAW,MI,4213,3617,-596,0.461941251596424
48605,SAGINAW,MI,759,653,-106,0.46246458923512745
48606,SAGINAW,MI,169,100,-69,0.37174721189591076
48607,SAGINAW,MI,859,940,81,0.5225125069483046
48608,SAGINAW,MI,160,148,-12,0.4805194805194805
48609,SAGINAW,MI,3538,3568,30,0.5021108922037715
48610,ALGER,MI,1480,1481,1,0.5001688618709895
48611,AUBURN,MI,2043,1999,-44,0.4945571499257793
48612,BEAVERTON,MI,4416,4029,-387,0.4770870337477798
48613,BENTLEY,MI,90,0,-90,0
48614,BRANT,MI,116,79,-37,0.40512820512820513
48615,BRECKENRIDGE,MI,1216,1076,-140,0.4694589877835951
48616,CHESANING,MI,2258,2208,-50,0.49440214957456335
48617,CLARE,MI,4276,3548,-728,0.4534764826175869
48618,COLEMAN,MI,1795,1690,-105,0.48493543758967
48619,COMINS,MI,125,49,-76,0.28160919540229884
48621,FAIRVIEW,MI,475,437,-38,0.4791666666666667
48622,FARMINGTON,MI,49,81,32,0.6230769230769231
48622,FARWELL,MI,3466,2805,-661,0.4472970818051347
48623,FREELAND,MI,3994,4083,89,0.5055094713383682
48624,GLADWIN,MI,8236,7371,-865,0.4722880758633946
48625,HARRISON,MI,7419,7033,-386,0.48664544699695544
48626,HEMLOCK,MI,1687,1562,-125,0.48076331178824255
48627,HIGGINS LAKE,MI,574,360,-214,0.3854389721627409
48628,HOPE,MI,749,661,-88,0.46879432624113476
48629,HOUGHTON LAKE,MI,4922,4453,-469,0.47498666666666667
48630,HOUGHTON LAKE HEIGHTS,MI,39,11,-28,0.22
48631,KAWKAWLIN,MI,1495,1345,-150,0.4735915492957746
48632,LAKE,MI,2827,2660,-167,0.4847822125022781
48633,LAKE GEORGE,MI,138,79,-59,0.3640552995391705
48634,LINWOOD,MI,1126,1082,-44,0.490036231884058
48635,LUPTON,MI,909,703,-206,0.43610421836228286
48636,LUZERNE,MI,364,274,-90,0.42946708463949845
48636,MIO,MI,0,13,13,1
48637,MERRILL,MI,1103,922,-181,0.4553086419753086
48638,SAGINAW,MI,6745,5323,-1422,0.4410838581372224
48640,MIDLAND,MI,14900,13070,-1830,0.46728637826242403
48641,MIDLAND,MI,559,574,15,0.5066195939982348
48642,MIDLAND,MI,14551,13656,-895,0.4841351437586415
48647,MIO,MI,2777,2080,-697,0.42824788964381305
48649,OAKLEY,MI,287,277,-10,0.49113475177304966
48650,PINCONNING,MI,2540,2139,-401,0.4571489634537294
48651,PRUDENVILLE,MI,3325,2865,-460,0.462843295638126
48652,RHODES,MI,214,152,-62,0.41530054644808745
48653,ROSCOMMON,MI,5846,5379,-467,0.47919821826280623
48654,ROSE CITY,MI,1235,1145,-90,0.48109243697478993
48655,SAINT CHARLES,MI,1983,1885,-98,0.4873319544984488
48656,SAINT HELEN,MI,2229,2162,-67,0.4923707583693919
48657,SANFORD,MI,3469,3089,-380,0.47102775236352545
48658,STANDISH,MI,2334,2160,-174,0.48064085447263016
48659,STERLING,MI,932,839,-93,0.47374364765669114
48661,WEST BRANCH,MI,5546,5220,-326,0.48485974363737694
48662,WHEELER,MI,197,65,-132,0.2480916030534351
48701,AKRON,MI,363,391,28,0.5185676392572944
48701,BAY CITY,MI,11,0,-11,0
48703,AU GRES,MI,2215,1997,-218,0.47412155745489076
48705,BARTON CITY,MI,48,69,21,0.5897435897435898
48706,BAY CITY,MI,15532,14234,-1298,0.4781966001478197
48707,BAY CITY,MI,257,429,172,0.6253644314868805
48707,FLINT,MI,18,19,1,0.5135135135135135
48708,BAY CITY,MI,12226,10547,-1679,0.4631361700259079
48720,BAY PORT,MI,192,146,-46,0.4319526627218935
48721,BLACK RIVER,MI,128,92,-36,0.41818181818181815
48722,BRIDGEPORT,MI,1074,1175,101,0.5224544241885283
48723,CARO,MI,5563,4846,-717,0.4655586511672591
48724,CARROLLTON,MI,65,22,-43,0.25287356321839083
48725,CASEVILLE,MI,1848,1463,-385,0.4418604651162791
48726,CASS CITY,MI,2092,2047,-45,0.49456390432471614
48727,CLIFFORD,MI,206,95,-111,0.31561461794019935
48729,DEFORD,MI,180,209,29,0.5372750642673522
48730,EAST TAWAS,MI,3186,2655,-531,0.45454545454545453
48731,ELKTON,MI,400,357,-43,0.4715984147952444
48732,ESSEXVILLE,MI,4736,4340,-396,0.47818422212428385
48733,FAIRGROVE,MI,522,498,-24,0.48823529411764705
48734,FRANKENMUTH,MI,2566,2501,-65,0.49358594829287544
48735,GAGETOWN,MI,128,120,-8,0.4838709677419355
48737,GLENNIE,MI,699,662,-37,0.48640705363703157
48738,GREENBUSH,MI,1032,957,-75,0.48114630467571645
48739,HALE,MI,2864,2470,-394,0.4630671166104237
48740,HARRISVILLE,MI,1277,1235,-42,0.491640127388535
48741,DETROIT,MI,15,20,5,0.5714285714285714
48741,KINGSTON,MI,757,567,-190,0.4282477341389728
48742,LINCOLN,MI,705,769,64,0.5217096336499322
48744,MAYVILLE,MI,1709,1542,-167,0.4743155952014765
48745,MIKADO,MI,283,226,-57,0.444007858546169
48746,MILLINGTON,MI,2524,2361,-163,0.4833162743091095
48747,MUNGER,MI,69,85,16,0.551948051948052
48748,NATIONAL CITY,MI,1020,986,-34,0.4915254237288136
48749,OMER,MI,340,240,-100,0.41379310344827586
48750,OSCODA,MI,6511,5277,-1234,0.4476586359009162
48754,OWENDALE,MI,53,0,-53,0
48755,PIGEON,MI,1542,1252,-290,0.44810307802433785
48755,SAND POINT,MI,79,60,-19,0.4316546762589928
48756,OSCODA,MI,46,41,-5,0.47126436781609193
48756,PRESCOTT,MI,2165,2210,45,0.5051428571428571
48757,REESE,MI,1118,1002,-116,0.47264150943396227
48759,SEBEWAING,MI,1216,1081,-135,0.47061384414453633
48760,SILVERWOOD,MI,219,215,-4,0.49539170506912444
48761,SOUTH BRANCH,MI,434,371,-63,0.4608695652173913
48762,SPRUCE,MI,479,458,-21,0.4887940234791889
48763,ALABASTER,MI,39,85,46,0.6854838709677419
48763,TAWAS CITY,MI,2522,2083,-439,0.45233441910966343
48764,TAWAS CITY,MI,34,11,-23,0.24444444444444444
48765,TURNER,MI,26,65,39,0.7142857142857143
48766,TWINING,MI,268,220,-48,0.45081967213114754
48767,UNIONVILLE,MI,486,421,-65,0.46416758544652703
48768,VASSAR,MI,3213,2681,-532,0.45486935866983375
48770,SANDUSKY,OH,14,0,-14,0
48770,WHITTEMORE,MI,683,678,-5,0.4981631153563556
48801,ALMA,MI,6140,5050,-1090,0.451295799821269
48804,MOUNT PLEASANT,MI,615,809,194,0.5681179775280899
48804,MT PLEASANT,MI,82,98,16,0.5444444444444444
48805,ALMA,MI,0,13,13,1
48805,OKEMOS,MI,38,125,87,0.7668711656441718
48806,ASHLEY,MI,181,230,49,0.559610705596107
48807,BANNISTER,MI,0,22,22,1
48808,BATH,MI,2696,2465,-231,0.477620616159659
48809,BELDING,MI,4714,4015,-699,0.4599610493756444
48811,CARSON CITY,MI,1263,1245,-18,0.4964114832535885
48813,CHARLOTTE,MI,8276,7551,-725,0.47709610159853416
48815,CLARKSVILLE,MI,460,531,71,0.5358224016145308
48816,CHASSELL,MI,12,0,-12,0
48817,CORUNNA,MI,2615,2409,-206,0.4794984076433121
48818,CRYSTAL,MI,1349,1123,-226,0.45428802588996764
48819,DANSVILLE,MI,637,571,-66,0.472682119205298
48820,DE WITT,MI,374,452,78,0.5472154963680388
48820,DEWITT,MI,6334,6392,58,0.5022787993085023
48821,DIMONDALE,MI,2071,2056,-15,0.4981826992973104
48822,EAGLE,MI,731,971,240,0.5705052878965923
48823,EAST LANSING,MI,25966,19795,-6171,0.4325735888638797
48825,EAST LANSING,MI,0,45,45,1
48826,EAST LANSING,MI,207,534,327,0.7206477732793523
48827,EATON RAPIDS,MI,5668,5488,-180,0.49193259232699893
48829,EDMORE,MI,1596,1364,-232,0.4608108108108108
48831,ELSIE,MI,1011,917,-94,0.4756224066390041
48832,EAST LANSING,MI,11,12,1,0.5217391304347826
48832,ELWELL,MI,299,213,-86,0.416015625
48834,FENWICK,MI,942,849,-93,0.474036850921273
48835,FOWLER,MI,241,147,-94,0.3788659793814433
48836,FOWLERVILLE,MI,4078,4249,171,0.5102678035306834
48837,GRAND LEDGE,MI,7079,6795,-284,0.48976502811013406
48838,GREENVILLE,MI,9588,8556,-1032,0.47156084656084657
48840,HASLETT,MI,6309,5435,-874,0.4627895095367847
48841,HENDERSON,MI,11,22,11,0.6666666666666666
48842,HOLT,MI,9473,9288,-185,0.49506955919194073
48843,HOWELL,MI,17459,17513,54,0.5007720462083953
48844,HOWELL,MI,674,829,155,0.5515635395874917
48845,HUBBARDSTON,MI,47,133,86,0.7388888888888889
48846,IONIA,MI,8126,7113,-1013,0.4667629109521622
48847,ITHACA,MI,2459,2272,-187,0.48023673641936165
48848,LAINGSBURG,MI,2578,2480,-98,0.4903123764333729
48849,LAKE ODESSA,MI,2072,1897,-175,0.47795414462081126
48850,LAKEVIEW,MI,1829,1773,-56,0.49222654081066075
48851,IONIA,MI,15,23,8,0.6052631578947368
48851,LYONS,MI,744,552,-192,0.42592592592592593
48853,MAPLE RAPIDS,MI,61,23,-38,0.27380952380952384
48854,MASON,MI,7736,6750,-986,0.4659671406875604
48855,HOWELL,MI,4944,5161,217,0.5107372587827808
48856,MIDDLETON,MI,117,28,-89,0.19310344827586207
48857,MORRICE,MI,688,674,-14,0.4948604992657856
48858,MOUNT PLEASANT,MI,19703,17094,-2609,0.46454874038644456
48858,MT PLEASANT,MI,1247,1201,-46,0.49060457516339867
48860,MUIR,MI,528,338,-190,0.3903002309468822
48861,MULLIKEN,MI,387,258,-129,0.4
48864,OKEMOS,MI,10201,9707,-494,0.4875929274663452
48865,ORLEANS,MI,685,544,-141,0.44263628966639545
48866,OVID,MI,1770,1478,-292,0.45504926108374383
48867,OWOSSO,MI,12711,11549,-1162,0.47605111294311625
48870,PALO,MI,50,18,-32,0.2647058823529412
48871,PERRINTON,MI,613,680,67,0.525908739365816
48872,PERRY,MI,2466,2471,5,0.5005063803929511
48873,PEWAMO,MI,88,86,-2,0.4942528735632184
48875,PORTLAND,MI,4077,3953,-124,0.49227895392278953
48876,LANSING,MI,40,44,4,0.5238095238095238
48876,POTTERVILLE,MI,1808,1605,-203,0.4702607676530911
48877,RIVERDALE,MI,778,699,-79,0.4732566012186865
48878,ROSEBUSH,MI,345,391,46,0.53125
48879,SAINT JOHNS,MI,6374,5795,-579,0.47621004190977073
48880,SAINT LOUIS,MI,3502,2966,-536,0.45856524427953
48880,ST LOUIS,MI,56,55,-1,0.4954954954954955
48881,SARANAC,MI,1760,1609,-151,0.4775897892549718
48883,SHEPHERD,MI,2527,2153,-374,0.460042735042735
48884,SHERIDAN,MI,1798,1689,-109,0.4843705190708345
48885,SIDNEY,MI,125,198,73,0.6130030959752322
48886,SIX LAKES,MI,1123,992,-131,0.4690307328605201
48888,STANTON,MI,2790,2691,-99,0.4909688013136289
48889,SUMNER,MI,179,249,70,0.5817757009345794
48890,SUNFIELD,MI,616,540,-76,0.4671280276816609
48891,VESTABURG,MI,1136,1067,-69,0.4843395369950068
48892,WEBBERVILLE,MI,1823,1405,-418,0.43525402726146223
48893,LAKE ISABELLA,MI,142,112,-30,0.4409448818897638
48893,WEIDMAN,MI,2250,2027,-223,0.4739303249941548
48894,WESTPHALIA,MI,169,62,-107,0.2683982683982684
48895,WILLIAMSTON,MI,3845,3867,22,0.5014263485477178
48897,WOODLAND,MI,217,231,14,0.515625
48901,LANSING,MI,488,690,202,0.5857385398981324
48901,WARREN MICHIGAN,NY,0,14,14,1
48906,LANSING,MI,13846,10524,-3322,0.4318424292162495
48908,LANSING,MI,512,473,-39,0.48020304568527916
48909,LANSING,MI,226,620,394,0.7328605200945626
48910,LANSING,MI,21165,17317,-3848,0.4500025986175355
48911,LANSING,MI,23220,17824,-5396,0.4342656661144138
48912,LANSING,MI,12510,9480,-3030,0.4311050477489768
48915,LANSING,MI,5001,4248,-753,0.4592928965293545
48917,LANSING,MI,19098,14899,-4199,0.4382445509897932
48933,LANSING,MI,3279,2334,-945,0.415820416889364
49001,KALAMAZOO,MI,12591,9386,-3205,0.4270828593529599
49002,PORTAGE,MI,8650,7968,-682,0.4794800818389698
49003,KALAMAZOO,MI,342,825,483,0.7069408740359897
49004,KALAMAZOO,MI,6809,5852,-957,0.4622067767158992
49004,PARCHMENT,MI,255,238,-17,0.4827586206896552
49005,KALAMAZOO,MI,59,143,84,0.7079207920792079
49006,KALAMAZOO,MI,16160,10142,-6018,0.3855980533799711
49007,KALAMAZOO,MI,12071,6644,-5427,0.35500935078813783
49008,KALAMAZOO,MI,9438,7043,-2395,0.4273405739942965
49009,KALAMAZOO,MI,22885,19082,-3803,0.4546905902256535
49010,ALLEGAN,MI,7857,7290,-567,0.48128342245989303
49011,ATHENS,MI,724,648,-76,0.47230320699708456
49012,AUGUSTA,MI,1252,1310,58,0.5113192818110851
49013,BANGOR,MI,2343,1927,-416,0.45128805620608897
49014,BATTLE CREEK,MI,9665,8160,-1505,0.45778401122019635
49015,BATTLE CREEK,MI,14809,12113,-2696,0.4499294257484585
49016,BATTLE CREEK,MI,1564,1600,36,0.5056890012642224
49017,BATTLE CREEK,MI,9999,8230,-1769,0.4514784135169236
49019,BATTLE CREEK,MI,0,11,11,1
49019,KALAMAZOO,MI,362,728,366,0.6678899082568808
49021,BELLEVUE,MI,2016,1966,-50,0.4937217478653943
49022,BENTON HARBOR,MI,11206,10045,-1161,0.47268363841701566
49023,BENTON HARBOR,MI,367,578,211,0.6116402116402117
49024,PORTAGE,MI,13793,12481,-1312,0.47503235137398186
49026,BLOOMINGDALE,MI,878,855,-23,0.4933641084824005
49028,BRONSON,MI,2275,2050,-225,0.47398843930635837
49029,BURLINGTON,MI,455,383,-72,0.45704057279236276
49030,BURR OAK,MI,668,592,-76,0.46984126984126984
49030,COLDWATER,MI,16,11,-5,0.4074074074074074
49031,CASSOPOLIS,MI,3835,3257,-578,0.45924985899605186
49032,CENTREVILLE,MI,1064,1016,-48,0.48846153846153845
49033,CERESCO,MI,387,473,86,0.55
49034,CLIMAX,MI,570,502,-68,0.46828358208955223
49036,COLDWATER,MI,12056,10778,-1278,0.4720154156083034
49037,BATTLE CREEK,MI,8357,6738,-1619,0.4463729711825108
49037,SPRINGFIELD,MI,3680,2889,-791,0.4397929669660527
49038,COLOMA,MI,3603,3382,-221,0.48418038654259127
49040,COLON,MI,1318,1174,-144,0.471107544141252
49041,COMSTOCK,MI,0,27,27,1
49042,CONSTANTINE,MI,2010,1707,-303,0.45924132364810333
49043,COVERT,MI,880,713,-167,0.4475831763967357
49045,DECATUR,MI,2056,1925,-131,0.4835468475257473
49046,DELTON,MI,2856,2658,-198,0.4820457018498368
49047,DOWAGIAC,MI,6944,5843,-1101,0.4569484632830218
49048,KALAMAZOO,MI,13983,10640,-3343,0.4321163140153515
49050,DOWLING,MI,428,327,-101,0.433112582781457
49051,EAST LEROY,MI,627,658,31,0.5120622568093385
49052,FULTON,MI,69,37,-32,0.3490566037735849
49053,GALESBURG,MI,2734,2654,-80,0.49257609502598365
49055,GOBLES,MI,2462,2356,-106,0.48899958488999584
49056,GRAND JCT,MI,79,81,2,0.50625
49056,GRAND JUNCTION,MI,1600,1417,-183,0.46967185946304274
49057,HARTFORD,MI,1891,1823,-68,0.49084544964997306
49058,HASTINGS,MI,8416,7522,-894,0.4719538210565943
49060,HICKORY CORNERS,MI,525,604,79,0.5349867139061116
49060,HICKORY CRNRS,MI,47,15,-32,0.24193548387096775
49061,JONES,MI,869,614,-255,0.4140256237356709
49064,LAWRENCE,MI,1257,1187,-70,0.48567921440261863
49065,LAWTON,MI,2710,2248,-462,0.45340863251311014
49066,LEONIDAS,MI,74,50,-24,0.4032258064516129
49067,MARCELLUS,MI,1792,1634,-158,0.47694103911266783
49068,MARSHALL,MI,6592,5995,-597,0.47628505601016924
49070,MARTIN,MI,920,757,-163,0.4514013118664281
49071,MATTAWAN,MI,3760,3547,-213,0.48542493499384154
49072,MENDON,MI,876,871,-5,0.4985689753863766
49073,NASHVILLE,MI,1848,1789,-59,0.4918889194390982
49074,NAZARETH,MI,13,11,-2,0.4583333333333333
49076,OLIVET,MI,1604,1287,-317,0.4451746800415081
49077,OSHTEMO,MI,40,49,9,0.550561797752809
49078,OTSEGO,MI,3830,3475,-355,0.4757015742642026
49079,PAW PAW,MI,5193,4974,-219,0.4892298613160224
49080,PLAINWELL,MI,5803,5571,-232,0.48980130121329346
49081,PORTAGE,MI,752,865,113,0.5349412492269635
49082,QUINCY,MI,2821,2195,-626,0.43759968102073366
49083,RICHLAND,MI,3141,3356,215,0.5165460981991689
49085,SAINT JOSEPH,MI,9899,9440,-459,0.48813278866539117
49087,SCHOOLCRAFT,MI,1913,1906,-7,0.49908352971982195
49088,SCOTTS,MI,922,932,10,0.5026968716289104
49089,SHERWOOD,MI,815,409,-406,0.3341503267973856
49090,SOUTH HAVEN,MI,7257,6417,-840,0.4692847740236946
49091,STURGIS,MI,7689,6963,-726,0.4752252252252252
49092,TEKONSHA,MI,886,611,-275,0.4081496325985304
49093,THREE RIVERS,MI,8271,7641,-630,0.4802036199095023
49094,UNION CITY,MI,1798,1505,-293,0.4556463820768998
49095,VANDALIA,MI,1189,822,-367,0.4087518647439085
49096,SOUTH HAVEN,MI,35,13,-22,0.2708333333333333
49096,VERMONTVILLE,MI,1008,869,-139,0.46297282898241876
49097,VICKSBURG,MI,3829,3638,-191,0.48721039239319675
49098,WATERVLIET,MI,2690,2288,-402,0.45962233828846927
49099,MOTTVILLE,MI,60,45,-15,0.42857142857142855
49099,WHITE PIGEON,MI,2202,2084,-118,0.48623425104993
49101,BARODA,MI,1053,815,-238,0.43629550321199145
49102,BERRIEN CENTER,MI,37,33,-4,0.4714285714285714
49103,BERRIEN SPRINGS,MI,5159,4174,-985,0.447230258223508
49106,BRIDGMAN,MI,2145,1994,-151,0.4817588789562696
49107,BUCHANAN,MI,3689,3682,-7,0.49952516619183285
49111,EAU CLAIRE,MI,1073,979,-94,0.4770955165692008
49112,EDWARDSBURG,MI,4296,3542,-754,0.45190099515182447
49113,GALIEN,MI,838,443,-395,0.34582357533177205
49115,HARBERT,MI,184,139,-45,0.43034055727554177
49116,LAKESIDE,MI,12,78,66,0.8666666666666667
49117,NEW BUFFALO,MI,2620,2418,-202,0.4799523620484319
49120,NILES,MI,14942,13667,-1275,0.47771680240483766
49125,SAWYER,MI,1236,995,-241,0.445988346033169
49126,SODUS,MI,216,133,-83,0.38108882521489973
49127,STEVENSVILLE,MI,4087,3743,-344,0.47803320561941254
49128,THREE OAKS,MI,1329,1242,-87,0.4830805134189031
49129,UNION PIER,MI,388,333,-55,0.4618585298196949
49130,UNION,MI,695,589,-106,0.45872274143302183
49201,JACKSON,MI,16640,16030,-610,0.4906642179369452
49202,JACKSON,MI,10855,8786,-2069,0.44732956570439386
49203,JACKSON,MI,16387,14424,-1963,0.46814449384959916
49204,JACKSON,MI,1743,1444,-299,0.4530906808911202
49220,ADDISON,MI,992,839,-153,0.4582195521572911
49221,ADRIAN,MI,16985,14663,-2322,0.4633152173913043
49224,ALBION,MI,5181,4806,-375,0.48122559327125264
49227,ALLEN,MI,290,305,15,0.5126050420168067
49228,BLISSFIELD,MI,1915,1692,-223,0.4690878846686998
49229,BRITTON,MI,916,818,-98,0.4717416378316032
49230,BROOKLYN,MI,4950,4394,-556,0.4702482876712329
49232,CAMDEN,MI,822,820,-2,0.4993909866017052
49233,CEMENT CITY,MI,984,1021,37,0.5092269326683292
49234,CLARKLAKE,MI,1001,965,-36,0.4908443540183113
49235,CLAYTON,MI,411,352,-59,0.4613368283093054
49236,CLINTON,MI,1724,1313,-411,0.43233454066513005
49237,CONCORD,MI,1044,927,-117,0.4703196347031963
49238,DEERFIELD,MI,415,209,-206,0.3349358974358974
49240,GRASS LAKE,MI,2745,2892,147,0.5130388504523683
49241,HANOVER,MI,765,599,-166,0.43914956011730205
49242,HILLSDALE,MI,6353,5860,-493,0.4798165888807009
49245,HOMER,MI,1780,1668,-112,0.4837587006960557
49246,HORTON,MI,871,845,-26,0.49242424242424243
49247,HUDSON,MI,2321,2025,-296,0.465945697192821
49248,JASPER,MI,52,19,-33,0.2676056338028169
49249,JEROME,MI,1281,1256,-25,0.49507292077256604
49250,JONESVILLE,MI,2582,2288,-294,0.4698151950718686
49251,LESLIE,MI,2422,2004,-418,0.4527790329868956
49252,LITCHFIELD,MI,1149,1104,-45,0.49001331557922767
49253,MANITOU BEACH,MI,1594,1618,24,0.5037359900373599
49254,MICHIGAN CENTER,MI,1437,1327,-110,0.4801013024602026
49255,MONTGOMERY,MI,384,291,-93,0.4311111111111111
49256,MORENCI,MI,1445,1303,-142,0.47416302765647744
49259,MUNITH,MI,990,743,-247,0.42873629544143105
49261,NAPOLEON,MI,146,24,-122,0.1411764705882353
49262,NORTH ADAMS,MI,369,257,-112,0.41054313099041534
49264,ONONDAGA,MI,373,368,-5,0.4966261808367072
49265,ONSTED,MI,1740,1757,17,0.5024306548470118
49266,OSSEO,MI,1149,1093,-56,0.4875111507582516
49267,OTTAWA LAKE,MI,1081,1102,21,0.5048098946404032
49268,PALMYRA,MI,115,75,-40,0.39473684210526316
49269,PARMA,MI,1983,1857,-126,0.48359375
49270,PETERSBURG,MI,1472,1398,-74,0.4871080139372822
49271,PITTSFORD,MI,608,650,42,0.5166931637519873
49272,PLEASANT LAKE,MI,948,812,-136,0.46136363636363636
49274,READING,MI,1278,1219,-59,0.4881858229875851
49276,RIGA,MI,92,23,-69,0.2
49277,RIVES JCT,MI,62,66,4,0.515625
49277,RIVES JUNCTION,MI,869,712,-157,0.450347881087919
49279,SAND CREEK,MI,0,11,11,1
49282,SOMERSET CENTER,MI,76,85,9,0.5279503105590062
49283,SPRING ARBOR,MI,1408,1212,-196,0.46259541984732827
49284,SPRINGFIELD,MI,21,20,-1,0.4878048780487805
49284,SPRINGPORT,MI,1248,1154,-94,0.48043297252289757
49285,STOCKBRIDGE,MI,1761,1588,-173,0.4741713944461033
49286,TECUMSEH,MI,5147,4986,-161,0.49205565972564885
49287,TIPTON,MI,580,502,-78,0.46395563770794823
49288,WALDRON,MI,423,280,-143,0.39829302987197723
49301,ADA,MI,5424,5785,361,0.516103131412258
49302,ALTO,MI,2076,2221,145,0.5168722364440307
49303,BAILEY,MI,37,25,-12,0.4032258064516129
49304,BALDWIN,MI,3278,2796,-482,0.4603226868620349
49305,BARRYTON,MI,1300,1162,-138,0.4719740048740861
49306,BELMONT,MI,2823,3579,756,0.5590440487347704
49307,BIG RAPIDS,MI,9455,8238,-1217,0.4656078675182275
49309,BITELY,MI,1024,1032,8,0.5019455252918288
49310,BLANCHARD,MI,771,738,-33,0.48906560636182905
49312,BROHMAN,MI,27,11,-16,0.2894736842105263
49315,BYRON CENTER,MI,7196,8219,1023,0.5331819656179047
49315,GRAND RAPIDS,MI,197,233,36,0.54186046511627906
49316,CALEDONIA,MI,8870,8166,-704,0.47933787274007983
49318,CASNOVIA,MI,221,168,-53,0.4318766066838046
49319,CEDAR SPRINGS,MI,5707,5776,69,0.5030044413480798
49320,CHIPPEWA LAKE,MI,57,52,-5,0.47706422018348627
49321,COMSTOCK PARK,MI,9672,6911,-2761,0.4167520955195079
49322,CORAL,MI,359,141,-218,0.282
49323,DORR,MI,2304,2300,-4,0.49956559513466553
49325,FREEPORT,MI,320,367,47,0.5342066957787481
49326,GOWEN,MI,1783,1769,-14,0.49802927927927926
49327,GRANT,MI,2891,2704,-187,0.4832886505808758
49328,HOPKINS,MI,1605,1846,241,0.5349174152419589
49329,HOWARD CITY,MI,3602,3242,-360,0.47369959088252483
49330,KENT CITY,MI,1783,1642,-141,0.47941605839416057
49331,LOWELL,MI,5688,5873,185,0.5080010379724937
49332,MECOSTA,MI,1601,1556,-45,0.49287298067785873
49333,MIDDLEVILLE,MI,4330,4507,177,0.5100147108747313
49336,MORLEY,MI,1686,1615,-71,0.4892456831263254
49337,NEWAYGO,MI,6159,6055,-104,0.4957425904699525
49338,PARIS,MI,764,755,-9,0.4970375246872943
49339,PIERSON,MI,967,863,-104,0.4715846994535519
49340,REMUS,MI,1369,1295,-74,0.4861111111111111
49341,ROCKFORD,MI,11806,12288,482,0.5100024902465344
49342,RODNEY,MI,583,600,17,0.5071851225697379
49343,SAND LAKE,MI,2035,1946,-89,0.48882190404421
49344,SHELBYVILLE,MI,2118,1816,-302,0.4616166751398068
49345,CP,MI,78,99,21,0.559322033898305
49345,SPARTA,MI,4552,4360,-192,0.48922800718132853
49346,CANADIAN LAKES,MI,67,125,58,0.6510416666666666
49346,STANWOOD,MI,3475,3204,-271,0.47971253181614015
49347,TRUFANT,MI,401,427,26,0.5157004830917874
49348,WAYLAND,MI,6262,5742,-520,0.47834055314895035
49349,WHITE CLOUD,MI,3764,3739,-25,0.49833399973343995
49401,ALLENDALE,MI,11421,6954,-4467,0.3784489795918367
49402,BRANCH,MI,565,561,-4,0.49822380106571934
49403,CONKLIN,MI,290,339,49,0.5389507154213037
49404,COOPERSVILLE,MI,2747,2598,-149,0.4860617399438728
49405,CUSTER,MI,499,469,-30,0.484504132231405
49406,DOUGLAS,MI,1019,1037,18,0.5043774319066148
49408,FENNVILLE,MI,3642,3449,-193,0.48639120011281906
49410,FOUNTAIN,MI,791,814,23,0.5071651090342679
49411,FREE SOIL,MI,543,562,19,0.5085972850678733
49411,FREESOIL,MI,0,11,11,1
49412,FREMONT,MI,4605,4097,-508,0.4708113077453459
49415,FRUITPORT,MI,2674,2173,-501,0.4483185475551888
49417,GRAND HAVEN,MI,13913,13657,-256,0.4953572723975336
49418,GRANDVILLE,MI,10189,11554,1365,0.5313894126845422
49418,WYOMING,MI,1808,1966,158,0.5209326974032856
49419,HAMILTON,MI,1815,1924,109,0.5145760898635999
49420,HART,MI,2909,2473,-436,0.45949461166852473
49421,HESPERIA,MI,2894,2317,-577,0.4446363461907503
49422,HOLLAND,MI,1405,1015,-390,0.4194214876033058
49423,HOLLAND,MI,18512,16533,-1979,0.47176487373377085
49424,HOLLAND,MI,18699,16725,-1974,0.47213753387533874
49425,HOLTON,MI,1336,1099,-237,0.4513347022587269
49426,HUDSONVILLE,MI,11151,10839,-312,0.4929058663028649
49428,GEORGETOWN TOWNSHIP,MI,110,142,32,0.5634920634920635
49428,JENISON,MI,6878,6976,98,0.5035368846542515
49429,JENISON,MI,144,137,-7,0.4875444839857651
49431,LUDINGTON,MI,9338,9024,-314,0.49144973314453766
49434,MACATAWA,MI,129,89,-40,0.40825688073394495
49435,MARNE,MI,969,904,-65,0.4826481580352376
49436,MEARS,MI,1322,1154,-168,0.46607431340872374
49437,MONTAGUE,MI,3116,2660,-456,0.4605263157894737
49440,MUSKEGON,MI,1280,1552,272,0.5480225988700564
49441,MUSKEGON,MI,9101,7838,-1263,0.46271916878210045
49441,NORTON SHORES,MI,7025,6233,-792,0.47013124151455726
49442,MUSKEGON,MI,18787,16299,-2488,0.4645442626688708
49443,MUSKEGON,MI,503,894,391,0.6399427344309234
49444,MUSKEGON,MI,7715,7116,-599,0.4798058121502259
49444,NORTON SHORES,MI,3723,3540,-183,0.48740190004130524
49445,MUSKEGON,MI,7221,7065,-156,0.49454010919781605
49446,NEW ERA,MI,788,803,15,0.5047140163419234
49448,NUNICA,MI,1301,1365,64,0.5120030007501876
49449,PENTWATER,MI,2891,2321,-570,0.4453184957789716
49450,PULLMAN,MI,1195,1008,-187,0.4575578756241489
49451,GRAND RAPIDS,MI,39,38,-1,0.4935064935064935
49451,RAVENNA,MI,1759,1681,-78,0.48866279069767443
49452,ROTHBURY,MI,806,717,-89,0.47078135259356535
49453,SAUGATUCK,MI,1853,1918,65,0.5086184036064705
49454,SCOTTVILLE,MI,1864,1702,-162,0.47728547392035897
49455,SHELBY,MI,2577,2183,-394,0.45861344537815124
49456,NORTON SHORES,MI,1723,1918,195,0.5267783575940675
49456,SPRING LAKE,MI,7606,7154,-452,0.48468834688346885
49457,TWIN LAKE,MI,3827,3698,-129,0.49142857142857144
49459,WALKERVILLE,MI,774,530,-244,0.40644171779141103
49460,WEST OLIVE,MI,3120,3299,179,0.5139429817728618
49461,WHITEHALL,MI,3707,3688,-19,0.4987153482082488
49464,ZEELAND,MI,7134,7011,-123,0.4956521739130435
49468,GRANDVILLE,MI,11,26,15,0.7027027027027027
49501,GRAND RAPIDS,MI,1213,2246,1033,0.6493206128939
49503,GRAND RAPIDS,MI,30292,22875,-7417,0.43024808621889515
49504,GRAND RAPIDS,MI,22746,18059,-4687,0.44256831270677616
49505,GRAND RAPIDS,MI,23960,13457,-10503,0.35964935724403346
49506,GRAND RAPIDS,MI,15512,12140,-3372,0.4390279184145812
49507,GRAND RAPIDS,MI,19666,13428,-6238,0.4057533087568744
49508,GR,MI,437,335,-102,0.4339378238341969
49508,GRAND RAPIDS,MI,18837,16113,-2724,0.46103004291845495
49508,KENTWOOD,MI,779,672,-107,0.4631288766368022
49509,WYOMING,MI,12852,10946,-1906,0.459954618035129
49510,GRAND RAPIDS,MI,209,369,160,0.6384083044982699
49512,GRAND RAPIDS,MI,10648,9195,-1453,0.46338759260192514
49512,KENTWOOD,MI,886,748,-138,0.45777233782129745
49514,GRAND RAPIDS,MI,380,233,-147,0.3800978792822186
49515,GRAND RAPIDS,MI,233,185,-48,0.44258373205741625
49516,GRAND RAPIDS,MI,579,429,-150,0.4255952380952381
49518,GRAND RAPIDS,MI,959,706,-253,0.424024024024024
49518,KENTWOOD,MI,93,215,122,0.698051948051948
49519,WYOMING,MI,16461,12270,-4191,0.4270648428526678
49523,GRAND RAPIDS,MI,226,0,-226,0
49525,GRAND RAPIDS,MI,13902,12162,-1740,0.4666206261510129
49528,GRAND RAPIDS,MI,59,66,7,0.528
49534,GRAND RAPIDS,MI,9383,8161,-1222,0.4651732786137711
49534,WALKER,MI,849,681,-168,0.44509803921568625
49544,GRAND RAPIDS,MI,4609,3916,-693,0.4593548387096774
49544,WALKER,MI,446,374,-72,0.4560975609756098
49546,GRAND RAPIDS,MI,14293,13589,-704,0.48737536762068717
49548,GRAND RAPIDS,MI,16133,13110,-3023,0.4483124166467189
49548,KENTWOOD,MI,432,383,-49,0.4699386503067485
49548,WYOMING,MI,727,538,-189,0.425296442687747
49588,GRAND RAPIDS,MI,63,52,-11,0.45217391304347826
49588,KENTWOOD,MI,0,17,17,1
49601,CADILLAC,MI,11973,10469,-1504,0.4664914000534712
49610,ACME,MI,494,415,-79,0.45654565456545654
49612,ALDEN,MI,938,513,-425,0.35354927636113026
49613,ARCADIA,MI,608,457,-151,0.4291079812206573
49614,BEAR LAKE,MI,1479,1505,26,0.5043565683646113
49615,BELLAIRE,MI,3025,2930,-95,0.4920235096557515
49616,BENZONIA,MI,1077,1144,67,0.515083295812697
49617,BEULAH,MI,2182,2017,-165,0.4803524648725887
49618,BOON,MI,45,25,-20,0.35714285714285715
49619,BRETHREN,MI,270,201,-69,0.4267515923566879
49620,BUCKLEY,MI,1146,1062,-84,0.48097826086956524
49621,CEDAR,MI,1563,1571,8,0.5012763241863434
49622,CENTRAL LAKE,MI,1604,1361,-243,0.4590219224283305
49623,CHASE,MI,360,275,-85,0.4330708661417323
49625,COPEMISH,MI,350,393,43,0.5289367429340511
49626,EASTLAKE,MI,22,0,-22,0
49627,EASTPORT,MI,601,309,-292,0.3395604395604396
49628,ELBERTA,MI,43,34,-9,0.44155844155844154
49629,ELK RAPIDS,MI,1917,1783,-134,0.4818918918918919
49630,EMPIRE,MI,1014,1085,71,0.5169128156264888
49631,EVART,MI,3017,2951,-66,0.494470509383378
49632,FALMOUTH,MI,225,212,-13,0.4851258581235698
49633,FIFE LAKE,MI,1784,1715,-69,0.49014004001143185
49635,FRANKFORT,MI,3221,3044,-177,0.4858739026336792
49636,GLEN ARBOR,MI,994,803,-191,0.4468558708959377
49637,GRAWN,MI,1533,1581,48,0.5077071290944123
49638,HARRIETTA,MI,89,90,1,0.5027932960893855
49639,HERSEY,MI,1226,1125,-101,0.47851977881752444
49640,HONOR,MI,955,956,1,0.500261643118786
49640,KALKASKA,MI,36,12,-24,0.25
49642,IDLEWILD,MI,664,433,-231,0.39471285323609845
49643,INTERLOCHEN,MI,2938,2916,-22,0.49812094294499487
49644,IRONS,MI,1509,1303,-206,0.46337126600284495
49645,KALEVA,MI,1118,746,-372,0.4002145922746781
49646,KALKASKA,MI,4444,4216,-228,0.4868360277136259
49648,KEWADIN,MI,2053,1741,-312,0.4588824459673168
49649,KINGSLEY,MI,2556,2396,-160,0.48384491114701134
49650,LAKE ANN,MI,1647,1465,-182,0.47075835475578404
49651,LAKE CITY,MI,4367,3970,-397,0.47619047619047616
49653,LAKE LEELANAU,MI,1247,1129,-118,0.4751683501683502
49654,LELAND,MI,922,768,-154,0.4544378698224852
49655,LEROY,MI,1364,1216,-148,0.47131782945736433
49656,LUTHER,MI,725,634,-91,0.4665194996320824
49657,MC BAIN,MI,941,906,-35,0.49052517596101786
49659,MANCELONA,MI,3742,3332,-410,0.47102063895957025
49660,MANISTEE,MI,7286,6272,-1014,0.46260510399763977
49663,MANTON,MI,2376,2249,-127,0.48627027027027026
49664,MAPLE CITY,MI,1203,1053,-150,0.46675531914893614
49665,MARION,MI,1779,1667,-112,0.483749274521184
49667,MERRITT,MI,0,32,32,1
49668,MESICK,MI,1623,1597,-26,0.49596273291925463
49670,NORTHPORT,MI,1998,1633,-365,0.4497383640870284
49674,OMENA,MI,165,125,-40,0.43103448275862066
49675,ONEKAMA,MI,645,703,58,0.521513353115727
49676,RAPID CITY,MI,2465,2092,-373,0.45907395216150976
49677,REED CITY,MI,3597,2947,-650,0.4503361858190709
49679,SEARS,MI,427,387,-40,0.47542997542997545
49680,S BOARDMAN,MI,31,11,-20,0.2619047619047619
49680,SOUTH BOARDMAN,MI,730,761,31,0.5103957075788061
49682,SUTTONS BAY,MI,2498,2209,-289,0.4693010410027618
49683,THOMPSONVILLE,MI,828,904,76,0.5219399538106235
49684,TRAVERSE CITY,MI,12539,11370,-1169,0.4755531389853193
49685,TRAVERSE CITY,MI,10065,9867,-198,0.49503311258278143
49686,TRAVERSE CITY,MI,15625,14006,-1619,0.47268063852046843
49688,TUSTIN,MI,1119,928,-191,0.45334636052760136
49689,WELLSTON,MI,844,824,-20,0.4940047961630695
49690,WILLIAMSBURG,MI,3263,3130,-133,0.4895979978101048
49696,TRAVERSE CITY,MI,4205,4526,321,0.5183827740235941
49701,MACKINAW CITY,MI,1081,893,-188,0.4523809523809524
49705,AFTON,MI,132,77,-55,0.3684210526315789
49706,ALANSON,MI,2329,2305,-24,0.4974104445403539
49707,ALPENA,MI,11585,9439,-2146,0.4489630898021309
49709,ATLANTA,MI,2386,2178,-208,0.47721297107800176
49710,BARBEAU,MI,83,113,30,0.576530612244898
49712,BOYNE CITY,MI,4758,4560,-198,0.489375402446877
49713,BOYNE FALLS,MI,952,933,-19,0.49496021220159153
49715,BRIMLEY,MI,1361,1234,-127,0.47552986512524087
49716,BRUTUS,MI,240,178,-62,0.4258373205741627
49717,BURT LAKE,MI,11,0,-11,0
49718,CARP LAKE,MI,353,286,-67,0.4475743348982786
49719,CEDARVILLE,MI,1393,1155,-238,0.4532967032967033
49720,CHARLEVOIX,MI,6195,6158,-37,0.49850238808386627
49721,CHEBOYGAN,MI,7750,6960,-790,0.47314751869476546
49722,CONWAY,MI,168,34,-134,0.16831683168316833
49723,CROSS VILLAGE,MI,11,0,-11,0
49724,DAFTER,MI,152,89,-63,0.36929460580912865
49725,DE TOUR VILLAGE,MI,392,327,-65,0.45479833101529904
49726,DRUMMOND IS,MI,11,42,31,0.7924528301886793
49726,DRUMMOND ISLAND,MI,845,760,-85,0.4735202492211838
49727,EAST JORDAN,MI,3776,3111,-665,0.4517206330768114
49728,ECKERMAN,MI,70,102,32,0.5930232558139535
49729,ELLSWORTH,MI,583,398,-185,0.4057084607543323
49730,ELMIRA,MI,856,894,38,0.5108571428571429
49733,FREDERIC,MI,818,874,56,0.516548463356974
49734,GAYLORD,MI,1870,1308,-562,0.4115796098174953
49735,GAYLORD,MI,10763,9810,-953,0.47683857483108927
49736,GOETZVILLE,MI,26,111,85,0.8102189781021898
49738,GRAYLING,MI,5620,5191,-429,0.48015909721579875
49740,HARBOR SPGS,MI,938,650,-288,0.4093198992443325
49740,HARBOR SPRINGS,MI,5385,5497,112,0.5051461128469031
49743,HAWKS,MI,97,74,-23,0.4327485380116959
49744,HERRON,MI,101,98,-3,0.49246231155778897
49745,HESSEL,MI,401,560,159,0.5827263267429761
49746,HILLMAN,MI,1726,1695,-31,0.4954691610640164
49747,HUBBARD LAKE,MI,1088,878,-210,0.44659206510681587
49748,HULBERT,MI,17,0,-17,0
49749,INDIAN RIVER,MI,3381,3148,-233,0.48215653239393474
49751,JOHANNESBURG,MI,1099,1007,-92,0.4781576448243115
49752,KINROSS,MI,11,25,14,0.6944444444444444
49753,LACHINE,MI,712,737,25,0.5086266390614217
49755,LEVERING,MI,870,814,-56,0.4833729216152019
49756,LEWISTON,MI,2698,2401,-297,0.4708766424789174
49757,MACKINAC ISLAND,MI,1640,1088,-552,0.39882697947214074
49759,MILLERSBURG,MI,852,789,-63,0.48080438756855576
49759,OCQUEOC,MI,24,16,-8,0.4
49760,MORAN,MI,175,201,26,0.5345744680851063
49761,MULLETT LAKE,MI,49,69,20,0.5847457627118644
49762,NAUBINWAY,MI,240,214,-26,0.4713656387665198
49764,ODEN,MI,36,12,-24,0.25
49765,ONAWAY,MI,1915,1779,-136,0.481591770438549
49766,OSSINEKE,MI,969,1021,52,0.5130653266331658
49768,PARADISE,MI,226,200,-26,0.4694835680751174
49769,PELLSTON,MI,929,726,-203,0.43867069486404836
49770,PETOSKEY,MI,12189,11228,-961,0.47948071913567064
49774,PICKFORD,MI,477,459,-18,0.49038461538461536
49775,BOIS BLANC ISLAND,MI,15,25,10,0.625
49775,POINTE AUX PINS,MI,40,127,87,0.7604790419161677
49776,POSEN,MI,387,377,-10,0.49345549738219896
49777,PRESQUE ISLE,MI,1187,1028,-159,0.46410835214446955
49779,ROGERS CITY,MI,2111,2015,-96,0.4883664566165778
49780,FIBRE,MI,21,22,1,0.5116279069767442
49780,RUDYARD,MI,444,453,9,0.5050167224080268
49781,SAINT IGNACE,MI,1996,1913,-83,0.48938347403427984
49782,BEAVER ISLAND,MI,1062,752,-310,0.4145534729878721
49783,SAULT SAINTE MARIE,MI,9409,7908,-1501,0.45666108448345555
49788,KINCHELOE,MI,1157,1106,-51,0.4887317719840919
49791,TOPINABEE,MI,144,178,34,0.5527950310559007
49793,TROUT LAKE,MI,14,46,32,0.7666666666666667
49795,VANDERBILT,MI,1281,1157,-124,0.4745693191140279
49796,WALLOON LAKE,MI,379,336,-43,0.4699300699300699
49797,WATERS,MI,72,46,-26,0.3898305084745763
49799,WOLVERINE,MI,1318,1249,-69,0.4865601869887028
49801,IRON MOUNTAIN,MI,5206,4792,-414,0.47929585917183437
49802,KINGSFORD,MI,2726,2436,-290,0.47191011235955055
49805,ALLOUEZ,MI,13,0,-13,0
49806,AU TRAIN,MI,269,192,-77,0.4164859002169197
49807,BARK RIVER,MI,1027,1044,17,0.5041042974408498
49808,BIG BAY,MI,184,124,-60,0.4025974025974026
49812,CARNEY,MI,80,98,18,0.550561797752809
49812,LANSING,MI,11,0,-11,0
49814,CHAMPION,MI,385,255,-130,0.3984375
49815,CHANNING,MI,97,21,-76,0.17796610169491525
49816,CHATHAM,MI,35,40,5,0.5333333333333333
49816,LIMESTONE,MI,11,0,-11,0
49817,COOKS,MI,27,11,-16,0.2894736842105263
49818,CORNELL,MI,76,83,7,0.5220125786163522
49819,ARNOLD,MI,51,19,-32,0.2714285714285714
49820,CURTIS,MI,515,363,-152,0.4134396355353075
49821,DAGGETT,MI,162,146,-16,0.474025974025974
49827,ENGADINE,MI,255,222,-33,0.46540880503144655
49829,ESCANABA,MI,7730,6956,-774,0.47364837259975484
49831,FELCH,MI,65,143,78,0.6875
49833,LITTLE LAKE,MI,24,49,25,0.6712328767123288
49835,GARDEN,MI,292,260,-32,0.47101449275362317
49836,GERMFASK,MI,193,229,36,0.542654028436019
49837,GLADSTONE,MI,3799,3519,-280,0.4808690899152774
49838,GOULD CITY,MI,156,45,-111,0.22388059701492538
49839,GRAND MARAIS,MI,285,242,-43,0.45920303605313095
49840,GULLIVER,MI,224,196,-28,0.4666666666666667
49841,GWINN,MI,4631,3822,-809,0.45214716668638355
49847,HERMANSVILLE,MI,141,90,-51,0.38961038961038963
49849,ISHPEMING,MI,5386,4920,-466,0.47739181059576946
49853,MC MILLAN,MI,571,553,-18,0.4919928825622776
49854,MANISTIQUE,MI,3650,3261,-389,0.4718564607148025
49855,MARQUETTE,MI,19289,14891,-4398,0.43566413107080165
49858,MENOMINEE,MI,5869,4769,-1100,0.4482985523594661
49861,IRON MOUNTAIN,MI,11,0,-11,0
49861,MICHIGAMME,MI,329,291,-38,0.4693548387096774
49862,CHRISTMAS,MI,122,112,-10,0.47863247863247865
49862,MUNISING,MI,1901,1700,-201,0.4720910858094974
49866,NEGAUNEE,MI,3229,2915,-314,0.4744466145833333
49868,NEWBERRY,MI,2168,1941,-227,0.47237770747140423
49870,NORWAY,MI,1394,1259,-135,0.4745571051639653
49871,PALMER,MI,0,11,11,1
49874,POWERS,MI,74,67,-7,0.475177304964539
49876,QUINNESEC,MI,71,49,-22,0.4083333333333333
49878,RAPID RIVER,MI,1739,1649,-90,0.4867178276269185
49879,REPUBLIC,MI,361,381,20,0.5134770889487871
49880,ROCK,MI,113,182,69,0.6169491525423729
49881,SAGOLA,MI,25,0,-25,0
49884,SHINGLETON,MI,62,24,-38,0.27906976744186046
49885,SKANDIA,MI,601,514,-87,0.4609865470852018
49886,SPALDING,MI,11,0,-11,0
49887,CEDAR RIVER,MI,243,167,-76,0.4073170731707317
49887,STEPHENSON,MI,580,636,56,0.5230263157894737
49891,TRENARY,MI,35,52,17,0.5977011494252874
49892,VULCAN,MI,481,465,-16,0.4915433403805497
49893,WALLACE,MI,278,210,-68,0.430327868852459
49894,WELLS,MI,128,49,-79,0.2768361581920904
49895,WETMORE,MI,362,417,55,0.5353016688061617
49896,WILSON,MI,195,194,-1,0.4987146529562982
49901,AHMEEK,MI,24,0,-24,0
49902,ALPHA,MI,12,0,-12,0
49903,AMASA,MI,11,0,-11,0
49905,ATLANTIC MINE,MI,403,385,-18,0.4885786802030457
49908,BARAGA,MI,992,951,-41,0.4894493051981472
49908,KEWEENAW BAY,MI,19,22,3,0.5365853658536586
49910,BERGLAND,MI,53,14,-39,0.208955223880597
49911,BESSEMER,MI,1291,1209,-82,0.4836
49912,BRUCE CROSSING,MI,142,137,-5,0.4910394265232975
49913,CALUMET,MI,2292,2163,-129,0.4855218855218855
49913,LAURIUM,MI,1064,872,-192,0.45041322314049587
49915,CASPIAN,MI,294,133,-161,0.3114754098360656
49916,CHASSELL,MI,1257,1065,-192,0.458656330749354
49918,COPPER HARBOR,MI,0,34,34,1
49920,CRYSTAL FALLS,MI,1993,1958,-35,0.495570741584409
49922,DOLLAR BAY,MI,136,92,-44,0.40350877192982454
49925,EWEN,MI,11,26,15,0.7027027027027027
49927,GAASTRA,MI,14,0,-14,0
49930,HANCOCK,MI,3508,3047,-461,0.464836003051106
49931,HOUGHTON,MI,5026,3750,-1276,0.4273017319963537
49934,HUBBELL,MI,55,69,14,0.5564516129032258
49935,IRON RIVER,MI,3408,3132,-276,0.47889908256880737
49938,IRONWOOD,MI,4288,3426,-862,0.4441275602800104
49945,LAKE LINDEN,MI,1304,1252,-52,0.48982785602503914
49946,LANSE,MI,1644,1609,-35,0.4946203504457424
49947,MARENISCO,MI,169,122,-47,0.41924398625429554
49948,MASS CITY,MI,11,0,-11,0
49950,EAGLE HARBOR,MI,143,69,-74,0.32547169811320753
49950,EAGLE RIVER,MI,66,0,-66,0
49950,MOHAWK,MI,681,761,80,0.5277392510402219
49953,ONTONAGON,MI,1401,1246,-155,0.4707215715904798
49955,PAINESDALE,MI,25,0,-25,0
49958,PELKIE,MI,246,221,-25,0.4732334047109208
49959,RAMSAY,MI,24,0,-24,0
49961,SIDNAW,MI,11,0,-11,0
49962,SKANEE,MI,0,23,23,1
49963,SOUTH RANGE,MI,37,36,-1,0.4931506849315068
49965,TOIVOLA,MI,113,171,58,0.602112676056338
49967,KENTON,MI,0,18,18,1
49967,TROUT CREEK,MI,36,34,-2,0.4857142857142857
49968,WAKEFIELD,MI,820,766,-54,0.48297604035308955
49969,WATERSMEET,MI,709,530,-179,0.42776432606941084
49971,WHITE PINE,MI,26,0,-26,0
50001,ACKWORTH,IA,0,24,24,1
50002,ADAIR,IA,314,301,-13,0.4894308943089431
50003,ADEL,IA,3179,3527,348,0.5259469132120489
50005,ALBION,IA,29,24,-5,0.4528301886792453
50006,ALDEN,IA,527,372,-155,0.41379310344827586
50008,ALLERTON,IA,82,89,7,0.52046783625731
50009,ALTOONA,IA,9662,10506,844,0.5209242364141213
50010,AMES,IA,22478,17225,-5253,0.43384630884316044
50014,AMES,IA,22448,16176,-6272,0.41880695940347973
50020,ANITA,IA,408,293,-115,0.41797432239657634
50021,ANKENY,IA,14607,14895,288,0.5048810250152532
50022,ATLANTIC,IA,4749,3961,-788,0.4547646383467279
50023,ANKENY,IA,19197,20957,1760,0.5219156248443493
50025,AUDUBON,IA,1314,1124,-190,0.4610336341263331
50026,BAGLEY,IA,46,0,-46,0
50027,BARNES CITY,IA,11,0,-11,0
50028,BAXTER,IA,529,501,-28,0.48640776699029126
50029,BAYARD,IA,101,49,-52,0.32666666666666666
50032,BERWICK,IA,34,23,-11,0.40350877192982454
50035,BONDURANT,IA,2636,3443,807,0.5663760486922191
50036,BOONE,IA,7813,7050,-763,0.4743322344075893
50037,BOONE,IA,34,603,569,0.9466248037676609
50044,BUSSEY,IA,40,24,-16,0.375
50046,CAMBRIDGE,IA,256,306,50,0.5444839857651246
50047,CARLISLE,IA,2188,2037,-151,0.4821301775147929
50048,CASEY,IA,48,46,-2,0.48936170212765956
50049,CHARITON,IA,3132,2712,-420,0.46406570841889117
50050,CHURDAN,IA,96,73,-23,0.4319526627218935
50054,COLFAX,IA,1367,1243,-124,0.4762452107279693
50055,COLLINS,IA,229,108,-121,0.32047477744807124
50056,COLO,IA,207,215,8,0.509478672985782
50058,COON RAPIDS,IA,549,595,46,0.5201048951048951
50060,CORYDON,IA,1065,1001,-64,0.48451113262342693
50061,CUMMING,IA,367,472,105,0.5625744934445769
50062,MELCHER DALLAS,IA,25,72,47,0.7422680412371134
50063,DALLAS CENTER,IA,836,838,2,0.5005973715651135
50065,DAVIS CITY,IA,36,11,-25,0.23404255319148937
50066,DAWSON,IA,13,0,-13,0
50069,DE SOTO,IA,240,165,-75,0.4074074074074074
50070,DEXTER,IA,288,228,-60,0.4418604651162791
50071,DOWS,IA,172,127,-45,0.42474916387959866
50072,EARLHAM,IA,698,636,-62,0.4767616191904048
50073,ELKHART,IA,246,384,138,0.6095238095238096
50074,BEACONSFIELD,IA,0,11,11,1
50074,ELLSTON,IA,102,24,-78,0.19047619047619047
50075,ELLSWORTH,IA,57,22,-35,0.27848101265822783
50076,EXIRA,IA,239,228,-11,0.48822269807280516
50103,GARDEN GROVE,IA,11,11,0,0.5
50105,GILBERT,IA,348,316,-32,0.4759036144578313
50106,GILMAN,IA,94,121,27,0.5627906976744186
50107,GRAND JUNCTION,IA,308,199,-109,0.39250493096646943
50108,GRAND RIVER,IA,23,11,-12,0.3235294117647059
50109,GRANGER,IA,928,1289,361,0.5814163283716735
50111,GRIMES,IA,7412,8834,1422,0.5437646189831343
50112,GRINNELL,IA,5307,5023,-284,0.4862536302032914
50115,GUTHRIE CENTER,IA,945,968,23,0.5060115002613695
50118,HARTFORD,IA,129,55,-74,0.29891304347826086
50119,HARVEY,IA,11,15,4,0.5769230769230769
50120,HAVERHILL,IA,17,0,-17,0
50122,HUBBARD,IA,194,93,-101,0.3240418118466899
50123,HUMESTON,IA,100,107,7,0.5169082125603864
50124,HUXLEY,IA,1868,2090,222,0.528044466902476
50125,INDIANOLA,IA,8625,8701,76,0.5021932355996768
50126,IOWA FALLS,IA,3511,2899,-612,0.45226209048361937
50128,JAMAICA,IA,11,11,0,0.5
50129,JEFFERSON,IA,2228,2169,-59,0.4932908801455538
50130,JEWELL,IA,411,381,-30,0.4810606060606061
50131,JOHNSTON,IA,12367,11830,-537,0.48890358308881265
50132,KAMRAR,IA,11,0,-11,0
50133,KELLERTON,IA,45,61,16,0.5754716981132075
50134,KELLEY,IA,47,121,74,0.7202380952380952
50135,KELLOGG,IA,478,373,-105,0.4383078730904818
50138,KNOXVILLE,IA,5242,4991,-251,0.48773575686504445
50139,LACONA,IA,221,213,-8,0.49078341013824883
50140,LAMONI,IA,1239,1081,-158,0.46594827586206894
50141,LAUREL,IA,16,0,-16,0
50142,LE GRAND,IA,150,93,-57,0.38271604938271603
50144,LEON,IA,1594,1403,-191,0.4681348014681348
50146,LINDEN,IA,13,11,-2,0.4583333333333333
50147,LINEVILLE,IA,38,12,-26,0.24
50148,LISCOMB,IA,67,0,-67,0
50149,LORIMOR,IA,218,192,-26,0.4682926829268293
50150,LOVILIA,IA,58,13,-45,0.18309859154929578
50151,LUCAS,IA,24,49,25,0.6712328767123288
50153,LYNNVILLE,IA,25,23,-2,0.4791666666666667
50154,MC CALLSBURG,IA,0,31,31,1
50155,MACKSBURG,IA,11,0,-11,0
50156,MADRID,IA,1586,1504,-82,0.4867313915857605
50157,MALCOM,IA,33,14,-19,0.2978723404255319
50158,MARSHALLTOWN,IA,15165,13013,-2152,0.4618141812761729
50160,MARTENSDALE,IA,91,0,-91,0
50161,MAXWELL,IA,740,665,-75,0.47330960854092524
50162,MELBOURNE,IA,264,148,-116,0.3592233009708738
50163,MELCHER,IA,152,79,-73,0.341991341991342
50163,MELCHER DALLAS,IA,275,294,19,0.5166959578207382
50164,MENLO,IA,13,23,10,0.6388888888888888
50166,MILO,IA,256,209,-47,0.44946236559139785
50167,MINBURN,IA,48,47,-1,0.49473684210526314
50168,MINGO,IA,49,37,-12,0.43023255813953487
50169,MITCHELLVILLE,IA,899,899,0,0.5
50170,MONROE,IA,1142,1000,-142,0.4668534080298786
50171,MONTEZUMA,IA,1736,1444,-292,0.4540880503144654
50173,MONTOUR,IA,16,11,-5,0.4074074074074074
50174,MURRAY,IA,239,237,-2,0.49789915966386555
50201,NEVADA,IA,4087,3425,-662,0.455937167199148
50206,NEW PROVIDENCE,IA,17,28,11,0.6222222222222222
50207,NEW SHARON,IA,700,603,-97,0.46277820414428245
50207,TAINTOR,IA,26,33,7,0.559322033898305
50208,NEWTON,IA,10119,9583,-536,0.4863973200690285
50210,NEW VIRGINIA,IA,348,346,-2,0.49855907780979825
50211,NORWALK,IA,5523,6518,995,0.54131716634831
50212,OGDEN,IA,1354,1012,-342,0.42772612003381233
50213,OSCEOLA,IA,3988,3346,-642,0.4562312517043905
50214,OTLEY,IA,11,12,1,0.5217391304347826
50216,PANORA,IA,1310,1275,-35,0.4932301740812379
50217,PATON,IA,0,12,12,1
50219,PELLA,IA,5735,5222,-513,0.47659030756593956
50220,PERRY,IA,4156,3895,-261,0.48379083343684015
50225,PLEASANTVILLE,IA,1266,1172,-94,0.4807219031993437
50226,POLK CITY,IA,2022,2550,528,0.5577427821522309
50228,PRAIRIE CITY,IA,827,756,-71,0.4775742261528743
50229,PROLE,IA,23,94,71,0.8034188034188035
50230,RADCLIFFE,IA,130,74,-56,0.3627450980392157
50232,REASNOR,IA,0,13,13,1
50233,REDFIELD,IA,352,248,-104,0.41333333333333333
50234,RHODES,IA,37,35,-2,0.4861111111111111
50236,ROLAND,IA,338,297,-41,0.46771653543307085
50237,RUNNELLS,IA,644,682,38,0.5143288084464555
50238,RUSSELL,IA,134,191,57,0.5876923076923077
50239,SAINT ANTHONY,IA,13,11,-2,0.4583333333333333
50240,SAINT CHARLES,IA,537,611,74,0.5322299651567944
50244,SLATER,IA,567,415,-152,0.4226069246435845
50246,STANHOPE,IA,11,33,22,0.75
50247,STATE CENTER,IA,846,809,-37,0.48882175226586105
50248,STORY CITY,IA,1717,1663,-54,0.4920118343195266
50249,STRATFORD,IA,218,148,-70,0.40437158469945356
50250,STUART,IA,1182,1139,-43,0.4907367514002585
50251,SULLY,IA,201,127,-74,0.3871951219512195
50257,TRURO,IA,198,199,1,0.5012594458438288
50258,UNION,IA,133,57,-76,0.3
50261,VAN METER,IA,759,869,110,0.5337837837837838
50262,VAN WERT,IA,27,11,-16,0.2894736842105263
50263,WAUKEE,IA,12131,15656,3525,0.5634289415913917
50264,WELDON,IA,38,0,-38,0
50265,WEST DES MOINES,IA,16223,15294,-929,0.48526192213725927
50266,WEST DES MOINES,IA,26481,25649,-832,0.4920199501246883
50268,WHAT CHEER,IA,199,139,-60,0.41124260355029585
50269,WHITTEN,IA,18,0,-18,0
50271,WILLIAMS,IA,42,22,-20,0.34375
50272,WILLIAMSON,IA,25,0,-25,0
50273,WINTERSET,IA,3766,3790,24,0.5015881418740075
50275,WOODBURN,IA,24,24,0,0.5
50276,WOODWARD,IA,838,772,-66,0.4795031055900621
50277,YALE,IA,23,0,-23,0
50278,ZEARING,IA,63,54,-9,0.46153846153846156
50301,DES MOINES,IA,874,613,-261,0.41223940820443844
50302,DES MOINES,IA,31,12,-19,0.27906976744186046
50303,DES MOINES,IA,65,0,-65,0
50304,DES MOINES,IA,0,12,12,1
50305,DES MOINES,IA,66,11,-55,0.14285714285714285
50306,DES MOINES,IA,25,0,-25,0
50309,DES MOINES,IA,13729,11964,-1765,0.46565212314638227
50310,DES MOINES,IA,15646,14386,-1260,0.4790223761321257
50311,DES MOINES,IA,8907,6360,-2547,0.41658479072509336
50312,DES MOINES,IA,8624,7124,-1500,0.4523749047498095
50313,DES MOINES,IA,6861,6255,-606,0.4768984446477585
50314,DES MOINES,IA,7289,5789,-1500,0.4426517816179844
50315,DES MOINES,IA,22921,18076,-4845,0.44091031051052515
50316,DES MOINES,IA,7847,6300,-1547,0.44532409698169223
50317,DES MOINES,IA,20519,14941,-5578,0.42134799774393683
50318,DES MOINES,IA,0,236,236,1
50320,DES MOINES,IA,12639,9827,-2812,0.4374165405501647
50321,DES MOINES,IA,4955,4383,-572,0.4693724566288284
50322,DES MOINES,IA,1112,906,-206,0.4489593657086224
50322,PL HILL,IA,345,293,-52,0.4592476489028213
50322,URBANDALE,IA,15834,11901,-3933,0.4290968090859924
50323,DES MOINES,IA,98,98,0,0.5
50323,URBANDALE,IA,4717,6298,1581,0.571765773944621
50324,WINDSOR HEIGHTS,IA,2113,1996,-117,0.4857629593575079
50324,WINDSOR HTS,IA,114,99,-15,0.4647887323943662
50325,CLIVE,IA,7044,7428,384,0.5132669983416253
50325,DES MOINES,IA,174,108,-66,0.3829787234042553
50327,DES MOINES,IA,94,90,-4,0.4891304347826087
50327,PLEASANT HILL,IA,5059,5168,109,0.5053290309963822
50393,DES MOINES,IA,0,12,12,1
50401,MASON CITY,IA,16584,13672,-2912,0.4518773135906928
50402,MASON CITY,IA,447,381,-66,0.4601449275362319
50420,ALEXANDER,IA,11,0,-11,0
50421,BELMOND,IA,1294,1159,-135,0.47248267427639623
50423,BRITT,IA,1137,1008,-129,0.4699300699300699
50424,BUFFALO CENTER,IA,407,248,-159,0.3786259541984733
50424,BUFFALO CTR,IA,22,0,-22,0
50428,CLEAR LAKE,IA,5662,4838,-824,0.46076190476190476
50434,FERTILE,IA,22,0,-22,0
50435,FLOYD,IA,49,34,-15,0.40963855421686746
50436,FOREST CITY,IA,2745,2124,-621,0.43622920517560076
50438,GARNER,IA,1843,1512,-331,0.45067064083457525
50441,HAMPTON,IA,2323,2073,-250,0.471565059144677
50446,JOICE,IA,39,0,-39,0
50447,KANAWHA,IA,264,202,-62,0.4334763948497854
50448,KENSETT,IA,34,50,16,0.5952380952380952
50449,KLEMME,IA,267,94,-173,0.26038781163434904
50450,LAKE MILLS,IA,1423,1157,-266,0.4484496124031008
50451,LAKOTA,IA,11,11,0,0.5
50452,LATIMER,IA,45,11,-34,0.19642857142857142
50456,MANLY,IA,684,480,-204,0.41237113402061853
50458,NORA SPRINGS,IA,691,601,-90,0.4651702786377709
50459,NORTHWOOD,IA,1013,1012,-1,0.4997530864197531
50461,MASON CITY,IA,62,44,-18,0.41509433962264153
50461,OSAGE,IA,2045,1960,-85,0.4893882646691635
50464,PLYMOUTH,IA,78,30,-48,0.2777777777777778
50465,RAKE,IA,12,15,3,0.5555555555555556
50466,RICEVILLE,IA,398,337,-61,0.45850340136054424
50468,ROCKFORD,IA,229,163,-66,0.41581632653061223
50469,ROCKWELL,IA,327,229,-98,0.4118705035971223
50470,ROWAN,IA,0,14,14,1
50471,RUDD,IA,23,12,-11,0.34285714285714286
50472,SAINT ANSGAR,IA,599,468,-131,0.4386129334582943
50475,SHEFFIELD,IA,352,223,-129,0.38782608695652177
50476,STACYVILLE,IA,0,25,25,1
50477,SWALEDALE,IA,14,0,-14,0
50478,THOMPSON,IA,191,131,-60,0.40683229813664595
50479,THORNTON,IA,26,12,-14,0.3157894736842105
50480,TITONKA,IA,132,133,1,0.5018867924528302
50482,VENTURA,IA,68,95,27,0.5828220858895705
50483,WESLEY,IA,40,29,-11,0.42028985507246375
50501,FORT DODGE,IA,15602,13222,-2380,0.4587149597557591
50510,ALBERT CITY,IA,129,102,-27,0.44155844155844154
50511,ALGONA,IA,4001,3457,-544,0.4635290962724591
50514,ARMSTRONG,IA,406,310,-96,0.4329608938547486
50516,BADGER,IA,95,11,-84,0.10377358490566038
50517,BANCROFT,IA,126,69,-57,0.35384615384615387
50519,BODE,IA,11,24,13,0.6857142857142857
50522,BURT,IA,88,28,-60,0.2413793103448276
50523,CALLENDER,IA,0,11,11,1
50525,CLARION,IA,1576,1313,-263,0.45448251990308064
50529,DAKOTA CITY,IA,248,101,-147,0.28939828080229224
50530,DAYTON,IA,186,184,-2,0.4972972972972973
50532,DUNCOMBE,IA,193,80,-113,0.29304029304029305
50533,EAGLE GROVE,IA,1903,1529,-374,0.44551282051282054
50535,EARLY,IA,158,68,-90,0.3008849557522124
50536,EMMETSBURG,IA,2180,1872,-308,0.46199407699901285
50538,FARNHAMVILLE,IA,45,11,-34,0.19642857142857142
50540,FONDA,IA,206,71,-135,0.2563176895306859
50541,GILMORE CITY,IA,106,36,-70,0.2535211267605634
50542,GOLDFIELD,IA,197,97,-100,0.3299319727891156
50543,GOWRIE,IA,281,187,-94,0.3995726495726496
50544,HARCOURT,IA,45,20,-25,0.3076923076923077
50546,HAVELOCK,IA,12,12,0,0.5
50548,HUMBOLDT,IA,3043,2485,-558,0.44952966714905934
50554,LAURENS,IA,1058,788,-270,0.4268689057421452
50556,LEDYARD,IA,13,0,-13,0
50557,LEHIGH,IA,128,30,-98,0.189873417721519
50558,LIVERMORE,IA,14,39,25,0.7358490566037735
50560,LU VERNE,IA,29,0,-29,0
50561,LYTTON,IA,24,0,-24,0
50562,MALLARD,IA,11,11,0,0.5
50563,MANSON,IA,1175,1026,-149,0.4661517492049069
50565,MARATHON,IA,23,25,2,0.5208333333333334
50568,NEWELL,IA,296,333,37,0.5294117647058824
50569,OTHO,IA,22,0,-22,0
50574,POCAHONTAS,IA,1202,971,-231,0.44684767602393005
50575,POMEROY,IA,184,62,-122,0.25203252032520324
50578,RINGSTED,IA,27,29,2,0.5178571428571429
50579,ROCKWELL CITY,IA,1076,920,-156,0.46092184368737477
50579,ROCKWELLCITY,IA,19,13,-6,0.40625
50581,ROLFE,IA,110,36,-74,0.2465753424657534
50583,SAC CITY,IA,1123,1053,-70,0.48391544117647056
50585,SIOUX RAPIDS,IA,167,178,11,0.5159420289855072
50588,STORM LAKE,IA,7103,5138,-1965,0.4197369495956213
50590,SWEA CITY,IA,235,77,-158,0.2467948717948718
50593,VARINA,IA,35,37,2,0.5138888888888888
50595,WEBSTER CITY,IA,4473,3633,-840,0.4481865284974093
50597,WEST BEND,IA,202,86,-116,0.2986111111111111
50598,WHITTEMORE,IA,41,12,-29,0.22641509433962265
50601,ACKLEY,IA,967,683,-284,0.41393939393939394
50602,ALLISON,IA,425,408,-17,0.4897959183673469
50603,ALTA VISTA,IA,0,12,12,1
50604,APLINGTON,IA,469,347,-122,0.4252450980392157
50606,ARLINGTON,IA,57,24,-33,0.2962962962962963
50607,AURORA,IA,14,0,-14,0
50609,BEAMAN,IA,22,16,-6,0.42105263157894735
50611,BRISTOW,IA,0,11,11,1
50613,CEDAR FALLS,IA,21777,18059,-3718,0.45333366803895975
50616,CHARLES CITY,IA,5527,4326,-1201,0.43905409519943167
50619,CLARKSVILLE,IA,690,546,-144,0.441747572815534
50621,CONRAD,IA,515,372,-143,0.41939120631341603
50622,DENVER,IA,1007,1009,2,0.5004960317460317
50624,DIKE,IA,424,319,-105,0.42934051144010765
50625,DUMONT,IA,212,171,-41,0.4464751958224543
50626,DUNKERTON,IA,376,327,-49,0.465149359886202
50627,ELDORA,IA,1812,1515,-297,0.45536519386834984
50628,ELMA,IA,113,107,-6,0.4863636363636364
50629,FAIRBANK,IA,308,341,33,0.5254237288135594
50630,FREDERICKSBURG,IA,570,374,-196,0.3961864406779661
50632,GARWIN,IA,95,104,9,0.5226130653266332
50632,GREEN MOUNTAIN,IA,13,16,3,0.5517241379310345
50634,GILBERTVILLE,IA,49,22,-27,0.30985915492957744
50635,GLADBROOK,IA,434,345,-89,0.4428754813863928
50636,GREENE,IA,478,462,-16,0.49148936170212765
50638,GRUNDY CENTER,IA,1325,1242,-83,0.48383326840670043
50641,HAZLETON,IA,713,446,-267,0.38481449525452976
50642,HOLLAND,IA,11,0,-11,0
50643,HUDSON,IA,964,850,-114,0.4685777287761852
50643,VOORHIES,IA,19,23,4,0.5476190476190477
50644,INDEPENDENCE,IA,3577,3432,-145,0.48965615637038096
50645,IONIA,IA,36,41,5,0.5324675324675324
50647,JANESVILLE,IA,277,327,50,0.5413907284768212
50648,JESUP,IA,1390,1231,-159,0.4696680656238077
50650,LAMONT,IA,119,25,-94,0.1736111111111111
50651,LA PORTE CITY,IA,1292,1112,-180,0.46256239600665555
50653,MARBLE ROCK,IA,0,13,13,1
50655,MAYNARD,IA,61,0,-61,0
50658,NASHUA,IA,899,681,-218,0.4310126582278481
50659,NEW HAMPTON,IA,1749,1663,-86,0.48739742086752635
50660,NEW HARTFORD,IA,231,181,-50,0.4393203883495146
50662,OELWEIN,IA,4563,3704,-859,0.44804644973992985
50665,PARKERSBURG,IA,873,814,-59,0.4825133372851215
50666,PLAINFIELD,IA,66,90,24,0.5769230769230769
50667,RAYMOND,IA,92,12,-80,0.11538461538461539
50668,READLYN,IA,115,59,-56,0.3390804597701149
50669,REINBECK,IA,844,758,-86,0.4731585518102372
50670,SHELL ROCK,IA,662,503,-159,0.4317596566523605
50671,STANLEY,IA,0,11,11,1
50672,STEAMBOAT ROCK,IA,39,30,-9,0.43478260869565216
50674,SUMNER,IA,1253,1123,-130,0.47264309764309764
50675,TRAER,IA,815,770,-45,0.48580441640378547
50676,TRIPOLI,IA,628,390,-238,0.3831041257367387
50677,WAVERLY,IA,4843,4745,-98,0.494889445139758
50680,WELLSBURG,IA,210,87,-123,0.29292929292929293
50682,WINTHROP,IA,158,166,8,0.5123456790123457
50701,WATERLOO,IA,16379,14451,-1928,0.468731754784301
50702,WASHBURN,IA,686,599,-87,0.466147859922179
50702,WATERLOO,IA,10792,9206,-1586,0.46034603460346035
50703,WATERLOO,IA,12245,8672,-3573,0.41459100253382414
50704,WATERLOO,IA,907,1203,296,0.5701421800947867
50707,ELK RUN HEIGHTS,IA,127,131,4,0.5077519379844961
50707,EVANSDALE,IA,2769,2721,-48,0.49562841530054647
50707,WATERLOO,IA,220,192,-28,0.46601941747572817
50801,CRESTON,IA,5566,4487,-1079,0.44633442753406943
50830,AFTON,IA,555,421,-134,0.43135245901639346
50833,BEDFORD,IA,922,843,-79,0.4776203966005666
50837,BRIDGEWATER,IA,16,0,-16,0
50840,CLEARFIELD,IA,34,24,-10,0.41379310344827586
50841,CORNING,IA,1182,1078,-104,0.47699115044247786
50843,CUMBERLAND,IA,51,12,-39,0.19047619047619047
50845,DIAGONAL,IA,13,11,-2,0.4583333333333333
50846,FONTANELLE,IA,149,116,-33,0.4377358490566038
50848,GRAVITY,IA,13,0,-13,0
50849,GREENFIELD,IA,1234,1028,-206,0.45446507515473034
50851,KENT,IA,151,134,-17,0.47017543859649125
50851,LENOX,IA,714,626,-88,0.4671641791044776
50853,MASSENA,IA,11,0,-11,0
50854,MOUNT AYR,IA,1083,1056,-27,0.49368863955119213
50858,ORIENT,IA,76,39,-37,0.3391304347826087
50859,PRESCOTT,IA,14,0,-14,0
50860,REDDING,IA,16,12,-4,0.42857142857142855
50863,TINGLEY,IA,12,0,-12,0
50864,VILLISCA,IA,729,536,-193,0.42371541501976284
51001,AKRON,IA,812,752,-60,0.48081841432225064
51002,ALTA,IA,1119,924,-195,0.4522760646108664
51003,ALTON,IA,304,282,-22,0.4812286689419795
51004,ANTHON,IA,188,65,-123,0.25691699604743085
51005,AURELIA,IA,210,250,40,0.5434782608695652
51006,BATTLE CREEK,IA,314,184,-130,0.36947791164658633
51007,BRONSON,IA,12,0,-12,0
51010,CASTANA,IA,12,0,-12,0
51012,CHEROKEE,IA,3317,2955,-362,0.4711415816326531
51016,CORRECTIONVILLE,IA,442,285,-157,0.3920220082530949
51019,DANBURY,IA,45,35,-10,0.4375
51020,GALVA,IA,91,28,-63,0.23529411764705882
51022,GRANVILLE,IA,11,0,-11,0
51023,HAWARDEN,IA,1218,1099,-119,0.4743202416918429
51024,HINTON,IA,318,302,-16,0.4870967741935484
51025,HOLSTEIN,IA,792,649,-143,0.45038167938931295
51026,HORNICK,IA,74,14,-60,0.1590909090909091
51027,IRETON,IA,138,40,-98,0.2247191011235955
51028,KINGSLEY,IA,664,516,-148,0.43728813559322033
51030,LAWTON,IA,239,206,-33,0.46292134831460674
51031,LE MARS,IA,5455,5252,-203,0.4905202204165499
51033,LINN GROVE,IA,11,0,-11,0
51034,MAPLETON,IA,768,566,-202,0.424287856071964
51035,MARCUS,IA,765,594,-171,0.4370860927152318
51037,MERIDEN,IA,22,0,-22,0
51038,MERRILL,IA,376,158,-218,0.2958801498127341
51039,MOVILLE,IA,850,747,-103,0.46775203506574825
51040,ONAWA,IA,1759,1428,-331,0.4480702855349859
51041,ORANGE CITY,IA,2120,2068,-52,0.49379178605539636
51046,PAULLINA,IA,624,407,-217,0.3947623666343356
51047,PETERSON,IA,16,11,-5,0.4074074074074074
51048,PIERSON,IA,23,25,2,0.5208333333333334
51049,QUIMBY,IA,26,0,-26,0
51050,REMSEN,IA,802,649,-153,0.4472777394900069
51052,SALIX,IA,92,53,-39,0.36551724137931035
51053,SCHALLER,IA,234,69,-165,0.22772277227722773
51054,SERGEANT BLUFF,IA,2653,2561,-92,0.4911775987725355
51055,SLOAN,IA,521,416,-105,0.4439701173959445
51058,SUTHERLAND,IA,202,135,-67,0.40059347181008903
51060,UTE,IA,48,0,-48,0
51061,WASHTA,IA,15,0,-15,0
51062,WESTFIELD,IA,0,12,12,1
51063,WHITING,IA,485,225,-260,0.31690140845070425
51101,SIOUX CITY,IA,1307,1526,219,0.5386516060713025
51102,SIOUX CITY,IA,1886,1333,-553,0.41410375893134516
51102,WATERLOO,IA,27,33,6,0.55
51103,SIOUX CITY,IA,7116,5872,-1244,0.45210963966738527
51104,SIOUX CITY,IA,10013,8655,-1358,0.46362759802871223
51105,SIOUX CITY,IA,5371,4252,-1119,0.4418580484256469
51106,SIOUX CITY,IA,12778,11870,-908,0.48158065563128855
51108,SIOUX CITY,IA,2017,1817,-200,0.47391757955138236
51109,SIOUX CITY,IA,1102,956,-146,0.4645286686103013
51201,SHELDON,IA,3297,2593,-704,0.4402376910016978
51232,ASHTON,IA,14,14,0,0.5
51234,BOYDEN,IA,164,32,-132,0.16326530612244897
51235,DOON,IA,14,12,-2,0.46153846153846156
51237,GEORGE,IA,461,281,-180,0.37870619946091644
51238,HOSPERS,IA,85,22,-63,0.205607476635514
51239,HULL,IA,888,747,-141,0.45688073394495415
51240,INWOOD,IA,459,334,-125,0.42118537200504413
51241,LARCHWOOD,IA,466,434,-32,0.4822222222222222
51243,LITTLE ROCK,IA,0,14,14,1
51245,PRIMGHAR,IA,343,317,-26,0.4803030303030303
51246,ROCK RAPIDS,IA,1126,1098,-28,0.493705035971223
51247,ROCK VALLEY,IA,1619,1229,-390,0.4315308988764045
51248,SANBORN,IA,829,711,-118,0.4616883116883117
51249,SIBLEY,IA,1395,1266,-129,0.47576099210823
51250,SIOUX CENTER,IA,2282,2011,-271,0.46843699044956905
51301,SPENCER,IA,6765,6152,-613,0.47627158008825576
51331,ARNOLDS PARK,IA,1148,832,-316,0.4202020202020202
51334,ESTHERVILLE,IA,3525,2809,-716,0.443479633722766
51338,EVERLY,IA,146,74,-72,0.33636363636363636
51340,FOSTORIA,IA,12,0,-12,0
51342,GRAETTINGER,IA,423,299,-124,0.41412742382271467
51346,HARTLEY,IA,1014,906,-108,0.471875
51347,LAKE PARK,IA,296,396,100,0.5722543352601156
51351,MILFORD,IA,2194,2231,37,0.504180790960452
51354,OCHEYEDAN,IA,38,25,-13,0.3968253968253968
51355,OKOBOJI,IA,1348,968,-380,0.41796200345423146
51357,ROYAL,IA,121,36,-85,0.22929936305732485
51358,RUTHVEN,IA,323,333,10,0.5076219512195121
51360,SPIRIT LAKE,IA,6320,5429,-891,0.46208187930887734
51364,TERRIL,IA,58,0,-58,0
51366,WEBB,IA,12,0,-12,0
51401,CARROLL,IA,5327,4469,-858,0.45620661494487547
51431,ARTHUR,IA,35,0,-35,0
51433,AUBURN,IA,92,40,-52,0.30303030303030304
51436,BREDA,IA,106,45,-61,0.2980132450331126
51439,CHARTER OAK,IA,79,77,-2,0.4935897435897436
51440,DEDHAM,IA,22,0,-22,0
51441,DELOIT,IA,0,13,13,1
51442,DENISON,IA,3554,3275,-279,0.47957241177331966
51443,GLIDDEN,IA,484,417,-67,0.462819089900111
51445,IDA GROVE,IA,1466,1263,-203,0.4628068889703188
51446,IRWIN,IA,27,12,-15,0.3076923076923077
51448,KIRON,IA,23,0,-23,0
51449,LAKE CITY,IA,894,657,-237,0.42359767891682787
51450,LAKE VIEW,IA,662,506,-156,0.4332191780821918
51453,LOHRVILLE,IA,97,14,-83,0.12612612612612611
51454,MANILLA,IA,266,135,-131,0.33665835411471323
51455,MANNING,IA,786,750,-36,0.48828125
51458,ODEBOLT,IA,253,225,-28,0.4707112970711297
51461,SCHLESWIG,IA,179,98,-81,0.35379061371841153
51462,SCRANTON,IA,207,249,42,0.5460526315789473
51463,TEMPLETON,IA,13,0,-13,0
51465,VAIL,IA,35,26,-9,0.4262295081967213
51466,WALL LAKE,IA,77,89,12,0.536144578313253
51501,COUCIL BLUFFS,IA,362,259,-103,0.4170692431561997
51501,COUNCIL BLUFFS,IA,19870,15704,-4166,0.44144599988755834
51502,COUNCIL BLUFFS,IA,898,505,-393,0.35994297933000713
51503,COUNCIL BLUFFS,IA,17278,14172,-3106,0.4506200317965024
51510,CARTER LAKE,IA,1544,1353,-191,0.4670348636520538
51521,AVOCA,IA,894,897,3,0.5008375209380235
51523,BLENCOE,IA,15,14,-1,0.4827586206896552
51525,CARSON,IA,261,221,-40,0.45850622406639
51526,CRESCENT,IA,326,320,-6,0.4953560371517028
51527,DEFIANCE,IA,12,14,2,0.5384615384615384
51528,DOW CITY,IA,186,98,-88,0.34507042253521125
51529,DUNLAP,IA,520,563,43,0.5198522622345337
51530,EARLING,IA,28,12,-16,0.3
51531,ELK HORN,IA,61,115,54,0.6534090909090909
51532,ELLIOTT,IA,43,23,-20,0.3484848484848485
51533,EMERSON,IA,128,60,-68,0.3191489361702128
51534,GLENWOOD,IA,3205,3426,221,0.5166641532197256
51534,OMAHA,IA,81,101,20,0.554945054945055
51535,GRISWOLD,IA,531,371,-160,0.4113082039911308
51536,HANCOCK,IA,11,0,-11,0
51537,HARLAN,IA,3063,2776,-287,0.475423873951019
51540,HASTINGS,IA,0,12,12,1
51542,HONEY CREEK,IA,24,29,5,0.5471698113207547
51543,KIMBALLTON,IA,29,0,-29,0
51544,LEWIS,IA,60,25,-35,0.29411764705882354
51545,LITTLE SIOUX,IA,16,11,-5,0.4074074074074074
51546,LOGAN,IA,738,809,71,0.5229476405946994
51549,MACEDONIA,IA,40,12,-28,0.23076923076923078
51551,MALVERN,IA,622,515,-107,0.4529463500439754
51553,MINDEN,IA,149,128,-21,0.4620938628158845
51555,MISSOURI VALLEY,IA,2206,1983,-223,0.4733826688947243
51556,MODALE,IA,11,0,-11,0
51557,MONDAMIN,IA,103,120,17,0.5381165919282511
51558,MOORHEAD,IA,0,37,37,1
51559,NEOLA,IA,296,307,11,0.5091210613598673
51560,OAKLAND,IA,571,589,18,0.5077586206896552
51561,PACIFIC JCT,IA,110,0,-110,0
51561,PACIFIC JUNCTION,IA,515,82,-433,0.1373534338358459
51563,PERSIA,IA,11,0,-11,0
51564,PISGAH,IA,79,22,-57,0.21782178217821782
51565,PORTSMOUTH,IA,27,12,-15,0.3076923076923077
51566,RED OAK,IA,3731,3358,-373,0.4736916349273522
51570,SHELBY,IA,302,381,79,0.5578330893118595
51571,SILVER CITY,IA,23,23,0,0.5
51572,SOLDIER,IA,0,14,14,1
51573,STANTON,IA,84,73,-11,0.46496815286624205
51575,TREYNOR,IA,350,349,-1,0.49928469241773965
51576,UNDERWOOD,IA,314,386,72,0.5514285714285714
51577,WALNUT,IA,347,178,-169,0.33904761904761904
51579,WOODBINE,IA,1075,927,-148,0.463036963036963
51601,SHENANDOAH,IA,3297,2853,-444,0.46390243902439027
51632,CLARINDA,IA,3116,2793,-323,0.47266881028938906
51636,COIN,IA,0,11,11,1
51638,ESSEX,IA,318,352,34,0.5253731343283582
51639,FARRAGUT,IA,57,104,47,0.6459627329192547
51640,HAMBURG,IA,637,498,-139,0.43876651982378856
51646,NEW MARKET,IA,43,12,-31,0.21818181818181817
51648,PERCIVAL,IA,18,0,-18,0
51649,RANDOLPH,IA,11,0,-11,0
51652,SIDNEY,IA,921,759,-162,0.4517857142857143
51653,TABOR,IA,397,303,-94,0.4328571428571429
51654,THURMAN,IA,27,0,-27,0
52001,DUBUQUE,IA,22739,18313,-4426,0.4460927604014421
52002,ASBURY,IA,493,545,52,0.5250481695568401
52002,DUBUQUE,IA,5861,5430,-431,0.48091400230271897
52003,DUBUQUE,IA,5065,4814,-251,0.48729628504909406
52004,DUBUQUE,IA,1240,765,-475,0.38154613466334164
52030,ANDREW,IA,53,13,-40,0.19696969696969696
52031,BELLEVUE,IA,1750,1571,-179,0.47305028605841615
52032,BERNARD,IA,36,56,20,0.6086956521739131
52033,CASCADE,IA,966,845,-121,0.46659304251794587
52035,COLESBURG,IA,104,48,-56,0.3157894736842105
52037,DELMAR,IA,38,50,12,0.5681818181818182
52039,DURANGO,IA,60,49,-11,0.44954128440366975
52040,DYERSVILLE,IA,1721,1812,91,0.5128785734503255
52041,EARLVILLE,IA,69,67,-2,0.49264705882352944
52042,EDGEWOOD,IA,455,411,-44,0.4745958429561201
52043,ELKADER,IA,648,582,-66,0.47317073170731705
52045,EPWORTH,IA,584,381,-203,0.39481865284974094
52046,FARLEY,IA,435,433,-2,0.4988479262672811
52047,FARMERSBURG,IA,0,11,11,1
52049,GARNAVILLO,IA,170,130,-40,0.43333333333333335
52052,GUTTENBERG,IA,1566,1253,-313,0.44448385952465413
52053,HOLY CROSS,IA,56,20,-36,0.2631578947368421
52054,LA MOTTE,IA,11,11,0,0.5
52057,MANCHESTER,IA,3606,3111,-495,0.4631531933899062
52060,MAQUOKETA,IA,3693,3479,-214,0.4850808700501952
52064,MILES,IA,63,18,-45,0.2222222222222222
52065,NEW VIENNA,IA,0,11,11,1
52068,PEOSTA,IA,1301,1433,132,0.5241404535479152
52069,PRESTON,IA,449,251,-198,0.3585714285714286
52070,SABULA,IA,89,92,3,0.5082872928176796
52073,SHERRILL,IA,36,39,3,0.52
52076,STRAWBERRY POINT,IA,677,435,-242,0.39118705035971224
52076,STRAWBERRY PT,IA,87,75,-12,0.46296296296296297
52079,ZWINGLE,IA,11,12,1,0.5217391304347826
52101,DECORAH,IA,4895,4272,-623,0.46601941747572817
52132,CALMAR,IA,736,673,-63,0.47764371894960966
52133,CASTALIA,IA,14,0,-14,0
52134,CHESTER,IA,0,12,12,1
52135,CLERMONT,IA,186,115,-71,0.38205980066445183
52136,CRESCO,IA,2490,2174,-316,0.46612349914236706
52141,ELGIN,IA,304,289,-15,0.4873524451939292
52142,FAYETTE,IA,570,399,-171,0.4117647058823529
52144,FORT ATKINSON,IA,46,71,25,0.6068376068376068
52146,HARPERS FERRY,IA,360,353,-7,0.4950911640953717
52147,HAWKEYE,IA,93,36,-57,0.27906976744186046
52151,LANSING,IA,569,527,-42,0.48083941605839414
52154,LAWLER,IA,84,24,-60,0.2222222222222222
52155,LIME SPRINGS,IA,206,37,-169,0.1522633744855967
52156,LUANA,IA,60,15,-45,0.2
52157,MC GREGOR,IA,736,642,-94,0.46589259796806964
52159,MONONA,IA,991,839,-152,0.45846994535519126
52160,NEW ALBIN,IA,36,11,-25,0.23404255319148937
52161,OSSIAN,IA,184,180,-4,0.4945054945054945
52162,POSTVILLE,IA,1910,1580,-330,0.45272206303724927
52163,PROTIVIN,IA,20,0,-20,0
52165,RIDGEWAY,IA,38,63,25,0.6237623762376238
52168,SPILLVILLE,IA,0,11,11,1
52171,WAUCOMA,IA,13,30,17,0.6976744186046512
52172,WAUKON,IA,2753,2363,-390,0.46188428459734165
52175,WEST UNION,IA,1713,1329,-384,0.4368836291913215
52201,AINSWORTH,IA,235,197,-38,0.45601851851851855
52202,ALBURNETT,IA,150,109,-41,0.42084942084942084
52203,AMANA,IA,511,491,-20,0.49001996007984033
52205,ANAMOSA,IA,3388,3172,-216,0.48353658536585364
52206,ATKINS,IA,584,522,-62,0.4719710669077758
52207,BALDWIN,IA,0,12,12,1
52208,BELLE PLAINE,IA,1199,1075,-124,0.4727352682497801
52209,BLAIRSTOWN,IA,115,136,21,0.5418326693227091
52210,BRANDON,IA,12,53,41,0.8153846153846154
52211,BROOKLYN,IA,1360,1105,-255,0.4482758620689655
52213,CENTER POINT,IA,1323,1276,-47,0.49095806079261256
52214,CENTRAL CITY,IA,1053,851,-202,0.44695378151260506
52215,CHELSEA,IA,33,37,4,0.5285714285714286
52216,CLARENCE,IA,433,425,-8,0.49533799533799533
52217,CLUTIER,IA,24,0,-24,0
52218,COGGON,IA,250,280,30,0.5283018867924528
52220,CONROY,IA,11,0,-11,0
52222,DEEP RIVER,IA,55,23,-32,0.2948717948717949
52223,DELHI,IA,482,449,-33,0.4822771213748657
52224,DYSART,IA,669,589,-80,0.4682034976152623
52225,ELBERON,IA,12,0,-12,0
52227,ELY,IA,979,929,-50,0.4868972746331237
52228,FAIRFAX,IA,1042,1227,185,0.5407668576465403
52229,GARRISON,IA,36,40,4,0.5263157894736842
52233,HIAWATHA,IA,6275,3715,-2560,0.3718718718718719
52235,HILLS,IA,374,278,-96,0.4263803680981595
52237,HOPKINTON,IA,311,163,-148,0.3438818565400844
52240,IOWA CITY,IA,19628,14279,-5349,0.42112248208334563
52241,CORALVILLE,IA,15156,13466,-1690,0.470477255258193
52244,IOWA CITY,IA,764,425,-339,0.35744322960470987
52245,IOWA CITY,IA,10681,9387,-1294,0.467759617301176
52246,IOWA CITY,IA,17046,11803,-5243,0.4091302991438178
52247,KALONA,IA,2068,1758,-310,0.4594877156299007
52248,IOWA CITY,IA,12,0,-12,0
52248,KEOTA,IA,349,414,65,0.5425950196592398
52249,KEYSTONE,IA,104,34,-70,0.2463768115942029
52251,LADORA,IA,11,0,-11,0
52253,LISBON,IA,1047,1124,77,0.5177337632427452
52254,ELWOOD,IA,13,30,17,0.6976744186046512
52254,LOST NATION,IA,52,25,-27,0.3246753246753247
52255,LOWDEN,IA,255,246,-9,0.49101796407185627
52301,MARENGO,IA,1343,1316,-27,0.49492290334712297
52302,MARION,IA,18832,18169,-663,0.49104078268154916
52305,MARTELLE,IA,12,0,-12,0
52306,MECHANICSVILLE,IA,429,390,-39,0.47619047619047616
52309,MONMOUTH,IA,0,11,11,1
52310,MONTICELLO,IA,2913,2374,-539,0.4490259126158502
52313,MOUNT AUBURN,IA,51,0,-51,0
52314,MOUNT VERNON,IA,1650,1703,53,0.5079033701163137
52315,DES MOINES,IA,13,0,-13,0
52315,NEWHALL,IA,268,105,-163,0.28150134048257375
52316,NORTH ENGLISH,IA,600,565,-35,0.48497854077253216
52317,NORTH LIBERTY,IA,10791,10616,-175,0.4959125519689821
52318,NORWAY,IA,22,60,38,0.7317073170731707
52320,OLIN,IA,418,246,-172,0.3704819277108434
52321,ONSLOW,IA,29,0,-29,0
52322,OXFORD,IA,761,725,-36,0.4878869448183042
52323,OXFORD JUNCTION,IA,61,54,-7,0.46956521739130436
52324,PALO,IA,664,826,162,0.5543624161073826
52325,PARNELL,IA,35,28,-7,0.4444444444444444
52326,QUASQUETON,IA,36,11,-25,0.23404255319148937
52327,RIVERSIDE,IA,891,963,72,0.5194174757281553
52328,ROBINS,IA,637,664,27,0.5103766333589547
52330,RYAN,IA,12,52,40,0.8125
52332,SHELLSBURG,IA,830,661,-169,0.443326626425218
52333,SOLON,IA,2192,2268,76,0.5085201793721973
52335,KINROSS,IA,33,12,-21,0.26666666666666666
52335,SOUTH ENGLISH,IA,44,12,-32,0.21428571428571427
52336,FAIRFIELD,IA,0,14,14,1
52336,SPRINGVILLE,IA,671,613,-58,0.47741433021806856
52337,STANWOOD,IA,105,58,-47,0.3558282208588957
52338,SWISHER,IA,909,929,20,0.5054406964091404
52339,TAMA,IA,1631,1348,-283,0.45250083920778783
52340,TIFFIN,IA,3429,4018,589,0.5395461259567611
52341,TODDVILLE,IA,89,25,-64,0.21929824561403508
52342,TOLEDO,IA,1394,1326,-68,0.4875
52345,URBANA,IA,257,398,141,0.6076335877862595
52346,VAN HORNE,IA,265,142,-123,0.3488943488943489
52347,VICTOR,IA,265,266,1,0.5009416195856874
52349,VINTON,IA,3708,3071,-637,0.4530166691252397
52351,WALFORD,IA,216,95,-121,0.3054662379421222
52352,WALKER,IA,363,302,-61,0.45413533834586467
52353,WASHINGTON,IA,4311,3907,-404,0.47541981017279145
52356,WELLMAN,IA,816,749,-67,0.47859424920127797
52358,WEST BRANCH,IA,1300,1476,176,0.531700288184438
52361,WILLIAMSBURG,IA,1731,1631,-100,0.4851279000594884
52362,WYOMING,IA,138,138,0,0.5
52401,CEDAR RAPIDS,IA,2762,2029,-733,0.42350240033395953
52402,CEDAR RAPIDS,IA,25109,19851,-5258,0.4415258007117438
52403,CEDAR RAPIDS,IA,13255,10715,-2540,0.4470171047142261
52404,CEDAR RAPIDS,IA,27493,23562,-3931,0.46150230143962395
52405,CEDAR RAPIDS,IA,13251,11353,-1898,0.4614290359291172
52406,CEDA RAPIDS,IA,61,28,-33,0.3146067415730337
52406,CEDAR RAPIDS,IA,2429,1595,-834,0.39637176938369784
52408,CEDAR RAPIDS,IA,757,461,-296,0.3784893267651888
52409,CEDAR RAPIDS,IA,153,0,-153,0
52410,CEDAR RAPIDS,IA,493,293,-200,0.3727735368956743
52411,CEDAR RAPIDS,IA,1950,2249,299,0.5356037151702786
52501,OTTUMWA,IA,19148,14880,-4268,0.4372869401669214
52530,AGENCY,IA,224,135,-89,0.37604456824512533
52531,ALBIA,IA,2320,2355,35,0.5037433155080214
52533,BATAVIA,IA,92,124,32,0.5740740740740741
52534,BEACON,IA,0,13,13,1
52535,BIRMINGHAM,IA,149,38,-111,0.20320855614973263
52536,BLAKESBURG,IA,80,0,-80,0
52537,BLOOMFIELD,IA,2408,2203,-205,0.4777705486879202
52540,BRIGHTON,IA,412,256,-156,0.38323353293413176
52542,CANTRIL,IA,0,23,23,1
52544,CENTERVILLE,IA,3993,3709,-284,0.4815632303297845
52544,NUMA,IA,174,152,-22,0.4662576687116564
52549,CINCINNATI,IA,27,12,-15,0.3076923076923077
52550,DELTA,IA,11,0,-11,0
52551,DOUDS,IA,81,52,-29,0.39097744360902253
52553,EDDYVILLE,IA,629,312,-317,0.33156216790648246
52554,ELDON,IA,376,253,-123,0.40222575516693165
52556,FAIRFIELD,IA,8340,6927,-1413,0.45372371782275495
52561,FREMONT,IA,330,171,-159,0.3413173652694611
52563,HEDRICK,IA,181,167,-14,0.47988505747126436
52565,KEOSAUQUA,IA,906,764,-142,0.45748502994011975
52567,LIBERTYVILLE,IA,37,11,-26,0.22916666666666666
52569,MELROSE,IA,53,27,-26,0.3375
52570,MILTON,IA,25,25,0,0.5
52571,MORAVIA,IA,460,558,98,0.5481335952848723
52572,MOULTON,IA,167,139,-28,0.4542483660130719
52574,MYSTIC,IA,70,47,-23,0.4017094017094017
52576,OLLIE,IA,47,44,-3,0.4835164835164835
52577,OSKALOOSA,IA,7113,6225,-888,0.46671165092217726
52580,PACKWOOD,IA,15,16,1,0.5161290322580645
52581,PLANO,IA,0,11,11,1
52585,RICHLAND,IA,130,54,-76,0.29347826086956524
52585,RUBIO,IA,28,33,5,0.5409836065573771
52586,ROSE HILL,IA,11,11,0,0.5
52590,SEYMOUR,IA,291,217,-74,0.4271653543307087
52591,SIGOURNEY,IA,1202,1197,-5,0.4989578991246353
52594,UNIONVILLE,IA,12,0,-12,0
52595,UNIVERSITY PARK,IA,83,0,-83,0
52601,BURLINGTON,IA,17301,13329,-3972,0.43516160626836436
52619,ARGYLE,IA,0,12,12,1
52620,BONAPARTE,IA,86,64,-22,0.4266666666666667
52621,CRAWFORDSVILLE,IA,41,0,-41,0
52623,DANVILLE,IA,498,513,15,0.5074183976261127
52624,DENMARK,IA,66,0,-66,0
52625,DONNELLSON,IA,831,685,-146,0.45184696569920846
52626,FARMINGTON,IA,225,138,-87,0.38016528925619836
52627,FORT MADISON,IA,7612,5395,-2217,0.4147766587222265
52632,KEOKUK,IA,7087,5651,-1436,0.44363322342596956
52635,LOCKRIDGE,IA,63,12,-51,0.16
52637,MEDIAPOLIS,IA,881,798,-83,0.4752829064919595
52638,MIDDLETOWN,IA,104,37,-67,0.2624113475177305
52639,MONTROSE,IA,476,445,-31,0.4831704668838219
52640,MORNING SUN,IA,168,111,-57,0.3978494623655914
52641,MOUNT PLEASANT,IA,4116,3540,-576,0.46238244514106586
52641,MT PLEASANT,IA,1582,1135,-447,0.4177401545822598
52644,MOUNT UNION,IA,11,0,-11,0
52645,NEW LONDON,IA,1087,916,-171,0.45731402895656514
52646,OAKVILLE,IA,23,0,-23,0
52647,OLDS,IA,17,0,-17,0
52649,SALEM,IA,96,38,-58,0.2835820895522388
52650,SPERRY,IA,38,12,-26,0.24
52651,STOCKPORT,IA,52,14,-38,0.21212121212121213
52653,WAPELLO,IA,1626,1182,-444,0.42094017094017094
52654,WAYLAND,IA,463,317,-146,0.4064102564102564
52655,W BURLINGTON,IA,42,43,1,0.5058823529411764
52655,WEST BURLINGTON,IA,2271,1857,-414,0.4498546511627907
52656,WEST POINT,IA,499,484,-15,0.4923702950152594
52658,WEVER,IA,133,147,14,0.525
52659,WINFIELD,IA,356,423,67,0.5430038510911425
52720,ATALISSA,IA,83,62,-21,0.42758620689655175
52721,BENNETT,IA,80,0,-80,0
52722,BETTENDORF,IA,17812,17561,-251,0.4964520962315891
52726,BLUE GRASS,IA,1255,1400,145,0.527306967984934
52728,BUFFALO,IA,140,23,-117,0.1411042944785276
52729,CALAMUS,IA,48,11,-37,0.1864406779661017
52730,CAMANCHE,IA,2020,1910,-110,0.4860050890585242
52731,CHARLOTTE,IA,24,12,-12,0.3333333333333333
52732,CLINTON,IA,13826,10994,-2832,0.44294923448831586
52733,CLINTON,IA,910,1495,585,0.6216216216216216
52738,COLUMBUS JCT,IA,99,110,11,0.5263157894736842
52738,COLUMBUS JUNCTION,IA,1070,936,-134,0.4666001994017946
52739,CONESVILLE,IA,137,23,-114,0.14375
52742,DE WITT,IA,3001,2639,-362,0.46790780141843974
52745,DIXON,IA,29,13,-16,0.30952380952380953
52746,DONAHUE,IA,0,39,39,1
52747,DURANT,IA,673,685,12,0.5044182621502209
52748,ELDRIDGE,IA,3780,3444,-336,0.47674418604651164
52749,FRUITLAND,IA,23,23,0,0.5
52751,GRAND MOUND,IA,87,35,-52,0.28688524590163933
52752,GRANDVIEW,IA,51,25,-26,0.32894736842105265
52753,LE CLAIRE,IA,1985,1964,-21,0.4973410990124082
52753,LECLAIRE,IA,234,259,25,0.5253549695740365
52754,LETTS,IA,189,132,-57,0.411214953271028
52755,LONE TREE,IA,807,719,-88,0.4711664482306684
52756,LONG GROVE,IA,292,382,90,0.5667655786350149
52757,LOW MOOR,IA,11,0,-11,0
52760,MOSCOW,IA,36,11,-25,0.23404255319148937
52761,MUSCATINE,IA,15652,12846,-2806,0.4507684749807004
52766,NICHOLS,IA,73,11,-62,0.13095238095238096
52767,PLEASANT VALLEY,IA,14,13,-1,0.48148148148148145
52768,PRINCETON,IA,127,189,62,0.5981012658227848
52769,STOCKTON,IA,0,14,14,1
52772,TIPTON,IA,1937,1767,-170,0.47705183585313177
52773,MAYSVILLE,IA,15,26,11,0.6341463414634146
52773,WALCOTT,IA,924,748,-176,0.4473684210526316
52776,WEST LIBERTY,IA,2180,1644,-536,0.4299163179916318
52777,TORONTO,IA,12,14,2,0.5384615384615384
52777,WHEATLAND,IA,337,198,-139,0.37009345794392523
52778,WILTON,IA,2137,1630,-507,0.43270507034775685
52801,DAVENPORT,IA,2242,1607,-635,0.4175110418290465
52802,DAVENPORT,IA,6634,5356,-1278,0.44670558798999166
52803,DAVENPORT,IA,13024,10026,-2998,0.43496746203904557
52804,DAVENPORT,IA,13668,10953,-2715,0.44486414036797856
52805,DAVENPORT,IA,0,12,12,1
52806,DAVENPORT,IA,14627,12367,-2260,0.458138845669408
52807,DAVENPORT,IA,9907,8031,-1876,0.44770877466830195
52808,DAVENPORT,IA,1056,855,-201,0.4474097331240188
52809,DAVENPORT,IA,887,381,-506,0.30047318611987384
53001,ADELL,WI,431,202,-229,0.31911532385466035
53002,ALLENTON,WI,744,644,-100,0.46397694524495675
53004,BELGIUM,WI,1135,1110,-25,0.49443207126948774
53005,BROOKFIELD,WI,7662,8291,629,0.5197141603460165
53006,BROWNSVILLE,WI,326,315,-11,0.4914196567862715
53006,BYRON,WI,11,0,-11,0
53007,BUTLER,WI,1033,895,-138,0.4642116182572614
53008,BROOKFIELD,WI,460,690,230,0.6
53010,CAMPBELLSPORT,WI,2013,1989,-24,0.4970014992503748
53011,CASCADE,WI,563,513,-50,0.4767657992565056
53012,CEDARBURG,WI,6099,6340,241,0.5096872738966155
53013,CEDAR GROVE,WI,1140,980,-160,0.46226415094339623
53014,CHILTON,WI,2676,2526,-150,0.4855824682814302
53015,CLEVELAND,WI,605,531,-74,0.46742957746478875
53016,CLYMAN,WI,175,29,-146,0.14215686274509803
53017,COLGATE,WI,1146,1344,198,0.5397590361445783
53018,DELAFIELD,WI,2912,2987,75,0.5063570096626547
53019,EDEN,WI,263,422,159,0.6160583941605839
53020,ELKHART LAKE,WI,1287,1183,-104,0.4789473684210526
53021,FREDONIA,WI,1200,1139,-61,0.48696023941855493
53021,WAUBEKA,WI,29,29,0,0.5
53022,GERMANTOWN,WI,6836,6914,78,0.5028363636363636
53023,GLENBEULAH,WI,51,198,147,0.7951807228915663
53024,GRAFTON,WI,7231,7263,32,0.5011039050641645
53027,HARTFORD,WI,8579,8179,-400,0.48806540159923617
53029,HARTLAND,WI,7236,7825,589,0.5195538144877498
53032,HORICON,WI,2230,1975,-255,0.469678953626635
53033,HUBERTUS,WI,1258,1441,183,0.5339014449796221
53034,HUSTISFORD,WI,825,609,-216,0.4246861924686193
53035,IRON RIDGE,WI,622,496,-126,0.44364937388193204
53036,IXONIA,WI,935,955,20,0.5052910052910053
53037,JACKSON,WI,3593,3829,236,0.5158986796011856
53038,JOHNSON CREEK,WI,1511,1569,58,0.5094155844155844
53039,JUNEAU,WI,1800,1357,-443,0.42983845422869815
53040,KEWASKUM,WI,2726,2579,-147,0.48614514608859566
53042,KIEL,WI,2526,2295,-231,0.4760423148724331
53044,KOHLER,WI,812,714,-98,0.46788990825688076
53045,BROOKFIELD,WI,9615,9588,-27,0.4992969848461178
53046,LANNON,WI,443,729,286,0.6220136518771331
53048,LOMIRA,WI,1617,1553,-64,0.48990536277602525
53049,MALONE,WI,487,420,-67,0.46306504961411243
53050,MAYVILLE,WI,2541,2153,-388,0.4586706433745207
53051,MENOMONEE FALLS,WI,12605,13233,628,0.5121526433934515
53051,MENOMONEE FLS,WI,569,513,-56,0.47412199630314233
53052,MENOMONEE FALLS,WI,209,76,-133,0.26666666666666666
53052,MENOMONEE FLS,WI,117,0,-117,0
53056,MERTON,WI,11,0,-11,0
53057,MOUNT CALVARY,WI,102,63,-39,0.38181818181818183
53058,NASHOTAH,WI,1396,1447,51,0.5089693985226873
53059,NEOSHO,WI,313,251,-62,0.4450354609929078
53061,NEW HOLSTEIN,WI,1623,1462,-161,0.4739059967585089
53063,NEWTON,WI,95,126,31,0.5701357466063348
53065,OAKFIELD,WI,342,335,-7,0.4948301329394387
53066,OCONOMOWOC,WI,13687,14969,1282,0.5223687883863763
53069,OKAUCHEE,WI,294,230,-64,0.4389312977099237
53070,OOSTBURG,WI,1358,1246,-112,0.478494623655914
53072,PEWAUKEE,WI,11725,11220,-505,0.48899542383961647
53073,PLYMOUTH,WI,5308,5085,-223,0.4892716251323006
53074,PORT WASHINGTON,WI,5171,4895,-276,0.48629048281343135
53075,RANDOM LAKE,WI,1164,963,-201,0.4527503526093089
53076,RICHFIELD,WI,744,858,114,0.5355805243445693
53078,RUBICON,WI,118,119,1,0.5021097046413502
53079,SAINT CLOUD,WI,121,102,-19,0.45739910313901344
53080,SAUKVILLE,WI,2044,1793,-251,0.46729215532968466
53081,SHEBOYGAN,WI,24371,18594,-5777,0.43277086000232745
53082,SHEBOYGAN,WI,574,207,-367,0.26504481434058896
53083,HOWARDS GROVE,WI,363,303,-60,0.45495495495495497
53083,SHEBOYGAN,WI,7434,6861,-573,0.47995802728226655
53085,SHEBOYGAN FALLS,WI,4156,4151,-5,0.49969904899482365
53085,SHEBOYGAN FLS,WI,123,96,-27,0.4383561643835616
53086,SLINGER,WI,3091,3305,214,0.516729205753596
53088,STOCKBRIDGE,WI,28,0,-28,0
53089,SUSSEX,WI,5557,6257,700,0.5296258676146944
53090,WEST BEND,WI,7834,6785,-1049,0.4641220329707914
53091,THERESA,WI,543,452,-91,0.4542713567839196
53092,MEQUON,WI,6622,7228,606,0.5218772563176896
53092,THIENSVILLE,WI,2462,2472,10,0.5010133765707336
53093,WALDO,WI,247,274,27,0.525911708253359
53094,WATERTOWN,WI,8321,6920,-1401,0.4540384489206745
53095,WEST BEND,WI,11671,10141,-1530,0.4649275628094627
53097,MEQUON,WI,1254,1731,477,0.5798994974874372
53098,WATERTOWN,WI,4210,3901,-309,0.4809517938601899
53103,BIG BEND,WI,797,938,141,0.5406340057636888
53104,BRISTOL,WI,1885,2005,120,0.5154241645244216
53105,BURLINGTON,WI,10467,9882,-585,0.48562582927908005
53108,CALEDONIA,WI,661,872,211,0.5688193085453359
53110,CUDAHY,WI,8135,7216,-919,0.4700670966060843
53114,DARIEN,WI,738,848,110,0.5346784363177806
53115,DELAVAN,WI,6775,6291,-484,0.48147864686973824
53118,DOUSMAN,WI,2104,2193,89,0.5103560623690947
53119,EAGLE,WI,1349,1517,168,0.5293091416608514
53120,EAST TROY,WI,3901,3751,-150,0.49019864087820175
53121,ELKHORN,WI,7418,7167,-251,0.49139526911210146
53122,ELM GROVE,WI,2395,2553,158,0.5159660468876314
53125,FONTANA,WI,1837,1902,65,0.5086921636801284
53126,FRANKSVILLE,WI,1564,1844,280,0.5410798122065728
53128,GENOA CITY,WI,2507,2665,158,0.5152745552977571
53129,GREENDALE,WI,5499,4978,-521,0.4751360122172378
53130,HALES CORNERS,WI,3606,3291,-315,0.4771639843410178
53132,FRANKLIN,WI,11616,12035,419,0.5088579764069172
53137,HELENVILLE,WI,309,388,79,0.5566714490674318
53139,KANSASVILLE,WI,874,982,108,0.5290948275862069
53140,KENOSHA,WI,15767,13105,-2662,0.4538999722914935
53141,KENOSHA,WI,1189,1272,83,0.5168630637952052
53142,KENOSHA,WI,12198,11263,-935,0.4800733131580069
53143,KENOSHA,WI,11456,8910,-2546,0.4374938623195522
53144,KENOSHA,WI,12767,11039,-1728,0.46370662858103
53146,NEW BERLIN,WI,1739,1896,157,0.5215955983493811
53147,LAKE GENEVA,WI,10077,9672,-405,0.4897463162691782
53149,MUKWONAGO,WI,5555,5680,125,0.5055629728526925
53150,MUSKEGO,WI,6812,7588,776,0.5269444444444444
53151,NEW BERLIN,WI,11643,11669,26,0.5005576527110501
53153,NORTH PRAIRIE,WI,735,688,-47,0.48348559381588196
53154,OAK CREEK,WI,16349,16183,-166,0.4974486659289315
53156,PALMYRA,WI,1114,1070,-44,0.4899267399267399
53157,PELL LAKE,WI,103,27,-76,0.2076923076923077
53158,PLEASANT PR,WI,126,95,-31,0.4298642533936652
53158,PLEASANT PRAIRIE,WI,6752,7110,358,0.5129129995671621
53167,ROCHESTER,WI,56,0,-56,0
53168,SALEM,WI,3062,3022,-40,0.49671268902038135
53170,SILVER LAKE,WI,859,843,-16,0.49529964747356053
53172,SOUTH MILWAUKEE,WI,8270,7437,-833,0.4734831603743554
53177,MOUNT PLEASANT,WI,229,192,-37,0.45605700712589076
53177,STURTEVANT,WI,2487,2281,-206,0.4783976510067114
53178,SULLIVAN,WI,857,952,95,0.5262576008844666
53179,TREVOR,WI,1837,1798,-39,0.49463548830811555
53181,TWIN LAKES,WI,3229,3239,10,0.5007730364873222
53182,UNION GROVE,WI,2987,3150,163,0.5132801042854815
53183,WALES,WI,1351,1309,-42,0.4921052631578947
53184,WALWORTH,WI,1517,1470,-47,0.4921325744894543
53185,WATERFORD,WI,5939,5794,-145,0.4938208471831586
53185,WIND LAKE,WI,283,256,-27,0.4749536178107607
53186,WAUKESHA,WI,15036,13411,-1625,0.47143811298203675
53187,WAUKESHA,WI,669,316,-353,0.3208121827411167
53188,WAUKESHA,WI,13301,12919,-382,0.4927154843630816
53189,WAUKESHA,WI,7424,7655,231,0.5076596591285895
53190,WHITEWATER,WI,11540,6462,-5078,0.35896011554271745
53191,WILLIAMS BAY,WI,2189,1992,-197,0.4764410428127242
53201,MILWAUKEE,WI,975,1386,411,0.5870393900889453
53202,MILWAUKEE,WI,31144,24121,-7023,0.43646068940559124
53203,MILWAUKEE,WI,3806,2886,-920,0.43126120741183505
53204,MILWAUKEE,WI,22178,17152,-5026,0.43610475464022375
53205,MILWAUKEE,WI,5158,5326,168,0.5080122090805036
53206,MILWAUKEE,WI,13993,11759,-2234,0.45662472817645233
53207,MILWAUKEE,WI,17180,15380,-1800,0.47235872235872234
53207,SAINT FRANCIS,WI,240,228,-12,0.48717948717948717
53208,MILWAUKEE,WI,18426,15732,-2694,0.46056560688564907
53209,BROWN DEER,WI,389,411,22,0.51375
53209,GLENDALE,WI,1429,1457,28,0.5048510048510049
53209,MILWAUKEE,WI,20861,19226,-1635,0.47960685509017886
53210,MILWAUKEE,WI,17429,13151,-4278,0.4300523217789405
53211,MILWAUKEE,WI,17026,12828,-4198,0.42969116366316074
53211,SHOREWOOD,WI,4868,3722,-1146,0.43329452852153666
53212,MILWAUKEE,WI,19569,16290,-3279,0.45427926043671046
53213,MILWAUKEE,WI,8694,7652,-1042,0.4681267588400832
53213,WAUWATOSA,WI,3975,3664,-311,0.47964393245189163
53214,MILWAUKEE,WI,9450,8699,-751,0.4793101548294672
53214,WEST ALLIS,WI,7900,7238,-662,0.4781344959704056
53215,MILWAUKEE,WI,22027,17489,-4538,0.4425802206701083
53216,MILWAUKEE,WI,15667,13992,-1675,0.47176236555514345
53217,BAYSIDE,WI,914,1062,148,0.5374493927125507
53217,FOX POINT,WI,806,1017,211,0.557871640153593
53217,GLENDALE,WI,1300,1398,98,0.5181616011860638
53217,MILWAUKEE,WI,7422,7252,-170,0.49420744173367864
53217,RIVER HILLS,WI,173,133,-40,0.434640522875817
53217,WHITEFISH BAY,WI,1164,1156,-8,0.4982758620689655
53218,MILWAUKEE,WI,20123,17956,-2167,0.47154599648100004
53219,GREENFIELD,WI,372,289,-83,0.4372163388804841
53219,MILWAUKEE,WI,11739,10465,-1274,0.4713114754098361
53219,WEST ALLIS,WI,1958,1765,-193,0.4740800429760946
53220,GREENFIELD,WI,3667,3293,-374,0.47313218390804596
53220,MILWAUKEE,WI,7967,7142,-825,0.47269839168707395
53221,GREENFIELD,WI,298,281,-17,0.4853195164075993
53221,MILWAUKEE,WI,17487,14885,-2602,0.45981094773260844
53222,MILWAUKEE,WI,8211,7772,-439,0.48626665832446975
53222,WAUWATOSA,WI,3174,3003,-171,0.4861583292860612
53223,BROWN DEER,WI,910,893,-17,0.49528563505268997
53223,MILWAUKEE,WI,12672,11688,-984,0.4798029556650246
53224,MILWAUKEE,WI,12043,10300,-1743,0.4609944949201092
53225,MILWAUKEE,WI,15271,12139,-3132,0.4428675665815396
53226,MILWAUKEE,WI,7117,6483,-634,0.47669117647058823
53226,WAUWATOSA,WI,2664,2447,-217,0.47877127763647037
53227,MILWAUKEE,WI,9640,8343,-1297,0.46393816382138686
53227,WEST ALLIS,WI,1920,1620,-300,0.4576271186440678
53228,GREENFIELD,WI,2795,2647,-148,0.4864020580668872
53228,MILWAUKEE,WI,4947,4471,-476,0.4747292418772563
53233,MILWAUKEE,WI,7218,4800,-2418,0.39940089865202194
53234,MILWAUKEE,WI,867,1315,448,0.6026581118240146
53235,MILWAUKEE,WI,214,208,-6,0.4928909952606635
53235,SAINT FRANCIS,WI,3719,3654,-65,0.49559202495592025
53235,ST FRANCIS,WI,752,712,-40,0.48633879781420764
53237,MILWAUKEE,WI,223,13,-210,0.05508474576271186
53401,RACINE,WI,227,472,245,0.6752503576537912
53402,RACINE,WI,12371,11918,-453,0.4906747910576804
53403,MOUNT PLEASANT,WI,1030,871,-159,0.4581799053129932
53403,MT PLEASANT,WI,502,450,-52,0.4726890756302521
53403,RACINE,WI,10275,9293,-982,0.4749080130825838
53404,RACINE,WI,7397,6241,-1156,0.4576184191230386
53405,MOUNT PLEASANT,WI,564,496,-68,0.4679245283018868
53405,RACINE,WI,9389,8368,-1021,0.47125077434251283
53406,MOUNT PLEASANT,WI,8213,7648,-565,0.48218901708593404
53406,RACINE,WI,3032,2589,-443,0.46059420032022774
53408,RACINE,WI,378,680,302,0.6427221172022685
53502,ALBANY,WI,793,855,62,0.5188106796116505
53503,ARENA,WI,513,577,64,0.5293577981651376
53504,ARGYLE,WI,336,431,95,0.5619295958279009
53506,AVOCA,WI,329,177,-152,0.34980237154150196
53507,BARNEVELD,WI,432,543,111,0.556923076923077
53508,BELLEVILLE,WI,1612,1738,126,0.5188059701492538
53510,BELMONT,WI,182,221,39,0.5483870967741935
53511,BELOIT,WI,22755,18741,-4014,0.4516338924233661
53512,BELOIT,WI,792,543,-249,0.4067415730337079
53515,BLACK EARTH,WI,629,802,173,0.5604472396925227
53516,BLANCHARDVILLE,WI,882,680,-202,0.4353393085787452
53517,BLUE MOUNDS,WI,335,397,62,0.5423497267759563
53518,BLUE RIVER,WI,294,325,31,0.5250403877221325
53520,BRODHEAD,WI,2192,2111,-81,0.49058796188705556
53521,BROOKLYN,WI,923,907,-16,0.49562841530054647
53522,BROWNTOWN,WI,145,85,-60,0.3695652173913043
53523,CAMBRIDGE,WI,2090,2096,6,0.5007166746297181
53525,CLINTON,WI,1290,1198,-92,0.4815112540192926
53526,COBB,WI,23,12,-11,0.34285714285714286
53527,COTTAGE GROVE,WI,3930,4362,432,0.5260492040520984
53528,CROSS PLAINS,WI,2095,2001,-94,0.488525390625
53529,DANE,WI,292,199,-93,0.40529531568228105
53530,DARLINGTON,WI,1734,1375,-359,0.4422643936957221
53531,DEERFIELD,WI,1456,1488,32,0.5054347826086957
53532,DEFOREST,WI,5467,6185,718,0.5308101613456917
53533,DODGEVILLE,WI,2896,2870,-26,0.4977454040929587
53534,EDGERTON,WI,4918,4988,70,0.5035332121946295
53536,EVANSVILLE,WI,3066,2892,-174,0.48539778449144005
53537,FOOTVILLE,WI,45,0,-45,0
53538,FORT ATKINSON,WI,7904,6908,-996,0.4663786119362679
53541,GRATIOT,WI,48,13,-35,0.21311475409836064
53543,HIGHLAND,WI,187,178,-9,0.4876712328767123
53544,HOLLANDALE,WI,11,0,-11,0
53545,JANESVILLE,WI,11730,10312,-1418,0.46783413483349967
53546,JANESVILLE,WI,12626,11658,-968,0.4800691813539779
53547,JANESVILLE,WI,1146,1088,-58,0.4870188003581021
53548,JANESVILLE,WI,9158,7919,-1239,0.46372313638226853
53549,JEFFERSON,WI,4602,4168,-434,0.4752565564424173
53550,JUDA,WI,44,105,61,0.7046979865771812
53551,LAKE MILLS,WI,3641,3634,-7,0.4995189003436426
53553,LINDEN,WI,44,12,-32,0.21428571428571427
53554,LIVINGSTON,WI,67,112,45,0.6256983240223464
53555,LODI,WI,3035,3037,2,0.5001646903820817
53556,LONE ROCK,WI,931,932,1,0.5002683843263553
53557,LOWELL,WI,11,0,-11,0
53558,MC FARLAND,WI,1371,1640,269,0.5446695450016605
53558,MCFARLAND,WI,3152,3433,281,0.521336370539104
53559,MARSHALL,WI,2067,2150,83,0.5098411192791084
53560,MAZOMANIE,WI,1214,1249,35,0.5071051563134389
53561,MERRIMAC,WI,871,836,-35,0.4897480960749854
53561,MONROE,WI,19,11,-8,0.36666666666666664
53562,MIDDLETON,WI,16281,15780,-501,0.4921867689716478
53563,MILTON,WI,4040,4054,14,0.5008648381517173
53565,MINERAL POINT,WI,1592,1623,31,0.5048211508553655
53566,MONROE,WI,6590,5402,-1188,0.45046697798532354
53569,MONTFORT,WI,175,98,-77,0.358974358974359
53570,MONTICELLO,WI,873,705,-168,0.4467680608365019
53571,MORRISONVILLE,WI,11,0,-11,0
53572,MOUNT HOREB,WI,3659,3680,21,0.5014307126311487
53573,MUSCODA,WI,1198,1142,-56,0.488034188034188
53574,NEW GLARUS,WI,1339,1326,-13,0.4975609756097561
53575,FITCHBURG,WI,1127,1153,26,0.5057017543859649
53575,OREGON,WI,4476,4851,375,0.5201029269861692
53576,ORFORDVILLE,WI,751,777,26,0.5085078534031413
53577,PLAIN,WI,383,178,-205,0.3172905525846702
53578,PR DU SAC,WI,43,77,34,0.6416666666666667
53578,PRAIRIE DU SAC,WI,2428,2286,-142,0.4849384811200679
53579,REESEVILLE,WI,431,284,-147,0.3972027972027972
53580,REWEY,WI,51,25,-26,0.32894736842105265
53581,RICHLAND CENTER,WI,3910,3905,-5,0.4996801023672425
53581,RICHLAND CTR,WI,189,166,-23,0.4676056338028169
53582,RIDGEWAY,WI,145,216,71,0.5983379501385041
53583,SAUK CITY,WI,2124,1969,-155,0.48106523332518936
53585,SHARON,WI,730,661,-69,0.47519769949676494
53586,SHULLSBURG,WI,655,533,-122,0.44865319865319864
53587,SOUTH WAYNE,WI,162,90,-72,0.35714285714285715
53588,SPRING GREEN,WI,1494,1525,31,0.5051341503809208
53589,STOUGHTON,WI,7496,7594,98,0.503247183565275
53590,SUN PRAIRIE,WI,21285,20592,-693,0.491725768321513
53593,VERONA,WI,11358,13487,2129,0.5428456429865164
53594,WATERLOO,WI,1680,1634,-46,0.4930597465298733
53597,MIDDLETON,WI,478,508,30,0.5152129817444219
53597,WAUNAKEE,WI,6905,7346,441,0.5154725984141464
53598,WINDSOR,WI,1907,2018,111,0.514140127388535
53701,MADISON,WI,210,74,-136,0.2605633802816901
53703,MADISON,WI,34694,22033,-12661,0.3884041109171999
53704,MADISON,WI,29114,25197,-3917,0.46393916517832484
53705,MADISON,WI,19677,14046,-5631,0.4165109865670314
53706,MADISON,WI,0,23,23,1
53707,MADISON,WI,350,382,32,0.5218579234972678
53708,MADISON,WI,759,740,-19,0.49366244162775186
53711,FITCHBURG,WI,8754,8129,-625,0.48149025647100635
53711,MADISON,WI,17410,15853,-1557,0.4765956167513453
53713,FITCHBURG,WI,1354,998,-356,0.42431972789115646
53713,MADISON,WI,16562,13122,-3440,0.44205632664061445
53713,MONONA,WI,1260,853,-407,0.403691433980123
53714,MADISON,WI,9025,8321,-704,0.479707137092125
53715,MADISON,WI,9534,5311,-4223,0.35776355675311555
53716,MADISON,WI,4987,4816,-171,0.491278180148934
53716,MONONA,WI,3698,3506,-192,0.4866740699611327
53717,MADISON,WI,7585,6955,-630,0.4783356258596974
53718,MADISON,WI,11695,11948,253,0.5053504208433786
53719,FITCHBURG,WI,1356,1125,-231,0.4534461910519952
53719,MADISON,WI,19396,16881,-2515,0.4653361634093227
53725,MADISON,WI,387,287,-100,0.4258160237388724
53726,MADISON,WI,4523,2100,-2423,0.31707685338970254
53744,MADISON,WI,704,791,87,0.5290969899665552
53801,BAGLEY,WI,193,149,-44,0.43567251461988304
53803,BENTON,WI,173,130,-43,0.429042904290429
53804,BLOOMINGTON,WI,103,96,-7,0.4824120603015075
53805,BOSCOBEL,WI,2223,2012,-211,0.47508854781582055
53806,CASSVILLE,WI,529,468,-61,0.46940822467402205
53807,CUBA CITY,WI,1337,1325,-12,0.4977460555972953
53808,DICKEYVILLE,WI,303,145,-158,0.3236607142857143
53809,FENNIMORE,WI,1403,1300,-103,0.4809470958194599
53811,HAZEL GREEN,WI,905,856,-49,0.48608745031232253
53812,KIELER,WI,15,11,-4,0.4230769230769231
53813,LANCASTER,WI,2207,2156,-51,0.49415539766215905
53816,MOUNT HOPE,WI,25,23,-2,0.4791666666666667
53818,PLATTEVILLE,WI,7290,5720,-1570,0.4396617986164489
53820,POTOSI,WI,806,760,-46,0.48531289910600256
53821,PR DU CHIEN,WI,67,64,-3,0.48854961832061067
53821,PRAIRIE DU CHIEN,WI,3517,3036,-481,0.4632992522508775
53825,STITZER,WI,13,0,-13,0
53826,WAUZEKA,WI,316,271,-45,0.4616695059625213
53901,PORTAGE,WI,7725,6882,-843,0.4711439720681865
53910,ADAMS,WI,1819,1651,-168,0.47579250720461097
53911,ARLINGTON,WI,204,120,-84,0.37037037037037035
53913,BARABOO,WI,11093,10127,-966,0.47723845428840717
53916,BEAVER DAM,WI,10959,10034,-925,0.4779688467584433
53919,BRANDON,WI,391,392,1,0.5006385696040868
53920,BRIGGSVILLE,WI,11,25,14,0.6944444444444444
53922,BURNETT,WI,24,45,21,0.6521739130434783
53923,CAMBRIA,WI,568,427,-141,0.4291457286432161
53924,CAZENOVIA,WI,189,120,-69,0.3883495145631068
53925,COLUMBUS,WI,2775,2738,-37,0.49664429530201343
53926,DALTON,WI,115,54,-61,0.31952662721893493
53929,ELROY,WI,1128,955,-173,0.4584733557369179
53930,ENDEAVOR,WI,112,147,35,0.5675675675675675
53932,FALL RIVER,WI,817,884,67,0.5196942974720753
53933,FOX LAKE,WI,1321,1292,-29,0.49445082280903174
53934,FRIENDSHIP,WI,2387,2377,-10,0.4989504617968094
53936,GRAND MARSH,WI,606,569,-37,0.48425531914893616
53937,HILLPOINT,WI,15,14,-1,0.4827586206896552
53939,KINGSTON,WI,11,0,-11,0
53940,LAKE DELTON,WI,737,491,-246,0.3998371335504886
53941,LA VALLE,WI,1194,1174,-20,0.49577702702702703
53943,LOGANVILLE,WI,53,24,-29,0.3116883116883117
53944,LYNDON STA,WI,30,14,-16,0.3181818181818182
53944,LYNDON STATION,WI,894,846,-48,0.4862068965517241
53946,MARKESAN,WI,1484,1465,-19,0.49677856900644285
53947,MARQUETTE,WI,11,0,-11,0
53948,MAUSTON,WI,4179,3708,-471,0.4701407379231647
53949,MONTELLO,WI,2461,2556,95,0.5094678094478772
53950,NEW LISBON,WI,2266,2265,-1,0.4998896490840874
53951,NORTH FREEDOM,WI,809,636,-173,0.4401384083044983
53952,OXFORD,WI,1429,1429,0,0.5
53952,REEDSBURG,WI,16,20,4,0.5555555555555556
53953,PACKWAUKEE,WI,12,0,-12,0
53954,PARDEEVILLE,WI,2357,2359,2,0.5002120441051738
53955,POYNETTE,WI,2132,2024,-108,0.4870067372473532
53956,RANDOLPH,WI,995,848,-147,0.46011937059142705
53959,REEDSBURG,WI,6478,6253,-225,0.49116330217579135
53960,RIO,WI,1033,991,-42,0.48962450592885376
53961,ROCK SPRINGS,WI,11,11,0,0.5
53963,WAUPUN,WI,4176,4024,-152,0.49073170731707316
53964,WESTFIELD,WI,1466,1344,-122,0.4782918149466192
53965,WISC DELLS,WI,89,129,40,0.591743119266055
53965,WISCONSIN DELLS,WI,4964,4978,14,0.5007040836853752
53968,WONEWOC,WI,642,639,-3,0.49882903981264637
53969,WYOCENA,WI,0,11,11,1
54001,AMERY,WI,3677,3592,-85,0.4941532535424405
54002,BALDWIN,WI,2476,2385,-91,0.4906397860522526
54003,BELDENVILLE,WI,65,56,-9,0.4628099173553719
54004,CLAYTON,WI,768,712,-56,0.4810810810810811
54005,CLEAR LAKE,WI,1081,1058,-23,0.4946236559139785
54006,CUSHING,WI,65,77,12,0.5422535211267606
54007,DEER PARK,WI,173,120,-53,0.40955631399317405
54009,DRESSER,WI,842,852,10,0.5029515938606848
54011,ELLSWORTH,WI,2478,2280,-198,0.4791929382093317
54013,EMERALD,WI,130,165,35,0.559322033898305
54013,GLENWOOD CITY,WI,985,934,-51,0.4867118290776446
54014,HAGER CITY,WI,497,590,93,0.5427782888684453
54015,HAMMOND,WI,1208,1261,53,0.5107330903199676
54016,HUDSON,WI,13916,13370,-546,0.4899948691636737
54017,NEW RICHMOND,WI,7505,8349,844,0.5266178882300997
54020,OSCEOLA,WI,2801,2929,128,0.5111692844677138
54021,PRESCOTT,WI,2469,2577,108,0.5107015457788348
54022,RIVER FALLS,WI,9576,9157,-419,0.4888165269844659
54023,ROBERTS,WI,1691,1718,27,0.5039601056028161
54024,SAINT CROIX FALLS,WI,1778,1884,106,0.5144729655925724
54024,ST CROIX FALLS,WI,46,50,4,0.5208333333333334
54024,ST CROIX FLS,WI,326,321,-5,0.49613601236476046
54025,SOMERSET,WI,2958,3075,117,0.5096966683242168
54026,STAR PRAIRIE,WI,516,632,116,0.5505226480836237
54027,WILSON,WI,177,52,-125,0.22707423580786026
54028,WOODVILLE,WI,862,850,-12,0.49649532710280375
54082,HOULTON,WI,303,371,68,0.5504451038575667
54101,ABRAMS,WI,553,687,134,0.5540322580645162
54102,AMBERG,WI,215,150,-65,0.410958904109589
54103,ARMSTRONG CREEK,WI,28,62,34,0.6888888888888889
54104,ATHELSTANE,WI,415,358,-57,0.463130659767141
54104,SILVER CLIFF,WI,0,14,14,1
54106,BLACK CREEK,WI,1179,1067,-112,0.47506678539626
54107,BONDUEL,WI,1106,964,-142,0.46570048309178746
54107,SHIOCTON,WI,18,26,8,0.5909090909090909
54110,BRILLION,WI,1790,1614,-176,0.47414806110458285
54111,CECIL,WI,1002,679,-323,0.40392623438429504
54112,COLEMAN,WI,665,627,-38,0.4852941176470588
54113,APPLETON,WI,14,0,-14,0
54113,COMBINED LCKS,WI,82,115,33,0.583756345177665
54113,COMBINED LOCKS,WI,764,809,45,0.5143038779402416
54114,CRIVITZ,WI,2761,2912,151,0.5133086550326106
54115,DE PERE,WI,19690,19154,-536,0.4931006075584389
54120,FENCE,WI,23,0,-23,0
54121,FLORENCE,WI,1742,1697,-45,0.49345740040709507
54123,FOREST JUNCTION,WI,14,0,-14,0
54124,GILLETT,WI,1309,1347,38,0.5071536144578314
54126,GREENLEAF,WI,699,747,48,0.516597510373444
54128,GRESHAM,WI,554,404,-150,0.42171189979123175
54129,HILBERT,WI,1037,890,-147,0.4618578100674624
54130,FREEDOM,WI,604,558,-46,0.4802065404475043
54130,KAUKAUNA,WI,8421,8414,-7,0.4997920997920998
54135,KESHENA,WI,648,834,186,0.562753036437247
54136,KIMBERLY,WI,3197,2961,-236,0.48083793439428385
54137,KRAKOW,WI,0,11,11,1
54138,LAKEWOOD,WI,538,471,-67,0.466798810703667
54139,LENA,WI,702,720,18,0.5063291139240507
54140,LITTLE CHUTE,WI,3546,3032,-514,0.4609303739738522
54141,LITTLE SUAMICO,WI,785,752,-33,0.4892648015614834
54143,MARINETTE,WI,7361,6560,-801,0.4712305150492062
54149,MOUNTAIN,WI,410,468,58,0.5330296127562643
54150,NEOPIT,WI,95,0,-95,0
54151,NIAGARA,WI,1346,1339,-7,0.4986964618249534
54152,NICHOLS,WI,11,0,-11,0
54153,OCONTO,WI,3230,2946,-284,0.47700777202072536
54154,OCONTO FALLS,WI,2007,1848,-159,0.4793774319066148
54155,ONEIDA,WI,3923,3866,-57,0.4963409937090769
54156,PEMBINE,WI,867,723,-144,0.4547169811320755
54157,PESHTIGO,WI,2126,1993,-133,0.4838553046856033
54159,PORTERFIELD,WI,178,155,-23,0.46546546546546547
54161,POUND,WI,1068,948,-120,0.47023809523809523
54162,PULASKI,WI,2672,2872,200,0.5180375180375181
54165,SEYMOUR,WI,2379,2184,-195,0.47863247863247865
54166,SHAWANO,WI,7517,6563,-954,0.4661221590909091
54169,SHERWOOD,WI,865,859,-6,0.4982598607888631
54170,SHIOCTON,WI,1065,968,-97,0.47614363010329563
54171,SOBIESKI,WI,743,988,245,0.5707683419988446
54173,SUAMICO,WI,1415,1540,125,0.5211505922165821
54174,SURING,WI,1099,1205,106,0.5230034722222222
54175,TOWNSEND,WI,793,659,-134,0.45385674931129477
54177,WAUSAUKEE,WI,1375,1287,-88,0.4834710743801653
54180,WRIGHTSTOWN,WI,993,1018,25,0.5062158130283441
54201,ALGOMA,WI,2209,2006,-203,0.4759193357058126
54202,BAILEYS HARBOR,WI,1328,1108,-220,0.4548440065681445
54204,BRUSSELS,WI,464,347,-117,0.4278668310727497
54205,CASCO,WI,261,236,-25,0.47484909456740443
54208,DENMARK,WI,1698,1620,-78,0.488245931283906
54209,EGG HARBOR,WI,1910,1618,-292,0.45861678004535145
54210,ELLISON BAY,WI,1017,1035,18,0.5043859649122807
54211,EPHRAIM,WI,682,460,-222,0.4028021015761821
54212,FISH CREEK,WI,1514,1151,-363,0.4318949343339587
54213,FORESTVILLE,WI,138,92,-46,0.4
54216,KEWAUNEE,WI,1823,1741,-82,0.4884960718294052
54217,LUXEMBURG,WI,1916,1917,1,0.5001304461257501
54217,STURGEON BAY,WI,29,27,-2,0.48214285714285715
54220,MANITOWOC,WI,17470,14956,-2514,0.4612348115709616
54221,MANITOWOC,WI,394,245,-149,0.38341158059467917
54227,MARIBEL,WI,103,81,-22,0.44021739130434784
54228,MISHICOT,WI,755,741,-14,0.49532085561497324
54229,NEW FRANKEN,WI,1310,1204,-106,0.4789180588703262
54230,CATO,WI,46,65,19,0.5855855855855856
54230,REEDSVILLE,WI,987,923,-64,0.48324607329842934
54232,SAINT NAZIANZ,WI,71,11,-60,0.13414634146341464
54234,SISTER BAY,WI,1946,1994,48,0.5060913705583756
54235,STURGEON BAY,WI,9695,9170,-525,0.48608534322820035
54241,TWO RIVERS,WI,5916,5409,-507,0.4776158940397351
54245,VALDERS,WI,626,623,-3,0.49879903923138513
54246,WASHINGTON ISLAND,WI,839,631,-208,0.42925170068027213
54247,WHITELAW,WI,343,352,9,0.5064748201438849
54301,GREEN BAY,WI,12823,10584,-2239,0.45217242705173666
54302,GREEN BAY,WI,19583,13355,-6228,0.40545874066427834
54303,GREEN BAY,WI,21580,14753,-6827,0.4060495967852916
54304,GREEN BAY,WI,16526,11997,-4529,0.4206079304420994
54305,GREEN BAY,WI,645,747,102,0.5366379310344828
54307,GREEN BAY,WI,1122,912,-210,0.44837758112094395
54308,GREEN BAY,WI,221,145,-76,0.39617486338797814
54311,GREEN BAY,WI,14173,13458,-715,0.4870616336723246
54313,GREEN BAY,WI,10276,10498,222,0.5053432174833927
54313,SUAMICO,WI,1818,2052,234,0.5302325581395348
54324,GREEN BAY,WI,305,23,-282,0.0701219512195122
54401,WAUSAU,WI,13909,12738,-1171,0.47802754531466957
54402,WAUSAU,WI,295,377,82,0.5610119047619048
54403,WAUSAU,WI,12620,10407,-2213,0.45194771355365443
54405,ABBOTSFORD,WI,1272,1128,-144,0.47
54406,AMHERST,WI,1047,1076,29,0.5068299576071597
54407,AMHERST JCT,WI,14,43,29,0.7543859649122807
54407,AMHERST JUNCTION,WI,101,145,44,0.5894308943089431
54407,WAUSAU,WI,12,0,-12,0
54408,ANIWA,WI,23,79,56,0.7745098039215687
54409,ANTIGO,WI,6531,5652,-879,0.4639251415907412
54410,ARPIN,WI,296,401,105,0.5753228120516499
54411,ATHENS,WI,1321,1135,-186,0.46213355048859933
54412,AUBURNDALE,WI,231,273,42,0.5416666666666666
54414,BIRNAMWOOD,WI,743,884,141,0.5433312845728334
54416,BOWLER,WI,271,294,23,0.5203539823008849
54418,BRYANT,WI,41,54,13,0.5684210526315789
54420,CHILI,WI,100,51,-49,0.33774834437086093
54421,COLBY,WI,1026,934,-92,0.47653061224489796
54422,CURTISS,WI,22,28,6,0.56
54423,CUSTER,WI,253,343,90,0.575503355704698
54424,DEERBROOK,WI,594,591,-3,0.49873417721518987
54425,DORCHESTER,WI,505,389,-116,0.43512304250559286
54426,EDGAR,WI,958,972,14,0.5036269430051813
54427,ELAND,WI,26,45,19,0.6338028169014085
54428,ELCHO,WI,694,438,-256,0.3869257950530035
54433,GILMAN,WI,388,322,-66,0.4535211267605634
54435,GLEASON,WI,656,604,-52,0.4793650793650794
54436,GRANTON,WI,638,500,-138,0.43936731107205623
54437,GREENWOOD,WI,964,891,-73,0.4803234501347709
54440,HATLEY,WI,680,733,53,0.5187544232130219
54441,HEWITT,WI,0,11,11,1
54442,IRMA,WI,150,129,-21,0.46236559139784944
54443,JUNCTION CITY,WI,423,599,176,0.586105675146771
54446,LOYAL,WI,833,713,-120,0.4611901681759379
54447,LUBLIN,WI,39,11,-28,0.22
54448,MARATHON,WI,960,901,-59,0.48414830736163356
54448,MARATHON CITY,WI,17,17,0,0.5
54449,MARSHFIELD,WI,13687,11526,-2161,0.45714512354737635
54451,MEDFORD,WI,4540,4261,-279,0.48414952846267467
54452,MERRILL,WI,6920,6888,-32,0.49884125144843566
54454,MILLADORE,WI,66,50,-16,0.43103448275862066
54455,KRONENWETTER,WI,3016,2987,-29,0.4975845410628019
54455,MOSINEE,WI,3529,3596,67,0.5047017543859649
54456,NEILLSVILLE,WI,2603,2387,-216,0.4783567134268537
54457,NEKOOSA,WI,4539,4104,-435,0.4748351266921208
54459,OGEMA,WI,274,267,-7,0.49353049907578556
54460,OWEN,WI,805,660,-145,0.45051194539249145
54462,PEARSON,WI,14,0,-14,0
54463,PELICAN LAKE,WI,273,202,-71,0.42526315789473684
54465,NEILLSVILLE,WI,20,0,-20,0
54465,PICKEREL,WI,181,181,0,0.5
54466,PITTSVILLE,WI,807,667,-140,0.4525101763907734
54467,PLOVER,WI,7404,6681,-723,0.4743343982960596
54469,PORT EDWARDS,WI,618,617,-1,0.49959514170040487
54470,RIB LAKE,WI,789,613,-176,0.4372325249643367
54470,WESTBORO,WI,22,22,0,0.5
54471,RINGLE,WI,132,167,35,0.5585284280936454
54473,ROSHOLT,WI,551,493,-58,0.4722222222222222
54474,ROTHSCHILD,WI,1800,1608,-192,0.47183098591549294
54475,RUDOLPH,WI,140,67,-73,0.32367149758454106
54476,SCHOFIELD,WI,10224,8021,-2203,0.439627295149356
54479,SPENCER,WI,1198,951,-247,0.44253140995812007
54480,STETSONVILLE,WI,306,165,-141,0.3503184713375796
54481,STEVENS POINT,WI,15672,11450,-4222,0.42216650689477175
54482,STEVENS POINT,WI,2708,2558,-150,0.48575769084694265
54484,STRATFORD,WI,1262,1171,-91,0.4812988080558981
54485,SUMMIT LAKE,WI,49,27,-22,0.35526315789473684
54486,TIGERTON,WI,614,639,25,0.509976057462091
54487,TOMAHAWK,WI,5304,5068,-236,0.4886232163517162
54488,UNITY,WI,148,27,-121,0.15428571428571428
54489,VESPER,WI,224,173,-51,0.4357682619647355
54490,WESTBORO,WI,92,90,-2,0.4945054945054945
54491,LILY,WI,68,44,-24,0.39285714285714285
54491,WHITE LAKE,WI,709,668,-41,0.4851125635439361
54493,WILLARD,WI,23,24,1,0.5106382978723404
54494,WISCONSIN RAPIDS,WI,10940,10133,-807,0.48085227542352776
54495,WISCONSIN RAPIDS,WI,4015,3537,-478,0.4683527542372881
54498,WITHEE,WI,557,430,-127,0.43566362715298884
54499,WITTENBERG,WI,882,936,54,0.5148514851485149
54501,RHINELANDER,WI,9613,9247,-366,0.49029692470837755
54511,ARGONNE,WI,225,233,8,0.5087336244541485
54511,HILES,WI,31,27,-4,0.46551724137931033
54511,NEWALD,WI,0,14,14,1
54512,BOULDER JCT,WI,188,346,158,0.6479400749063671
54512,BOULDER JUNCTION,WI,937,730,-207,0.4379124175164967
54514,BUTTERNUT,WI,554,566,12,0.5053571428571428
54519,CONOVER,WI,1127,915,-212,0.44809010773751223
54520,CRANDON,WI,1855,1709,-146,0.47951739618406286
54521,EAGLE RIVER,WI,5837,5620,-217,0.49052980710482674
54524,FIFIELD,WI,40,40,0,0.5
54526,GLEN FLORA,WI,25,47,22,0.6527777777777778
54527,GLIDDEN,WI,318,271,-47,0.4601018675721562
54529,HARSHAW,WI,402,463,61,0.5352601156069364
54530,HAWKINS,WI,67,23,-44,0.25555555555555554
54531,HAZELHURST,WI,688,662,-26,0.49037037037037035
54534,HURLEY,WI,1244,1142,-102,0.4786253143336127
54536,IRON BELT,WI,13,0,-13,0
54538,LAC DU FLAMBEAU,WI,1364,1314,-50,0.49066467513069456
54538,LAC DU FLAMBU,WI,49,44,-5,0.4731182795698925
54539,LAKE TOMAHAWK,WI,928,789,-139,0.45952242283051836
54540,LAND O LAKES,WI,1320,1125,-195,0.4601226993865031
54541,LAONA,WI,396,468,72,0.5416666666666666
54542,ALVIN,WI,0,16,16,1
54542,LONG LAKE,WI,59,58,-1,0.49572649572649574
54545,MANITOWISH WATERS,WI,969,1092,123,0.529839883551674
54546,MELLEN,WI,283,277,-6,0.49464285714285716
54547,MERCER,WI,1059,1105,46,0.5106284658040665
54548,MINOCQUA,WI,4372,4158,-214,0.48745603751465416
54550,MONTREAL,WI,0,17,17,1
54552,PARK FALLS,WI,2313,2300,-13,0.4985909386516367
54554,PHELPS,WI,697,685,-12,0.4956584659913169
54555,PHILLIPS,WI,2477,2180,-297,0.4681125187889199
54556,NEENAH,WI,0,12,12,1
54556,PRENTICE,WI,282,170,-112,0.37610619469026546
54557,PRESQUE ISLE,WI,763,607,-156,0.44306569343065694
54557,WINCHESTER,WI,238,234,-4,0.4957627118644068
54558,SAINT GERMAIN,WI,1570,1468,-102,0.48321263989466756
54559,SAXON,WI,35,0,-35,0
54560,SAYNER,WI,278,284,6,0.505338078291815
54561,STAR LAKE,WI,46,22,-24,0.3235294117647059
54562,THREE LAKES,WI,1978,1856,-122,0.4840897235263432
54563,TONY,WI,0,13,13,1
54564,TRIPOLI,WI,11,47,36,0.8103448275862069
54566,WABENO,WI,668,496,-172,0.4261168384879725
54568,ARBOR VITAE,WI,112,200,88,0.6410256410256411
54568,WOODRUFF,WI,3698,3094,-604,0.4555359246171967
54601,LA CROSSE,WI,27201,20979,-6222,0.43542963885429636
54602,LA CROSSE,WI,959,473,-486,0.3303072625698324
54603,LA CROSSE,WI,9240,6909,-2331,0.42782834850455137
54610,ALMA,WI,696,565,-131,0.44805709754163364
54611,ALMA CENTER,WI,271,150,-121,0.35629453681710216
54612,ARCADIA,WI,3612,1865,-1747,0.34051488040898303
54613,ARKDALE,WI,864,933,69,0.5191986644407346
54614,BANGOR,WI,925,890,-35,0.4903581267217631
54615,BLACK RIVER FALLS,WI,5150,4178,-972,0.44789879931389365
54616,BLAIR,WI,970,807,-163,0.45413618458075405
54618,CAMP DOUGLAS,WI,746,663,-83,0.47054648687012063
54619,CASHTON,WI,977,897,-80,0.4786552828175027
54621,CHASEBURG,WI,24,36,12,0.6
54622,BUFFALO CITY,WI,95,158,63,0.6245059288537549
54622,COCHRANE,WI,535,527,-8,0.4962335216572505
54622,WAUMANDEE,WI,16,13,-3,0.4482758620689655
54623,COON VALLEY,WI,412,436,24,0.5141509433962265
54624,DE SOTO,WI,363,259,-104,0.41639871382636656
54626,EASTMAN,WI,190,153,-37,0.446064139941691
54626,LYNXVILLE,WI,20,40,20,0.6666666666666666
54627,ETTRICK,WI,516,378,-138,0.4228187919463087
54628,FERRYVILLE,WI,107,138,31,0.563265306122449
54629,FOUNTAIN CITY,WI,847,812,-35,0.48945147679324896
54630,GALESVILLE,WI,1526,1422,-104,0.48236092265943015
54631,GAYS MILLS,WI,404,422,18,0.5108958837772397
54632,GENOA,WI,72,81,9,0.5294117647058824
54634,HILLSBORO,WI,1146,1065,-81,0.4816824966078697
54635,HIXTON,WI,518,378,-140,0.421875
54636,HOLMEN,WI,5869,5971,102,0.5043074324324325
54638,KENDALL,WI,205,177,-28,0.46335078534031415
54639,LA FARGE,WI,788,696,-92,0.46900269541778977
54642,MELROSE,WI,558,504,-54,0.4745762711864407
54644,MINDORO,WI,239,222,-17,0.48156182212581344
54646,NECEDAH,WI,1995,1876,-119,0.484629294755877
54648,NORWALK,WI,405,237,-168,0.3691588785046729
54650,ONALASKA,WI,10964,10368,-596,0.48603037689855616
54651,ONTARIO,WI,217,150,-67,0.4087193460490463
54652,READSTOWN,WI,130,114,-16,0.4672131147540984
54653,ROCKLAND,WI,110,159,49,0.5910780669144982
54655,SOLDIER GROVE,WI,11,16,5,0.5925925925925926
54655,SOLDIERS GROVE,WI,499,417,-82,0.45524017467248906
54656,FORT MCCOY,WI,444,243,-201,0.3537117903930131
54656,SPARTA,WI,7234,6862,-372,0.48680476730987515
54658,STODDARD,WI,667,667,0,0.5
54659,TAYLOR,WI,303,184,-119,0.37782340862423
54660,TOMAH,WI,8312,7628,-684,0.4785445420326223
54661,TREMPEALEAU,WI,1247,1244,-3,0.4993978321959053
54664,VIOLA,WI,616,634,18,0.5072
54665,VIROQUA,WI,3104,3028,-76,0.4938030006523157
54666,WARRENS,WI,1186,1186,0,0.5
54667,WESTBY,WI,1377,1390,13,0.5023491145645103
54669,WEST SALEM,WI,2731,2682,-49,0.495473859227785
54670,WILTON,WI,201,129,-72,0.39090909090909093
54701,EAU CLAIRE,WI,21401,17958,-3443,0.4562615920119922
54702,EAU CLAIRE,WI,1296,944,-352,0.42142857142857143
54703,EAU CLAIRE,WI,23861,19014,-4847,0.4434752186588921
54720,ALTOONA,WI,4891,4955,64,0.5032500507820434
54721,ARKANSAW,WI,133,79,-54,0.37264150943396224
54722,AUGUSTA,WI,1389,1275,-114,0.4786036036036036
54723,BAY CITY,WI,149,99,-50,0.39919354838709675
54724,BLOOMER,WI,2498,2384,-114,0.4883244571896764
54725,BOYCEVILLE,WI,951,965,14,0.5036534446764092
54726,BOYD,WI,469,390,-79,0.4540162980209546
54727,CADOTT,WI,1746,1627,-119,0.48235991698784464
54728,CHETEK,WI,3420,3152,-268,0.4796104686548996
54729,CHIPPEWA FALLS,WI,15094,13767,-1327,0.47701049859672223
54730,COLFAX,WI,1755,1753,-2,0.499714937286203
54731,CONRATH,WI,15,24,9,0.6153846153846154
54732,CORNELL,WI,1399,1212,-187,0.4641899655304481
54733,DALLAS,WI,172,111,-61,0.392226148409894
54733,HILLSDALE,WI,39,50,11,0.5617977528089888
54734,DOWNING,WI,13,33,20,0.717391304347826
54736,DURAND,WI,1547,1422,-125,0.4789491411249579
54738,ELEVA,WI,828,901,73,0.5211104684788895
54739,ELK MOUND,WI,1449,1529,80,0.5134318334452653
54740,ELMWOOD,WI,552,473,-79,0.46146341463414636
54741,FAIRCHILD,WI,345,365,20,0.5140845070422535
54742,FALL CREEK,WI,1321,1262,-59,0.4885791715060008
54745,HOLCOMBE,WI,1077,1010,-67,0.4839482510781025
54746,HUMBIRD,WI,23,23,0,0.5
54747,INDEPENDENCE,WI,1184,864,-320,0.421875
54748,JIM FALLS,WI,174,171,-3,0.4956521739130435
54749,KNAPP,WI,188,196,8,0.5104166666666666
54750,MAIDEN ROCK,WI,115,88,-27,0.43349753694581283
54751,MENOMONIE,WI,13514,10818,-2696,0.44459970409337496
54754,MERRILLAN,WI,731,582,-149,0.44325971058644326
54755,MONDOVI,WI,2652,2407,-245,0.4757857284048231
54756,NELSON,WI,45,29,-16,0.3918918918918919
54757,NEW AUBURN,WI,1577,1432,-145,0.4759056164838817
54758,OSSEO,WI,1698,1598,-100,0.4848300970873786
54759,PEPIN,WI,606,511,-95,0.4574753804834378
54761,PLUM CITY,WI,50,111,61,0.6894409937888198
54762,PRAIRIE FARM,WI,178,124,-54,0.4105960264900662
54763,RIDGELAND,WI,136,62,-74,0.31313131313131315
54766,SHELDON,WI,334,317,-17,0.4869431643625192
54767,SPRING VALLEY,WI,1025,962,-63,0.4841469552088576
54768,STANLEY,WI,1965,1656,-309,0.45733222866611434
54769,STOCKHOLM,WI,110,68,-42,0.38202247191011235
54770,STRUM,WI,555,507,-48,0.4774011299435028
54771,THORP,WI,1708,1267,-441,0.4258823529411765
54772,WHEELER,WI,405,266,-139,0.39642324888226527
54773,WHITEHALL,WI,1273,1175,-98,0.47998366013071897
54801,SPOONER,WI,3713,3485,-228,0.4841622672964712
54805,ALMENA,WI,684,623,-61,0.47666411629686306
54806,ASHLAND,WI,4932,4349,-583,0.4685917465790324
54810,BALSAM LAKE,WI,1685,1427,-258,0.45854755784061696
54812,BARRON,WI,2647,2275,-372,0.4622104835432751
54813,BARRONETT,WI,14,40,26,0.7407407407407407
54814,BAYFIELD,WI,1708,1525,-183,0.4716981132075472
54817,BIRCHWOOD,WI,1720,1612,-108,0.4837935174069628
54819,BRUCE,WI,1110,991,-119,0.4716801523084246
54820,BRULE,WI,47,93,46,0.6642857142857143
54821,CABLE,WI,950,892,-58,0.48425624321389793
54822,CAMERON,WI,1996,1771,-225,0.47013538624900453
54824,CENTURIA,WI,983,672,-311,0.4060422960725076
54826,COMSTOCK,WI,109,123,14,0.5301724137931034
54827,CORNUCOPIA,WI,29,77,48,0.7264150943396226
54828,COUDERAY,WI,108,98,-10,0.47572815533980584
54829,CUMBERLAND,WI,2713,2377,-336,0.4669941060903733
54830,DANBURY,WI,2633,2428,-205,0.4797470855562142
54832,DRUMMOND,WI,90,137,47,0.6035242290748899
54835,EXELAND,WI,163,127,-36,0.4379310344827586
54836,FOXBORO,WI,23,106,83,0.8217054263565892
54837,FREDERIC,WI,1707,1650,-57,0.4915102770330652
54838,GORDON,WI,838,750,-88,0.4722921914357683
54840,GRANTSBURG,WI,1914,1862,-52,0.493114406779661
54841,HAUGEN,WI,0,16,16,1
54842,HAWTHORNE,WI,0,12,12,1
54843,HAYWARD,WI,6931,7151,220,0.5078113904274961
54844,HERBSTER,WI,29,34,5,0.5396825396825397
54847,IRON RIVER,WI,1465,1374,-91,0.4839732300105671
54848,LADYSMITH,WI,2970,2683,-287,0.4746152485405979
54849,LAKE NEBAGAMON,WI,908,959,51,0.5136582753079807
54849,LK NEBAGAMON,WI,135,143,8,0.5143884892086331
54850,LA POINTE,WI,780,635,-145,0.44876325088339225
54853,LUCK,WI,1794,1692,-102,0.4853700516351119
54854,MAPLE,WI,82,54,-28,0.39705882352941174
54855,MARENGO,WI,36,24,-12,0.4
54856,MASON,WI,53,105,52,0.6645569620253164
54857,MIKANA,WI,101,64,-37,0.3878787878787879
54858,MILLTOWN,WI,894,741,-153,0.45321100917431195
54859,MINONG,WI,1289,1220,-69,0.48624950179354326
54861,ODANAH,WI,11,0,-11,0
54864,POPLAR,WI,132,178,46,0.5741935483870968
54865,PORT WING,WI,88,30,-58,0.2542372881355932
54867,RADISSON,WI,94,30,-64,0.24193548387096775
54868,RICE LAKE,WI,8377,7508,-869,0.47264715140069247
54870,SARONA,WI,786,579,-207,0.42417582417582417
54871,SHELL LAKE,WI,1614,1423,-191,0.46855449456700693
54872,SIREN,WI,1519,1247,-272,0.4508315256688359
54873,BARNES,WI,392,462,70,0.5409836065573771
54873,BENNETT,WI,30,26,-4,0.4642857142857143
54873,SOLON SPRINGS,WI,1466,1332,-134,0.4760543245175125
54874,SOUTH RANGE,WI,1136,921,-215,0.447739426349052
54875,SPRINGBROOK,WI,265,284,19,0.517304189435337
54876,STONE LAKE,WI,1464,1111,-353,0.43145631067961165
54880,SUPERIOR,WI,15219,13228,-1991,0.4650050971982986
54888,SPOONER,WI,0,28,28,1
54888,TREGO,WI,715,682,-33,0.4881889763779528
54889,TURTLE LAKE,WI,1445,1347,-98,0.48244985673352436
54891,WASHBURN,WI,1552,1442,-110,0.4816299265197061
54893,WEBSTER,WI,2313,2123,-190,0.47858431018935976
54895,WEYERHAEUSER,WI,167,141,-26,0.4577922077922078
54896,LORETTA,WI,82,66,-16,0.44594594594594594
54896,WINTER,WI,843,672,-171,0.44356435643564357
54901,OSHKOSH,WI,20217,16152,-4065,0.4441144931122659
54902,OSHKOSH,WI,11849,9526,-2323,0.4456608187134503
54903,OSHKOSH,WI,945,927,-18,0.4951923076923077
54904,OSHKOSH,WI,7444,7735,291,0.5095856117003755
54909,ALMOND,WI,692,564,-128,0.44904458598726116
54911,APPLETON,WI,14545,12316,-2229,0.45850861844309593
54912,APPLETON,WI,1307,1018,-289,0.4378494623655914
54912,GRAND CHUTE,WI,18,20,2,0.5263157894736842
54913,APPLETON,WI,9776,10400,624,0.5154639175257731
54913,FREEDOM,WI,472,417,-55,0.46906636670416196
54914,APPLETON,WI,17482,13664,-3818,0.4387080202915302
54915,APPLETON,WI,17518,14713,-2805,0.45648599174707577
54921,BANCROFT,WI,216,116,-100,0.3493975903614458
54922,BEAR CREEK,WI,183,165,-18,0.47413793103448276
54923,BERLIN,WI,3781,3526,-255,0.48255097851375395
54927,BUTTE DES MORTS,WI,41,22,-19,0.3492063492063492
54929,CLINTONVILLE,WI,3470,3479,9,0.5006475751906749
54930,COLOMA,WI,395,506,111,0.5615982241953386
54931,DALE,WI,0,23,23,1
54932,ELDORADO,WI,61,50,-11,0.45045045045045046
54935,FOND DU LAC,WI,22254,18133,-4121,0.4489811077822071
54936,FOND DU LAC,WI,1161,698,-463,0.37547068316299087
54937,FOND DU LAC,WI,4475,4455,-20,0.4988801791713326
54937,NORTH FOND DU LAC,WI,3131,3139,8,0.5006379585326953
54940,FREMONT,WI,1424,1385,-39,0.49305802776788893
54941,GREEN LAKE,WI,1748,1686,-62,0.49097262667443214
54942,GREENVILLE,WI,2676,3135,459,0.5394940629839958
54943,HANCOCK,WI,798,721,-77,0.47465437788018433
54944,HORTONVILLE,WI,2386,2590,204,0.5204983922829582
54945,IOLA,WI,1441,1325,-116,0.4790310918293565
54946,KING,WI,0,42,42,1
54947,LARSEN,WI,576,711,135,0.5524475524475524
54949,MANAWA,WI,1180,1051,-129,0.47108919766920665
54950,MARION,WI,1061,933,-128,0.4679037111334002
54952,MENASHA,WI,12311,10936,-1375,0.47042629156450294
54956,NEENAH,WI,18270,18005,-265,0.4963473466574776
54957,NEENAH,WI,112,25,-87,0.18248175182481752
54960,NESHKORO,WI,1138,1062,-76,0.4827272727272727
54961,NEW LONDON,WI,6271,5132,-1139,0.45005700254319037
54962,OGDENSBURG,WI,80,89,9,0.5266272189349113
54963,OMRO,WI,2364,2490,126,0.5129789864029666
54964,PICKETT,WI,68,66,-2,0.4925373134328358
54965,PINE RIVER,WI,75,51,-24,0.40476190476190477
54966,PLAINFIELD,WI,735,507,-228,0.4082125603864734
54967,POY SIPPI,WI,50,24,-26,0.32432432432432434
54968,PRINCETON,WI,1245,1272,27,0.5053635280095352
54970,REDGRANITE,WI,1345,1170,-175,0.46520874751491054
54971,RIPON,WI,5149,4257,-892,0.45258345736763766
54974,ROSENDALE,WI,181,129,-52,0.4161290322580645
54977,SCANDINAVIA,WI,267,113,-154,0.29736842105263156
54978,TILLEDA,WI,13,0,-13,0
54979,VAN DYNE,WI,127,166,39,0.5665529010238908
54981,WAUPACA,WI,8059,7098,-961,0.4682984759517055
54982,WAUTOMA,WI,3462,3262,-200,0.4851279000594884
54983,WEYAUWEGA,WI,1552,1519,-33,0.4946271572777597
54984,WILD ROSE,WI,1438,1570,132,0.5219414893617021
54986,WINNECONNE,WI,1833,1734,-99,0.4861227922624054
55001,AFTON,MN,925,939,14,0.503755364806867
55003,BAYPORT,MN,1143,1199,56,0.5119555935098207
55005,BETHEL,MN,1299,1246,-53,0.48958742632612967
55005,EAST BETHEL,MN,115,145,30,0.5576923076923077
55006,BRAHAM,MN,1765,1491,-274,0.45792383292383293
55007,BROOK PARK,MN,876,878,2,0.500570125427594
55008,CAMBRIDGE,MN,8017,7745,-272,0.4913716533434843
55009,CANNON FALLS,MN,2813,2726,-87,0.49214659685863876
55011,CEDAR,MN,2428,2529,101,0.5101876134758927
55011,CEDAR E BETHL,MN,81,67,-14,0.4527027027027027
55011,CEDAR EAST BETHEL,MN,142,122,-20,0.4621212121212121
55011,EAST BETHEL,MN,122,171,49,0.5836177474402731
55011,OAK GROVE,MN,179,166,-13,0.4811594202898551
55012,CENTER CITY,MN,594,553,-41,0.48212728857890147
55013,CHISAGO CITY,MN,2716,2793,77,0.5069885641677255
55014,CIRCLE PINES,MN,7755,7646,-109,0.49646126874878255
55014,LINO LAKES,MN,1241,1403,162,0.5306354009077155
55016,COTTAGE GROVE,MN,11836,13156,1320,0.5264084507042254
55017,DALBO,MN,11,14,3,0.56
55018,DENNISON,MN,30,25,-5,0.45454545454545453
55019,DUNDAS,MN,780,871,91,0.5275590551181102
55020,ELKO,MN,107,103,-4,0.49047619047619045
55020,ELKO NEW MARKET,MN,1007,1117,110,0.525894538606403
55021,FARIBAULT,MN,12173,10957,-1216,0.4737137916126243
55024,FARMINGTON,MN,10051,10173,122,0.5030162183544303
55025,COLUMBUS,MN,403,439,36,0.5213776722090261
55025,FOREST LAKE,MN,10649,10455,-194,0.49540371493555724
55026,FRONTENAC,MN,13,26,13,0.6666666666666666
55027,BELLECHESTER,MN,44,31,-13,0.41333333333333333
55027,GOODHUE,MN,598,468,-130,0.43902439024390244
55030,GRASSTON,MN,283,356,73,0.5571205007824727
55031,HAMPTON,MN,440,354,-86,0.44584382871536526
55031,NEW TRIER,MN,27,40,13,0.5970149253731343
55032,HARRIS,MN,1142,1127,-15,0.49669457910973996
55033,HASTINGS,MN,11338,10867,-471,0.4893942805674398
55037,HINCKLEY,MN,2566,2391,-175,0.4823481944724632
55038,CENTERVILLE,MN,627,709,82,0.530688622754491
55038,HUGO,MN,6492,7798,1306,0.5456962911126662
55038,LINO LAKES,MN,193,186,-7,0.49076517150395776
55040,ISANTI,MN,5013,5471,458,0.5218428080885158
55041,LAKE CITY,MN,3411,3196,-215,0.4837293779324958
55042,LAKE ELMO,MN,3809,5842,2033,0.605325872966532
55043,LAKE SAINT CROIX BEACH,MN,30,31,1,0.5081967213114754
55043,LAKELAND,MN,1279,1158,-121,0.47517439474764056
55044,LAKEVILLE,MN,18503,23188,4685,0.5561871866829772
55045,LINDSTROM,MN,3129,3056,-73,0.4940986257073565
55046,LONSDALE,MN,1530,1897,367,0.553545374963525
55047,MARINE ON SAINT CROIX,MN,947,962,15,0.5039287585123101
55049,MEDFORD,MN,733,649,-84,0.46960926193921854
55051,MORA,MN,5100,4592,-508,0.4737928188196451
55052,MORRISTOWN,MN,575,517,-58,0.4734432234432234
55053,NERSTRAND,MN,23,46,23,0.6666666666666666
55054,ELKO NEW MARKET,MN,352,454,102,0.5632754342431762
55054,ELKO NEW MRKT,MN,26,19,-7,0.4222222222222222
55054,NEW MARKET,MN,50,59,9,0.5412844036697247
55055,NEWPORT,MN,1796,2088,292,0.537590113285273
55056,NORTH BRANCH,MN,4865,5311,446,0.5219143081761006
55057,NORTHFIELD,MN,8604,7964,-640,0.48068565910188316
55060,OWATONNA,MN,13545,12085,-1460,0.47151775263363244
55063,PINE CITY,MN,4506,4305,-201,0.4885938032005448
55065,RANDOLPH,MN,73,22,-51,0.23157894736842105
55066,RED WING,MN,9354,8048,-1306,0.4624755775198253
55068,ROSEMOUNT,MN,10091,10555,464,0.511237043495108
55069,RUSH CITY,MN,2328,2038,-290,0.4667888227210261
55070,SAINT FRANCIS,MN,3307,3071,-236,0.4814989024772656
55071,SAINT PAUL PARK,MN,1898,1611,-287,0.4591051581647193
55071,ST PAUL,MN,40,50,10,0.5555555555555556
55071,ST PAUL PARK,MN,314,290,-24,0.48013245033112584
55072,SANDSTONE,MN,1793,1580,-213,0.46842573376815894
55073,SCANDIA,MN,1036,1036,0,0.5
55074,SHAFER,MN,650,746,96,0.5343839541547278
55075,SOUTH SAINT PAUL,MN,9741,8281,-1460,0.4594939518366441
55076,INVER GROVE HEIGHTS,MN,8696,8084,-612,0.48176400476758047
55077,INVER GROVE HEIGHTS,MN,6495,5925,-570,0.47705314009661837
55079,STACY,MN,2486,2555,69,0.5068438801825035
55080,STANCHFIELD,MN,930,991,61,0.5158771473191046
55082,STILLWATER,MN,15558,14037,-1521,0.47430309173846935
55084,TAYLORS FALLS,MN,602,499,-103,0.45322434150772023
55088,WEBSTER,MN,419,387,-32,0.4801488833746898
55089,WELCH,MN,281,243,-38,0.4637404580152672
55090,WILLERNIE,MN,178,110,-68,0.3819444444444444
55092,COLUMBUS,MN,75,75,0,0.5
55092,EAST BETHEL,MN,60,82,22,0.5774647887323944
55092,WYOMING,MN,3034,3109,75,0.5061045091974605
55101,SAINT PAUL,MN,12759,11857,-902,0.4816785830354241
55102,SAINT PAUL,MN,15917,13618,-2299,0.46108007448789573
55103,SAINT PAUL,MN,8315,6255,-2060,0.42930679478380235
55104,SAINT PAUL,MN,27345,21504,-5841,0.44021371983049806
55105,SAINT PAUL,MN,12232,10644,-1588,0.46529113481377865
55106,SAINT PAUL,MN,32108,25509,-6599,0.4427339153374872
55107,SAINT PAUL,MN,7421,6368,-1053,0.46181739067372546
55107,WEST SAINT PAUL,MN,181,157,-24,0.46449704142011833
55108,FALCON HEIGHTS,MN,461,480,19,0.51009564293305
55108,SAINT PAUL,MN,8523,7372,-1151,0.4637936458005662
55109,MAPLEWOOD,MN,3672,3619,-53,0.49636538197778085
55109,N SAINT PAUL,MN,354,360,6,0.5042016806722689
55109,NORTH SAINT PAUL,MN,800,659,-141,0.4516792323509253
55109,NORTH ST PAUL,MN,223,255,32,0.5334728033472803
55109,SAINT PAUL,MN,10885,10520,-365,0.49147395468348515
55110,SAINT PAUL,MN,12273,11635,-638,0.4866571858792036
55110,WHITE BEAR LAKE,MN,1970,1948,-22,0.49719244512506383
55110,WHITE BEAR LK,MN,326,351,25,0.518463810930576
55110,WHITE BEAR TOWNSHIP,MN,502,535,33,0.5159112825458052
55111,SAINT PAUL,MN,12,38,26,0.76
55112,NEW BRIGHTON,MN,4431,4076,-355,0.4791348301398848
55112,SAINT PAUL,MN,16406,14003,-2403,0.4604886711171035
55113,ROSEVILLE,MN,7061,6514,-547,0.4798526703499079
55113,SAINT PAUL,MN,13164,12793,-371,0.4928535655121932
55114,MINNEAPOLIS,MN,146,130,-16,0.47101449275362317
55114,SAINT PAUL,MN,5150,5050,-100,0.4950980392156863
55115,MAHTOMEDI,MN,1431,1456,25,0.5043297540699688
55115,SAINT PAUL,MN,1215,1236,21,0.5042839657282742
55115,WHITE BEAR LAKE,MN,125,111,-14,0.4703389830508475
55116,SAINT PAUL,MN,13891,11917,-1974,0.4617560446373218
55117,MAPLEWOOD,MN,570,549,-21,0.4906166219839142
55117,SAINT PAUL,MN,23504,20200,-3304,0.462200256269449
55118,MENDOTA HEIGHTS,MN,675,790,115,0.5392491467576792
55118,SAINT PAUL,MN,11889,11708,-181,0.4961647667076323
55118,WEST SAINT PAUL,MN,542,381,-161,0.41278439869989164
55119,MAPLEWOOD,MN,10989,9375,-1614,0.4603712433706541
55119,SAINT PAUL,MN,9600,8502,-1098,0.46967185946304274
55120,APPLE VALLEY,MN,53,86,33,0.6187050359712231
55120,MENDOTA HEIGHTS,MN,849,820,-29,0.49131216297183944
55120,MENDOTA HTS,MN,60,60,0,0.5
55120,MINNESOTA,MN,43,35,-8,0.44871794871794873
55120,SAINT PAUL,MN,1280,1332,52,0.5099540581929556
55121,EAGAN,MN,2992,3010,18,0.5014995001666112
55121,SAINT PAUL,MN,4151,4435,284,0.5165385511297461
55122,EAGAN,MN,6355,5826,-529,0.4782858550201133
55122,SAINT PAUL,MN,8860,8395,-465,0.4865256447406549
55123,EAGAN,MN,5492,5244,-248,0.4884500745156483
55123,SAINT PAUL,MN,4010,3630,-380,0.47513089005235604
55124,APPLE VALLEY,MN,11703,10557,-1146,0.4742587601078167
55124,SAINT PAUL,MN,12000,11983,-17,0.4996455822874536
55125,SAINT PAUL,MN,13873,12902,-971,0.4818674136321195
55125,WOODBURY,MN,5847,5273,-574,0.4741906474820144
55126,SAINT PAUL,MN,5178,4834,-344,0.48282061526168596
55126,SHOREVIEW,MN,6242,6044,-198,0.4919420478593521
55127,NORTH OAKS,MN,1335,1357,22,0.5040861812778603
55127,SAINT PAUL,MN,3928,4278,350,0.5213258591274678
55127,VADNAIS HEIGHTS,MN,931,860,-71,0.480178671133445
55127,VADNAIS HTS,MN,567,424,-143,0.42785065590312815
55127,WHITE BEAR LAKE,MN,480,563,83,0.5397890699904123
55127,WHITE BEAR LAKE TOWNSHIP,MN,105,93,-12,0.4696969696969697
55127,WHITE BEAR LK,MN,205,123,-82,0.375
55128,OAKDALE,MN,5738,5627,-111,0.49511658600967884
55128,SAINT PAUL,MN,6160,5187,-973,0.4571252313386798
55129,SAINT PAUL,MN,5195,5891,696,0.5313909435323831
55129,WOODBURY,MN,7037,9059,2022,0.5628106361829026
55130,SAINT PAUL,MN,10921,8069,-2852,0.42490784623486044
55164,SAINT PAUL,MN,140,12,-128,0.07894736842105263
55301,ALBERTVILLE,MN,3129,3369,240,0.5184672206832872
55301,OTSEGO,MN,917,1047,130,0.5330957230142567
55302,ANNANDALE,MN,3152,3185,33,0.5026037557203724
55303,ANOKA,MN,20091,18397,-1694,0.4779931407191852
55303,RAMSEY,MN,2741,2369,-372,0.46360078277886496
55304,ANDOVER,MN,12304,13103,799,0.5157240130672649
55304,HAM LAKE,MN,853,820,-33,0.49013747758517634
55305,HOPKINS,MN,10267,9423,-844,0.4785678009141696
55305,MINNETONKA,MN,4927,4528,-399,0.478900052882073
55306,BURNSVILLE,MN,9598,8445,-1153,0.468048550684476
55307,ARLINGTON,MN,1068,1011,-57,0.4862914862914863
55307,BARNESVILLE,MN,23,18,-5,0.43902439024390244
55308,BECKER,MN,3038,2922,-116,0.49026845637583893
55309,BIG LAKE,MN,9128,8112,-1016,0.4705336426914153
55310,BIRD ISLAND,MN,570,341,-229,0.3743139407244786
55311,MAPLE GROVE,MN,14600,14168,-432,0.4924916573971079
55312,BROWNTON,MN,204,231,27,0.5310344827586206
55313,BUFFALO,MN,8951,8372,-579,0.4832881140680021
55314,BUFFALO LAKE,MN,191,227,36,0.5430622009569378
55315,CARVER,MN,1819,2393,574,0.5681386514719848
55316,CHAMPLIN,MN,8794,8118,-676,0.48001419110690635
55317,CHANHASSEN,MN,8038,8205,167,0.5051406759835005
55318,CHASKA,MN,11577,11681,104,0.5022357898357555
55319,CLEAR LAKE,MN,2648,2433,-215,0.4788427474906514
55320,CLEARWATER,MN,1996,1810,-186,0.47556489753021547
55320,SAINT AUGUSTA,MN,103,74,-29,0.4180790960451977
55321,COKATO,MN,2022,1788,-234,0.4692913385826772
55322,COLOGNE,MN,900,956,56,0.5150862068965517
55323,CRYSTAL BAY,MN,12,12,0,0.5
55324,DARWIN,MN,243,161,-82,0.39851485148514854
55325,DASSEL,MN,1633,1546,-87,0.4863164517143756
55327,DAYTON,MN,1550,2653,1103,0.6312157982393528
55328,DELANO,MN,2797,3100,303,0.525691029336951
55329,EDEN VALLEY,MN,846,614,-232,0.42054794520547945
55330,ELK RIVER,MN,14607,15866,1259,0.5206576313457815
55330,OTSEGO,MN,261,381,120,0.5934579439252337
55331,EXCELSIOR,MN,7733,8091,358,0.5113119312436805
55331,MINNETRISTA,MN,464,823,359,0.6394716394716394
55332,FAIRFAX,MN,936,653,-283,0.41095028319697924
55333,FRANKLIN,MN,81,75,-6,0.4807692307692308
55334,GAYLORD,MN,1400,1017,-383,0.4207695490277203
55335,GIBBON,MN,299,244,-55,0.44935543278084716
55336,GLENCOE,MN,2920,2753,-167,0.48528115635466246
55337,BURNSVILLE,MN,32322,23308,-9014,0.41898256336509077
55338,GREEN ISLE,MN,128,113,-15,0.46887966804979253
55339,HAMBURG,MN,62,24,-38,0.27906976744186046
55340,CORCORAN,MN,438,591,153,0.5743440233236151
55340,HAMEL,MN,1503,2100,597,0.5828476269775187
55340,MEDINA,MN,687,1095,408,0.6144781144781145
55341,HANOVER,MN,692,956,264,0.5800970873786407
55342,HECTOR,MN,667,546,-121,0.45012366034624895
55343,HOPKINS,MN,18140,15650,-2490,0.4631547795205682
55343,MINNETONKA,MN,1409,1330,-79,0.4855786783497627
55344,EDEN PRAIRIE,MN,15294,13678,-1616,0.4721110037277371
55345,MINNETONKA,MN,8634,8138,-496,0.48521345098974483
55346,EDEN PRAIRIE,MN,5590,5456,-134,0.4939344559116422
55347,EDEN PRAIRIE,MN,11015,11037,22,0.5004988209686196
55349,HOWARD LAKE,MN,1556,1432,-124,0.47925033467202144
55350,HUTCHINSON,MN,8934,7962,-972,0.47123579545454547
55352,JORDAN,MN,3395,3117,-278,0.47865479115479115
55353,KIMBALL,MN,952,932,-20,0.49469214437367304
55354,LESTER PR,MN,17,0,-17,0
55354,LESTER PRAIRIE,MN,686,592,-94,0.46322378716744916
55355,LITCHFIELD,MN,4156,3625,-531,0.4658784217966842
55356,LONG LAKE,MN,2074,2014,-60,0.4926614481409002
55356,ORONO,MN,144,152,8,0.5135135135135135
55357,LORETTO,MN,934,1014,80,0.5205338809034907
55358,MAPLE LAKE,MN,1966,1681,-285,0.46092678914176033
55359,INDEPENDENCE,MN,127,81,-46,0.3894230769230769
55359,MAPLE PLAIN,MN,1824,1918,94,0.5125601282736505
55359,MINNETRISTA,MN,53,26,-27,0.3291139240506329
55359,ORONO,MN,64,44,-20,0.4074074074074074
55360,MAYER,MN,651,894,243,0.5786407766990291
55362,MONTICELLO,MN,7507,7610,103,0.5034067606006483
55362,OTSEGO,MN,163,197,34,0.5472222222222223
55363,MONTROSE,MN,1908,1880,-28,0.4963041182682154
55364,MOUND,MN,6719,6009,-710,0.47210873664362035
55366,NEW AUBURN,MN,34,0,-34,0
55367,NEW GERMANY,MN,67,36,-31,0.34951456310679613
55368,NORWOOD,MN,71,48,-23,0.40336134453781514
55368,NORWOOD YOUNG AMERICA,MN,874,730,-144,0.4551122194513716
55368,NYA,MN,50,41,-9,0.45054945054945056
55369,MAPLE GROVE,MN,13398,13854,456,0.5083663584324086
55369,OSSEO,MN,4262,4247,-15,0.4991185803267129
55370,PLATO,MN,0,13,13,1
55371,PRINCETON,MN,6101,6238,137,0.5055515033633196
55372,PRIOR LAKE,MN,12979,13090,111,0.5021289654378764
55373,ROCKFORD,MN,2197,2199,2,0.5002274795268425
55374,ROGERS,MN,4895,5883,988,0.5458341065132678
55375,MINNETRISTA,MN,63,66,3,0.5116279069767442
55375,SAINT BONIFACIUS,MN,1041,919,-122,0.4688775510204082
55375,ST BONIFACIUS,MN,207,177,-30,0.4609375
55376,SAINT MICHAEL,MN,5003,5730,727,0.5338675114133979
55378,SAVAGE,MN,10199,10640,441,0.5105811219348337
55379,SHAKOPEE,MN,18689,19022,333,0.5044151573811355
55381,SILVER LAKE,MN,453,283,-170,0.3845108695652174
55382,SAINT AUGUSTA,MN,23,14,-9,0.3783783783783784
55382,SOUTH HAVEN,MN,1415,1281,-134,0.47514836795252224
55384,SPRING PARK,MN,1538,1401,-137,0.4766927526369513
55385,STEWART,MN,294,134,-160,0.3130841121495327
55386,VICTORIA,MN,2695,3401,706,0.5579068241469817
55387,WACONIA,MN,4661,4915,254,0.5132623224728488
55388,WATERTOWN,MN,2018,2054,36,0.5044204322200393
55389,WATKINS,MN,815,686,-129,0.4570286475682878
55390,WAVERLY,MN,903,1136,233,0.5571358509073076
55391,WAYZATA,MN,8936,8795,-141,0.49602391292087306
55395,WINSTED,MN,1093,969,-124,0.46993210475266733
55396,WINTHROP,MN,659,630,-29,0.4887509697439876
55397,EDEN PRAIRIE,MN,15,16,1,0.5161290322580645
55397,NORWOOD YOUNG AMERICA,MN,155,221,66,0.5877659574468085
55397,NYA,MN,28,33,5,0.5409836065573771
55397,YOUNG AMERICA,MN,531,536,5,0.5023430178069354
55398,ZIMMERMAN,MN,5497,5949,452,0.5197448890442076
55401,MINNEAPOLIS,MN,17811,14729,-3082,0.4526429010448679
55402,MINNEAPOLIS,MN,3334,1769,-1565,0.3466588281403096
55403,MINNEAPOLIS,MN,19573,15724,-3849,0.44547695271552823
55404,MINNEAPOLIS,MN,20910,16705,-4205,0.44410474544729495
55405,MINNEAPOLIS,MN,12555,10074,-2481,0.4451809624817712
55406,MINNEAPOLIS,MN,17623,15109,-2514,0.4615972137357937
55406,ROCHESTER,MN,343,305,-38,0.470679012345679
55407,MINNEAPOLIS,MN,20965,16185,-4780,0.4356662180349933
55407,MP,MN,360,280,-80,0.4375
55408,MINNEAPOLIS,MN,35003,26774,-8229,0.4333975427748191
55409,MINNEAPOLIS,MN,6513,5513,-1000,0.458423415932147
55410,EDINA,MN,252,271,19,0.5181644359464627
55410,MINNEAPOLIS,MN,8639,8127,-512,0.48473100322080404
55411,MINNEAPOLIS,MN,22332,13961,-8371,0.38467473066431546
55412,MINNEAPOLIS,MN,14313,10485,-3828,0.42281635615775465
55413,MINNEAPOLIS,MN,12878,11114,-1764,0.4632377459153051
55414,MINNEAPOLIS,MN,27888,18541,-9347,0.3993409291606539
55415,MINNEAPOLIS,MN,5790,6575,785,0.5317428224828143
55416,EDINA,MN,401,338,-63,0.45737483085250336
55416,GOLDEN VALLEY,MN,1255,1118,-137,0.47113358617783396
55416,MINNEAPOLIS,MN,20129,17362,-2767,0.4630978101411005
55416,SAINT LOUIS PARK,MN,4524,4014,-510,0.4701335207308503
55416,ST LOUIS PARK,MN,2084,1724,-360,0.4527310924369748
55417,MINNEAPOLIS,MN,10620,9760,-860,0.478900883218842
55418,MINNEAPOLIS,MN,16277,13965,-2312,0.46177501487996825
55418,ST ANTHNY VLG,MN,310,252,-58,0.4483985765124555
55419,MINNEAPOLIS,MN,11597,10324,-1273,0.47096391587975
55420,BLOOMINGTON,MN,4277,3534,-743,0.45243886826270646
55420,MINNEAPOLIS,MN,7850,6053,-1797,0.43537366036107317
55421,COLUMBIA HEIGHTS,MN,2100,1668,-432,0.4426751592356688
55421,COLUMBIA HTS,MN,613,476,-137,0.43709825528007346
55421,FRIDLEY,MN,346,299,-47,0.4635658914728682
55421,MINNEAPOLIS,MN,14291,10742,-3549,0.4291135700874845
55421,SAINT ANTHONY,MN,439,283,-156,0.39196675900277006
55422,CRYSTAL,MN,723,611,-112,0.4580209895052474
55422,GOLDEN VALLEY,MN,244,224,-20,0.47863247863247865
55422,MINNEAPOLIS,MN,12411,10945,-1466,0.46861620140435006
55422,ROBBINSDALE,MN,1537,1366,-171,0.47054770926627626
55423,BLOOMINGTON,MN,442,371,-71,0.45633456334563344
55423,MINNEAPOLIS,MN,7748,6718,-1030,0.4643992810728605
55423,RICHFIELD,MN,10648,9132,-1516,0.4616784630940344
55424,EDINA,MN,2541,2607,66,0.5064102564102564
55424,MINNEAPOLIS,MN,956,1086,130,0.5318315377081293
55425,BLOOMINGTON,MN,4479,3875,-604,0.46384965286090496
55425,MINNEAPOLIS,MN,3728,3065,-663,0.45119976446341825
55426,MINNEAPOLIS,MN,10735,9143,-1592,0.45995572995271156
55426,SAINT LOUIS PARK,MN,2266,1829,-437,0.44664224664224667
55426,ST LOUIS PARK,MN,3185,2701,-484,0.45888549099558273
55427,CRYSTAL,MN,2673,2483,-190,0.4815748642358417
55427,GOLDEN VALLEY,MN,975,710,-265,0.42136498516320475
55427,MINNEAPOLIS,MN,7439,6684,-755,0.47327055158252496
55427,NEW HOPE,MN,1111,1005,-106,0.47495274102079393
55428,BROOKLYN PARK,MN,1639,1543,-96,0.4849151477058454
55428,CRYSTAL,MN,2553,2091,-462,0.4502583979328165
55428,MINNEAPOLIS,MN,9927,8461,-1466,0.46013704589949966
55428,NEW HOPE,MN,1356,1190,-166,0.4673998428908091
55429,BROOKLYN CENTER,MN,911,534,-377,0.3695501730103806
55429,BROOKLYN PARK,MN,3121,2644,-477,0.4586296617519514
55429,CRYSTAL,MN,695,536,-159,0.4354183590576767
55429,MINNEAPOLIS,MN,13078,9348,-3730,0.41683759921519664
55430,BROOKLYN CENTER,MN,2238,1875,-363,0.45587162654996355
55430,BROOKLYN CTR,MN,1277,1190,-87,0.4823672476692339
55430,MINNEAPOLIS,MN,9211,7516,-1695,0.4493334130447779
55431,BLOOMINGTON,MN,4804,4369,-435,0.476289109342636
55431,MINNEAPOLIS,MN,4787,4502,-285,0.4846592744105932
55432,FRIDLEY,MN,5809,4605,-1204,0.44219320145957364
55432,MINNEAPOLIS,MN,10045,7878,-2167,0.4395469508452826
55432,SPRING LAKE PARK,MN,1064,883,-181,0.4535182331792501
55432,SPRING LK PK,MN,1729,1459,-270,0.45765370138017564
55433,COON RAPIDS,MN,6675,5540,-1135,0.45354072861236183
55433,MINNEAPOLIS,MN,11603,9007,-2596,0.43702086365841825
55434,BLAINE,MN,6102,5905,-197,0.4917964520696261
55434,MINNEAPOLIS,MN,6230,6016,-214,0.49126245304589256
55435,BLOOMINGTON,MN,212,231,19,0.5214446952595937
55435,EDINA,MN,5814,5019,-795,0.4633065632788701
55435,MINNEAPOLIS,MN,5224,5030,-194,0.4905402769650868
55436,EDINA,MN,3928,4223,295,0.5180959391485708
55436,MINNEAPOLIS,MN,2951,2614,-337,0.4697214734950584
55437,BLOOMINGTON,MN,4375,4125,-250,0.4852941176470588
55437,MINNEAPOLIS,MN,6685,6073,-612,0.4760150493807807
55438,BLOOMINGTON,MN,2207,1679,-528,0.43206381883685024
55438,MINNEAPOLIS,MN,7252,6146,-1106,0.4587251828631139
55439,EDINA,MN,1731,1502,-229,0.46458397772966287
55439,MINNEAPOLIS,MN,3047,3164,117,0.5094187731444212
55440,MINNEAPOLIS,MN,2667,4379,1712,0.621487368719841
55441,MINNEAPOLIS,MN,7355,7033,-322,0.4888101195440645
55441,PLYMOUTH,MN,3378,2903,-475,0.462187549753224
55442,MINNEAPOLIS,MN,3704,3651,-53,0.49639700883752547
55442,PLYMOUTH,MN,3198,2899,-299,0.47547974413646055
55443,BROOKLYN PARK,MN,5976,5289,-687,0.4695073235685752
55443,MINNEAPOLIS,MN,9731,8911,-820,0.478006651646819
55444,BROOKLYN CENTER,MN,162,142,-20,0.46710526315789475
55444,BROOKLYN PARK,MN,2608,2137,-471,0.45036880927291884
55444,MINNEAPOLIS,MN,2994,2805,-189,0.4837040869115365
55445,BROOKLYN PARK,MN,2265,2116,-149,0.4829947500570646
55445,MINNEAPOLIS,MN,3490,3150,-340,0.4743975903614458
55446,MINNEAPOLIS,MN,3786,3959,173,0.5111684958037443
55446,PLYMOUTH,MN,7125,7994,869,0.5287386731926714
55447,MINNEAPOLIS,MN,5913,5143,-770,0.4651772793053546
55447,PLYMOUTH,MN,4198,4047,-151,0.4908429351121892
55448,COON RAPIDS,MN,4662,3900,-762,0.4555010511562719
55448,MINNEAPOLIS,MN,8475,6757,-1718,0.44360556722689076
55449,BLAINE,MN,4300,4845,545,0.5297977036632039
55449,MINNEAPOLIS,MN,6288,6774,486,0.5186035829122646
55454,MINNEAPOLIS,MN,4055,3541,-514,0.4661664033701948
55455,MINNEAPOLIS,MN,467,27,-440,0.05465587044534413
55458,MINNEAPOLIS,MN,702,889,187,0.5587680703959774
55603,FINLAND,MN,28,13,-15,0.3170731707317073
55604,GRAND MARAIS,MN,2362,2457,95,0.5098568167669641
55606,HOVLAND,MN,38,57,19,0.6
55609,KNIFE RIVER,MN,12,26,14,0.6842105263157895
55612,LUTSEN,MN,308,370,62,0.5457227138643068
55613,SCHROEDER,MN,11,0,-11,0
55614,SILVER BAY,MN,1183,1010,-173,0.4605563155494756
55615,TOFTE,MN,50,22,-28,0.3055555555555556
55616,TWO HARBORS,MN,2667,2644,-23,0.49783468273394843
55703,ANGORA,MN,11,11,0,0.5
55704,ASKOV,MN,84,166,82,0.664
55705,AURORA,MN,1348,1146,-202,0.4595028067361668
55705,BIWABIK,MN,27,36,9,0.5714285714285714
55706,BABBITT,MN,940,839,-101,0.4716132658797077
55707,BARNUM,MN,830,982,152,0.5419426048565121
55707,MAHTOWA,MN,147,177,30,0.5462962962962963
55708,BIWABIK,MN,301,135,-166,0.30963302752293576
55709,BOVEY,MN,1561,1726,165,0.5250988743535139
55710,BRITT,MN,249,207,-42,0.45394736842105265
55713,BUHL,MN,120,111,-9,0.4805194805194805
55716,CALUMET,MN,11,0,-11,0
55717,CANYON,MN,11,13,2,0.5416666666666666
55718,CARLTON,MN,1224,1269,45,0.5090252707581228
55719,CHISHOLM,MN,2598,2187,-411,0.4570532915360502
55720,CLOQUET,MN,7171,6446,-725,0.47337886465447604
55721,COHASSET,MN,1359,1357,-2,0.4996318114874816
55722,COLERAINE,MN,344,269,-75,0.43882544861337686
55723,COOK,MN,1747,1441,-306,0.45200752823086576
55724,COTTON,MN,121,103,-18,0.45982142857142855
55725,CRANE LAKE,MN,30,117,87,0.7959183673469388
55726,CROMWELL,MN,165,164,-1,0.49848024316109424
55731,ELY,MN,3816,3820,4,0.500261917234154
55732,EMBARRASS,MN,211,249,38,0.5413043478260869
55733,ESKO,MN,1273,1264,-9,0.49822625147812377
55734,EVELETH,MN,2440,2255,-185,0.4802981895633653
55735,FINLAYSON,MN,649,745,96,0.5344332855093257
55736,FLOODWOOD,MN,199,237,38,0.5435779816513762
55741,GILBERT,MN,1079,1032,-47,0.4888678351492184
55744,GRAND RAPIDS,MN,10177,9560,-617,0.4843694583776663
55746,HIBBING,MN,9331,7310,-2021,0.4392764857881137
55748,HILL CITY,MN,417,446,29,0.5168018539976825
55750,HOYT LAKES,MN,727,693,-34,0.4880281690140845
55751,IRON,MN,121,123,2,0.5040983606557377
55752,JACOBSON,MN,13,18,5,0.5806451612903226
55753,KEEWATIN,MN,251,71,-180,0.2204968944099379
55757,KETTLE RIVER,MN,22,117,95,0.841726618705036
55760,MCGREGOR,MN,1727,1627,-100,0.48509242695289206
55763,MAKINEN,MN,98,42,-56,0.3
55764,MARBLE,MN,31,12,-19,0.27906976744186046
55765,MEADOWLANDS,MN,37,33,-4,0.4714285714285714
55767,MOOSE LAKE,MN,1597,1493,-104,0.4831715210355987
55768,MOUNTAIN IRON,MN,922,903,-19,0.4947945205479452
55768,MTN IRON,MN,19,18,-1,0.4864864864864865
55769,NASHWAUK,MN,875,929,54,0.5149667405764967
55771,BUYCK,MN,36,93,57,0.7209302325581395
55771,GHEEN,MN,48,50,2,0.5102040816326531
55771,ORR,MN,895,637,-258,0.4157963446475196
55775,PENGILLY,MN,322,290,-32,0.4738562091503268
55779,CULVER,MN,99,82,-17,0.4530386740331492
55779,SAGINAW,MN,1274,1212,-62,0.48753016894609813
55781,SIDE LAKE,MN,259,280,21,0.5194805194805194
55782,SOUDAN,MN,24,0,-24,0
55783,STURGEON LAKE,MN,1222,1115,-107,0.4771074026529739
55787,TAMARACK,MN,24,13,-11,0.35135135135135137
55790,TOWER,MN,1716,1487,-229,0.46425226350296595
55792,VIRGINIA,MN,4905,4416,-489,0.47376890891535245
55793,WARBA,MN,55,14,-41,0.2028985507246377
55795,RUTLEDGE,MN,0,36,36,1
55795,WILLOW RIVER,MN,500,469,-31,0.4840041279669763
55796,WINTON,MN,20,12,-8,0.375
55797,WRENSHALL,MN,267,334,67,0.5557404326123128
55798,WRIGHT,MN,58,23,-35,0.2839506172839506
55802,DULUTH,MN,2321,2046,-275,0.46851385390428213
55803,DULUTH,MN,6993,6368,-625,0.47661103210837513
55804,DULUTH,MN,4901,4978,77,0.5038971555825489
55805,DULUTH,MN,7053,5207,-1846,0.4247145187601958
55806,DULUTH,MN,6913,5938,-975,0.46206520893315695
55807,DULUTH,MN,4560,4080,-480,0.4722222222222222
55808,DULUTH,MN,2654,2448,-206,0.47981183849470793
55810,DULUTH,MN,1324,1332,8,0.5015060240963856
55810,HERMANTOWN,MN,550,612,62,0.5266781411359724
55810,PROCTOR,MN,993,921,-72,0.48119122257053293
55811,DULUTH,MN,9577,8788,-789,0.47851892186223793
55811,HERMANTOWN,MN,2646,2515,-131,0.48730866111218757
55812,DULUTH,MN,5488,4192,-1296,0.43305785123966944
55815,DULUTH,MN,12,0,-12,0
55816,DULUTH,MN,1179,872,-307,0.4251584592881521
55901,ROCHESTER,MN,30948,28328,-2620,0.47789999325190635
55902,ROCHESTER,MN,12939,12548,-391,0.492329422843018
55903,ROCHESTER,MN,1429,1666,237,0.5382875605815832
55904,ROCHESTER,MN,16108,13788,-2320,0.4611988225849612
55906,ROCHESTER,MN,8964,7910,-1054,0.46876851961597726
55909,ADAMS,MN,325,219,-106,0.4025735294117647
55910,ALTURA,MN,106,124,18,0.5391304347826087
55910,MINNEISKA,MN,38,0,-38,0
55912,AUSTIN,MN,13519,12724,-795,0.4848531036847921
55917,BLMNG PRAIRIE,MN,58,61,3,0.5126050420168067
55917,BLOOMING PRAIRIE,MN,1055,976,-79,0.48055145248645986
55918,BROWNSDALE,MN,86,152,66,0.6386554621848739
55919,BROWNSVILLE,MN,133,61,-72,0.31443298969072164
55920,BYRON,MN,2548,2831,283,0.5263060048336122
55921,CALEDONIA,MN,1690,1458,-232,0.46315120711562896
55922,CANTON,MN,25,34,9,0.576271186440678
55923,CHATFIELD,MN,1311,1403,92,0.5169491525423728
55924,CLAREMONT,MN,244,175,-69,0.41766109785202865
55926,DEXTER,MN,104,24,-80,0.1875
55927,DODGE CENTER,MN,1491,1367,-124,0.47830650804758573
55929,DOVER,MN,120,76,-44,0.3877551020408163
55932,ELGIN,MN,541,368,-173,0.40484048404840484
55934,EYOTA,MN,943,891,-52,0.48582333696837515
55934,VIOLA,MN,32,23,-9,0.41818181818181815
55935,FOUNTAIN,MN,23,28,5,0.5490196078431373
55936,GRAND MEADOW,MN,547,435,-112,0.4429735234215886
55939,HARMONY,MN,601,601,0,0.5
55940,HAYFIELD,MN,868,777,-91,0.4723404255319149
55941,HOKAH,MN,157,71,-86,0.31140350877192985
55943,HOUSTON,MN,853,869,16,0.5046457607433217
55944,KASSON,MN,2397,2481,84,0.508610086100861
55945,KELLOGG,MN,209,250,41,0.5446623093681917
55945,THEILMAN,MN,0,14,14,1
55946,KENYON,MN,1106,1156,50,0.51105216622458
55947,LA CRESCENT,MN,2758,2577,-181,0.4830365510777882
55949,LANESBORO,MN,471,415,-56,0.4683972911963883
55949,WHALAN,MN,0,14,14,1
55951,LE ROY,MN,516,312,-204,0.37681159420289856
55952,LEWISTON,MN,641,620,-21,0.4916732751784298
55953,LYLE,MN,72,11,-61,0.13253012048192772
55954,MABEL,MN,289,283,-6,0.49475524475524474
55955,MANTORVILLE,MN,415,546,131,0.5681581685744017
55956,MAZEPPA,MN,398,359,-39,0.47424042272126815
55957,MILLVILLE,MN,49,42,-7,0.46153846153846156
55959,MINNESOTA CITY,MN,299,415,116,0.5812324929971989
55960,ORONOCO,MN,862,994,132,0.5355603448275862
55961,OSTRANDER,MN,12,0,-12,0
55962,PETERSON,MN,23,23,0,0.5
55963,PINE ISLAND,MN,1917,1980,63,0.5080831408775982
55964,PLAINVIEW,MN,1647,1277,-370,0.43673050615595077
55965,PRESTON,MN,721,843,122,0.539002557544757
55969,ROLLINGSTONE,MN,73,48,-25,0.39669421487603307
55970,ROSE CREEK,MN,49,23,-26,0.3194444444444444
55971,RUSHFORD,MN,975,849,-126,0.4654605263157895
55972,SAINT CHARLES,MN,1783,1679,-104,0.4849797804737146
55974,SPRING GROVE,MN,908,562,-346,0.38231292517006804
55975,ROSE CREEK,MN,20,39,19,0.6610169491525424
55975,SPRING VALLEY,MN,1454,1408,-46,0.4919636617749825
55976,STEWARTVILLE,MN,3118,2804,-314,0.4734886862546437
55979,UTICA,MN,0,12,12,1
55981,WABASHA,MN,2278,1966,-312,0.4632422243166824
55983,WANAMINGO,MN,440,341,-99,0.43661971830985913
55985,WEST CONCORD,MN,562,413,-149,0.4235897435897436
55987,WINONA,MN,16035,13160,-2875,0.45076211680082207
55990,WYKOFF,MN,87,27,-60,0.23684210526315788
55991,HAMMOND,MN,36,22,-14,0.3793103448275862
55991,ZUMBRO FALLS,MN,147,188,41,0.5611940298507463
55992,ZUMBROTA,MN,1758,1861,103,0.5142304504006632
56001,MANKATO,MN,44261,25015,-19246,0.36109186442635255
56002,MANKATO,MN,1595,1215,-380,0.43238434163701067
56003,MANKATO,MN,210,205,-5,0.4939759036144578
56003,NORTH MANKATO,MN,7207,5806,-1401,0.4461692153999846
56007,ALBERT LEA,MN,10650,9355,-1295,0.46763309172706824
56009,ALDEN,MN,131,171,40,0.5662251655629139
56010,AMBOY,MN,154,90,-64,0.36885245901639346
56011,BELLE PLAINE,MN,3033,3109,76,0.5061869098013676
56013,BLUE EARTH,MN,1875,1795,-80,0.4891008174386921
56014,BRICELYN,MN,69,51,-18,0.425
56016,CLARKS GROVE,MN,177,216,39,0.549618320610687
56017,CLEVELAND,MN,413,394,-19,0.4882280049566295
56019,COMFREY,MN,73,12,-61,0.1411764705882353
56021,COURTLAND,MN,39,92,53,0.7022900763358778
56021,FARIBAULT,MN,12,0,-12,0
56024,EAGLE LAKE,MN,1597,1293,-304,0.44740484429065747
56026,ELLENDALE,MN,453,473,20,0.5107991360691144
56027,ELMORE,MN,104,115,11,0.5251141552511416
56028,ELYSIAN,MN,578,487,-91,0.4572769953051643
56029,EMMONS,MN,13,75,62,0.8522727272727273
56031,FAIRMONT,MN,6062,5277,-785,0.4653849545815328
56032,FREEBORN,MN,14,0,-14,0
56033,FROST,MN,12,0,-12,0
56034,GARDEN CITY,MN,12,131,119,0.916083916083916
56035,GENEVA,MN,11,11,0,0.5
56036,GLENVILLE,MN,144,144,0,0.5
56036,MYRTLE,MN,29,14,-15,0.32558139534883723
56037,GOOD THUNDER,MN,296,213,-83,0.41846758349705304
56039,GRANADA,MN,78,69,-9,0.46938775510204084
56041,HANSKA,MN,123,52,-71,0.29714285714285715
56042,HARTLAND,MN,24,0,-24,0
56043,HAYWARD,MN,0,11,11,1
56044,HENDERSON,MN,488,389,-99,0.443557582668187
56045,HOLLANDALE,MN,13,15,2,0.5357142857142857
56048,JANESVILLE,MN,1419,1267,-152,0.47170513775130307
56050,KASOTA,MN,567,405,-162,0.4166666666666667
56051,KIESTER,MN,87,11,-76,0.11224489795918367
56052,KILKENNY,MN,69,22,-47,0.24175824175824176
56054,LAFAYETTE,MN,24,70,46,0.7446808510638298
56055,LAKE CRYSTAL,MN,1848,1193,-655,0.39230516277540284
56057,LE CENTER,MN,1167,988,-179,0.45846867749419956
56058,LE SUEUR,MN,2612,2277,-335,0.46573941501329513
56060,LEWISVILLE,MN,35,0,-35,0
56062,MADELIA,MN,1142,1056,-86,0.48043676069153773
56063,MADISON LAKE,MN,1476,1254,-222,0.4593406593406593
56065,MAPLETON,MN,1071,880,-191,0.451050743208611
56068,MINNESOTA LAKE,MN,142,150,8,0.5136986301369864
56069,MONTGOMERY,MN,1880,1839,-41,0.4944877655283678
56071,NEW PRAGUE,MN,4196,4197,1,0.5000595734540688
56072,NEW RICHLAND,MN,765,592,-173,0.43625644804716285
56073,NEW ULM,MN,6582,5767,-815,0.4670013766296866
56074,NICOLLET,MN,594,386,-208,0.39387755102040817
56081,SAINT JAMES,MN,2475,2013,-462,0.4485294117647059
56082,SAINT PETER,MN,5168,4563,-605,0.46891378070085293
56083,SANBORN,MN,25,23,-2,0.4791666666666667
56085,SLEEPY EYE,MN,1706,1597,-109,0.4834998486224644
56087,SPRINGFIELD,MN,1318,1007,-311,0.43311827956989246
56088,TRUMAN,MN,745,646,-99,0.46441409058231486
56090,VERNON CENTER,MN,52,59,7,0.5315315315315315
56093,WASECA,MN,5470,4424,-1046,0.44713968061451387
56096,WATERVILLE,MN,1316,1092,-224,0.45348837209302323
56097,WALTERS,MN,29,19,-10,0.3958333333333333
56097,WELLS,MN,1369,1216,-153,0.4704061895551257
56098,WINNEBAGO,MN,817,742,-75,0.47594611930724823
56101,WINDOM,MN,2861,2266,-595,0.44197386385800663
56110,ADRIAN,MN,445,264,-181,0.3723554301833568
56114,AVOCA,MN,12,0,-12,0
56115,BALATON,MN,242,209,-33,0.4634146341463415
56116,BEAVER CREEK,MN,23,12,-11,0.34285714285714286
56118,BINGHAM LAKE,MN,15,0,-15,0
56119,BREWSTER,MN,108,40,-68,0.2702702702702703
56120,BUTTERFIELD,MN,213,37,-176,0.148
56121,CEYLON,MN,66,12,-54,0.15384615384615385
56122,CHANDLER,MN,49,11,-38,0.18333333333333332
56123,CURRIE,MN,28,0,-28,0
56128,EDGERTON,MN,326,244,-82,0.4280701754385965
56129,ELLSWORTH,MN,15,85,70,0.85
56131,DUNDEE,MN,15,0,-15,0
56131,FULDA,MN,686,666,-20,0.492603550295858
56131,KINBRAE,MN,26,0,-26,0
56132,GARVIN,MN,12,13,1,0.52
56134,HARDWICK,MN,0,11,11,1
56136,HENDRICKS,MN,264,233,-31,0.4688128772635815
56137,HERON LAKE,MN,144,136,-8,0.4857142857142857
56138,HILLS,MN,47,84,37,0.6412213740458015
56142,IVANHOE,MN,106,86,-20,0.4479166666666667
56143,JACKSON,MN,2113,1708,-405,0.4470034022507197
56144,JASPER,MN,214,114,-100,0.3475609756097561
56144,TROSKY,MN,13,12,-1,0.48
56145,JEFFERS,MN,75,36,-39,0.32432432432432434
56149,LAKE BENTON,MN,357,242,-115,0.4040066777963272
56150,LAKEFIELD,MN,978,740,-238,0.4307334109429569
56151,LAKE WILSON,MN,38,0,-38,0
56152,LAMBERTON,MN,459,301,-158,0.3960526315789474
56156,LUVERNE,MN,2343,2184,-159,0.4824387011265739
56157,LYND,MN,39,11,-28,0.22
56158,MAGNOLIA,MN,0,11,11,1
56159,MOUNTAIN LAKE,MN,1396,1058,-338,0.4311328443357783
56161,OKABENA,MN,13,0,-13,0
56164,PIPESTONE,MN,3123,2668,-455,0.46071490243481267
56166,REVERE,MN,12,0,-12,0
56167,ROUND LAKE,MN,15,15,0,0.5
56168,RUSHMORE,MN,13,39,26,0.75
56169,RUSSELL,MN,52,11,-41,0.1746031746031746
56170,RUTHTON,MN,23,0,-23,0
56171,SHERBURN,MN,405,390,-15,0.49056603773584906
56172,SLAYTON,MN,1382,1085,-297,0.4398054316984191
56174,STORDEN,MN,11,0,-11,0
56175,TRACY,MN,1381,1220,-161,0.46905036524413685
56176,TRIMONT,MN,89,76,-13,0.46060606060606063
56178,TYLER,MN,411,366,-45,0.47104247104247104
56180,WALNUT GROVE,MN,266,166,-100,0.38425925925925924
56181,WELCOME,MN,325,166,-159,0.3380855397148676
56183,WESTBROOK,MN,402,374,-28,0.48195876288659795
56185,WILMONT,MN,12,0,-12,0
56187,WORTHINGTON,MN,6817,4890,-1927,0.41769881267617665
56201,WILLMAR,MN,13983,12509,-1474,0.4721802808394987
56208,APPLETON,MN,1122,895,-227,0.443728309370352
56209,ATWATER,MN,776,689,-87,0.47030716723549487
56211,BEARDSLEY,MN,12,0,-12,0
56212,BELLINGHAM,MN,23,0,-23,0
56214,BELVIEW,MN,15,12,-3,0.4444444444444444
56215,BENSON,MN,2154,1947,-207,0.4747622531089978
56216,BLOMKEST,MN,26,24,-2,0.48
56216,SVEA,MN,0,14,14,1
56218,BOYD,MN,13,0,-13,0
56219,BROWNS VALLEY,MN,296,164,-132,0.3565217391304348
56220,CANBY,MN,1040,1002,-38,0.49069539666993145
56221,CHOKIO,MN,75,11,-64,0.12790697674418605
56222,CLARA CITY,MN,627,518,-109,0.4524017467248908
56223,CLARKFIELD,MN,338,222,-116,0.3964285714285714
56225,CLINTON,MN,148,46,-102,0.23711340206185566
56228,COSMOS,MN,140,35,-105,0.2
56229,COTTONWOOD,MN,472,528,56,0.528
56230,DANUBE,MN,166,35,-131,0.17412935323383086
56232,DAWSON,MN,691,639,-52,0.48045112781954885
56236,JOHNSON,MN,11,0,-11,0
56237,ECHO,MN,22,13,-9,0.37142857142857144
56239,GHENT,MN,12,25,13,0.6756756756756757
56240,GRACEVILLE,MN,105,63,-42,0.375
56241,GRANITE FALLS,MN,1745,1628,-117,0.48265638897124225
56243,GROVE CITY,MN,365,313,-52,0.4616519174041298
56244,HANCOCK,MN,264,197,-67,0.42733188720173537
56245,HANLEY FALLS,MN,11,11,0,0.5
56248,HERMAN,MN,126,22,-104,0.14864864864864866
56251,KANDIYOHI,MN,106,69,-37,0.3942857142857143
56252,KERKHOVEN,MN,277,130,-147,0.3194103194103194
56253,LAKE LILLIAN,MN,106,35,-71,0.24822695035460993
56255,LUCAN,MN,12,0,-12,0
56256,MADISON,MN,1145,878,-267,0.43400889767671774
56257,MARIETTA,MN,152,64,-88,0.2962962962962963
56258,MARSHALL,MN,8919,6970,-1949,0.43866826106111145
56260,MAYNARD,MN,60,33,-27,0.3548387096774194
56262,MILAN,MN,13,0,-13,0
56263,MILROY,MN,30,0,-30,0
56264,MINNEAPOLIS,MN,17,0,-17,0
56264,MINNEOTA,MN,651,327,-324,0.3343558282208589
56264,SAINT LEO,MN,13,0,-13,0
56265,MONTEVIDEO,MN,3317,2855,-462,0.46257290991574856
56266,MORGAN,MN,457,213,-244,0.31791044776119404
56267,MORRIS,MN,3353,2392,-961,0.4163620539599652
56270,MORTON,MN,190,132,-58,0.40993788819875776
56271,DE GRAFF,MN,42,41,-1,0.4939759036144578
56271,MURDOCK,MN,155,36,-119,0.18848167539267016
56273,HAWICK,MN,61,70,9,0.5343511450381679
56273,NEW LONDON,MN,1813,1794,-19,0.4973662323260327
56277,OLIVIA,MN,1463,1276,-187,0.46586345381526106
56278,ORTONVILLE,MN,1239,1118,-121,0.474331777683496
56279,PENNOCK,MN,83,91,8,0.5229885057471264
56280,PORTER,MN,12,0,-12,0
56281,PRINSBURG,MN,38,23,-15,0.3770491803278688
56282,RAYMOND,MN,136,146,10,0.5177304964539007
56283,REDWOOD FALLS,MN,2946,2596,-350,0.468422952002887
56284,RENVILLE,MN,471,430,-41,0.4772475027746948
56285,SACRED HEART,MN,110,71,-39,0.39226519337016574
56288,SPICER,MN,2612,2344,-268,0.47296206618240516
56289,SUNBURG,MN,0,15,15,1
56292,VESTA,MN,22,0,-22,0
56293,WABASSO,MN,115,80,-35,0.41025641025641024
56296,WHEATON,MN,891,666,-225,0.4277456647398844
56297,WOOD LAKE,MN,168,34,-134,0.16831683168316833
56301,SAINT AUGUSTA,MN,403,486,83,0.5466816647919011
56301,SAINT CLOUD,MN,21143,16981,-4162,0.44541496170391354
56301,ST CLOUD,MN,463,388,-75,0.45593419506462984
56302,SAINT CLOUD,MN,1162,1325,163,0.5327704061117813
56303,SAINT CLOUD,MN,15847,13614,-2233,0.4621024405145786
56304,SAINT CLOUD,MN,11282,9689,-1593,0.4620189785894807
56307,ALBANY,MN,1266,1304,38,0.5073929961089494
56308,ALEXANDRIA,MN,14887,13655,-1232,0.47841777030341254
56309,ASHBY,MN,381,244,-137,0.3904
56310,AVON,MN,1318,1355,37,0.5069210624766181
56311,BARRETT,MN,24,68,44,0.7391304347826086
56312,BELGRADE,MN,761,599,-162,0.4404411764705882
56314,BOWLUS,MN,43,54,11,0.5567010309278351
56315,BRANDON,MN,723,513,-210,0.41504854368932037
56316,BROOTEN,MN,484,448,-36,0.48068669527896996
56318,BURTRUM,MN,196,202,6,0.507537688442211
56319,CARLOS,MN,231,323,92,0.5830324909747292
56320,COLD SPRING,MN,2743,2763,20,0.5018162005085361
56323,CYRUS,MN,24,0,-24,0
56324,DALTON,MN,256,165,-91,0.3919239904988123
56326,EVANSVILLE,MN,371,307,-64,0.4528023598820059
56327,FARWELL,MN,45,46,1,0.5054945054945055
56329,FOLEY,MN,2227,2051,-176,0.4794296400187003
56330,FORESTON,MN,383,441,58,0.5351941747572816
56331,FREEPORT,MN,198,192,-6,0.49230769230769234
56332,GARFIELD,MN,268,310,42,0.5363321799307958
56334,GLENWOOD,MN,2970,2702,-268,0.4763751763046544
56334,LONG BEACH,MN,46,38,-8,0.4523809523809524
56336,GREY EAGLE,MN,482,425,-57,0.4685777287761852
56338,HILLMAN,MN,433,335,-98,0.4361979166666667
56339,HOFFMAN,MN,253,224,-29,0.469601677148847
56340,HOLDINGFORD,MN,449,357,-92,0.44292803970223327
56342,ISLE,MN,1889,1622,-267,0.46197664483053263
56343,KENSINGTON,MN,78,33,-45,0.2972972972972973
56345,LITTLE FALLS,MN,6065,5762,-303,0.487190327217384
56347,LONG PRAIRIE,MN,2533,2227,-306,0.46785714285714286
56349,LOWRY,MN,85,37,-48,0.30327868852459017
56350,MC GRATH,MN,12,16,4,0.5714285714285714
56352,MELROSE,MN,1552,1389,-163,0.472288337300238
56353,MILACA,MN,3617,3771,154,0.5104223064428803
56354,MILTONA,MN,485,440,-45,0.4756756756756757
56355,NELSON,MN,12,0,-12,0
56356,NEW MUNICH,MN,13,0,-13,0
56357,FOLEY,MN,0,12,12,1
56357,OAK PARK,MN,13,38,25,0.7450980392156863
56358,OGILVIE,MN,1281,1160,-121,0.4752150757886112
56359,ONAMIA,MN,2263,1961,-302,0.4642518939393939
56360,OSAKIS,MN,1734,1648,-86,0.4872856298048492
56361,PARKERS PRAIRIE,MN,913,801,-112,0.46732788798133024
56362,PAYNESVILLE,MN,2471,2380,-91,0.4906204906204906
56364,PIERZ,MN,1662,1600,-62,0.49049662783568365
56367,RICE,MN,2035,2030,-5,0.4993849938499385
56368,RICHMOND,MN,1730,1496,-234,0.46373217606943584
56369,ROCHESTER,MN,11,0,-11,0
56369,ROCKVILLE,MN,465,24,-441,0.049079754601226995
56373,ROYALTON,MN,905,834,-71,0.4795859689476711
56374,SAINT JOSEPH,MN,2970,3058,88,0.5072992700729927
56375,SAINT STEPHEN,MN,37,41,4,0.5256410256410257
56376,SAINT MARTIN,MN,12,0,-12,0
56377,SARTELL,MN,8554,8715,161,0.5046615322253749
56378,SAUK CENTRE,MN,3429,3056,-373,0.4712413261372398
56379,SAUK RAPIDS,MN,7810,7099,-711,0.47615534241062446
56381,STARBUCK,MN,1082,973,-109,0.4734793187347932
56382,SWANVILLE,MN,49,115,66,0.7012195121951219
56385,VILLARD,MN,158,98,-60,0.3828125
56386,WAHKON,MN,445,338,-107,0.43167305236270753
56387,WAITE PARK,MN,6125,4936,-1189,0.44625259922249344
56401,BRAINERD,MN,16239,14834,-1405,0.4773919479934348
56425,BAXTER,MN,4158,4000,-158,0.49031625398381956
56431,AITKIN,MN,5293,4750,-543,0.47296624514587277
56433,AKELEY,MN,833,822,-11,0.49667673716012084
56435,BACKUS,MN,1424,1344,-80,0.48554913294797686
56437,BERTHA,MN,270,143,-127,0.34624697336561744
56438,BROWERVILLE,MN,1080,967,-113,0.47239863214460187
56440,CLARISSA,MN,320,246,-74,0.43462897526501765
56441,CROSBY,MN,1887,1602,-285,0.4591573516766982
56442,CROSSLAKE,MN,3406,3257,-149,0.48881885036770223
56443,CUSHING,MN,635,600,-35,0.48582995951417
56444,DEERWOOD,MN,2023,1965,-58,0.49272818455366096
56446,EAGLE BEND,MN,375,341,-34,0.4762569832402235
56447,EMILY,MN,877,584,-293,0.3997262149212868
56448,FIFTY LAKES,MN,266,304,38,0.5333333333333333
56449,FORT RIPLEY,MN,327,357,30,0.5219298245614035
56450,GARRISON,MN,883,861,-22,0.49369266055045874
56452,HACKENSACK,MN,2062,2042,-20,0.4975633528265107
56453,HEWITT,MN,37,44,7,0.5432098765432098
56455,IRONTON,MN,814,579,-235,0.41564967695620963
56458,LAKE GEORGE,MN,111,32,-79,0.22377622377622378
56461,LAPORTE,MN,1392,1446,54,0.5095137420718816
56464,MENAHGA,MN,1983,1828,-155,0.47966413014956705
56465,MERRIFIELD,MN,1301,1454,153,0.5277676950998185
56466,MOTLEY,MN,1583,1491,-92,0.4850357839947951
56467,NEVIS,MN,1881,1689,-192,0.473109243697479
56468,LAKE SHORE,MN,361,355,-6,0.4958100558659218
56468,NISSWA,MN,3192,2952,-240,0.48046875
56469,PALISADE,MN,363,402,39,0.5254901960784314
56470,PARK RAPIDS,MN,7221,6802,-419,0.4850602581473294
56472,BREEZY POINT,MN,176,344,168,0.6615384615384615
56472,PEQUOT LAKES,MN,5285,5158,-127,0.49391937182801876
56473,PILLAGER,MN,1481,1519,38,0.5063333333333333
56474,JENKINS,MN,136,252,116,0.6494845360824743
56474,PINE RIVER,MN,2295,2165,-130,0.4854260089686099
56475,RANDALL,MN,396,348,-48,0.46774193548387094
56477,SEBEKA,MN,1073,950,-123,0.46959960454770144
56479,STAPLES,MN,2653,2543,-110,0.48941493456505003
56481,VERNDALE,MN,524,462,-62,0.4685598377281947
56482,WADENA,MN,3587,3286,-301,0.47810272079150296
56484,WALKER,MN,2763,2584,-179,0.4832616420422667
56501,DETROIT LAKES,MN,9455,8906,-549,0.4850498338870432
56502,DETROIT LAKES,MN,706,469,-237,0.39914893617021274
56510,ADA,MN,809,698,-111,0.46317186463171867
56511,AUDUBON,MN,980,945,-35,0.4909090909090909
56514,BARNESVILLE,MN,1047,1184,137,0.5307037203047961
56515,BATTLE LAKE,MN,2331,2207,-124,0.4863375936535919
56516,BEJOU,MN,11,12,1,0.5217391304347826
56520,BRECKENRIDGE,MN,1703,1575,-128,0.4804758999389872
56521,CALLAWAY,MN,11,46,35,0.8070175438596491
56522,CAMPBELL,MN,13,0,-13,0
56524,CLITHERALL,MN,339,351,12,0.508695652173913
56527,DEER CREEK,MN,172,146,-26,0.4591194968553459
56528,DENT,MN,992,1065,73,0.5177442877977637
56529,DILWORTH,MN,2053,1949,-104,0.48700649675162416
56531,ELBOW LAKE,MN,830,796,-34,0.48954489544895446
56534,ERHARD,MN,146,172,26,0.5408805031446541
56535,ERSKINE,MN,456,363,-93,0.4432234432234432
56537,FERGUS FALLS,MN,8514,8102,-412,0.4876023110255176
56538,FERGUS FALLS,MN,62,102,40,0.6219512195121951
56540,FERTILE,MN,597,576,-21,0.49104859335038364
56542,FOSSTON,MN,1134,966,-168,0.46
56544,FRAZEE,MN,2455,2178,-277,0.4701057630045327
56547,GLYNDON,MN,892,786,-106,0.4684147794994041
56548,HALSTAD,MN,143,81,-62,0.36160714285714285
56549,HAWLEY,MN,1263,1192,-71,0.4855397148676171
56550,HENDRUM,MN,12,13,1,0.52
56551,HENNING,MN,1014,979,-35,0.49121926743602606
56552,HITTERDAL,MN,11,0,-11,0
56554,LAKE PARK,MN,1252,1146,-106,0.4778982485404504
56556,MCINTOSH,MN,141,46,-95,0.24598930481283424
56557,MAHNOMEN,MN,1264,930,-334,0.4238833181403829
56560,MOORHEAD,MN,24407,20510,-3897,0.45661998797782577
56561,MOORHEAD,MN,834,393,-441,0.3202933985330073
56566,NAYTAHWAUSH,MN,105,49,-56,0.3181818181818182
56567,NEW YORK MILLS,MN,1194,1099,-95,0.4792847797645007
56569,OGEMA,MN,252,206,-46,0.4497816593886463
56570,OSAGE,MN,345,437,92,0.5588235294117647
56571,OTTERTAIL,MN,1527,1327,-200,0.4649614576033637
56572,PEL RAPIDS,MN,49,48,-1,0.4948453608247423
56572,PELICAN RAPIDS,MN,2931,2629,-302,0.47284172661870505
56573,PERHAM,MN,3850,3526,-324,0.4780368763557484
56574,PERLEY,MN,11,0,-11,0
56575,PONSFORD,MN,149,135,-14,0.4753521126760563
56576,RICHVILLE,MN,544,466,-78,0.4613861386138614
56578,ROCHERT,MN,123,146,23,0.5427509293680297
56579,ROTHSAY,MN,35,35,0,0.5
56580,BAKER,MN,11,0,-11,0
56580,SABIN,MN,25,37,12,0.5967741935483871
56584,TWIN VALLEY,MN,419,329,-90,0.43983957219251335
56585,ULEN,MN,23,80,57,0.7766990291262136
56586,UNDERWOOD,MN,623,646,23,0.5090622537431048
56587,VERGAS,MN,751,760,9,0.5029781601588352
56588,VINING,MN,79,83,4,0.5123456790123457
56589,WAUBUN,MN,1400,446,-954,0.24160346695557963
56601,BEMIDJI,MN,16181,14494,-1687,0.47250203748981257
56619,BEMIDJI,MN,1274,792,-482,0.38334946757018395
56621,BAGLEY,MN,1657,1577,-80,0.4876314162028448
56623,BAUDETTE,MN,1685,1465,-220,0.4650793650793651
56626,BENA,MN,91,76,-15,0.4550898203592814
56627,BIG FALLS,MN,11,0,-11,0
56628,BIGFORK,MN,929,881,-48,0.4867403314917127
56630,BLACKDUCK,MN,927,920,-7,0.49810503519220356
56633,CASS LAKE,MN,2950,2099,-851,0.4157258863141216
56634,CLEARBROOK,MN,358,383,25,0.5168690958164642
56636,DEER RIVER,MN,2072,2113,41,0.5048984468339307
56639,EFFIE,MN,72,43,-29,0.3739130434782609
56641,FEDERAL DAM,MN,47,51,4,0.5204081632653061
56644,GONVICK,MN,89,95,6,0.5163043478260869
56647,HINES,MN,40,11,-29,0.21568627450980393
56649,INTERNATIONAL FALLS,MN,4895,3918,-977,0.44457052082151366
56649,INTL FALLS,MN,104,69,-35,0.3988439306358382
56650,KELLIHER,MN,38,63,25,0.6237623762376238
56650,SAUM,MN,18,11,-7,0.3793103448275862
56651,LENGBY,MN,71,24,-47,0.25263157894736843
56652,LEONARD,MN,24,28,4,0.5384615384615384
56653,LITTLEFORK,MN,242,132,-110,0.35294117647058826
56655,LONGVILLE,MN,1321,1385,64,0.5118255728011826
56657,MARCELL,MN,191,207,16,0.5201005025125628
56661,NORTHOME,MN,175,199,24,0.5320855614973262
56662,OUTING,MN,313,302,-11,0.49105691056910566
56668,RANIER,MN,46,92,46,0.6666666666666666
56669,KABETOGAMA,MN,80,138,58,0.6330275229357798
56669,RAY,MN,0,38,38,1
56670,REDBY,MN,24,0,-24,0
56671,REDLAKE,MN,187,111,-76,0.3724832214765101
56672,REMER,MN,1128,1006,-122,0.47141518275538896
56673,ROOSEVELT,MN,0,36,36,1
56676,PINEWOOD,MN,22,11,-11,0.3333333333333333
56676,SHEVLIN,MN,325,378,53,0.5376955903271693
56678,BECIDA,MN,14,45,31,0.7627118644067796
56678,SOLWAY,MN,74,111,37,0.6
56683,TENSTRIKE,MN,69,33,-36,0.3235294117647059
56686,WILLIAMS,MN,97,107,10,0.5245098039215687
56701,THIEF RIVER FALLS,MN,5601,4881,-720,0.4656554092730395
56701,THIEF RVR FLS,MN,213,190,-23,0.47146401985111663
56711,ANGLE INLET,MN,0,13,13,1
56713,ARGYLE,MN,76,11,-65,0.12643678160919541
56714,BADGER,MN,129,135,6,0.5113636363636364
56715,BROOKS,MN,11,0,-11,0
56716,CROOKSTON,MN,4465,3707,-758,0.45362212432697013
56721,E GRAND FORKS,MN,327,238,-89,0.42123893805309737
56721,EAST GRAND FORKS,MN,5288,3833,-1455,0.42023900888060517
56723,FISHER,MN,70,39,-31,0.3577981651376147
56725,GOODRIDGE,MN,11,12,1,0.5217391304347826
56726,GREENBUSH,MN,264,179,-85,0.4040632054176072
56727,GRYGLA,MN,23,0,-23,0
56728,HALLOCK,MN,364,135,-229,0.27054108216432865
56732,KARLSTAD,MN,352,162,-190,0.3151750972762646
56735,LANCASTER,MN,0,11,11,1
56736,MENTOR,MN,371,216,-155,0.3679727427597956
56737,MIDDLE RIVER,MN,0,35,35,1
56738,NEWFOLDEN,MN,62,90,28,0.5921052631578947
56742,OKLEE,MN,37,53,16,0.5888888888888889
56744,OSLO,MN,78,23,-55,0.22772277227722773
56750,RED LAKE FALLS,MN,888,745,-143,0.45621555419473364
56751,ROSEAU,MN,2058,1919,-139,0.4825245159668092
56754,SAINT HILAIRE,MN,13,11,-2,0.4583333333333333
56756,SALOL,MN,13,35,22,0.7291666666666666
56757,STEPHEN,MN,48,12,-36,0.2
56760,VIKING,MN,12,0,-12,0
56762,ANGUS,MN,19,14,-5,0.42424242424242425
56762,WARREN,MN,988,808,-180,0.44988864142538976
56763,WARROAD,MN,2095,1845,-250,0.4682741116751269
57001,ALCESTER,SD,512,379,-133,0.42536475869809204
57002,AURORA,SD,335,390,55,0.5379310344827586
57003,BALTIC,SD,640,670,30,0.5114503816793893
57004,BERESFORD,SD,1180,1156,-24,0.4948630136986301
57005,BRANDON,SD,4598,4536,-62,0.49660608714692356
57006,BROOKINGS,SD,14322,10699,-3623,0.4276008153151353
57012,CANISTOTA,SD,271,224,-47,0.45252525252525255
57013,CANTON,SD,1714,1523,-191,0.47049737411183196
57014,CENTERVILLE,SD,268,234,-34,0.46613545816733065
57015,CHANCELLOR,SD,12,13,1,0.52
57016,CHESTER,SD,115,28,-87,0.1958041958041958
57017,COLMAN,SD,210,162,-48,0.43548387096774194
57018,COLTON,SD,160,147,-13,0.4788273615635179
57020,CROOKS,SD,214,233,19,0.5212527964205816
57022,DELL RAPIDS,SD,1835,1641,-194,0.47209436133486765
57025,ELK,SD,28,16,-12,0.36363636363636365
57025,ELK POINT,SD,1243,1017,-226,0.45
57026,ELKTON,SD,332,170,-162,0.3386454183266932
57026,WARD,SD,32,18,-14,0.36
57028,FLANDREAU,SD,1267,1086,-181,0.46153846153846156
57029,FREEMAN,SD,565,629,64,0.5268006700167505
57030,GARRETSON,SD,826,798,-28,0.49137931034482757
57030,SHERMAN,SD,69,79,10,0.5337837837837838
57031,GAYVILLE,SD,12,0,-12,0
57032,HARRISBURG,SD,3326,3716,390,0.5276909968758875
57033,HARTFORD,SD,1925,1858,-67,0.4911445942373777
57034,HUDSON,SD,24,16,-8,0.4
57035,HUMBOLDT,SD,78,116,38,0.5979381443298969
57036,HURLEY,SD,38,27,-11,0.4153846153846154
57037,IRENE,SD,39,48,9,0.5517241379310345
57038,JEFFERSON,SD,362,404,42,0.5274151436031331
57039,LENNOX,SD,1188,1176,-12,0.49746192893401014
57042,MADISON,SD,5257,3391,-1866,0.392113783533765
57043,MARION,SD,225,179,-46,0.4430693069306931
57045,MENNO,SD,106,27,-79,0.20300751879699247
57046,MISSION HILL,SD,41,42,1,0.5060240963855421
57048,MONTROSE,SD,49,55,6,0.5288461538461539
57049,N SIOUX CITY,SD,656,564,-92,0.46229508196721314
57049,NORTH SIOUX CITY,SD,3429,3034,-395,0.46944143586569703
57052,OLIVET,SD,12,12,0,0.5
57053,PARKER,SD,361,473,112,0.5671462829736211
57054,RAMONA,SD,11,0,-11,0
57055,RENNER,SD,112,61,-51,0.35260115606936415
57058,SALEM,SD,857,645,-212,0.42942743009320905
57059,SCOTLAND,SD,160,215,55,0.5733333333333334
57062,SPRINGFIELD,SD,174,281,107,0.6175824175824176
57063,TABOR,SD,15,12,-3,0.4444444444444444
57064,TEA,SD,3043,3376,333,0.5259386197226983
57065,TRENT,SD,0,11,11,1
57066,TYNDALL,SD,279,319,40,0.5334448160535117
57067,UTICA,SD,23,0,-23,0
57068,VALLEY SPGS,SD,39,18,-21,0.3157894736842105
57068,VALLEY SPRINGS,SD,351,310,-41,0.4689863842662632
57069,VERMILLION,SD,8019,5650,-2369,0.41334406320872047
57070,VIBORG,SD,169,88,-81,0.3424124513618677
57071,VOLGA,SD,1111,1047,-64,0.48517145505097314
57072,VOLIN,SD,0,12,12,1
57073,WAKONDA,SD,11,38,27,0.7755102040816326
57075,WENTWORTH,SD,384,292,-92,0.4319526627218935
57076,WINFRED,SD,0,13,13,1
57077,WORTHING,SD,103,175,72,0.6294964028776978
57078,YANKTON,SD,11334,9484,-1850,0.4555672975309828
57101,SIOUX FALLS,SD,1615,1818,203,0.5295659772793475
57103,SIOUX FALLS,SD,20907,17601,-3306,0.4570738547834216
57104,SIOUX FALLS,SD,22584,18896,-3688,0.45554484088717456
57105,SIOUX FALLS,SD,12937,9914,-3023,0.43385409828891514
57106,SIOUX FALLS,SD,27577,23031,-4546,0.4550861523869744
57107,SIOUX FALLS,SD,5568,5861,293,0.5128182693149007
57108,SIOUX FALLS,SD,18675,18485,-190,0.49744348762109797
57109,SIOUX FALLS,SD,993,1281,288,0.5633245382585752
57110,SIOUX FALLS,SD,10412,11635,1223,0.5277361999364993
57117,SIOUX FALLS,SD,51,203,152,0.7992125984251969
57201,WATERTOWN,SD,14147,11887,-2260,0.45659522163324884
57212,ARLINGTON,SD,778,768,-10,0.49676584734799484
57213,ASTORIA,SD,11,0,-11,0
57216,BIG STONE CITY,SD,445,163,-282,0.2680921052631579
57219,BRISTOL,SD,0,12,12,1
57220,BRUCE,SD,53,11,-42,0.171875
57221,BRYANT,SD,171,130,-41,0.4318936877076412
57223,CASTLEWOOD,SD,157,139,-18,0.46959459459459457
57225,CLARK,SD,621,572,-49,0.47946353730092206
57226,ALTAMONT,SD,11,11,0,0.5
57226,CLEAR LAKE,SD,673,573,-100,0.45987158908507225
57231,DE SMET,SD,557,422,-135,0.4310520939734423
57234,ESTELLINE,SD,384,251,-133,0.3952755905511811
57235,FLORENCE,SD,23,13,-10,0.3611111111111111
57237,GARY,SD,123,79,-44,0.3910891089108911
57239,GRENVILLE,SD,35,12,-23,0.2553191489361702
57241,HAYTI,SD,50,22,-28,0.3055555555555556
57247,LAKE CITY,SD,23,12,-11,0.34285714285714286
57248,LAKE NORDEN,SD,604,462,-142,0.4333958724202627
57249,LAKE PRESTON,SD,74,87,13,0.5403726708074534
57252,MILBANK,SD,2380,1906,-474,0.4447036864209053
57255,NEW EFFINGTON,SD,11,0,-11,0
57260,ROSHOLT,SD,233,72,-161,0.2360655737704918
57262,SISSETON,SD,2106,1754,-352,0.4544041450777202
57266,SUMMIT,SD,13,0,-13,0
57270,VEBLEN,SD,23,16,-7,0.41025641025641024
57273,WAUBAY,SD,289,196,-93,0.4041237113402062
57274,WEBSTER,SD,1156,971,-185,0.45651151857075695
57276,BUSHNELL,SD,24,11,-13,0.3142857142857143
57276,WHITE,SD,73,72,-1,0.496551724137931
57278,WILLOW LAKE,SD,51,16,-35,0.23880597014925373
57279,WILMOT,SD,134,117,-17,0.46613545816733065
57301,MITCHELL,SD,11431,8405,-3026,0.42372454123815284
57311,ALEXANDRIA,SD,11,12,1,0.5217391304347826
57312,ALPENA,SD,0,23,23,1
57313,ARMOUR,SD,46,0,-46,0
57315,AVON,SD,37,38,1,0.5066666666666667
57319,BRIDGEWATER,SD,193,200,7,0.5089058524173028
57319,DOLTON,SD,11,0,-11,0
57323,CARTHAGE,SD,11,0,-11,0
57325,CHAMBERLAIN,SD,1455,1156,-299,0.44274224435082343
57328,CORSICA,SD,66,15,-51,0.18518518518518517
57330,DELMONT,SD,11,0,-11,0
57332,EMERY,SD,0,739,739,1
57334,ETHAN,SD,13,11,-2,0.4583333333333333
57339,FORT THOMPSON,SD,232,95,-137,0.290519877675841
57342,GEDDES,SD,0,13,13,1
57345,HIGHMORE,SD,192,116,-76,0.37662337662337664
57348,HITCHCOCK,SD,11,0,-11,0
57349,HOWARD,SD,403,342,-61,0.4590604026845638
57350,HURON,SD,8265,7140,-1125,0.4634858812074002
57353,BANCROFT,SD,0,26,26,1
57353,IROQUOIS,SD,54,34,-20,0.38636363636363635
57355,KIMBALL,SD,46,51,5,0.5257731958762887
57356,LAKE ANDES,SD,358,211,-147,0.37082601054481545
57356,RAVINIA,SD,15,0,-15,0
57359,LETCHER,SD,0,22,22,1
57362,MILLER,SD,805,684,-121,0.45936870382807254
57363,MOUNT VERNON,SD,73,40,-33,0.35398230088495575
57365,OACOMA,SD,11,11,0,0.5
57366,PARKSTON,SD,586,571,-15,0.49351771823681934
57368,PLANKINTON,SD,241,109,-132,0.31142857142857144
57369,PLATTE,SD,305,438,133,0.5895020188425303
57370,PUKWANA,SD,26,25,-1,0.49019607843137253
57375,STICKNEY,SD,24,12,-12,0.3333333333333333
57376,TRIPP,SD,164,52,-112,0.24074074074074073
57380,WAGNER,SD,1165,1075,-90,0.4799107142857143
57382,WESSINGTN SPG,SD,16,0,-16,0
57382,WESSINGTON SPRINGS,SD,392,222,-170,0.36156351791530944
57383,WHITE LAKE,SD,34,0,-34,0
57384,WOLSEY,SD,25,12,-13,0.32432432432432434
57385,WOONSOCKET,SD,156,178,22,0.5329341317365269
57401,ABERDEEN,SD,18139,14097,-4042,0.43730611738429087
57402,ABERDEEN,SD,267,256,-11,0.4894837476099426
57428,BOWDLE,SD,11,11,0,0.5
57430,BRITTON,SD,515,446,-69,0.46409989594172735
57436,DOLAND,SD,27,0,-27,0
57437,EUREKA,SD,259,195,-64,0.42951541850220265
57438,FAULKTON,SD,164,95,-69,0.3667953667953668
57438,WECOTA,SD,15,23,8,0.6052631578947368
57441,FREDERICK,SD,48,67,19,0.5826086956521739
57442,GETTYSBURG,SD,547,344,-203,0.38608305274971944
57445,GROTON,SD,692,559,-133,0.44684252597921664
57446,HECLA,SD,18,12,-6,0.4
57448,HOSMER,SD,11,22,11,0.6666666666666666
57450,HOVEN,SD,11,0,-11,0
57451,IPSWICH,SD,195,180,-15,0.48
57451,MINA,SD,287,286,-1,0.49912739965095987
57456,LEOLA,SD,39,15,-24,0.2777777777777778
57457,LONG LAKE,SD,0,12,12,1
57461,MELLETTE,SD,0,11,11,1
57468,PIERPONT,SD,12,0,-12,0
57469,REDFIELD,SD,1635,1354,-281,0.45299431247909
57470,ROCKHAM,SD,0,12,12,1
57471,ROSCOE,SD,14,0,-14,0
57472,SELBY,SD,202,51,-151,0.2015810276679842
57501,PIERRE,SD,7360,6963,-397,0.48614117154227465
57522,BLUNT,SD,11,11,0,0.5
57523,BURKE,SD,86,74,-12,0.4625
57528,COLOME,SD,61,51,-10,0.45535714285714285
57532,FORT PIERRE,SD,1348,1234,-114,0.47792408985282725
57533,GREGORY,SD,380,432,52,0.5320197044334976
57533,IONA,SD,48,35,-13,0.42168674698795183
57543,KADOKA,SD,12,0,-12,0
57548,LOWER BRULE,SD,200,104,-96,0.34210526315789475
57551,MARTIN,SD,248,99,-149,0.28530259365994237
57555,MISSION,SD,1547,730,-817,0.32059727711901626
57564,ONIDA,SD,82,74,-8,0.47435897435897434
57567,PHILIP,SD,101,92,-9,0.47668393782383417
57568,PRESHO,SD,12,0,-12,0
57570,ROSEBUD,SD,323,337,14,0.5106060606060606
57572,SAINT FRANCIS,SD,39,18,-21,0.3157894736842105
57577,WANBLEE,SD,11,11,0,0.5
57579,WHITE RIVER,SD,30,0,-30,0
57580,CARTER,SD,33,36,3,0.5217391304347826
57580,WINNER,SD,1728,1353,-375,0.439143135345667
57601,MOBRIDGE,SD,1682,1315,-367,0.4387721054387721
57620,BISON,SD,11,0,-11,0
57623,DUPREE,SD,28,0,-28,0
57625,EAGLE BUTTE,SD,1223,478,-745,0.2810111699000588
57626,FAITH,SD,36,24,-12,0.4
57632,HERREID,SD,12,22,10,0.6470588235294118
57638,LEMMON,SD,776,637,-139,0.4508138711960368
57638,SHADEHILL,SD,16,13,-3,0.4482758620689655
57642,KENEL,SD,0,15,15,1
57642,MC LAUGHLIN,SD,221,180,-41,0.4488778054862843
57648,POLLOCK,SD,24,14,-10,0.3684210526315789
57701,RAPID CITY,SD,26838,22190,-4648,0.452598515134209
57702,RAPID CITY,SD,16334,15573,-761,0.48807471714670764
57703,RAPID CITY,SD,7191,7588,397,0.5134312199742879
57706,ELLSWORTH AFB,SD,2439,2850,411,0.5388542257515598
57709,RAPID CITY,SD,3163,2221,-942,0.412518573551263
57714,ALLEN,SD,30,0,-30,0
57717,BELLE FOURCHE,SD,4676,3877,-799,0.45329124283877004
57718,BLACK HAWK,SD,2440,2054,-386,0.45705384957721407
57718,SUMMERSET,SD,692,589,-103,0.4597970335675254
57719,BOX ELDER,SD,7272,13807,6535,0.6550120973480715
57720,BUFFALO,SD,105,44,-61,0.2953020134228188
57730,CUSTER,SD,3275,3359,84,0.5063310220078384
57732,DEADWOOD,SD,1604,1247,-357,0.4373903893370747
57735,ARDMORE,SD,0,18,18,1
57735,EDGEMONT,SD,509,546,37,0.5175355450236967
57744,HERMOSA,SD,926,1078,152,0.5379241516966068
57745,HILL CITY,SD,1265,1216,-49,0.49012494961708986
57747,HOT SPRINGS,SD,3527,3577,50,0.5035191441441441
57750,INTERIOR,SD,11,0,-11,0
57751,KEYSTONE,SD,267,315,48,0.5412371134020618
57752,KYLE,SD,71,29,-42,0.29
57754,CENTRAL CITY,SD,53,31,-22,0.36904761904761907
57754,LEAD,SD,2588,2031,-557,0.43970556397488636
57759,NEMO,SD,91,76,-15,0.4550898203592814
57760,NEWELL,SD,359,257,-102,0.4172077922077922
57761,NEW UNDERWOOD,SD,192,196,4,0.5051546391752577
57762,NISLAND,SD,11,12,1,0.5217391304347826
57769,PIEDMONT,SD,1544,1668,124,0.5193026151930261
57769,SUMMERSET,SD,138,144,6,0.5106382978723404
57770,PINE RIDGE,SD,303,230,-73,0.43151969981238275
57779,SAINT ONGE,SD,15,0,-15,0
57783,SPEARFISH,SD,9807,9106,-701,0.48146777348913444
57785,STURGIS,SD,4920,4577,-343,0.4819416657891966
57790,CREIGHTON,SD,12,0,-12,0
57790,WALL,SD,154,83,-71,0.350210970464135
57793,WHITEWOOD,SD,823,865,42,0.5124407582938388
58012,CASSELTON,ND,895,716,-179,0.4444444444444444
58018,COLFAX,ND,13,13,0,0.5
58027,ENDERLIN,ND,350,318,-32,0.47604790419161674
58030,FAIRMOUNT,ND,160,120,-40,0.42857142857142855
58032,FORMAN,ND,96,33,-63,0.2558139534883721
58033,ENGLEVALE,ND,24,0,-24,0
58035,GALESBURG,ND,0,23,23,1
58040,GWINNER,ND,323,295,-28,0.4773462783171521
58041,HANKINSON,ND,466,382,-84,0.45047169811320753
58042,GARDNER,ND,25,12,-13,0.32432432432432434
58042,HARWOOD,ND,119,96,-23,0.44651162790697674
58045,HILLSBORO,ND,955,694,-261,0.4208611279563372
58046,HOPE,ND,15,0,-15,0
58047,HICKSON,ND,97,149,52,0.6056910569105691
58047,HORACE,ND,1092,1675,583,0.6053487531622697
58047,OXBOW,ND,49,103,54,0.6776315789473685
58048,HUNTER,ND,24,24,0,0.5
58049,KATHRYN,ND,11,0,-11,0
58051,KINDRED,ND,182,324,142,0.6403162055335968
58052,LEONARD,ND,51,15,-36,0.22727272727272727
58053,LIDGERWOOD,ND,293,130,-163,0.3073286052009456
58054,LISBON,ND,1285,1195,-90,0.48185483870967744
58059,MAPLETON,ND,292,412,120,0.5852272727272727
58060,MILNOR,ND,275,156,-119,0.3619489559164733
58061,MOORETON,ND,13,12,-1,0.48
58064,PAGE,ND,12,0,-12,0
58072,VALLEY CITY,ND,4198,3316,-882,0.4413095554964067
58074,WAHPETON,ND,23,34,11,0.5964912280701754
58075,GREAT BEND,ND,90,95,5,0.5135135135135135
58075,WAHPETON,ND,4682,3753,-929,0.44493183165382333
58077,WALCOTT,ND,11,24,13,0.6857142857142857
58078,WEST FARGO,ND,21336,19795,-1541,0.48126717074712505
58081,WYNDMERE,ND,80,40,-40,0.3333333333333333
58102,FARGO,ND,25160,15265,-9895,0.37761286332714905
58103,FARGO,ND,44255,27447,-16808,0.38279266966053943
58104,FARGO,ND,32241,31794,-447,0.49650972124619347
58105,FARGO,ND,11,12,1,0.5217391304347826
58106,FARGO,ND,1085,1355,270,0.555327868852459
58107,FARGO,ND,1438,708,-730,0.3299161230195713
58108,FARGO,ND,27,0,-27,0
58201,GRAND FORKS,ND,28648,21928,-6720,0.4335653274280291
58202,GRAND FORKS,ND,0,43,43,1
58203,GRAND FORKS,ND,11523,7611,-3912,0.3977735967387896
58204,GFAFB,ND,45,27,-18,0.375
58204,GRAND FORKS,ND,33,29,-4,0.46774193548387094
58204,GRAND FORKS AFB,ND,962,723,-239,0.429080118694362
58206,GRAND FORKS,ND,24,55,31,0.6962025316455697
58207,GRAND FORKS,ND,0,12,12,1
58208,GRAND FORKS,ND,764,360,-404,0.3202846975088968
58210,ADAMS,ND,11,0,-11,0
58212,ANETA,ND,0,14,14,1
58218,BUXTON,ND,14,0,-14,0
58220,CAVALIER,ND,843,692,-151,0.450814332247557
58220,CAVALIER AFS,ND,20,24,4,0.5454545454545454
58225,DRAYTON,ND,568,253,-315,0.3081607795371498
58228,EMERADO,ND,439,150,-289,0.2546689303904924
58229,FAIRDALE,ND,11,0,-11,0
58230,FINLEY,ND,121,13,-108,0.09701492537313433
58237,GRAFTON,ND,2548,2177,-371,0.46074074074074073
58240,HATTON,ND,255,154,-101,0.3765281173594132
58243,HOOPLE,ND,49,0,-49,0
58249,LANGDON,ND,1168,1011,-157,0.4639743001376778
58251,LARIMORE,ND,436,321,-115,0.4240422721268164
58251,MCCANNA,ND,49,37,-12,0.43023255813953487
58254,MCVILLE,ND,44,28,-16,0.3888888888888889
58256,MANVEL,ND,0,12,12,1
58257,MAYVILLE,ND,1109,844,-265,0.4321556579621096
58261,ARDOCH,ND,16,0,-16,0
58261,MINTO,ND,186,65,-121,0.2589641434262948
58265,NECHE,ND,11,0,-11,0
58267,NORTHWOOD,ND,405,247,-158,0.37883435582822084
58270,PARK RIVER,ND,588,541,-47,0.479185119574845
58271,PEMBINA,ND,213,69,-144,0.24468085106382978
58274,PORTLAND,ND,121,53,-68,0.3045977011494253
58275,REYNOLDS,ND,39,37,-2,0.4868421052631579
58276,SAINT THOMAS,ND,34,0,-34,0
58277,SHARON,ND,0,22,22,1
58278,THOMPSON,ND,333,325,-8,0.4939209726443769
58282,WALHALLA,ND,205,172,-33,0.4562334217506631
58301,DEVILS LAKE,ND,5293,4243,-1050,0.44494546979865773
58316,BELCOURT,ND,909,841,-68,0.4805714285714286
58318,BOTTINEAU,ND,1671,1522,-149,0.4766677106169746
58324,CANDO,ND,389,318,-71,0.4497878359264498
58329,DUNSEITH,ND,777,438,-339,0.36049382716049383
58330,EDMORE,ND,13,12,-1,0.48
58332,ESMOND,ND,0,11,11,1
58335,FORT TOTTEN,ND,130,62,-68,0.3229166666666667
58341,HARVEY,ND,881,846,-35,0.4898668210770122
58341,SELZ,ND,21,21,0,0.5
58344,LAKOTA,ND,78,35,-43,0.30973451327433627
58346,LEEDS,ND,14,12,-2,0.46153846153846156
58348,MADDOCK,ND,48,11,-37,0.1864406779661017
58356,NEW ROCKFORD,ND,783,634,-149,0.44742413549753
58366,ROLETTE,ND,56,49,-7,0.4666666666666667
58367,ROLLA,ND,569,144,-425,0.20196353436185133
58368,RUGBY,ND,1422,1207,-215,0.4591099277291746
58369,SAINT JOHN,ND,48,35,-13,0.42168674698795183
58370,SAINT MICHAEL,ND,13,0,-13,0
58380,TOLNA,ND,22,0,-22,0
58381,WARWICK,ND,15,0,-15,0
58384,WILLOW CITY,ND,0,11,11,1
58401,JAMESTOWN,ND,8122,7103,-1019,0.46653530377668306
58402,JAMESTOWN,ND,245,177,-68,0.4194312796208531
58413,ASHLEY,ND,255,96,-159,0.27350427350427353
58416,BINFORD,ND,22,40,18,0.6451612903225806
58418,BOWDON,ND,11,0,-11,0
58421,BORDULAC,ND,18,26,8,0.5909090909090909
58421,CARRINGTON,ND,1140,887,-253,0.43759250123334975
58425,COOPERSTOWN,ND,374,368,-6,0.49595687331536387
58428,DAWSON,ND,30,35,5,0.5384615384615384
58429,DAZEY,ND,12,0,-12,0
58433,EDGELEY,ND,133,58,-75,0.3036649214659686
58436,ELLENDALE,ND,515,453,-62,0.46797520661157027
58436,MONANGO,ND,17,15,-2,0.46875
58438,FESSENDEN,ND,95,11,-84,0.10377358490566038
58439,FORBES,ND,14,0,-14,0
58442,GACKLE,ND,11,0,-11,0
58444,GOODRICH,ND,11,0,-11,0
58456,KULM,ND,51,0,-51,0
58458,LAMOURE,ND,264,230,-34,0.46558704453441296
58463,MCCLUSKY,ND,12,0,-12,0
58466,MARION,ND,24,0,-24,0
58467,CRYSTAL SPRINGS,ND,14,0,-14,0
58467,MEDINA,ND,28,11,-17,0.28205128205128205
58474,OAKES,ND,990,895,-95,0.47480106100795755
58476,PINGREE,ND,0,11,11,1
58482,STEELE,ND,264,106,-158,0.2864864864864865
58483,STREETER,ND,13,27,14,0.675
58487,TAPPEN,ND,11,11,0,0.5
58492,WIMBLEDON,ND,41,13,-28,0.24074074074074073
58495,WISHEK,ND,456,178,-278,0.2807570977917981
58501,BISMARCK,ND,18594,12779,-5815,0.4073247697064355
58502,BISMARCK,ND,1492,983,-509,0.3971717171717172
58503,BISMARCK,ND,14942,14905,-37,0.49938017221161257
58504,BISMARCK,ND,14506,11259,-3247,0.4369881622355909
58521,BALDWIN,ND,0,13,13,1
58523,BEULAH,ND,1694,1223,-471,0.4192663695577648
58528,CANNON BALL,ND,12,0,-12,0
58529,CARSON,ND,13,12,-1,0.48
58530,CENTER,ND,109,40,-69,0.2684563758389262
58530,HENSLER,ND,0,14,14,1
58531,COLEHARBOR,ND,76,23,-53,0.23232323232323232
58532,DRISCOLL,ND,12,0,-12,0
58533,ELGIN,ND,119,50,-69,0.2958579881656805
58535,FLASHER,ND,28,22,-6,0.44
58538,FORT YATES,ND,715,705,-10,0.4964788732394366
58540,GARRISON,ND,956,996,40,0.5102459016393442
58544,HAZELTON,ND,11,0,-11,0
58545,HAZEN,ND,1461,1192,-269,0.449302676215605
58552,LINTON,ND,479,331,-148,0.408641975308642
58552,STERLING,ND,0,11,11,1
58554,MANDAN,ND,15742,12329,-3413,0.43920772327312885
58558,MENOKEN,ND,11,34,23,0.7555555555555555
58561,NAPOLEON,ND,201,68,-133,0.2527881040892193
58563,NEW SALEM,ND,265,374,109,0.5852895148669797
58565,RIVERDALE,ND,17,0,-17,0
58571,STANTON,ND,11,0,-11,0
58572,STERLING,ND,0,17,17,1
58573,STRASBURG,ND,27,0,-27,0
58575,TURTLE LAKE,ND,127,89,-38,0.41203703703703703
58576,UNDERWOOD,ND,241,66,-175,0.21498371335504887
58577,WASHBURN,ND,644,547,-97,0.45927791771620485
58579,WILTON,ND,298,235,-63,0.44090056285178236
58580,ZAP,ND,12,0,-12,0
58601,DICKINSON,ND,15006,13060,-1946,0.46533171809306634
58602,DICKINSON,ND,679,725,46,0.5163817663817664
58621,BEACH,ND,75,59,-16,0.44029850746268656
58622,BELFIELD,ND,822,586,-236,0.4161931818181818
58623,BOWMAN,ND,1017,887,-130,0.46586134453781514
58630,GLADSTONE,ND,24,0,-24,0
58631,GLEN ULLIN,ND,270,150,-120,0.35714285714285715
58634,GRASSY BUTTE,ND,11,11,0,0.5
58636,HALLIDAY,ND,96,40,-56,0.29411764705882354
58638,HEBRON,ND,40,66,26,0.6226415094339622
58639,HETTINGER,ND,938,576,-362,0.380449141347424
58640,KILLDEER,ND,1098,835,-263,0.4319710294878427
58645,MEDORA,ND,98,101,3,0.507537688442211
58646,MOTT,ND,167,129,-38,0.4358108108108108
58647,NEW ENGLAND,ND,659,133,-526,0.16792929292929293
58649,REEDER,ND,0,11,11,1
58652,RICHARDTON,ND,168,123,-45,0.422680412371134
58653,SCRANTON,ND,12,0,-12,0
58655,SOUTH HEART,ND,46,76,30,0.6229508196721312
58701,MINOT,ND,19740,14989,-4751,0.43159895188459213
58702,MINOT,ND,919,858,-61,0.48283624085537424
58703,MINOT,ND,14934,10685,-4249,0.41707326593543853
58704,MINOT,ND,32,32,0,0.5
58704,MINOT AFB,ND,2903,2080,-823,0.41741922536624526
58705,MINOT AFB,ND,0,59,59,1
58710,ANAMOOSE,ND,11,0,-11,0
58718,BERTHOLD,ND,42,23,-19,0.35384615384615387
58722,BURLINGTON,ND,464,392,-72,0.45794392523364486
58730,CROSBY,ND,414,248,-166,0.37462235649546827
58736,DRAKE,ND,13,0,-13,0
58740,GLENBURN,ND,85,51,-34,0.375
58741,GRANVILLE,ND,91,48,-43,0.34532374100719426
58746,KENMARE,ND,375,238,-137,0.38825448613376834
58750,LANSFORD,ND,29,0,-29,0
58757,MANDAREE,ND,0,11,11,1
58759,MAX,ND,26,27,1,0.5094339622641509
58761,MOHALL,ND,91,50,-41,0.3546099290780142
58763,NEW TOWN,ND,1712,1304,-408,0.4323607427055703
58770,PARSHALL,ND,315,258,-57,0.450261780104712
58770,ROSS,ND,16,0,-16,0
58771,PLAZA,ND,41,29,-12,0.4142857142857143
58773,POWERS LAKE,ND,63,61,-2,0.49193548387096775
58776,ROSS,ND,11,0,-11,0
58779,RYDER,ND,14,0,-14,0
58781,SAWYER,ND,25,0,-25,0
58782,SHERWOOD,ND,11,0,-11,0
58784,STANLEY,ND,1509,1383,-126,0.4782157676348548
58785,SURREY,ND,193,224,31,0.5371702637889688
58788,TOWNER,ND,53,30,-23,0.3614457831325301
58790,VELVA,ND,363,217,-146,0.3741379310344828
58793,WESTHOPE,ND,67,53,-14,0.44166666666666665
58801,WILLISTON,ND,26227,19204,-7023,0.42270696220642295
58802,WILLISTON,ND,1545,679,-866,0.30530575539568344
58803,WILLISTON,ND,1982,785,-1197,0.2837007589447055
58831,ALEXANDER,ND,404,267,-137,0.3979135618479881
58835,ARNEGARD,ND,51,54,3,0.5142857142857142
58843,EPPING,ND,37,26,-11,0.4126984126984127
58845,GRENORA,ND,48,0,-48,0
58847,KEENE,ND,11,0,-11,0
58849,RAY,ND,384,302,-82,0.4402332361516035
58852,TIOGA,ND,1320,1036,-284,0.4397283531409168
58853,TRENTON,ND,81,0,-81,0
58854,WATFORD CITY,ND,6743,5449,-1294,0.44693241469816275
59001,ABSAROKEE,MT,895,575,-320,0.391156462585034
59003,ASHLAND,MT,92,13,-79,0.12380952380952381
59006,BALLANTINE,MT,96,23,-73,0.19327731092436976
59008,BELFRY,MT,0,42,42,1
59011,BIG TIMBER,MT,1262,1271,9,0.5017765495459929
59014,BRIDGER,MT,566,470,-96,0.45366795366795365
59016,BUSBY,MT,56,23,-33,0.2911392405063291
59018,CLYDE PARK,MT,67,70,3,0.5109489051094891
59019,COLUMBUS,MT,1560,1683,123,0.5189639222941721
59020,COOKE CITY,MT,84,114,30,0.5757575757575758
59022,CROW AGENCY,MT,418,213,-205,0.3375594294770206
59024,CUSTER,MT,11,11,0,0.5
59027,EMIGRANT,MT,692,648,-44,0.4835820895522388
59028,FISHTAIL,MT,34,60,26,0.6382978723404256
59029,FROMBERG,MT,67,39,-28,0.36792452830188677
59030,GARDINER,MT,1194,756,-438,0.38769230769230767
59032,GRASS RANGE,MT,25,0,-25,0
59034,HARDIN,MT,1719,1339,-380,0.4378678875081753
59035,FORT SMITH,MT,24,11,-13,0.3142857142857143
59036,HARLOWTON,MT,293,266,-27,0.47584973166368516
59037,HUNTLEY,MT,664,636,-28,0.48923076923076925
59038,HYSHAM,MT,63,22,-41,0.25882352941176473
59041,JOLIET,MT,699,732,33,0.5115303983228512
59043,LAME DEER,MT,542,135,-407,0.19940915805022155
59044,LAUREL,MT,4962,4999,37,0.5018572432486698
59046,LAVINA,MT,20,48,28,0.7058823529411765
59047,LIVINGSTON,MT,8001,7883,-118,0.49628557038529336
59050,LODGE GRASS,MT,96,0,-96,0
59052,MC LEOD,MT,49,30,-19,0.379746835443038
59057,MOLT,MT,12,25,13,0.6756756756756757
59061,NYE,MT,57,80,23,0.583941605839416
59063,PARK CITY,MT,640,739,99,0.5358955765047135
59065,PRAY,MT,12,38,26,0.76
59066,PRYOR,MT,12,0,-12,0
59068,RED LODGE,MT,2280,2247,-33,0.4963552021206097
59069,REED POINT,MT,49,59,10,0.5462962962962963
59070,FOX,MT,0,40,40,1
59070,ROBERTS,MT,305,551,246,0.6436915887850467
59071,ROSCOE,MT,37,13,-24,0.26
59072,ROUNDUP,MT,2189,2445,256,0.5276219249028917
59074,RYEGATE,MT,27,11,-16,0.2894736842105263
59079,SHEPHERD,MT,1194,1320,126,0.5250596658711217
59086,WILSALL,MT,225,220,-5,0.4943820224719101
59087,WINNETT,MT,0,12,12,1
59088,WORDEN,MT,329,299,-30,0.47611464968152867
59101,BILLINGS,MT,24823,21145,-3678,0.459993908806126
59102,BILLINGS,MT,27252,22646,-4606,0.45384584552487073
59103,BILLINGS,MT,916,460,-456,0.33430232558139533
59104,BILLINGS,MT,1400,816,-584,0.36823104693140796
59105,BILLINGS,MT,17923,15358,-2565,0.46146449926384425
59106,BILLINGS,MT,8816,10569,1753,0.545215372710859
59107,BILLINGS,MT,768,466,-302,0.37763371150729336
59108,BILLINGS,MT,545,698,153,0.5615446500402252
59201,WOLF POINT,MT,1423,1253,-170,0.46823617339312407
59212,BAINVILLE,MT,81,22,-59,0.21359223300970873
59215,CIRCLE,MT,141,44,-97,0.23783783783783785
59218,CULBERTSON,MT,302,177,-125,0.3695198329853862
59221,FAIRVIEW,MT,771,585,-186,0.4314159292035398
59223,FORT PECK,MT,48,0,-48,0
59226,FROID,MT,13,0,-13,0
59230,GLASGOW,MT,1837,1732,-105,0.4852899971980947
59231,SAINT MARIE,MT,11,44,33,0.8
59247,MEDICINE LAKE,MT,11,0,-11,0
59248,NASHUA,MT,11,26,15,0.7027027027027027
59252,OUTLOOK,MT,13,0,-13,0
59254,PLENTYWOOD,MT,963,831,-132,0.46321070234113715
59255,POPLAR,MT,686,487,-199,0.4151747655583973
59262,SAVAGE,MT,47,0,-47,0
59263,SCOBEY,MT,172,136,-36,0.44155844155844154
59270,SIDNEY,MT,5714,4091,-1623,0.4172361040285569
59275,WESTBY,MT,12,16,4,0.5714285714285714
59301,MILES CITY,MT,5249,5073,-176,0.49147452044177486
59313,BAKER,MT,671,402,-269,0.3746505125815471
59317,BROADUS,MT,142,87,-55,0.3799126637554585
59323,COLSTRIP,MT,645,356,-289,0.35564435564435565
59324,EKALAKA,MT,109,13,-96,0.10655737704918032
59327,FORSYTH,MT,1006,803,-203,0.4438916528468767
59330,GLENDIVE,MT,3626,3511,-115,0.49194339358273786
59337,JORDAN,MT,0,43,43,1
59347,ROSEBUD,MT,44,0,-44,0
59349,TERRY,MT,76,116,40,0.6041666666666666
59353,WIBAUX,MT,146,91,-55,0.38396624472573837
59401,GREAT FALLS,MT,7652,6901,-751,0.4741977599120456
59403,GREAT FALLS,MT,989,858,-131,0.46453708716838116
59404,GREAT FALLS,MT,10247,10172,-75,0.49816347519467163
59405,GREAT FALLS,MT,17730,15495,-2235,0.46636568848758464
59406,GREAT FALLS,MT,639,460,-179,0.41856232939035487
59410,AUGUSTA,MT,177,102,-75,0.3655913978494624
59411,BABB,MT,121,109,-12,0.47391304347826085
59412,BELT,MT,371,361,-10,0.4931693989071038
59414,BLACK EAGLE,MT,367,411,44,0.5282776349614395
59416,BRADY,MT,12,0,-12,0
59417,BROWNING,MT,1104,1184,80,0.5174825174825175
59421,CASCADE,MT,1214,1048,-166,0.46330680813439434
59421,WSS,MT,0,31,31,1
59422,CHOTEAU,MT,896,893,-3,0.4991615427613192
59425,CONRAD,MT,1395,1365,-30,0.4945652173913043
59427,CUT BANK,MT,1981,1862,-119,0.48451730418943534
59430,DENTON,MT,11,0,-11,0
59434,E GLACIER PAR,MT,11,0,-11,0
59434,E GLACIER PARK,MT,11,0,-11,0
59434,EAST GLACIER PARK,MT,120,98,-22,0.44954128440366975
59436,FAIRFIELD,MT,361,431,70,0.5441919191919192
59442,FORT BENTON,MT,836,615,-221,0.4238456237077877
59443,FORT SHAW,MT,24,16,-8,0.4
59446,GERALDINE,MT,12,0,-12,0
59452,HOBSON,MT,23,38,15,0.6229508196721312
59453,JUDITH GAP,MT,13,0,-13,0
59457,LEWISTOWN,MT,4034,4146,112,0.5068459657701712
59463,MONARCH,MT,0,13,13,1
59464,MOORE,MT,22,38,16,0.6333333333333333
59468,POWER,MT,12,0,-12,0
59472,SAND COULEE,MT,84,37,-47,0.30578512396694213
59474,SHELBY,MT,1637,1616,-21,0.49677221026744545
59477,SIMMS,MT,15,0,-15,0
59479,STANFORD,MT,64,38,-26,0.37254901960784315
59482,SUNBURST,MT,16,14,-2,0.4666666666666667
59483,SUN RIVER,MT,11,0,-11,0
59485,ULM,MT,0,25,25,1
59486,VALIER,MT,214,187,-27,0.46633416458852867
59487,VAUGHN,MT,499,437,-62,0.4668803418803419
59501,HAVRE,MT,6391,5094,-1297,0.44353504571179797
59520,BIG SANDY,MT,290,118,-172,0.28921568627450983
59521,BOX ELDER,MT,1485,1072,-413,0.4192412983965585
59522,CHESTER,MT,335,168,-167,0.33399602385685884
59523,CHINOOK,MT,583,414,-169,0.4152457372116349
59524,DODSON,MT,14,0,-14,0
59526,HARLEM,MT,1218,406,-812,0.25
59527,HAYS,MT,81,41,-40,0.3360655737704918
59538,MALTA,MT,760,593,-167,0.43828529194382854
59546,ZORTMAN,MT,0,11,11,1
59601,HELENA,MT,17562,16416,-1146,0.4831361469185944
59602,HELENA,MT,10220,11243,1023,0.5238317103853143
59604,HELENA,MT,2137,1933,-204,0.47493857493857494
59624,HELENA,MT,799,732,-67,0.47811887655127366
59632,BOULDER,MT,647,759,112,0.5398293029871978
59632,FAIRBANKS,MT,0,15,15,1
59634,CLANCY,MT,1404,1750,346,0.5548509828788839
59634,MONTANA CITY,MT,81,89,8,0.5235294117647059
59635,EAST HELENA,MT,3472,3625,153,0.5107792024799211
59636,FORT HARRISON,MT,0,11,11,1
59638,JEFFERSON CITY,MT,29,37,8,0.5606060606060606
59639,LINCOLN,MT,586,586,0,0.5
59643,TOSTON,MT,11,36,25,0.7659574468085106
59644,TOWNSEND,MT,2056,2403,347,0.5389100695223145
59645,WHITE SULPHUR SPRINGS,MT,781,617,-164,0.4413447782546495
59645,WHT SPHR SPGS,MT,13,14,1,0.5185185185185185
59648,CRAIG,MT,48,0,-48,0
59648,WOLF CREEK,MT,252,179,-73,0.41531322505800466
59701,BUTTE,MT,14526,13839,-687,0.4878900052882073
59702,BILLINGS,MT,14,11,-3,0.44
59702,BUTTE,MT,724,698,-26,0.4908579465541491
59703,BUTTE,MT,106,104,-2,0.49523809523809526
59711,ANACONDA,MT,4447,4280,-167,0.4904319926664375
59714,BELGRADE,MT,11433,11805,372,0.508004131164472
59715,BOZEMAN,MT,23059,18858,-4201,0.4498890664885369
59716,BIG SKY,MT,2843,2955,112,0.5096585029320455
59718,BOZEMAN,MT,29603,26696,-2907,0.474182489919892
59719,BOZEMAN,MT,956,1046,90,0.5224775224775224
59720,CAMERON,MT,456,443,-13,0.492769744160178
59721,CARDWELL,MT,40,26,-14,0.3939393939393939
59722,DEER LODGE,MT,1895,2103,208,0.5260130065032517
59725,DILLON,MT,4741,4411,-330,0.48197115384615385
59729,ENNIS,MT,1958,1854,-104,0.4863588667366212
59730,GALLATIN GATEWAY,MT,1176,1425,249,0.5478662053056517
59730,GALLATIN GTWY,MT,78,90,12,0.5357142857142857
59732,GLEN,MT,11,0,-11,0
59735,HARRISON,MT,0,11,11,1
59739,LIMA,MT,26,23,-3,0.46938775510204084
59740,MC ALLISTER,MT,255,231,-24,0.47530864197530864
59740,MCALLISTER,MT,31,0,-31,0
59741,MANHATTAN,MT,2221,2161,-60,0.49315381104518485
59743,MELROSE,MT,11,36,25,0.7659574468085106
59746,POLARIS,MT,0,11,11,1
59747,PONY,MT,13,0,-13,0
59749,SHERIDAN,MT,826,846,20,0.5059808612440191
59752,THREE FORKS,MT,1975,2351,376,0.5434581599630144
59754,TWIN BRIDGES,MT,302,225,-77,0.4269449715370019
59755,VIRGINIA CITY,MT,80,0,-80,0
59758,W YELLOWSTONE,MT,25,114,89,0.8201438848920863
59758,WEST YELLOWSTONE,MT,2312,1470,-842,0.3886832363828662
59759,WHITEHALL,MT,1677,1657,-20,0.497000599880024
59760,WILLOW CREEK,MT,13,0,-13,0
59761,WISDOM,MT,27,0,-27,0
59762,WISE RIVER,MT,11,12,1,0.5217391304347826
59771,BOZEMAN,MT,1485,1386,-99,0.4827586206896552
59772,BOZEMAN,MT,454,446,-8,0.4955555555555556
59801,MISSOULA,MT,21559,17794,-3765,0.4521637486341575
59802,MISSOULA,MT,12141,10738,-1403,0.46933869487302765
59803,MISSOULA,MT,6324,6625,301,0.511622519113445
59804,MISSOULA,MT,3125,3078,-47,0.49621151055940677
59806,MISSOULA,MT,1645,1804,159,0.523050159466512
59807,MISSOULA,MT,1607,979,-628,0.3785769528228925
59808,MISSOULA,MT,12608,12339,-269,0.49460857016875776
59820,ALBERTON,MT,617,724,107,0.5398956002982849
59821,ARLEE,MT,963,886,-77,0.4791779340183883
59823,BONNER,MT,552,620,68,0.5290102389078498
59823,GREENOUGH,MT,22,16,-6,0.42105263157894735
59823,POTOMAC,MT,18,19,1,0.5135135135135135
59824,CHARLO,MT,265,386,121,0.5929339477726574
59824,MOIESE,MT,36,13,-23,0.2653061224489796
59825,CLINTON,MT,935,896,-39,0.4893500819224468
59826,CONDON,MT,199,328,129,0.6223908918406073
59827,CONNER,MT,15,36,21,0.7058823529411765
59828,CORVALLIS,MT,2294,2844,550,0.5535227715064227
59829,DARBY,MT,1382,1463,81,0.5142355008787346
59831,DIXON,MT,12,0,-12,0
59832,DRUMMOND,MT,156,77,-79,0.33047210300429186
59833,FLORENCE,MT,2537,2605,68,0.5066122131466355
59834,FRENCHTOWN,MT,1084,1119,35,0.5079437131184749
59837,HALL,MT,0,13,13,1
59840,HAMILTON,MT,7837,8266,429,0.5133204992858473
59842,HAUGAN,MT,14,0,-14,0
59843,HELMVILLE,MT,0,11,11,1
59844,HERON,MT,53,56,3,0.5137614678899083
59845,HOT SPRINGS,MT,617,659,42,0.5164576802507836
59846,HUSON,MT,431,423,-8,0.4953161592505855
59847,LOLO,MT,2407,2639,232,0.5229885057471264
59851,MILLTOWN,MT,37,25,-12,0.4032258064516129
59853,NOXON,MT,249,262,13,0.512720156555773
59854,OVANDO,MT,13,14,1,0.5185185185185185
59855,PABLO,MT,225,249,24,0.5253164556962026
59856,PARADISE,MT,11,0,-11,0
59858,PHILIPSBURG,MT,1119,718,-401,0.3908546543277082
59859,PLAINS,MT,1702,1939,237,0.5325460038450975
59860,POLSON,MT,7165,6865,-300,0.48930862437633643
59863,RAVALLI,MT,0,11,11,1
59864,RONAN,MT,2708,2722,14,0.5012891344383057
59865,SAINT IGNATIUS,MT,1254,1213,-41,0.49169031211998376
59865,ST IGNATIUS,MT,71,90,19,0.5590062111801242
59866,SAINT REGIS,MT,619,567,-52,0.47807757166947723
59868,SEELEY LAKE,MT,1665,1330,-335,0.44407345575959933
59870,STEVENSVILLE,MT,5290,5495,205,0.5095039406583217
59871,SULA,MT,41,62,21,0.6019417475728155
59872,SUPERIOR,MT,1288,1248,-40,0.4921135646687697
59873,THOMPSON FALLS,MT,1572,1595,23,0.5036311967161351
59873,THOMPSON FLS,MT,48,64,16,0.5714285714285714
59874,TROUT CREEK,MT,724,942,218,0.5654261704681873
59875,VICTOR,MT,1801,1996,195,0.5256781669739268
59901,KALISPELL,MT,23021,25740,2719,0.5278808884149218
59903,KALISPELL,MT,1529,1555,26,0.5042153047989624
59904,KALISPELL,MT,2174,2528,354,0.5376435559336452
59910,BIG ARM,MT,244,92,-152,0.27380952380952384
59911,BIGFORK,MT,6684,7286,602,0.521546170365068
59912,COLUMBIA FALLS,MT,7287,7363,76,0.5025938566552901
59913,CORAM,MT,49,34,-15,0.40963855421686746
59914,DAYTON,MT,130,93,-37,0.4170403587443946
59915,ELMO,MT,0,11,11,1
59916,ESSEX,MT,29,57,28,0.6627906976744186
59917,EUREKA,MT,2044,2596,552,0.5594827586206896
59918,FORTINE,MT,38,27,-11,0.4153846153846154
59919,HUNGRY HORSE,MT,335,211,-124,0.38644688644688646
59920,KILA,MT,964,826,-138,0.46145251396648046
59922,LAKESIDE,MT,1753,1953,200,0.5269832703723691
59923,LIBBY,MT,5527,5217,-310,0.48557334326135515
59925,MARION,MT,901,1123,222,0.5548418972332015
59926,MARTIN CITY,MT,11,11,0,0.5
59927,OLNEY,MT,27,0,-27,0
59928,POLEBRIDGE,MT,27,36,9,0.5714285714285714
59930,REXFORD,MT,193,442,249,0.6960629921259842
59931,ROLLINS,MT,95,162,67,0.6303501945525292
59932,SOMERS,MT,1066,1061,-5,0.4988246356370475
59934,TREGO,MT,83,32,-51,0.2782608695652174
59935,TROY,MT,1869,2006,137,0.5176774193548387
59936,WEST GLACIER,MT,638,422,-216,0.39811320754716983
59937,WHITEFISH,MT,10449,10880,431,0.5101036147967556
60002,ANTIOCH,IL,8833,8623,-210,0.4939848762603116
60004,ARLINGTON HEIGHTS,IL,17070,16648,-422,0.4937422148407379
60005,ARLINGTON HEIGHTS,IL,12250,10858,-1392,0.4698805608447291
60005,ARLINGTON HTS,IL,435,366,-69,0.45692883895131087
60006,ARLINGTON HEIGHTS,IL,100,303,203,0.7518610421836228
60006,ARLINGTON HTS,IL,0,12,12,1
60007,ELK GROVE VILLAGE,IL,11050,10825,-225,0.4948571428571429
60007,ELK GROVE VLG,IL,148,161,13,0.5210355987055016
60008,ROLLING MDWS,IL,922,901,-21,0.494240263302249
60008,ROLLING MEADOWS,IL,7480,7384,-96,0.4967707212055974
60009,ELK GROVE VILLAGE,IL,126,73,-53,0.36683417085427134
60009,ELK GROVE VLG,IL,12,12,0,0.5
60010,BARRINGTON,IL,8658,9352,694,0.5192670738478623
60010,DEER PARK,IL,2226,2888,662,0.5647242862729761
60010,HOFFMAN ESTATES,IL,700,808,108,0.5358090185676393
60010,INVERNESS,IL,596,843,247,0.5858234885337039
60010,LAKE BARRINGTON,IL,2321,2559,238,0.5243852459016394
60010,NORTH BARRINGTON,IL,266,295,29,0.5258467023172906
60010,PORT BARRINGTON,IL,236,396,160,0.6265822784810127
60011,BARRINGTON,IL,129,231,102,0.6416666666666667
60012,CRYSTAL LAKE,IL,2486,3105,619,0.5553568234662851
60012,PRAIRIE GROVE,IL,235,315,80,0.5727272727272728
60013,CARY,IL,5832,6249,417,0.5172585050906382
60013,OAKWOOD HILLS,IL,959,1037,78,0.5195390781563126
60013,TROUT VALLEY,IL,386,396,10,0.5063938618925832
60014,CRYSTAL LAKE,IL,15231,14903,-328,0.49455764253003254
60014,VILLAGE OF LAKEWOOD,IL,631,619,-12,0.4952
60015,DEERFIELD,IL,8199,9837,1638,0.5454091816367266
60015,RIVERWOODS,IL,1002,859,-143,0.461579795808705
60016,DES PLAINES,IL,24200,21096,-3104,0.4657364888731897
60017,DES PLAINES,IL,38,195,157,0.8369098712446352
60018,DES PLAINES,IL,3311,3189,-122,0.4906153846153846
60018,ROSEMONT,IL,4906,4782,-124,0.49360033030553263
60020,FOX LAKE,IL,5302,5230,-72,0.49658184580326625
60021,FOX RIVER GROVE,IL,1653,1525,-128,0.47986154814348647
60021,FOX RIVER GRV,IL,274,116,-158,0.29743589743589743
60022,GLENCOE,IL,2497,2833,336,0.5315196998123828
60025,GLENVIEW,IL,13435,13780,345,0.5063384163145325
60026,GLENVIEW,IL,4934,5092,158,0.5078795132655097
60029,GOLF,IL,0,12,12,1
60030,GRAYSLAKE,IL,12010,11489,-521,0.4889144218902932
60030,HAINESVILLE,IL,539,524,-15,0.4929444967074318
60031,GURNEE,IL,14671,13779,-892,0.484323374340949
60033,HARVARD,IL,5090,3995,-1095,0.4397358282883875
60034,HEBRON,IL,894,581,-313,0.39389830508474577
60035,HIGHLAND PARK,IL,12060,12824,764,0.515351229705835
60039,CRYSTAL LAKE,IL,239,451,212,0.6536231884057971
60040,HIGHWOOD,IL,2369,1918,-451,0.44739911359925355
60041,INGLESIDE,IL,3265,3142,-123,0.4904011237708756
60042,ISLAND LAKE,IL,2521,2504,-17,0.4983084577114428
60043,KENILWORTH,IL,474,691,217,0.5931330472103005
60044,LAKE BLUFF,IL,4532,4404,-128,0.4928379588182632
60045,LAKE FOREST,IL,7936,9096,1160,0.5340535462658526
60046,LAKE VILLA,IL,8123,7751,-372,0.48828272647095883
60046,LINDENHURST,IL,2425,2385,-40,0.49584199584199584
60047,HAWTHORN WOODS,IL,1313,1449,136,0.5246198406951484
60047,KILDEER,IL,1551,1717,166,0.5253977968176254
60047,LAKE ZURICH,IL,6303,7663,1360,0.5486896749248175
60047,LONG GROVE,IL,1676,1799,123,0.5176978417266187
60048,LIBERTYVILLE,IL,9444,10064,620,0.5158909165470577
60050,BULL VALLEY,IL,195,195,0,0.5
60050,MCCULLOM LAKE,IL,203,179,-24,0.468586387434555
60050,MCHENRY,IL,11278,11502,224,0.5049165935030728
60051,JOHNSBURG,IL,766,762,-4,0.4986910994764398
60051,LAKEMOOR,IL,854,715,-139,0.455704270235819
60051,MCHENRY,IL,7541,7361,-180,0.49396054220909946
60053,MORTON GROVE,IL,5765,5994,229,0.5097372225529382
60056,MOUNT PROSPECT,IL,15818,15318,-500,0.49197070914696817
60056,MT PROSPECT,IL,3038,2804,-234,0.4799726121191373
60060,MUNDELEIN,IL,12613,11526,-1087,0.47748456854053606
60061,VERNON HILLS,IL,11218,10671,-547,0.48750513956781943
60062,NORTHBROOK,IL,15680,16800,1120,0.5172413793103449
60064,NORTH CHICAGO,IL,6440,5316,-1124,0.4521946240217761
60065,NORTHBROOK,IL,113,15717,15604,0.9928616550852811
60067,INVERNESS,IL,1204,1261,57,0.5115618661257606
60067,PALATINE,IL,13224,12725,-499,0.49038498593394736
60068,PARK RIDGE,IL,10276,10766,490,0.5116433799068529
60069,LINCOLNSHIRE,IL,3748,4446,698,0.5425921405906761
60070,PROSPECT HEIGHTS,IL,4923,4515,-408,0.47838525111252383
60070,PROSPECT HTS,IL,1057,926,-131,0.4669692385274836
60071,RICHMOND,IL,1724,1657,-67,0.4900916888494528
60072,RINGWOOD,IL,222,113,-109,0.3373134328358209
60073,HAINESVILLE,IL,286,283,-3,0.4973637961335677
60073,ROUND LAKE,IL,8842,7587,-1255,0.46180534420841196
60073,ROUND LAKE BEACH,IL,5168,4433,-735,0.46172273721487345
60073,ROUND LAKE HEIGHTS,IL,406,348,-58,0.46153846153846156
60073,ROUND LAKE PARK,IL,3915,3296,-619,0.4570794619331577
60074,PALATINE,IL,14956,12844,-2112,0.4620143884892086
60076,SKOKIE,IL,9486,9373,-113,0.49700408293122644
60077,SKOKIE,IL,9849,8906,-943,0.47486003732338045
60078,PALATINE,IL,75,341,266,0.8197115384615384
60079,WAUKEGAN,IL,773,1532,759,0.6646420824295011
60081,SPRING GROVE,IL,3065,3080,15,0.5012205044751831
60083,BEACH PARK,IL,387,439,52,0.5314769975786925
60083,OLD MILL CRK,IL,83,73,-10,0.46794871794871795
60083,WADSWORTH,IL,2484,2471,-13,0.4986881937436932
60084,WAUCONDA,IL,5570,5030,-540,0.47452830188679246
60085,WAUKEGAN,IL,31777,20336,-11441,0.390228925603976
60087,BEACH PARK,IL,1612,1234,-378,0.43359100491918484
60087,WAUKEGAN,IL,8328,6715,-1613,0.4463870238649206
60088,GREAT LAKES,IL,2758,2129,-629,0.43564559034172295
60088,NORTH CHICAGO,IL,74,38,-36,0.3392857142857143
60088,WAUKEGAN,IL,52,35,-17,0.40229885057471265
60089,BUFFALO GROVE,IL,14630,14984,354,0.5059769028162355
60090,WHEELING,IL,17107,15242,-1865,0.47117376116726944
60091,WILMETTE,IL,7810,8720,910,0.5275257108287962
60093,NORTHFIELD,IL,2869,2838,-31,0.4972840371473629
60093,WINNETKA,IL,4029,4932,903,0.5503850016739203
60095,PALATINE,IL,0,15,15,1
60096,WINTHROP HARBOR,IL,2333,2075,-258,0.4707350272232305
60096,WINTHROP HBR,IL,68,42,-26,0.38181818181818183
60097,WONDER LAKE,IL,3919,3743,-176,0.4885147481075437
60098,WOODSTOCK,IL,12748,12063,-685,0.48619563903107493
60099,BEACH PARK,IL,907,788,-119,0.4648967551622419
60099,ZION,IL,13070,10788,-2282,0.45217537094475646
60101,ADDISON,IL,11590,10478,-1112,0.474805147725213
60102,ALGONQUIN,IL,10079,10356,277,0.5067775874724737
60103,BARTLETT,IL,10049,10415,366,0.5089425332290852
60104,BELLWOOD,IL,5596,5356,-240,0.48904309715120525
60106,BENSENVILLE,IL,7735,5888,-1847,0.4322102326947075
60107,STREAMWOOD,IL,11580,10921,-659,0.48535620639082705
60108,BLOOMINGDALE,IL,8746,8278,-468,0.4862546992481203
60109,BURLINGTON,IL,100,52,-48,0.34210526315789475
60110,CARPENTERSVILLE,IL,11520,9200,-2320,0.444015444015444
60112,CORTLAND,IL,1587,1569,-18,0.49714828897338403
60113,CRESTON,IL,37,0,-37,0
60115,DEKALB,IL,23392,19431,-3961,0.4537514886859865
60118,DUNDEE,IL,1719,1600,-119,0.4820729135281711
60118,EAST DUNDEE,IL,1336,1452,116,0.5208034433285509
60118,SLEEPY HOLLOW,IL,543,525,-18,0.49157303370786515
60118,WEST DUNDEE,IL,3663,3749,86,0.5058014031300594
60119,ELBURN,IL,2992,3354,362,0.5285219035612985
60120,ELGIN,IL,16532,13203,-3329,0.44402219606524296
60121,ELGIN,IL,2071,1338,-733,0.3924904664124377
60121,FRANKLIN PARK,IL,52,33,-19,0.38823529411764707
60123,ELGIN,IL,17704,14912,-2792,0.45719892077507973
60124,CAMPTON HILLS,IL,169,167,-2,0.49702380952380953
60124,ELGIN,IL,6615,9291,2676,0.5841192003017729
60126,ELMHURST,IL,13271,13843,572,0.5105480563546507
60130,FOREST PARK,IL,8053,7032,-1021,0.46615843553198544
60131,FRANKLIN PARK,IL,5099,4634,-465,0.4761121956231378
60133,ELGIN,IL,233,172,-61,0.4246913580246914
60133,HANOVER PARK,IL,10300,8687,-1613,0.45752356875757094
60134,GENEVA,IL,8972,9280,308,0.5084374315143546
60135,GENOA,IL,2361,2236,-125,0.48640417663693714
60136,GILBERTS,IL,2191,2228,37,0.5041864675265897
60137,GLEN ELLYN,IL,11416,11576,160,0.5034794711203897
60138,GLEN ELLYN,IL,61,133,72,0.6855670103092784
60139,GLENDALE HEIGHTS,IL,10798,9246,-1552,0.4612851726202355
60139,GLENDALE HTS,IL,985,864,-121,0.4672796106003245
60140,HAMPSHIRE,IL,3583,4265,682,0.5434505606523955
60140,PINGREE GROVE,IL,2552,3171,619,0.554080027957365
60141,HINES,IL,257,1049,792,0.8032159264931087
60142,HUNTLEY,IL,9964,9930,-34,0.49914547099628026
60143,ITASCA,IL,4707,4319,-388,0.4785065366718369
60145,KINGSTON,IL,741,562,-179,0.4313123561013047
60146,KIRKLAND,IL,660,627,-33,0.48717948717948717
60148,LOMBARD,IL,21178,19448,-1730,0.47870821641313444
60150,MALTA,IL,512,487,-25,0.4874874874874875
60151,MAPLE PARK,IL,1001,1146,145,0.5337680484396833
60151,VIRGIL,IL,52,54,2,0.5094339622641509
60152,MARENGO,IL,4439,4157,-282,0.4835970218706375
60153,MAYWOOD,IL,7226,6589,-637,0.4769453492580528
60154,WESTCHESTER,IL,4924,5221,297,0.5146377525874816
60155,BROADVIEW,IL,2537,2405,-132,0.4866450829623634
60155,MAYWOOD,IL,95,107,12,0.5297029702970297
60156,ALGONQUIN,IL,107,106,-1,0.49765258215962443
60156,LAKE IN THE HILLS,IL,8132,7852,-280,0.49124124124124124
60157,MEDINAH,IL,540,659,119,0.5496246872393661
60159,SCHAUMBURG,IL,42,79,37,0.6528925619834711
60160,MELROSE PARK,IL,7027,5549,-1478,0.44123727735368956
60161,MELROSE PARK,IL,37,245,208,0.8687943262411347
60162,HILLSIDE,IL,2626,2566,-60,0.49422187981510013
60163,BERKELEY,IL,1246,1359,113,0.5216890595009597
60164,MELROSE PARK,IL,1785,1669,-116,0.48320787492762013
60164,NORTHLAKE,IL,3553,3259,-294,0.47842043452730476
60165,STONE PARK,IL,1266,752,-514,0.3726461843409316
60168,SCHAUMBURG,IL,337,293,-44,0.4650793650793651
60169,HOFFMAN ESTATES,IL,13161,11106,-2055,0.4576585486463098
60171,RIVER GROVE,IL,3767,3182,-585,0.4579076126061304
60172,ROSELLE,IL,7391,7229,-162,0.4944596443228454
60173,SCHAUMBURG,IL,11153,10075,-1078,0.4746090069719239
60174,SAINT CHARLES,IL,13432,11701,-1731,0.465563203756018
60174,ST CHARLES,IL,1251,1237,-14,0.4971864951768489
60175,CAMPTON HILLS,IL,92,139,47,0.6017316017316018
60175,SAINT CHARLES,IL,5150,6005,855,0.5383236216943075
60175,ST CHARLES,IL,588,732,144,0.5545454545454546
60176,CHICAGO,IL,104,97,-7,0.48258706467661694
60176,SCHILLER PARK,IL,4285,3525,-760,0.4513444302176697
60177,SOUTH ELGIN,IL,7452,7479,27,0.5009041591320073
60178,SYCAMORE,IL,8604,7774,-830,0.47466113078519967
60180,UNION,IL,157,230,73,0.5943152454780362
60181,OAKBROOK TERRACE,IL,2572,2263,-309,0.46804550155118924
60181,VILLA PARK,IL,8740,8239,-501,0.48524648094705225
60184,WAYNE,IL,856,762,-94,0.47095179233621753
60185,WEST CHICAGO,IL,8736,7920,-816,0.4755043227665706
60186,WEST CHICAGO,IL,0,62,62,1
60187,WHEATON,IL,10985,10447,-538,0.4874486748786861
60188,CAROL STREAM,IL,14013,13361,-652,0.488090889164901
60189,WHEATON,IL,10978,10201,-777,0.4816563577128287
60190,WINFIELD,IL,3095,3588,493,0.5368846326500075
60191,WOOD DALE,IL,5016,4623,-393,0.47961406784936195
60192,HOFFMAN EST,IL,70,87,17,0.554140127388535
60192,HOFFMAN ESTATES,IL,3790,4466,676,0.5409399224806202
60193,SCHAUMBURG,IL,13939,12664,-1275,0.47603653723264294
60194,SCHAUMBURG,IL,7427,6856,-571,0.4800112021284044
60195,HOFFMAN ESTATES,IL,2101,1701,-400,0.44739610731194107
60195,SCHAUMBURG,IL,1966,1626,-340,0.4526726057906459
60197,CAROL STREAM,IL,447,180,-267,0.28708133971291866
60201,EVANSTON,IL,20743,16856,-3887,0.44830979547328387
60202,EVANSTON,IL,15305,13185,-2120,0.4627939627939628
60203,EVANSTON,IL,980,1142,162,0.5381715362865221
60204,EVANSTON,IL,500,917,417,0.6471418489767113
60301,OAK PARK,IL,3854,3383,-471,0.467458891805997
60302,OAK PARK,IL,14459,13107,-1352,0.4754770369295509
60303,OAK PARK,IL,235,814,579,0.7759771210676835
60304,OAK PARK,IL,5591,5444,-147,0.49333937471681016
60305,RIVER FOREST,IL,3000,3461,461,0.5356755920136201
60401,BEECHER,IL,2646,2416,-230,0.477281706835243
60402,BERWYN,IL,18373,15521,-2852,0.45792765681241515
60403,CREST HILL,IL,8434,6189,-2245,0.4232373657936128
60404,SHOREWOOD,IL,5217,5796,579,0.5262871152274584
60406,BLUE ISLAND,IL,8387,6699,-1688,0.4440540898846613
60407,BRACEVILLE,IL,313,270,-43,0.4631217838765009
60407,GODLEY,IL,100,151,51,0.601593625498008
60408,BRAIDWOOD,IL,2156,1954,-202,0.4754257907542579
60409,CALUMET CITY,IL,12854,12492,-362,0.49285883374102424
60410,CHANNAHON,IL,3567,4061,494,0.5323807026743577
60411,CHICAGO HEIGHTS,IL,7395,6546,-849,0.469550247471487
60411,FORD HEIGHTS,IL,2709,2488,-221,0.4787377333076775
60411,LYNWOOD,IL,6237,5770,-467,0.4805530107437328
60411,S CHICAGO HEIGHTS,IL,357,303,-54,0.4590909090909091
60411,SAUK VILLAGE,IL,633,586,-47,0.4807219031993437
60412,CHICAGO HEIGHTS,IL,352,886,534,0.715670436187399
60412,CHICAGO HTS,IL,24,35,11,0.5932203389830508
60415,CHICAGO RIDGE,IL,6110,4423,-1687,0.41991835184657744
60416,CARBON HILL,IL,267,208,-59,0.4378947368421053
60416,COAL CITY,IL,3000,2476,-524,0.45215485756026297
60416,DIAMOND,IL,847,741,-106,0.46662468513853905
60417,CRETE,IL,4497,4698,201,0.5109298531810766
60418,CRESTWOOD,IL,3241,2995,-246,0.48027581783194356
60419,CHICAGO,IL,153,152,-1,0.49836065573770494
60419,DOLTON,IL,8075,7758,-317,0.4899892629318512
60420,DWIGHT,IL,2167,1776,-391,0.45041846309916306
60421,ELWOOD,IL,1246,1170,-76,0.48427152317880795
60422,FLOSSMOOR,IL,2979,3335,356,0.5281913208742477
60422,HOMEWOOD,IL,38,49,11,0.5632183908045977
60423,FRANKFORT,IL,8325,8916,591,0.5171393770662954
60424,GARDNER,IL,930,813,-117,0.4664371772805508
60425,GLENWOOD,IL,3064,2875,-189,0.48408823034180837
60426,DIXMOOR,IL,592,539,-53,0.4765694076038904
60426,HARVEY,IL,6497,5628,-869,0.46416494845360823
60426,PHOENIX,IL,579,486,-93,0.4563380281690141
60428,MARKHAM,IL,3814,3279,-535,0.4622867615959397
60429,E HAZEL CREST,IL,104,101,-3,0.4926829268292683
60429,EAST HAZEL CREST,IL,220,203,-17,0.4799054373522459
60429,HAZEL CREST,IL,5228,4957,-271,0.48669612174766813
60430,HOMEWOOD,IL,6171,6338,167,0.5066751938604205
60431,JOLIET,IL,6926,7947,1021,0.5343239427149868
60432,JOLIET,IL,5908,4789,-1119,0.44769561559315696
60433,JOLIET,IL,4976,4439,-537,0.47148167817312797
60434,JOLIET,IL,992,1610,618,0.6187548039969254
60435,JOLIET,IL,17241,14262,-2979,0.4527187886867917
60436,JOLIET,IL,6323,5282,-1041,0.45514864282636797
60436,ROCKDALE,IL,272,227,-45,0.45490981963927857
60438,LANSING,IL,10372,10218,-154,0.49626032054395336
60439,LEMONT,IL,5724,6879,1155,0.5458224232325637
60440,BOLINGBROOK,IL,16905,15634,-1271,0.48046959033774855
60441,LOCKPORT,IL,10204,9457,-747,0.4810030008646559
60442,MANHATTAN,IL,2856,3854,998,0.5743666169895678
60443,MATTESON,IL,7543,7519,-24,0.49920329305537114
60444,MAZON,IL,507,288,-219,0.3622641509433962
60445,MIDLOTHIAN,IL,4544,4016,-528,0.4691588785046729
60446,ROMEOVILLE,IL,12882,11650,-1232,0.47488993967063425
60447,MINOOKA,IL,4606,4395,-211,0.4882790801022109
60448,MOKENA,IL,6378,6554,176,0.5068048252397155
60449,MONEE,IL,2801,3068,267,0.5227466348611348
60450,MORRIS,IL,8267,7899,-368,0.488618087343808
60451,NEW LENOX,IL,9186,9124,-62,0.49830693610049154
60452,OAK FOREST,IL,7432,6950,-482,0.48324294256709777
60453,OAK LAWN,IL,15811,13737,-2074,0.46490456206849873
60454,OAK LAWN,IL,130,408,278,0.758364312267658
60455,BRIDGEVIEW,IL,4719,4322,-397,0.47804446410795265
60456,HOMETOWN,IL,1360,1076,-284,0.44170771756978655
60457,HICKORY HILLS,IL,3917,3331,-586,0.45957505518763797
60458,JUSTICE,IL,5363,4944,-419,0.4796740079557582
60459,BURBANK,IL,6090,5499,-591,0.47450168263008025
60460,ODELL,IL,425,285,-140,0.4014084507042254
60461,OLYMPIA FIELDS,IL,1616,1723,107,0.5160227613057802
60461,OLYMPIA FLDS,IL,93,87,-6,0.48333333333333334
60462,ORLAND PARK,IL,11817,11907,90,0.5018968133535661
60463,PALOS HEIGHTS,IL,3446,3974,528,0.5355795148247978
60464,PALOS PARK,IL,2249,2772,523,0.5520812587134037
60465,PALOS HILLS,IL,5383,4874,-509,0.47518767670858925
60466,PARK FOREST,IL,8973,8145,-828,0.4758149316508938
60467,ORLAND PARK,IL,5752,6808,1056,0.5420382165605095
60468,PEOTONE,IL,1912,1829,-83,0.4889067094359797
60469,POSEN,IL,1165,1166,1,0.5002145002145002
60470,RANSOM,IL,15,0,-15,0
60471,RICHTON PARK,IL,5232,5022,-210,0.4897600936220012
60472,ROBBINS,IL,1774,1539,-235,0.4645336552973136
60473,SOUTH HOLLAND,IL,6349,7188,839,0.5309891408731624
60474,SOUTH WILMINGTON,IL,35,0,-35,0
60475,STEGER,IL,3970,3439,-531,0.4641652044810366
60476,THORNTON,IL,679,746,67,0.5235087719298246
60477,TINLEY PARK,IL,12302,11635,-667,0.4860675941011823
60478,CNTRY CLB HLS,IL,127,143,16,0.5296296296296297
60478,COUNTRY CLUB HILLS,IL,5766,5183,-583,0.47337656406977807
60479,VERONA,IL,25,25,0,0.5
60480,WILLOW SPGS,IL,89,120,31,0.5741626794258373
60480,WILLOW SPRINGS,IL,1543,1592,49,0.5078149920255184
60481,CUSTER PARK,IL,70,83,13,0.5424836601307189
60481,WILMINGTON,IL,4611,4103,-508,0.470851503327978
60482,WORTH,IL,3979,3598,-381,0.4748581232677841
60484,PARK FOREST,IL,59,54,-5,0.4778761061946903
60484,UNIVERSITY PARK,IL,2908,2340,-568,0.4458841463414634
60487,ORLAND HILLS,IL,1562,1542,-20,0.49677835051546393
60487,TINLEY PARK,IL,3593,3859,266,0.5178475577026301
60490,BOLINGBROOK,IL,4543,5053,510,0.5265735723218008
60491,HOMER GLEN,IL,3992,4907,915,0.5514102708169457
60491,LOCKPORT,IL,324,303,-21,0.48325358851674644
60499,BEDFORD PARK,IL,133,26,-107,0.16352201257861634
60501,ARGO,IL,67,55,-12,0.45081967213114754
60501,SUMMIT,IL,644,511,-133,0.44242424242424244
60501,SUMMIT ARGO,IL,2502,2067,-435,0.45239658568614577
60502,AURORA,IL,8453,8066,-387,0.4882862158726315
60503,AURORA,IL,3967,3993,26,0.5016331658291457
60503,NAPERVILLE,IL,65,82,17,0.5578231292517006
60504,AURORA,IL,19233,16113,-3120,0.45586487862841624
60505,AURORA,IL,15015,11631,-3384,0.43650078811078585
60506,AURORA,IL,16962,14372,-2590,0.4586710921044233
60507,AURORA,IL,649,1543,894,0.7039233576642335
60510,BATAVIA,IL,8570,8574,4,0.5001166588894074
60511,BIG ROCK,IL,306,242,-64,0.4416058394160584
60512,BRISTOL,IL,204,178,-26,0.46596858638743455
60513,BROOKFIELD,IL,5351,5106,-245,0.4882853590896051
60514,CLARENDON HILLS,IL,3121,3188,67,0.5053098747820574
60515,DOWNER,IL,167,161,-6,0.49085365853658536
60515,DOWNERS GROVE,IL,10028,10046,18,0.5004483411377901
60516,DOWNERS GROVE,IL,8502,8370,-132,0.49608819345661453
60517,WOODRIDGE,IL,13383,11438,-1945,0.46081946738648727
60518,EARLVILLE,IL,1212,1061,-151,0.4667839859216894
60520,HINCKLEY,IL,1092,892,-200,0.4495967741935484
60521,HINSDALE,IL,5721,6289,568,0.5236469608659451
60522,HINSDALE,IL,119,275,156,0.6979695431472082
60522,OAK BROOK,IL,100,278,178,0.7354497354497355
60523,OAK BROOK,IL,4594,5738,1144,0.5553619821912504
60525,HODGKINS,IL,699,709,10,0.5035511363636364
60525,INDIAN HEAD PARK,IL,216,196,-20,0.47572815533980584
60525,LA GRANGE,IL,9344,9130,-214,0.4942080762152214
60526,LA GRANGE PARK,IL,3691,3504,-187,0.48700486448922864
60527,BURR RIDGE,IL,6174,5873,-301,0.4875072632190587
60527,WILLOWBROOK,IL,5255,5330,75,0.5035427491733585
60530,LEE,IL,12,13,1,0.52
60531,LELAND,IL,430,386,-44,0.4730392156862745
60532,LISLE,IL,13749,12558,-1191,0.47736343938875586
60534,LYONS,IL,3581,3046,-535,0.45963482722197074
60537,MILLINGTON,IL,41,0,-41,0
60538,MONTGOMERY,IL,9869,8629,-1240,0.46648286301221753
60539,MOOSEHEART,IL,30,47,17,0.6103896103896104
60540,NAPERVILLE,IL,14636,14409,-227,0.4960922706145636
60541,NEWARK,IL,698,858,160,0.5514138817480719
60542,NORTH AURORA,IL,6266,6126,-140,0.49435119431891544
60543,OSWEGO,IL,12581,12764,183,0.5036101795225882
60544,PLAINFIELD,IL,10019,8967,-1052,0.4722953755398715
60545,PLANO,IL,4836,4736,-100,0.4947764312578354
60546,N RIVERSIDE,IL,119,152,33,0.5608856088560885
60546,NORTH RIVERSIDE,IL,421,492,71,0.5388828039430449
60546,RIVERSIDE,IL,3733,3766,33,0.5022002933724496
60548,SANDWICH,IL,4539,3955,-584,0.4656227925594537
60549,SERENA,IL,11,0,-11,0
60550,SHABBONA,IL,335,237,-98,0.4143356643356643
60551,SHERIDAN,IL,1204,1029,-175,0.4608150470219436
60552,SOMONAUK,IL,1929,1504,-425,0.43810078648412465
60553,STEWARD,IL,0,23,23,1
60554,SUGAR GROVE,IL,3669,3878,209,0.5138465615476349
60555,WARRENVILLE,IL,5858,5983,125,0.50527827041635
60556,WATERMAN,IL,636,513,-123,0.4464751958224543
60558,WESTERN SPRGS,IL,163,167,4,0.5060606060606061
60558,WESTERN SPRINGS,IL,2711,3299,588,0.54891846921797
60559,WESTMONT,IL,12323,10615,-1708,0.4627692039410585
60560,AURORA,IL,124,157,33,0.5587188612099644
60560,YORKVILLE,IL,8836,10090,1254,0.5331290288492021
60561,DARIEN,IL,6600,6691,91,0.5034233691972011
60563,NAPERVILLE,IL,20398,18750,-1648,0.47895167058342697
60564,NAPERVILLE,IL,12469,14581,2112,0.5390388170055452
60565,NAPERVILLE,IL,9678,10266,588,0.5147412755716004
60567,NAPERVILLE,IL,722,1122,400,0.6084598698481561
60585,PLAINFIELD,IL,5952,7244,1292,0.5489542285541074
60586,PLAINFIELD,IL,11885,11666,-219,0.49535051590166024
60598,AURORA,IL,53,391,338,0.8806306306306306
60601,CHICAGO,IL,19681,16801,-2880,0.4605284797982567
60602,CHICAGO,IL,3550,2429,-1121,0.4062552266265262
60603,CHICAGO,IL,2906,2465,-441,0.4589461925153603
60604,CHICAGO,IL,2234,1648,-586,0.4245234415249871
60605,CHICAGO,IL,27626,24814,-2812,0.4731884057971015
60606,CHICAGO,IL,9918,7968,-1950,0.4454880912445488
60607,CHICAGO,IL,25550,23890,-1660,0.48321197411003236
60608,CHICAGO,IL,24211,19355,-4856,0.4442684662351375
60609,CHICAGO,IL,15004,11974,-3030,0.44384313144043297
60610,CHICAGO,IL,38334,32131,-6203,0.45598524089973747
60611,CHICAGO,IL,36194,30475,-5719,0.4571090011849585
60612,CHICAGO,IL,17291,15360,-1931,0.4704296958745521
60613,CHICAGO,IL,40798,32665,-8133,0.444645603909451
60614,CHICAGO,IL,53102,42079,-11023,0.44209453567413665
60615,CHICAGO,IL,26918,21654,-5264,0.44581240220703283
60616,CHICAGO,IL,23966,20105,-3861,0.45619568423679974
60617,CHICAGO,IL,21045,19307,-1738,0.4784645122918319
60618,CHICAGO,IL,40541,35258,-5283,0.46515125529360546
60619,CHICAGO,IL,24954,22842,-2112,0.47790610092894803
60620,CHICAGO,IL,24541,22005,-2536,0.4727581317406437
60621,CHICAGO,IL,12098,10802,-1296,0.47170305676855895
60622,CHICAGO,IL,38457,32060,-6397,0.4546421430293404
60623,CHICAGO,IL,19549,15095,-4454,0.4357175845745295
60624,CHICAGO,IL,15222,13168,-2054,0.46382529059528005
60625,CHICAGO,IL,34081,28146,-5935,0.45231169749465666
60626,CHICAGO,IL,28846,23100,-5746,0.44469256535633156
60628,CHICAGO,IL,21354,19305,-2049,0.4748026267247104
60629,CHICAGO,IL,23068,18798,-4270,0.4490039650312903
60630,CHICAGO,IL,15810,14674,-1136,0.48136727463587453
60630,JEFFERSON PARK,IL,630,552,-78,0.467005076142132
60631,CHICAGO,IL,8123,8123,0,0.5
60632,CHICAGO,IL,14885,11441,-3444,0.43458937932082353
60633,BURNHAM,IL,405,413,8,0.5048899755501223
60633,CHICAGO,IL,2819,2729,-90,0.4918889689978371
60634,CHICAGO,IL,19968,18058,-1910,0.47488560458633566
60636,CHICAGO,IL,11558,10011,-1547,0.46413834670128423
60637,CHICAGO,IL,23874,20153,-3721,0.4577418402344016
60638,BEDFORD PARK,IL,713,717,4,0.5013986013986014
60638,CHICAGO,IL,11529,10460,-1069,0.47569239165037064
60639,CHICAGO,IL,22849,17823,-5026,0.4382130212431157
60640,CHICAGO,IL,45024,39783,-5241,0.469100428030705
60641,CHICAGO,IL,24446,21267,-3179,0.4652287095574563
60642,CHICAGO,IL,18328,15440,-2888,0.4572376214167259
60643,CHICAGO,IL,13379,13948,569,0.5104109488783987
60644,CHICAGO,IL,18641,15632,-3009,0.4561024713331194
60645,CHICAGO,IL,16090,13086,-3004,0.4485193309569509
60646,CHICAGO,IL,6645,6994,349,0.512794193122663
60647,CHICAGO,IL,52617,45013,-7604,0.46105705213561404
60649,CHICAGO,IL,23531,19773,-3758,0.4566090892296324
60651,CHICAGO,IL,20137,16364,-3773,0.44831648447987726
60652,CHICAGO,IL,7519,7279,-240,0.49189079605352076
60653,CHICAGO,IL,13659,13019,-640,0.4880050978334208
60654,CHICAGO,IL,29941,23818,-6123,0.44305139604531335
60655,CHICAGO,IL,5491,5502,11,0.5005003183844264
60656,CHICAGO,IL,10578,9413,-1165,0.4708618878495323
60657,CHICAGO,IL,62189,48190,-13999,0.43658666956576886
60659,CHICAGO,IL,15348,12499,-2849,0.4488454770711387
60660,CHICAGO,IL,25175,21109,-4066,0.4560755336617406
60661,CHICAGO,IL,16891,13184,-3707,0.4383707398171239
60664,CHICAGO,IL,0,24,24,1
60680,CHICAGO,IL,962,1935,973,0.6679323438039351
60690,CHICAGO,IL,806,1191,385,0.5963945918878317
60699,CHICAGO,IL,98,49,-49,0.3333333333333333
60706,CHICAGO,IL,198,174,-24,0.46774193548387094
60706,HARWOOD HEIGHTS,IL,3321,3276,-45,0.4965893587994543
60706,NORRIDGE,IL,2758,2547,-211,0.48011310084825637
60707,CHICAGO,IL,4963,4396,-567,0.46970830216903514
60707,ELMWOOD PARK,IL,8250,7437,-813,0.47408682348441383
60712,LINCOLNWOOD,IL,3274,3705,431,0.5308783493337155
60714,NILES,IL,8211,8150,-61,0.49813581076951285
60803,ALSIP,IL,5221,4545,-676,0.4653901290190457
60803,CHICAGO,IL,111,92,-19,0.45320197044334976
60803,MERRIONETTE PARK,IL,852,782,-70,0.4785801713586291
60804,CICERO,IL,15648,12414,-3234,0.442377592473808
60805,AURORA,IL,68,54,-14,0.4426229508196721
60805,CHICAGO,IL,124,89,-35,0.41784037558685444
60805,EVERGREEN PARK,IL,4119,4218,99,0.5059373875494783
60805,EVERGREEN PK,IL,59,71,12,0.5461538461538461
60827,CALUMET PARK,IL,2073,1835,-238,0.4695496417604913
60827,CHICAGO,IL,1693,1485,-208,0.4672750157331655
60827,RIVERDALE,IL,6135,5421,-714,0.4691069574247144
60901,KANKAKEE,IL,19758,13070,-6688,0.3981357377848178
60910,AROMA PARK,IL,164,28,-136,0.14583333333333334
60911,ASHKUM,IL,253,136,-117,0.3496143958868895
60912,BEAVERVILLE,IL,0,12,12,1
60913,BONFIELD,IL,49,142,93,0.743455497382199
60914,BOURBONNAIS,IL,11618,10676,-942,0.4788732394366197
60915,BRADLEY,IL,5531,4041,-1490,0.42216882574174674
60918,BUCKLEY,IL,76,58,-18,0.43283582089552236
60919,CABERY,IL,12,11,-1,0.4782608695652174
60921,CHATSWORTH,IL,832,560,-272,0.40229885057471265
60922,CHEBANSE,IL,829,647,-182,0.4383468834688347
60924,CISSNA PARK,IL,294,307,13,0.5108153078202995
60927,CLIFTON,IL,576,562,-14,0.4938488576449912
60928,CRESCENT CITY,IL,57,24,-33,0.2962962962962963
60929,CULLOM,IL,177,52,-125,0.22707423580786026
60930,DANFORTH,IL,55,101,46,0.6474358974358975
60931,DONOVAN,IL,71,25,-46,0.2604166666666667
60933,ELLIOTT,IL,11,0,-11,0
60935,ESSEX,IL,46,126,80,0.7325581395348837
60936,GIBSON CITY,IL,1653,1580,-73,0.4887101763068358
60938,GILMAN,IL,793,552,-241,0.4104089219330855
60940,GRANT PARK,IL,992,862,-130,0.46494066882416396
60941,HERSCHER,IL,325,283,-42,0.4654605263157895
60942,HOOPESTON,IL,3642,2967,-675,0.44893327280980483
60948,LODA,IL,427,473,46,0.5255555555555556
60949,LUDLOW,IL,76,61,-15,0.44525547445255476
60950,MANTENO,IL,4363,4250,-113,0.4934401486125624
60951,MARTINTON,IL,61,34,-27,0.35789473684210527
60952,MELVIN,IL,124,26,-98,0.17333333333333334
60953,MILFORD,IL,953,745,-208,0.4387514723203769
60954,MOMENCE,IL,2179,1847,-332,0.45876800794833583
60955,ONARGA,IL,255,125,-130,0.32894736842105265
60957,PAXTON,IL,2230,2001,-229,0.47293783975419523
60958,PEMBROKE,IL,0,17,17,1
60958,PEMBROKE TOWNSHIP,IL,424,299,-125,0.4135546334716459
60958,PEMBROKE TWP,IL,12,0,-12,0
60959,PIPER CITY,IL,182,170,-12,0.48295454545454547
60960,CLARENCE,IL,92,51,-41,0.35664335664335667
60960,RANKIN,IL,429,178,-251,0.2932454695222405
60961,REDDICK,IL,13,52,39,0.8
60962,ROBERTS,IL,12,15,3,0.5555555555555556
60963,ROSSVILLE,IL,601,520,-81,0.463871543264942
60964,SAINT ANNE,IL,1570,1344,-226,0.4612216884008236
60964,SUN RIVER TERRACE,IL,116,100,-16,0.46296296296296297
60966,SHELDON,IL,430,232,-198,0.3504531722054381
60968,THAWVILLE,IL,11,0,-11,0
60970,WATSEKA,IL,3425,3114,-311,0.4762196054442575
60973,WELLINGTON,IL,49,0,-49,0
61001,APPLE RIVER,IL,551,345,-206,0.38504464285714285
61006,ASHTON,IL,292,323,31,0.5252032520325203
61008,BELVIDERE,IL,10773,10175,-598,0.4857265610082108
61010,BYRON,IL,2680,2448,-232,0.47737909516380655
61011,CALEDONIA,IL,630,777,147,0.5522388059701493
61012,CAPRON,IL,618,439,-179,0.4153263954588458
61013,CEDARVILLE,IL,12,12,0,0.5
61014,CHADWICK,IL,106,49,-57,0.3161290322580645
61015,CHANA,IL,0,11,11,1
61016,CHERRY VALLEY,IL,1520,1508,-12,0.49801849405548215
61016,ROCFORD,IL,37,24,-13,0.39344262295081966
61018,DAKOTA,IL,64,41,-23,0.3904761904761905
61019,DAVIS,IL,1334,1223,-111,0.47829487680876026
61020,DAVIS JCT,IL,14,17,3,0.5483870967741935
61020,DAVIS JUNCTION,IL,663,752,89,0.5314487632508834
61021,DIXON,IL,9616,8477,-1139,0.46852373846238876
61024,DURAND,IL,695,695,0,0.5
61025,EAST DUBUQUE,IL,1379,1247,-132,0.47486671744097486
61028,ELIZABETH,IL,489,471,-18,0.490625
61030,FORRESTON,IL,572,477,-95,0.4547187797902765
61031,FRANKLIN GROVE,IL,274,219,-55,0.44421906693711966
61031,FRANKLIN GRV,IL,16,0,-16,0
61032,FREEPORT,IL,14869,12093,-2776,0.44852013945553
61036,GALENA,IL,3286,3349,63,0.5047475508666164
61038,GARDEN PR,IL,0,12,12,1
61038,GARDEN PRAIRIE,IL,61,149,88,0.7095238095238096
61039,GERMAN VALLEY,IL,0,13,13,1
61041,HANOVER,IL,553,358,-195,0.3929747530186608
61046,LANARK,IL,1315,1260,-55,0.4893203883495146
61047,LEAF RIVER,IL,360,298,-62,0.45288753799392095
61048,LENA,IL,1217,1183,-34,0.49291666666666667
61049,LINDENWOOD,IL,14,0,-14,0
61051,MILLEDGEVILLE,IL,369,319,-50,0.4636627906976744
61052,MONROE CENTER,IL,116,76,-40,0.3958333333333333
61053,MOUNT CARROLL,IL,884,844,-40,0.48842592592592593
61054,MOUNT MORRIS,IL,1750,1514,-236,0.4638480392156863
61054,MT MORRIS,IL,72,46,-26,0.3898305084745763
61060,ORANGEVILLE,IL,329,248,-81,0.42980935875216636
61061,OREGON,IL,2768,2760,-8,0.4992764109985528
61062,PEARL CITY,IL,234,230,-4,0.4956896551724138
61063,PECATONICA,IL,1092,1057,-35,0.49185667752442996
61064,POLO,IL,1256,1171,-85,0.4824886691388546
61065,POPLAR GROVE,IL,3388,3384,-4,0.49970466627288834
61067,RIDOTT,IL,0,23,23,1
61068,ROCHELLE,IL,6034,5578,-456,0.48036513951085086
61070,ROCK CITY,IL,51,11,-40,0.1774193548387097
61071,ROCK FALLS,IL,6940,5662,-1278,0.4492937628947786
61072,ROCKTON,IL,3153,3373,220,0.5168556543058536
61073,ROSCOE,IL,6777,6700,-77,0.49714328114565554
61074,SAVANNA,IL,1973,1631,-342,0.4525527192008879
61075,SCALES MOUND,IL,37,37,0,0.5
61078,SHANNON,IL,186,212,26,0.5326633165829145
61080,SOUTH BELOIT,IL,4593,3669,-924,0.444081336238199
61081,STERLING,IL,10220,8175,-2045,0.44441424300081545
61084,STILLMAN VALLEY,IL,801,767,-34,0.48915816326530615
61084,STILLMAN VLY,IL,41,45,4,0.5232558139534884
61085,STOCKTON,IL,1323,1188,-135,0.4731182795698925
61087,WARREN,IL,622,426,-196,0.4064885496183206
61088,WINNEBAGO,IL,1494,1469,-25,0.49578130273371585
61089,WINSLOW,IL,56,39,-17,0.4105263157894737
61101,ROCKFORD,IL,10546,9385,-1161,0.47087451708393957
61102,ROCKFORD,IL,7821,6114,-1707,0.438751345532831
61103,ROCKFORD,IL,13054,11618,-1436,0.4708981841763943
61104,ROCKFORD,IL,11754,8783,-2971,0.42766713736183476
61105,ROCKFORD,IL,143,108,-35,0.4302788844621514
61106,ROCKFORD,IL,13,0,-13,0
61107,ROCKFORD,IL,14226,12909,-1317,0.47573244886677724
61108,ROCKFORD,IL,12964,12091,-873,0.48257832767910597
61109,ROCKFORD,IL,13276,11001,-2275,0.4531449520121926
61110,ROCKFORD,IL,457,78,-379,0.14579439252336449
61111,LOVES PARK,IL,10520,10088,-432,0.48951863354037267
61112,ROCKFORD,IL,11,0,-11,0
61114,ROCKFORD,IL,6036,5731,-305,0.487040027194697
61115,MACHESNEY PARK,IL,8038,7783,-255,0.4919410909550597
61115,MACHESNEY PK,IL,138,153,15,0.5257731958762887
61125,ROCKFORD,IL,815,1197,382,0.5949304174950298
61126,ROCKFORD,IL,298,143,-155,0.3242630385487528
61130,LOVES PARK,IL,15,0,-15,0
61131,LOVES PARK,IL,37,0,-37,0
61132,LOVES PARK,IL,200,132,-68,0.39759036144578314
61201,ROCK ISLAND,IL,18484,14922,-3562,0.44668622403161107
61204,ROCK ISLAND,IL,218,111,-107,0.3373860182370821
61230,ALBANY,IL,102,103,1,0.5024390243902439
61231,ALEDO,IL,2225,1845,-380,0.4533169533169533
61232,ANDALUSIA,IL,187,143,-44,0.43333333333333335
61232,SILVIS,IL,0,16,16,1
61234,ANNAWAN,IL,180,179,-1,0.4986072423398329
61234,CC,IL,14,12,-2,0.46153846153846156
61235,ATKINSON,IL,178,89,-89,0.3333333333333333
61238,CAMBRIDGE,IL,888,860,-28,0.4919908466819222
61239,CARBON CLIFF,IL,1107,551,-556,0.3323281061519904
61240,COAL VALLEY,IL,1861,2000,139,0.518000518000518
61241,CLEVELAND,IL,46,57,11,0.5533980582524272
61241,COLONA,IL,2469,2258,-211,0.4776814046964248
61242,CORDOVA,IL,240,102,-138,0.2982456140350877
61244,EAST MOLINE,IL,11119,8918,-2201,0.4450766082746918
61250,ERIE,IL,972,813,-159,0.45546218487394957
61252,FULTON,IL,2097,1920,-177,0.47796863330843914
61254,GENESEO,IL,3286,3550,264,0.5193095377413692
61256,HAMPTON,IL,618,535,-83,0.4640069384215091
61257,HILLSDALE,IL,547,236,-311,0.30140485312899107
61257,PT BYRON,IL,11,0,-11,0
61259,ILLINOIS CITY,IL,49,43,-6,0.4673913043478261
61260,JOY,IL,124,48,-76,0.27906976744186046
61261,LYNDON,IL,247,148,-99,0.37468354430379747
61262,LYNN CENTER,IL,11,23,12,0.6764705882352942
61263,MATHERVILLE,IL,68,11,-57,0.13924050632911392
61264,MILAN,IL,4516,3750,-766,0.4536656181950157
61265,MOLINE,IL,21299,18153,-3146,0.46012876406772785
61266,MOLINE,IL,589,149,-440,0.2018970189701897
61270,MORRISON,IL,2673,2374,-299,0.4703784426391916
61272,NEW BOSTON,IL,224,172,-52,0.43434343434343436
61273,ORION,IL,1027,834,-193,0.44814615797958085
61275,PORT BYRON,IL,1563,1580,17,0.5027044225262488
61277,PROPHETSTOWN,IL,1132,1089,-43,0.49031967582170194
61278,RAPIDS CITY,IL,72,0,-72,0
61279,REYNOLDS,IL,98,42,-56,0.3
61281,SHERRARD,IL,743,613,-130,0.45206489675516226
61282,SILVIS,IL,4112,3498,-614,0.45965834428383706
61283,TAMPICO,IL,412,180,-232,0.30405405405405406
61284,TAYLOR RIDGE,IL,430,509,79,0.5420660276890309
61285,THOMSON,IL,465,497,32,0.5166320166320166
61301,LA SALLE,IL,4428,3967,-461,0.47254318046456223
61310,AMBOY,IL,1715,1419,-296,0.45277600510529675
61314,BUDA,IL,86,11,-75,0.1134020618556701
61315,BUREAU,IL,11,0,-11,0
61317,CHERRY,IL,28,0,-28,0
61318,COMPTON,IL,11,0,-11,0
61319,CORNELL,IL,91,50,-41,0.3546099290780142
61320,DALZELL,IL,0,11,11,1
61322,DEPUE,IL,268,74,-194,0.21637426900584794
61325,GRAND RIDGE,IL,46,24,-22,0.34285714285714286
61326,GRANVILLE,IL,609,443,-166,0.4211026615969582
61327,HENNEPIN,IL,327,146,-181,0.3086680761099366
61329,LADD,IL,187,90,-97,0.3249097472924188
61330,LA MOILLE,IL,185,127,-58,0.40705128205128205
61333,LONG POINT,IL,0,11,11,1
61334,LOSTANT,IL,27,0,-27,0
61335,MC NABB,IL,11,0,-11,0
61336,MAGNOLIA,IL,22,13,-9,0.37142857142857144
61338,MANLIUS,IL,25,0,-25,0
61341,MARSEILLES,IL,3400,3078,-322,0.4751466502006792
61342,MENDOTA,IL,3548,2926,-622,0.45196169292554833
61342,MENDPTA,IL,90,48,-42,0.34782608695652173
61344,MINERAL,IL,13,12,-1,0.48
61345,NEPONSET,IL,27,50,23,0.6493506493506493
61348,OGLESBY,IL,1609,1504,-105,0.4831352393189849
61349,OHIO,IL,192,89,-103,0.3167259786476868
61350,OTTAWA,IL,10180,9181,-999,0.47420071277310055
61353,PAW PAW,IL,310,113,-197,0.26713947990543735
61354,PERU,IL,3888,3436,-452,0.4691425450573457
61356,PRINCETON,IL,4292,4171,-121,0.49285123478671866
61358,RUTLAND,IL,12,15,3,0.5555555555555556
61360,SENECA,IL,1849,1376,-473,0.4266666666666667
61361,SHEFFIELD,IL,372,253,-119,0.4048
61362,SPRING VALLEY,IL,2204,1836,-368,0.45445544554455447
61364,STREATOR,IL,7639,6671,-968,0.46617749825296995
61367,SUBLETTE,IL,392,365,-27,0.4821664464993395
61368,TISKILWA,IL,206,140,-66,0.4046242774566474
61369,TOLUCA,IL,748,518,-230,0.40916271721958924
61370,TONICA,IL,164,108,-56,0.39705882352941174
61373,UTICA,IL,624,537,-87,0.4625322997416021
61375,VARNA,IL,369,268,-101,0.4207221350078493
61376,WALNUT,IL,702,566,-136,0.44637223974763407
61377,WENONA,IL,591,405,-186,0.4066265060240964
61378,WEST BROOKLYN,IL,23,16,-7,0.41025641025641024
61379,WYANET,IL,345,115,-230,0.25
61401,GALESBURG,IL,17266,13121,-4145,0.4317964919208872
61402,GALESBURG,IL,271,153,-118,0.3608490566037736
61410,ABINGDON,IL,1733,1460,-273,0.4572502348888193
61411,ADAIR,IL,24,0,-24,0
61412,ALEXIS,IL,432,277,-155,0.3906911142454161
61413,ALPHA,IL,201,122,-79,0.37770897832817335
61414,ALTONA,IL,27,0,-27,0
61415,AVON,IL,590,381,-209,0.39237899073120497
61416,BARDOLPH,IL,11,0,-11,0
61418,BIGGSVILLE,IL,11,0,-11,0
61420,BLANDINSVILLE,IL,158,99,-59,0.3852140077821012
61421,BRADFORD,IL,125,115,-10,0.4791666666666667
61422,BUSHNELL,IL,1686,1414,-272,0.4561290322580645
61423,CAMERON,IL,0,11,11,1
61427,CUBA,IL,984,751,-233,0.4328530259365994
61428,DAHINDA,IL,373,369,-4,0.4973045822102426
61430,E GALESBURG,IL,0,13,13,1
61430,EAST GALESBURG,IL,66,38,-28,0.36538461538461536
61431,ELLISVILLE,IL,0,13,13,1
61432,FAIRVIEW,IL,11,0,-11,0
61434,GALVA,IL,1354,1049,-305,0.43653766125676235
61436,DELONG,IL,11,0,-11,0
61436,GILSON,IL,0,14,14,1
61437,GLADSTONE,IL,85,26,-59,0.23423423423423423
61438,GOOD HOPE,IL,55,36,-19,0.3956043956043956
61439,HENDERSON,IL,26,0,-26,0
61440,INDUSTRY,IL,78,11,-67,0.12359550561797752
61441,IPAVA,IL,27,57,30,0.6785714285714286
61442,KEITHSBURG,IL,96,40,-56,0.29411764705882354
61443,KEWANEE,IL,6518,5257,-1261,0.4464543524416136
61447,KIRKWOOD,IL,145,47,-98,0.24479166666666666
61448,KNOXVILLE,IL,1256,1226,-30,0.4939564867042707
61450,LA HARPE,IL,385,263,-122,0.4058641975308642
61453,LITTLE YORK,IL,75,11,-64,0.12790697674418605
61454,LOMAX,IL,15,0,-15,0
61455,MACOMB,IL,9692,8409,-1283,0.46455996906248276
61458,MAQUON,IL,48,37,-11,0.43529411764705883
61462,MONMOUTH,IL,4472,3850,-622,0.4626291756789233
61465,NEW WINDSOR,IL,245,150,-95,0.379746835443038
61467,ONEIDA,IL,198,119,-79,0.3753943217665615
61469,OQUAWKA,IL,936,640,-296,0.40609137055837563
61471,RARITAN,IL,12,0,-12,0
61472,RIO,IL,17,0,-17,0
61473,ROSEVILLE,IL,340,308,-32,0.47530864197530864
61474,SAINT AUGUSTINE,IL,12,0,-12,0
61476,SEATON,IL,25,13,-12,0.34210526315789475
61480,STRONGHURST,IL,340,236,-104,0.4097222222222222
61482,TABLE GROVE,IL,63,12,-51,0.16
61483,TOULON,IL,694,639,-55,0.47936984246061515
61484,VERMONT,IL,58,95,37,0.6209150326797386
61485,VICTORIA,IL,12,11,-1,0.4782608695652174
61486,VIOLA,IL,239,272,33,0.5322896281800391
61488,WATAGA,IL,415,151,-264,0.2667844522968198
61489,WILLIAMSFIELD,IL,40,11,-29,0.21568627450980393
61490,WOODHULL,IL,253,78,-175,0.23564954682779457
61491,WYOMING,IL,638,539,-99,0.45794392523364486
61501,ASTORIA,IL,486,327,-159,0.4022140221402214
61516,BENSON,IL,33,0,-33,0
61517,BRIMFIELD,IL,763,684,-79,0.4727021423635107
61520,BANNER,IL,409,416,7,0.5042424242424243
61520,CANTON,IL,6608,5940,-668,0.47338221230474975
61523,CHILLICOTHE,IL,4508,3729,-779,0.4527133665169358
61524,DUNFERMLINE,IL,14,0,-14,0
61525,DUNLAP,IL,3466,3583,117,0.5082990495105689
61526,EDELSTEIN,IL,35,84,49,0.7058823529411765
61528,EDWARDS,IL,699,764,65,0.5222146274777854
61529,ELMWOOD,IL,914,842,-72,0.479498861047836
61530,EUREKA,IL,2478,2200,-278,0.47028644719965795
61531,FARMINGTON,IL,1382,1246,-136,0.4741248097412481
61532,FOREST CITY,IL,50,23,-27,0.3150684931506849
61533,GLASFORD,IL,723,555,-168,0.43427230046948356
61534,GREEN VALLEY,IL,268,233,-35,0.46506986027944114
61535,GROVELAND,IL,292,238,-54,0.4490566037735849
61536,HANNA CITY,IL,891,798,-93,0.4724689165186501
61537,HENRY,IL,1129,1047,-82,0.4811580882352941
61540,LACON,IL,1017,998,-19,0.49528535980148886
61542,LEWISTOWN,IL,1314,1236,-78,0.48470588235294115
61544,LONDON MILLS,IL,23,25,2,0.5208333333333334
61545,LOWPOINT,IL,0,17,17,1
61546,MANITO,IL,1338,1214,-124,0.47570532915360503
61547,MAPLETON,IL,942,991,49,0.512674599068805
61548,GERMANTOWN HILLS,IL,1252,1300,48,0.5094043887147336
61548,METAMORA,IL,1964,2136,172,0.5209756097560976
61550,MORTON,IL,7400,6628,-772,0.4724836042201312
61552,MOSSVILLE,IL,0,13,13,1
61554,MARQUETTE HEIGHTS,IL,681,663,-18,0.49330357142857145
61554,PEKIN,IL,17543,15855,-1688,0.47472902569016107
61555,PEKIN,IL,37,29,-8,0.4393939393939394
61559,PRINCEVILLE,IL,982,807,-175,0.4510899944102851
61560,PUTNAM,IL,49,76,27,0.608
61561,ROANOKE,IL,793,689,-104,0.4649122807017544
61562,ROME,IL,12,0,-12,0
61563,SAINT DAVID,IL,81,36,-45,0.3076923076923077
61564,SOUTH PEKIN,IL,364,142,-222,0.28063241106719367
61565,HOPEWELL,IL,26,28,2,0.5185185185185185
61565,SPARLAND,IL,105,127,22,0.5474137931034483
61567,TOPEKA,IL,78,113,35,0.5916230366492147
61568,TREMONT,IL,1130,1183,53,0.5114569822741029
61569,TRIVOLI,IL,47,95,48,0.6690140845070423
61570,WASHBURN,IL,636,490,-146,0.4351687388987567
61571,WASHINGTON,IL,8663,8040,-623,0.48135065557085555
61572,YATES CITY,IL,39,46,7,0.5411764705882353
61601,PEORIA,IL,1033,788,-245,0.4327292696320703
61602,PEORIA,IL,1429,947,-482,0.3985690235690236
61603,PEORIA,IL,8642,6991,-1651,0.44719503614149553
61604,BELLEVUE,IL,391,269,-122,0.4075757575757576
61604,PEORIA,IL,14835,12122,-2713,0.44967911859628296
61605,PEORIA,IL,8384,6181,-2203,0.4243734981119121
61606,PEORIA,IL,4040,2279,-1761,0.36065833201455927
61607,BARTONVILLE,IL,2930,2613,-317,0.4714053761500992
61607,PEORIA,IL,826,772,-54,0.4831038798498123
61610,CREVE COEUR,IL,2588,2056,-532,0.4427217915590009
61611,EAST PEORIA,IL,10274,9046,-1228,0.46821946169772255
61612,PEORIA,IL,1354,638,-716,0.32028112449799195
61614,PEORIA,IL,15629,13198,-2431,0.4578346688868075
61615,PEORIA,IL,13519,11606,-1913,0.4619303482587065
61616,PEORIA,IL,245,203,-42,0.453125
61616,PEORIA HEIGHTS,IL,2902,2323,-579,0.4445933014354067
61616,PEORIA HTS,IL,375,276,-99,0.423963133640553
61656,PEORIA,IL,0,24,24,1
61701,BLOOMINGTON,IL,18415,16508,-1907,0.4726970764252785
61702,BLOOMINGTON,IL,1149,773,-376,0.40218522372528615
61704,BLOOMINGTON,IL,16952,15865,-1087,0.48343846177286165
61705,BLOOMINGTON,IL,4645,5134,489,0.5250025564986195
61721,ARMINGTON,IL,11,0,-11,0
61722,ARROWSMITH,IL,11,0,-11,0
61723,ATLANTA,IL,719,765,46,0.5154986522911051
61725,CARLOCK,IL,241,106,-135,0.30547550432276654
61726,CHENOA,IL,1329,1013,-316,0.43253629376601194
61727,CLINTON,IL,4234,3777,-457,0.4714767195106728
61728,COLFAX,IL,633,280,-353,0.3066812705366922
61729,CONGERVILLE,IL,27,38,11,0.5846153846153846
61730,COOKSVILLE,IL,22,0,-22,0
61732,DANVERS,IL,373,302,-71,0.4474074074074074
61733,DEER CREEK,IL,273,150,-123,0.3546099290780142
61734,DELAVAN,IL,1229,1051,-178,0.46096491228070174
61736,DOWNS,IL,350,383,33,0.5225102319236017
61736,HOLDER,IL,22,13,-9,0.37142857142857144
61737,ELLSWORTH,IL,11,13,2,0.5416666666666666
61738,EL PASO,IL,1302,1307,5,0.5009582215408203
61738,KAPPA,IL,96,79,-17,0.4514285714285714
61739,FAIRBURY,IL,1834,1615,-219,0.4682516671498985
61740,FLANAGAN,IL,336,359,23,0.516546762589928
61741,FORREST,IL,417,336,-81,0.44621513944223107
61742,GOODFIELD,IL,393,174,-219,0.30687830687830686
61743,GRAYMONT,IL,12,0,-12,0
61744,GRIDLEY,IL,405,432,27,0.5161290322580645
61745,HEYWORTH,IL,1214,1233,19,0.5038823048630977
61747,HOPEDALE,IL,294,183,-111,0.3836477987421384
61748,HUDSON,IL,669,637,-32,0.4877488514548239
61749,KENNEY,IL,0,24,24,1
61752,LE ROY,IL,1395,1228,-167,0.4681662218833397
61753,LEXINGTON,IL,1055,936,-119,0.47011551983927674
61754,MC LEAN,IL,103,92,-11,0.4717948717948718
61755,MACKINAW,IL,1430,1346,-84,0.48487031700288186
61756,MAROA,IL,754,683,-71,0.47529575504523314
61759,MINIER,IL,540,383,-157,0.41495124593716143
61760,MINONK,IL,1090,839,-251,0.43494038361845516
61761,NORMAL,IL,19798,16929,-2869,0.46094154164511125
61764,PONTIAC,IL,5588,5173,-415,0.48071740544559055
61769,SAUNEMIN,IL,23,22,-1,0.4888888888888889
61770,SAYBROOK,IL,22,164,142,0.8817204301075269
61771,SECOR,IL,24,23,-1,0.48936170212765956
61773,SIBLEY,IL,27,0,-27,0
61774,STANFORD,IL,184,40,-144,0.17857142857142858
61776,TOWANDA,IL,111,97,-14,0.46634615384615385
61777,WAPELLA,IL,52,47,-5,0.47474747474747475
61778,WAYNESVILLE,IL,12,0,-12,0
61801,URBANA,IL,17173,11870,-5303,0.40870433495162345
61802,URBANA,IL,10975,9672,-1303,0.46844577904780355
61803,URBANA,IL,229,477,248,0.6756373937677054
61810,ALLERTON,IL,24,0,-24,0
61811,ALVIN,IL,11,0,-11,0
61813,BEMENT,IL,542,469,-73,0.4638971315529179
61814,BISMARCK,IL,103,127,24,0.5521739130434783
61815,BONDVILLE,IL,69,59,-10,0.4609375
61817,CATLIN,IL,850,747,-103,0.46775203506574825
61818,CERRO GORDO,IL,558,345,-213,0.38205980066445183
61820,CHAMPAIGN,IL,20301,13987,-6314,0.407926971535231
61821,CHAMPAIGN,IL,16209,13820,-2389,0.4602217856072463
61822,CHAMPAIGN,IL,12061,12065,4,0.5000828981182127
61824,CHAMPAIGN,IL,83,168,85,0.6693227091633466
61825,CHAMPAIGN,IL,0,11,11,1
61826,CHAMPAIGN,IL,266,519,253,0.6611464968152866
61830,CISCO,IL,12,0,-12,0
61832,DANVILLE,IL,18461,16237,-2224,0.4679520433454378
61832,TILTON,IL,304,257,-47,0.45811051693404636
61833,DANVILLE,IL,74,53,-21,0.41732283464566927
61833,TILTON,IL,894,619,-275,0.4091209517514871
61834,DANVILLE,IL,2022,2116,94,0.5113581440309328
61839,DE LAND,IL,82,11,-71,0.11827956989247312
61840,DEWEY,IL,0,31,31,1
61841,FAIRMOUNT,IL,388,122,-266,0.23921568627450981
61842,FARMER CITY,IL,938,873,-65,0.4820541137493098
61843,FISHER,IL,1085,1006,-79,0.4811095169775227
61844,FITHIAN,IL,42,42,0,0.5
61845,FOOSLAND,IL,0,13,13,1
61846,GEORGETOWN,IL,2392,1878,-514,0.43981264637002343
61847,GIFFORD,IL,86,87,1,0.5028901734104047
61849,HOMER,IL,417,361,-56,0.4640102827763496
61851,IVESDALE,IL,13,0,-13,0
61853,MAHOMET,IL,5091,5139,48,0.5023460410557185
61854,MANSFIELD,IL,306,273,-33,0.47150259067357514
61856,LODGE,IL,138,143,5,0.5088967971530249
61856,MONTICELLO,IL,2663,2681,18,0.5016841317365269
61858,OAKWOOD,IL,1007,950,-57,0.4854368932038835
61859,OGDEN,IL,213,91,-122,0.2993421052631579
61862,PENFIELD,IL,11,0,-11,0
61863,PESOTUM,IL,23,13,-10,0.3611111111111111
61864,PHILO,IL,323,207,-116,0.3905660377358491
61865,POTOMAC,IL,243,167,-76,0.4073170731707317
61866,RANTOUL,IL,7709,7362,-347,0.48848782429832127
61870,RIDGE FARM,IL,343,268,-75,0.4386252045826514
61871,ROYAL,IL,0,12,12,1
61872,SADORUS,IL,29,0,-29,0
61873,SAINT JOSEPH,IL,1809,1647,-162,0.4765625
61874,SAVOY,IL,4258,4400,142,0.5082005082005082
61875,SEYMOUR,IL,24,15,-9,0.38461538461538464
61876,SIDELL,IL,69,0,-69,0
61877,SIDNEY,IL,607,334,-273,0.35494155154091395
61878,THOMASBORO,IL,551,404,-147,0.42303664921465967
61880,TOLONO,IL,1272,1278,6,0.5011764705882353
61882,WELDON,IL,35,45,10,0.5625
61883,WESTVILLE,IL,1608,1529,-79,0.4874083519285942
61884,WHITE HEATH,IL,117,105,-12,0.47297297297297297
61910,ARCOLA,IL,1237,1120,-117,0.4751803139584217
61911,ARTHUR,IL,1244,1025,-219,0.4517408550022036
61912,ASHMORE,IL,279,130,-149,0.31784841075794623
61913,ATWOOD,IL,452,311,-141,0.4076015727391874
61914,BETHANY,IL,426,410,-16,0.4904306220095694
61917,BROCTON,IL,12,0,-12,0
61919,CAMARGO,IL,147,40,-107,0.21390374331550802
61920,CHARLESTON,IL,10976,9815,-1161,0.47207926506661535
61924,CHRISMAN,IL,640,572,-68,0.47194719471947194
61925,DALTON CITY,IL,117,38,-79,0.24516129032258063
61929,HAMMOND,IL,12,25,13,0.6756756756756757
61929,PIERSON STATION,IL,11,0,-11,0
61931,HUMBOLDT,IL,163,39,-124,0.19306930693069307
61932,HUME,IL,14,0,-14,0
61933,KANSAS,IL,130,171,41,0.5681063122923588
61937,LAKE CITY,IL,0,14,14,1
61937,LOVINGTON,IL,617,393,-224,0.3891089108910891
61938,MATTOON,IL,10558,9489,-1069,0.47333765650720805
61942,NEWMAN,IL,420,215,-205,0.33858267716535434
61943,OAKLAND,IL,386,244,-142,0.3873015873015873
61944,PARIS,IL,5585,5076,-509,0.4761279429697027
61951,ALLENVILLE,IL,63,45,-18,0.4166666666666667
61951,SULLIVAN,IL,2963,2803,-160,0.48612556364897674
61953,TUSCOLA,IL,2560,2393,-167,0.48314153038562485
61955,VERMILION,IL,25,0,-25,0
61956,VILLA GROVE,IL,1188,1071,-117,0.47410358565737054
61957,GAYS,IL,15,16,1,0.5161290322580645
61957,WINDSOR,IL,409,421,12,0.5072289156626506
62001,ALHAMBRA,IL,174,154,-20,0.4695121951219512
62002,ALTON,IL,13769,11963,-1806,0.4649075081610446
62009,BENLD,IL,786,540,-246,0.4072398190045249
62010,BETHALTO,IL,4068,4122,54,0.5032967032967033
62011,BINGHAM,IL,11,11,0,0.5
62012,BRIGHTON,IL,1864,1710,-154,0.47845551203133746
62014,BUNKER HILL,IL,1189,1079,-110,0.4757495590828924
62015,BUTLER,IL,0,11,11,1
62016,CARROLLTON,IL,1402,1226,-176,0.4665144596651446
62017,COFFEEN,IL,197,93,-104,0.32068965517241377
62018,COTTAGE HILLS,IL,1715,1305,-410,0.43211920529801323
62021,DORSEY,IL,0,25,25,1
62022,DOW,IL,13,39,26,0.75
62024,EAST ALTON,IL,4433,3515,-918,0.4422496225465526
62025,EDWARDSVILLE,IL,12399,11701,-698,0.4855186721991701
62027,ELDRED,IL,24,0,-24,0
62028,ELSAH,IL,74,127,53,0.6318407960199005
62031,FIELDON,IL,41,12,-29,0.22641509433962265
62033,GILLESPIE,IL,1863,1588,-275,0.4601564763836569
62034,GLEN CARBON,IL,5130,4708,-422,0.4785525513315715
62035,GODFREY,IL,5568,5237,-331,0.4846830171217029
62036,GOLDEN EAGLE,IL,0,12,12,1
62037,GRAFTON,IL,526,411,-115,0.4386339381003202
62040,GRANITE CITY,IL,18407,14581,-3826,0.44200921547229294
62040,PONTOON BEACH,IL,444,332,-112,0.42783505154639173
62044,GREENFIELD,IL,590,489,-101,0.4531974050046339
62046,HAMEL,IL,40,28,-12,0.4117647058823529
62047,HARDIN,IL,221,74,-147,0.25084745762711863
62048,HARTFORD,IL,285,128,-157,0.3099273607748184
62049,HILLSBORO,IL,2639,2478,-161,0.4842681258549932
62051,IRVING,IL,41,37,-4,0.47435897435897434
62052,JERSEYVILLE,IL,4489,4379,-110,0.49379792512404147
62054,KANE,IL,121,0,-121,0
62056,LITCHFIELD,IL,3971,3319,-652,0.455281207133059
62058,LIVINGSTON,IL,249,93,-156,0.2719298245614035
62059,LOVEJOY,IL,39,0,-39,0
62060,MADISON,IL,1625,1441,-184,0.4699934768427919
62061,MARINE,IL,235,198,-37,0.45727482678983833
62062,MARYVILLE,IL,2566,2803,237,0.5220711491897932
62063,MEDORA,IL,60,53,-7,0.4690265486725664
62067,MORO,IL,592,678,86,0.5338582677165354
62069,MOUNT OLIVE,IL,1111,1086,-25,0.49431042330450614
62074,NEW DOUGLAS,IL,33,23,-10,0.4107142857142857
62075,NOKOMIS,IL,1264,1150,-114,0.4763877381938691
62077,PANAMA,IL,28,0,-28,0
62080,RAMSEY,IL,619,635,16,0.5063795853269537
62082,ROODHOUSE,IL,864,873,9,0.5025906735751295
62083,ROSAMOND,IL,49,46,-3,0.4842105263157895
62084,ROXANA,IL,672,378,-294,0.36
62086,SORENTO,IL,141,88,-53,0.38427947598253276
62087,SOUTH ROXANA,IL,1010,718,-292,0.41550925925925924
62088,STAUNTON,IL,2694,2453,-241,0.4765883038663299
62089,TAYLOR SPRINGS,IL,64,11,-53,0.14666666666666667
62090,VENICE,IL,182,42,-140,0.1875
62092,WHITE HALL,IL,1017,966,-51,0.48714069591527986
62093,WILSONVILLE,IL,74,28,-46,0.27450980392156865
62094,WITT,IL,441,197,-244,0.30877742946708464
62095,WOOD RIVER,IL,5669,4481,-1188,0.44147783251231526
62097,WORDEN,IL,886,767,-119,0.46400483968542044
62201,E SAINT LOUIS,IL,32,12,-20,0.2727272727272727
62201,EAST SAINT LOUIS,IL,1498,1027,-471,0.4067326732673267
62201,FAIRMONT CITY,IL,64,47,-17,0.42342342342342343
62201,SAUGET,IL,24,30,6,0.5555555555555556
62202,E SAINT LOUIS,IL,0,18,18,1
62202,EAST SAINT LOUIS,IL,44,355,311,0.8897243107769424
62203,CENTREVILLE,IL,48,35,-13,0.42168674698795183
62203,E SAINT LOUIS,IL,106,64,-42,0.3764705882352941
62203,EAST SAINT LOUIS,IL,2205,1990,-215,0.47437425506555425
62204,E SAINT LOUIS,IL,68,67,-1,0.4962962962962963
62204,EAST SAINT LOUIS,IL,1672,1272,-400,0.4320652173913043
62204,WASHINGTON PK,IL,199,133,-66,0.4006024096385542
62205,CENTREVILLE,IL,57,39,-18,0.40625
62205,E SAINT LOUIS,IL,224,160,-64,0.4166666666666667
62205,EAST SAINT LOUIS,IL,2350,1956,-394,0.454249883882954
62206,CAHOKIA,IL,2560,1980,-580,0.43612334801762115
62206,EAST SAINT LOUIS,IL,4558,3061,-1497,0.4017587609922562
62207,ALORTON,IL,108,62,-46,0.36470588235294116
62207,CAHOKIA HEIGHTS,IL,98,66,-32,0.4024390243902439
62207,CENTREVILLE,IL,392,281,-111,0.4175334323922734
62207,E SAINT LOUIS,IL,153,141,-12,0.47959183673469385
62207,EAST SAINT LOUIS,IL,1814,1350,-464,0.42667509481668775
62208,FAIRVIEW HEIGHTS,IL,6584,6358,-226,0.49126873744398086
62214,ADDIEVILLE,IL,0,11,11,1
62214,VENEDY,IL,0,11,11,1
62215,ALBERS,IL,176,88,-88,0.3333333333333333
62215,DAMIANSVILLE,IL,83,52,-31,0.3851851851851852
62216,AVISTON,IL,473,579,106,0.5503802281368821
62217,BALDWIN,IL,12,12,0,0.5
62218,BARTELSO,IL,11,58,47,0.8405797101449275
62219,BECKEMEYER,IL,80,39,-41,0.3277310924369748
62220,BELLEVILLE,IL,7594,6749,-845,0.47054312208045734
62221,BELLEVILLE,IL,12184,10816,-1368,0.4702608695652174
62222,BELLEVILLE,IL,46,129,83,0.7371428571428571
62223,BELLEVILLE,IL,6314,6142,-172,0.49309569685292226
62225,SCOTT AFB,IL,581,702,121,0.5471551052221356
62225,SCOTT AIR FORCE BASE,IL,2693,3284,591,0.5494395181529195
62226,BELLEVILLE,IL,3844,3709,-135,0.49106315371375614
62226,SWANSEA,IL,7603,7258,-345,0.4883924365789651
62230,BREESE,IL,1707,1691,-16,0.49764567392583875
62231,CARLYLE,IL,2208,2048,-160,0.48120300751879697
62231,SHATTUC,IL,42,43,1,0.5058823529411764
62232,CASEYVILLE,IL,2563,2374,-189,0.48085882114644524
62233,CHESTER,IL,2634,2014,-620,0.43330464716006883
62234,COLLINSVILLE,IL,11912,10810,-1102,0.4757503740867881
62236,COLUMBIA,IL,3781,3942,161,0.510423410591739
62237,COULTERVILLE,IL,791,671,-120,0.45896032831737343
62237,SWANSEA,IL,18,12,-6,0.4
62238,CUTLER,IL,77,27,-50,0.25961538461538464
62239,DUPO,IL,1733,1528,-205,0.4685679239497087
62240,EAST CARONDELET,IL,348,183,-165,0.3446327683615819
62241,ELLIS GROVE,IL,37,0,-37,0
62242,EVANSVILLE,IL,140,22,-118,0.13580246913580246
62243,FREEBURG,IL,1519,1607,88,0.5140754958413307
62245,GERMANTOWN,IL,145,129,-16,0.4708029197080292
62246,GREENVILLE,IL,3704,3019,-685,0.44905548118399524
62248,HECKER,IL,20,0,-20,0
62249,HIGHLAND,IL,5635,5279,-356,0.48369067253069453
62250,HOFFMAN,IL,60,0,-60,0
62253,KEYESPORT,IL,34,30,-4,0.46875
62254,LEBANON,IL,2163,2041,-122,0.48549000951474786
62255,LENZBURG,IL,124,120,-4,0.4918032786885246
62257,MARISSA,IL,805,882,77,0.5228215767634855
62258,MASCOUTAH,IL,3658,3267,-391,0.47176895306859207
62260,MILLSTADT,IL,1703,1787,84,0.5120343839541547
62262,MULBERRY GROVE,IL,396,371,-25,0.48370273794002605
62263,NASHVILLE,IL,1640,1629,-11,0.49831752829611503
62264,NEW ATHENS,IL,891,795,-96,0.47153024911032027
62265,NEW BADEN,IL,1532,1297,-235,0.45846588900671614
62269,O FALLON,IL,13506,14015,509,0.5092474837396896
62269,OFALLON,IL,273,251,-22,0.47900763358778625
62269,SHILOH,IL,219,260,41,0.5427974947807933
62271,OKAWVILLE,IL,684,496,-188,0.42033898305084744
62272,PERCY,IL,385,291,-94,0.43047337278106507
62274,PINCKNEYVILLE,IL,1863,1799,-64,0.4912616056799563
62275,POCAHONTAS,IL,883,903,20,0.5055991041433371
62277,PRAIRIE DU ROCHER,IL,135,34,-101,0.20118343195266272
62278,RED BUD,IL,1969,1851,-118,0.48455497382198953
62278,RUMA,IL,40,49,9,0.550561797752809
62281,SAINT JACOB,IL,677,734,57,0.520198440822112
62282,SAINT LIBORY,IL,107,24,-83,0.183206106870229
62284,SMITHBORO,IL,0,14,14,1
62284,SPARTA,IL,19,0,-19,0
62285,SMITHTON,IL,1085,1216,131,0.5284658843980878
62286,SPARTA,IL,2606,2152,-454,0.45229087852038674
62288,STEELEVILLE,IL,979,841,-138,0.4620879120879121
62289,SUMMERFIELD,IL,47,0,-47,0
62292,TILDEN,IL,99,55,-44,0.35714285714285715
62293,TRENTON,IL,1129,1074,-55,0.48751702224239674
62294,TROY,IL,5351,4948,-403,0.4804349936887076
62295,VALMEYER,IL,120,42,-78,0.25925925925925924
62298,WATERLOO,IL,4838,5052,214,0.5108190091001011
62301,QUINCY,IL,16364,13260,-3104,0.44761004590872266
62305,QUINCY,IL,5969,6004,35,0.5014616219827946
62306,QUINCY,IL,224,63,-161,0.21951219512195122
62311,AUGUSTA,IL,106,62,-44,0.36904761904761907
62312,BARRY,IL,644,610,-34,0.4864433811802233
62314,BAYLIS,IL,0,17,17,1
62320,CAMP POINT,IL,514,451,-63,0.46735751295336786
62320,COLUMBUS,IL,0,11,11,1
62321,CARTHAGE,IL,1503,1297,-206,0.4632142857142857
62321,DECATUR,IL,36,44,8,0.55
62324,CLAYTON,IL,129,125,-4,0.4921259842519685
62326,COLCHESTER,IL,798,734,-64,0.47911227154047
62330,BURNSIDE,IL,167,92,-75,0.3552123552123552
62330,DALLAS CITY,IL,578,357,-221,0.38181818181818183
62338,FOWLER,IL,52,48,-4,0.48
62339,GOLDEN,IL,25,26,1,0.5098039215686274
62340,GRIGGSVILLE,IL,448,389,-59,0.4647550776583035
62341,HAMILTON,IL,1295,1110,-185,0.46153846153846156
62343,HULL,IL,25,0,-25,0
62345,KINDERHOOK,IL,0,11,11,1
62347,LIBERTY,IL,331,172,-159,0.341948310139165
62349,LORAINE,IL,12,35,23,0.7446808510638298
62351,MENDON,IL,258,295,37,0.5334538878842676
62352,MILTON,IL,0,11,11,1
62353,MOUNT STERLING,IL,1189,1191,2,0.5004201680672269
62353,MT STERLING,IL,95,102,7,0.5177664974619289
62354,NAUVOO,IL,566,829,263,0.5942652329749104
62355,NEBO,IL,28,11,-17,0.28205128205128205
62356,NEW CANTON,IL,12,23,11,0.6571428571428571
62358,NIOTA,IL,59,22,-37,0.2716049382716049
62360,PAYSON,IL,217,194,-23,0.4720194647201946
62362,PERRY,IL,12,0,-12,0
62363,PITTSFIELD,IL,2360,2189,-171,0.4812046603649154
62366,PLEASANT HILL,IL,786,505,-281,0.3911696359411309
62367,PLYMOUTH,IL,256,139,-117,0.3518987341772152
62370,ROCKPORT,IL,13,0,-13,0
62376,URSA,IL,171,103,-68,0.3759124087591241
62378,VERSAILLES,IL,77,74,-3,0.4900662251655629
62379,WARSAW,IL,376,348,-28,0.48066298342541436
62380,WEST POINT,IL,12,0,-12,0
62401,EFFINGHAM,IL,8573,7583,-990,0.4693612280267393
62410,ALLENDALE,IL,50,23,-27,0.3150684931506849
62411,ALTAMONT,IL,1404,1408,4,0.5007112375533428
62414,BEECHER CITY,IL,274,193,-81,0.4132762312633833
62417,BRIDGEPORT,IL,1000,898,-102,0.4731296101159115
62418,BROWNSTOWN,IL,636,512,-124,0.445993031358885
62420,CASEY,IL,2013,1718,-295,0.4604663629053873
62421,CLAREMONT,IL,11,0,-11,0
62422,COWDEN,IL,277,118,-159,0.29873417721518986
62423,DENNISON,IL,13,22,9,0.6285714285714286
62424,DIETERICH,IL,343,315,-28,0.4787234042553192
62426,EDGEWOOD,IL,239,151,-88,0.3871794871794872
62427,FLAT ROCK,IL,113,88,-25,0.43781094527363185
62428,GREENUP,IL,853,891,38,0.510894495412844
62428,HAZEL DELL,IL,18,21,3,0.5384615384615384
62431,HERRICK,IL,97,76,-21,0.4393063583815029
62433,HUTSONVILLE,IL,52,59,7,0.5315315315315315
62436,JEWETT,IL,11,0,-11,0
62438,LAKEWOOD,IL,11,0,-11,0
62439,LAWRENCEVILLE,IL,3957,3290,-667,0.4539809576376432
62440,JANESVILLE,IL,12,0,-12,0
62440,LERNA,IL,225,135,-90,0.375
62441,MARSHALL,IL,2992,2679,-313,0.4724034561805678
62442,MARTINSVILLE,IL,757,686,-71,0.4753984753984754
62443,MASON,IL,115,144,29,0.555984555984556
62445,MONTROSE,IL,12,23,11,0.6571428571428571
62447,NEOGA,IL,1171,982,-189,0.45610775661867164
62448,NEWTON,IL,1868,1725,-143,0.4801001948232675
62449,NSUN,IL,21,24,3,0.5333333333333333
62449,OBLONG,IL,973,886,-87,0.4766003227541689
62450,OLNEY,IL,5947,5348,-599,0.4734838424081452
62451,PALESTINE,IL,801,673,-128,0.45658073270013566
62454,ROBINSON,IL,4618,4057,-561,0.4676657060518732
62458,SAINT ELMO,IL,499,406,-93,0.4486187845303867
62459,SAINTE MARIE,IL,11,0,-11,0
62460,SAINT FRANCISVILLE,IL,225,150,-75,0.4
62461,SHUMWAY,IL,11,58,47,0.8405797101449275
62462,SIGEL,IL,22,0,-22,0
62463,STEWARDSON,IL,210,60,-150,0.2222222222222222
62465,STRASBURG,IL,25,11,-14,0.3055555555555556
62466,OLNEY,IL,20,18,-2,0.47368421052631576
62466,SUMNER,IL,815,653,-162,0.44482288828337874
62467,TEUTOPOLIS,IL,626,486,-140,0.4370503597122302
62468,TOLEDO,IL,761,820,59,0.5186590765338394
62469,TRILLA,IL,11,0,-11,0
62471,VANDALIA,IL,3996,3657,-339,0.4778518228145825
62473,WATSON,IL,143,94,-49,0.39662447257383965
62474,WESTFIELD,IL,11,0,-11,0
62476,WEST SALEM,IL,335,289,-46,0.46314102564102566
62477,WEST UNION,IL,0,49,49,1
62480,WILLOW HILL,IL,22,0,-22,0
62481,YALE,IL,0,12,12,1
62501,ARGENTA,IL,403,406,3,0.5018541409147095
62501,OAKLEY,IL,102,106,4,0.5096153846153846
62510,ASSUMPTION,IL,550,358,-192,0.394273127753304
62512,BEASON,IL,32,0,-32,0
62513,BLUE MOUND,IL,578,522,-56,0.47454545454545455
62515,BUFFALO,IL,13,47,34,0.7833333333333333
62517,BULPITT,IL,25,22,-3,0.46808510638297873
62518,CHESTNUT,IL,0,13,13,1
62520,DAWSON,IL,178,182,4,0.5055555555555555
62521,DECATUR,IL,16098,13231,-2867,0.45112346142043713
62522,DECATUR,IL,8486,6088,-2398,0.41773020447372033
62523,DECATUR,IL,397,261,-136,0.3966565349544073
62524,DECATUR,IL,515,166,-349,0.24375917767988253
62525,DECATUR,IL,349,502,153,0.5898942420681551
62526,DECATUR,IL,20417,14552,-5865,0.41614000972289744
62530,DIVERNON,IL,429,293,-136,0.40581717451523547
62531,EDENBURG,IL,31,25,-6,0.44642857142857145
62531,EDINBURG,IL,407,352,-55,0.463768115942029
62533,FARMERSVILLE,IL,271,163,-108,0.37557603686635943
62534,FINDLAY,IL,170,130,-40,0.43333333333333335
62535,FORSYTH,IL,1201,1276,75,0.5151392813887767
62536,GLENARM,IL,0,11,11,1
62538,HARVEL,IL,11,0,-11,0
62539,ILLIOPOLIS,IL,164,122,-42,0.42657342657342656
62540,KINCAID,IL,3387,1618,-1769,0.3232767232767233
62544,MACON,IL,493,419,-74,0.4594298245614035
62545,MECHANICSBURG,IL,186,157,-29,0.4577259475218659
62546,MORRISONVILLE,IL,424,185,-239,0.30377668308702793
62547,MOUNT AUBURN,IL,23,12,-11,0.34285714285714286
62548,MOUNT PULASKI,IL,531,494,-37,0.4819512195121951
62549,MOUNT ZION,IL,296,253,-43,0.46083788706739526
62549,MT ZION,IL,1959,1849,-110,0.4855567226890756
62550,MOWEAQUA,IL,759,774,15,0.5048923679060665
62551,NIANTIC,IL,87,63,-24,0.42
62553,OCONEE,IL,11,0,-11,0
62554,OREANA,IL,259,245,-14,0.4861111111111111
62555,OWANECO,IL,12,0,-12,0
62556,PALMER,IL,0,11,11,1
62557,PANA,IL,3258,2632,-626,0.4468590831918506
62558,PAWNEE,IL,1413,1245,-168,0.4683972911963883
62560,RAYMOND,IL,395,346,-49,0.4669365721997301
62561,RIVERTON,IL,1770,1731,-39,0.4944301628106255
62561,SPAULDING,IL,303,257,-46,0.4589285714285714
62563,ROCHESTER,IL,1766,1705,-61,0.49121290694324404
62565,SHELBYVILLE,IL,3176,2728,-448,0.462059620596206
62567,STONINGTON,IL,203,110,-93,0.3514376996805112
62568,TAYLORVILLE,IL,6285,5803,-482,0.48006287227001987
62570,TOVEY,IL,161,34,-127,0.17435897435897435
62571,TOWER HILL,IL,103,98,-5,0.48756218905472637
62572,WAGGONER,IL,11,0,-11,0
62573,WARRENSBURG,IL,331,258,-73,0.4380305602716469
62611,ARENZVILLE,IL,12,0,-12,0
62612,ASHLAND,IL,537,417,-120,0.4371069182389937
62613,ATHENS,IL,1136,1136,0,0.5
62615,AUBURN,IL,1845,1683,-162,0.4770408163265306
62617,BATH,IL,0,17,17,1
62618,BEARDSTOWN,IL,3302,2804,-498,0.45922043891254505
62621,BLUFFS,IL,110,65,-45,0.37142857142857144
62621,BROWNING,IL,0,12,12,1
62621,EXETER,IL,14,12,-2,0.46153846153846156
62625,CANTRALL,IL,35,13,-22,0.2708333333333333
62626,CARLINVILLE,IL,3708,3310,-398,0.4716443431176974
62627,CHANDLERVILLE,IL,73,72,-1,0.496551724137931
62628,CHAPIN,IL,35,25,-10,0.4166666666666667
62629,CHATHAM,IL,5762,5781,19,0.5008230096162176
62633,EASTON,IL,11,25,14,0.6944444444444444
62634,BROADWELL,IL,12,11,-1,0.4782608695652174
62634,ELKHART,IL,47,50,3,0.5154639175257731
62635,EMDEN,IL,22,0,-22,0
62638,FRANKLIN,IL,273,216,-57,0.44171779141104295
62640,GIRARD,IL,1250,1199,-51,0.4895875867701103
62640,STANDARD CITY,IL,62,79,17,0.5602836879432624
62642,GREENVIEW,IL,225,38,-187,0.1444866920152091
62643,HARTSBURG,IL,36,16,-20,0.3076923076923077
62644,HAVANA,IL,2214,1882,-332,0.45947265625
62649,HETTICK,IL,11,11,0,0.5
62650,JACKSONVILLE,IL,6892,6582,-310,0.4884963633664836
62650,SOUTH JACKSONVILLE,IL,3526,3416,-110,0.49207721117833475
62651,JACKSONVILLE,IL,22,155,133,0.8757062146892656
62656,LINCOLN,IL,7963,6704,-1259,0.4570805208972523
62661,LOAMI,IL,399,273,-126,0.40625
62663,MANCHESTER,IL,16,0,-16,0
62664,MASON CITY,IL,1227,1131,-96,0.4796437659033079
62665,MEREDOSIA,IL,368,389,21,0.5138705416116248
62665,NAPLES,IL,13,0,-13,0
62666,MIDDLETOWN,IL,54,13,-41,0.19402985074626866
62667,MODESTO,IL,13,11,-2,0.4583333333333333
62668,MURRAYVILLE,IL,250,179,-71,0.4172494172494173
62670,BERLIN,IL,34,27,-7,0.4426229508196721
62670,NEW BERLIN,IL,783,795,12,0.5038022813688213
62671,NEW HOLLAND,IL,26,15,-11,0.36585365853658536
62673,OAKFORD,IL,24,11,-13,0.3142857142857143
62674,PALMYRA,IL,389,231,-158,0.3725806451612903
62675,PETERSBURG,IL,2129,2086,-43,0.4948991696322657
62677,PLEASANT PLAINS,IL,508,402,-106,0.44175824175824174
62677,PLEASANT PLNS,IL,111,68,-43,0.37988826815642457
62681,RUSHVILLE,IL,2149,1859,-290,0.4638223552894212
62682,SAN JOSE,IL,66,34,-32,0.34
62684,SHERMAN,IL,1458,1491,33,0.5055951169888098
62685,PLAINVIEW,IL,66,51,-15,0.4358974358974359
62685,ROYAL LAKES,IL,51,40,-11,0.43956043956043955
62685,SHIPMAN,IL,217,178,-39,0.4506329113924051
62688,TALLULA,IL,262,224,-38,0.4609053497942387
62689,THAYER,IL,59,11,-48,0.15714285714285714
62690,VIRDEN,IL,1743,1637,-106,0.48431952662721894
62691,VIRGINIA,IL,783,831,48,0.5148698884758365
62692,WAVERLY,IL,616,545,-71,0.4694229112833764
62693,WILLIAMSVILLE,IL,422,400,-22,0.48661800486618007
62694,RIGGSTON,IL,29,20,-9,0.40816326530612246
62694,WINCHESTER,IL,826,811,-15,0.4954184483811851
62695,WOODSON,IL,70,16,-54,0.18604651162790697
62701,SPRINGFIELD,IL,1199,944,-255,0.4405039664022399
62702,SPRINGFIELD,IL,20525,16665,-3860,0.4481043291207314
62703,SPRINGFIELD,IL,16699,14988,-1711,0.4730015463754852
62704,SPRINGFIELD,IL,21583,18709,-2874,0.4643353519309044
62705,SPRINGFIELD,IL,74,79,5,0.5163398692810458
62707,SPRINGFIELD,IL,2501,2258,-243,0.47446942635007355
62708,SPRINGFIELD,IL,395,691,296,0.6362799263351749
62711,SPRINGFIELD,IL,6331,7159,828,0.5306893995552261
62712,SPRINGFIELD,IL,3192,3366,174,0.5132662397072278
62791,SPRINGFIELD,IL,593,803,210,0.5752148997134671
62794,SPRINGFIELD,IL,22,53,31,0.7066666666666667
62801,CENTRALIA,IL,9013,7751,-1262,0.46235981865903125
62803,HOYLETON,IL,14,23,9,0.6216216216216216
62806,ALBION,IL,1468,1177,-291,0.4449905482041588
62807,ALMA,IL,26,27,1,0.5094339622641509
62808,ASHLEY,IL,262,236,-26,0.4738955823293173
62810,BELLE RIVE,IL,22,12,-10,0.35294117647058826
62811,BELLMONT,IL,11,0,-11,0
62812,BENTON,IL,4711,4865,154,0.5080409356725146
62812,DU QUION,IL,90,97,7,0.5187165775401069
62812,DU QUOIN,IL,114,121,7,0.5148936170212766
62814,BLUFORD,IL,326,217,-109,0.3996316758747698
62816,BONNIE,IL,89,40,-49,0.31007751937984496
62816,NASON,IL,0,12,12,1
62817,BROUGHTON,IL,24,22,-2,0.4782608695652174
62819,BUCKNER,IL,12,0,-12,0
62821,CARMI,IL,3262,3192,-70,0.4945770065075922
62822,CHRISTOPHER,IL,1687,1305,-382,0.43616310160427807
62823,CISNE,IL,462,326,-136,0.4137055837563452
62824,CLAY CITY,IL,607,355,-252,0.369022869022869
62827,CROSSVILLE,IL,455,234,-221,0.33962264150943394
62828,DAHLGREN,IL,92,71,-21,0.43558282208588955
62830,DIX,IL,388,177,-211,0.31327433628318585
62830,DIXMOOR,IL,0,14,14,1
62831,DU BOIS,IL,38,0,-38,0
62832,DU QUOIN,IL,3587,3090,-497,0.46278268683540513
62835,ENFIELD,IL,137,92,-45,0.4017467248908297
62836,EWING,IL,30,33,3,0.5238095238095238
62837,FAIRFIELD,IL,3961,3400,-561,0.4618937644341801
62838,FARINA,IL,283,168,-115,0.37250554323725055
62839,FLORA,IL,2429,2370,-59,0.4938528860179204
62842,GEFF,IL,37,11,-26,0.22916666666666666
62844,GRAYVILLE,IL,794,779,-15,0.49523204068658616
62846,INA,IL,71,16,-55,0.1839080459770115
62848,IRVINGTON,IL,81,11,-70,0.11956521739130435
62849,IUKA,IL,492,480,-12,0.49382716049382713
62853,KELL,IL,11,33,22,0.75
62854,KINMUNDY,IL,550,418,-132,0.4318181818181818
62858,BIBLE GROVE,IL,0,15,15,1
62858,LOUISVILLE,IL,888,763,-125,0.46214415505754086
62859,MC LEANSBORO,IL,1891,1733,-158,0.47820088300220753
62862,MILL SHOALS,IL,11,0,-11,0
62863,MOUNT CARMEL,IL,3925,3521,-404,0.4728713403169487
62864,MOUNT VERNON,IL,11617,9908,-1709,0.4603019744483159
62865,MULKEYTOWN,IL,225,237,12,0.512987012987013
62867,NEW HAVEN,IL,47,34,-13,0.41975308641975306
62868,NOBLE,IL,540,490,-50,0.47572815533980584
62869,NORRIS CITY,IL,939,830,-109,0.46919163369135103
62870,ODIN,IL,701,676,-25,0.49092229484386346
62871,OMAHA,IL,12,12,0,0.5
62872,OPDYKE,IL,61,56,-5,0.47863247863247865
62874,ORIENT,IL,11,0,-11,0
62875,PATOKA,IL,111,76,-35,0.40641711229946526
62881,SALEM,IL,4643,4107,-536,0.46937142857142855
62882,SANDOVAL,IL,808,757,-51,0.4837060702875399
62884,SESSER,IL,1090,908,-182,0.4544544544544545
62885,SHOBONIER,IL,12,11,-1,0.4782608695652174
62886,SIMS,IL,12,0,-12,0
62888,TAMAROA,IL,471,317,-154,0.4022842639593909
62889,TEXICO,IL,22,0,-22,0
62890,THOMPSONVILLE,IL,718,732,14,0.5048275862068966
62891,VALIER,IL,29,11,-18,0.275
62893,WALNUT HILL,IL,37,15,-22,0.28846153846153844
62894,WALTONVILLE,IL,11,25,14,0.6944444444444444
62895,WAYNE CITY,IL,447,331,-116,0.4254498714652956
62896,WEST FRANKFORT,IL,5700,4927,-773,0.4636303754587372
62897,WHITTINGTON,IL,0,11,11,1
62898,WOODLAWN,IL,372,423,51,0.5320754716981132
62899,XENIA,IL,316,317,1,0.5007898894154819
62901,CARBONDALE,IL,18884,11876,-7008,0.3860858257477243
62902,CARBONDALE,IL,2495,2050,-445,0.45104510451045104
62903,CARBONDALE,IL,1403,1125,-278,0.4450158227848101
62905,ALTO PASS,IL,120,36,-84,0.23076923076923078
62906,ANNA,IL,2761,2591,-170,0.48411808669656203
62907,AVA,IL,589,575,-14,0.49398625429553267
62910,BROOKPORT,IL,725,647,-78,0.4715743440233236
62912,BUNCOMBE,IL,101,141,40,0.5826446280991735
62914,CAIRO,IL,1032,762,-270,0.42474916387959866
62915,CAMBRIA,IL,59,51,-8,0.4636363636363636
62916,CAMPBELL HILL,IL,11,24,13,0.6857142857142857
62917,CARRIER MILLS,IL,754,693,-61,0.47892190739460955
62917,STONEFORT,IL,11,23,12,0.6764705882352942
62918,CARTERVILLE,IL,4371,4313,-58,0.4966605251036389
62919,CAVE IN ROCK,IL,139,95,-44,0.405982905982906
62920,COBDEN,IL,720,716,-4,0.4986072423398329
62920,ELOADORE,IL,15,19,4,0.5588235294117647
62921,COLP,IL,15,13,-2,0.4642857142857143
62922,CREAL SPRINGS,IL,901,886,-15,0.49580302182428654
62923,CYPRESS,IL,11,0,-11,0
62924,DE SOTO,IL,1827,1148,-679,0.38588235294117645
62926,DONGOLA,IL,633,578,-55,0.4772914946325351
62927,DOWELL,IL,11,0,-11,0
62930,ELDORADO,IL,2330,2030,-300,0.46559633027522934
62931,ELIZABETHTOWN,IL,294,250,-44,0.45955882352941174
62932,ELKVILLE,IL,563,411,-152,0.4219712525667351
62933,ENERGY,IL,419,399,-20,0.4877750611246944
62934,EQUALITY,IL,74,75,1,0.5033557046979866
62935,GALATIA,IL,695,443,-252,0.38927943760984185
62938,GOLCONDA,IL,847,805,-42,0.4872881355932203
62939,GOREVILLE,IL,1101,1101,0,0.5
62941,GRAND CHAIN,IL,26,12,-14,0.3157894736842105
62942,GRAND TOWER,IL,23,11,-12,0.3235294117647059
62943,GRANTSBURG,IL,23,12,-11,0.34285714285714286
62946,HARRISBURG,IL,5923,5096,-827,0.4624739087031491
62948,HERRIN,IL,6233,5410,-823,0.4646568753757623
62949,HURST,IL,88,60,-28,0.40540540540540543
62951,JOHNSTON CITY,IL,2034,1961,-73,0.49086357947434295
62952,JONESBORO,IL,1160,836,-324,0.4188376753507014
62953,JOPPA,IL,11,0,-11,0
62954,JUNCTION,IL,0,15,15,1
62956,KARNAK,IL,50,23,-27,0.3150684931506849
62957,MC CLURE,IL,256,52,-204,0.16883116883116883
62958,MAKANDA,IL,823,710,-113,0.46314416177429873
62959,MARION,IL,12649,12146,-503,0.4898568259729784
62960,METROPOLIS,IL,4383,3819,-564,0.4656181419166057
62963,MOUND CITY,IL,48,38,-10,0.4418604651162791
62964,MOUNDS,IL,264,165,-99,0.38461538461538464
62966,MURPHYSBORO,IL,6311,5820,-491,0.47976259170719643
62970,OLMSTED,IL,11,0,-11,0
62972,OZARK,IL,30,0,-30,0
62972,TUNNEL HILL,IL,41,64,23,0.6095238095238096
62974,PITTSBURG,IL,268,192,-76,0.41739130434782606
62977,RALEIGH,IL,11,11,0,0.5
62979,RIDGWAY,IL,214,104,-110,0.3270440251572327
62982,ROSICLARE,IL,334,98,-236,0.22685185185185186
62983,ROYALTON,IL,540,520,-20,0.49056603773584906
62984,SHAWNEETOWN,IL,564,535,-29,0.48680618744313015
62985,SIMPSON,IL,24,33,9,0.5789473684210527
62987,STONEFORT,IL,209,87,-122,0.2939189189189189
62988,TAMMS,IL,119,142,23,0.5440613026819924
62990,THEBES,IL,39,71,32,0.6454545454545455
62992,ULLIN,IL,11,0,-11,0
62994,VERGENNES,IL,26,0,-26,0
62995,VIENNA,IL,1182,1238,56,0.5115702479338843
62997,WILLISVILLE,IL,24,0,-24,0
62999,ZEIGLER,IL,630,499,-131,0.4419840566873339
63005,CHESTERFIELD,MO,5818,5736,-82,0.496451445386879
63005,WILDWOOD,MO,792,976,184,0.5520361990950227
63006,CHESTERFIELD,MO,473,444,-29,0.4841875681570338
63010,ARNOLD,MO,12512,11506,-1006,0.47905737363643935
63011,BALLWIN,MO,7918,8347,429,0.5131878266215801
63011,ELLISVILLE,MO,298,304,6,0.5049833887043189
63011,MANCHESTER,MO,1426,1455,29,0.5050329746615758
63011,WILDWOOD,MO,1589,1566,-23,0.49635499207606976
63012,ARNOLD,MO,61,60,-1,0.49586776859504134
63012,BARNHART,MO,2556,2852,296,0.5273668639053254
63013,BEAUFORT,MO,166,234,68,0.585
63014,BERGER,MO,35,37,2,0.5138888888888888
63015,CATAWISSA,MO,506,630,124,0.5545774647887324
63016,6609 GAZEBO DR,MO,52,51,-1,0.49514563106796117
63016,CEDAR HILL,MO,2677,2471,-206,0.47999222999223
63017,CHESTERFIELD,MO,15963,16881,918,0.5139751552795031
63019,CRYSTAL CITY,MO,1747,1638,-109,0.48389955686853764
63020,DE SOTO,MO,7367,6769,-598,0.47884833050367853
63021,BALLWIN,MO,14087,13170,-917,0.48317863301170344
63021,ELLISVILLE,MO,1085,1048,-37,0.49132676980778245
63021,MANCHESTER,MO,3014,2696,-318,0.47215411558669
63022,BALLWIN,MO,77,113,36,0.5947368421052631
63023,DITTMER,MO,1461,1465,4,0.5006835269993165
63025,EUREKA,MO,4463,5673,1210,0.5596882399368587
63025,WILDWOOD,MO,148,158,10,0.5163398692810458
63026,FENTON,MO,14768,14907,139,0.5023420387531592
63028,FESTUS,MO,9286,10083,797,0.520574113273788
63031,FLORISSANT,MO,16899,15962,-937,0.485742977998235
63032,FLORISSANT,MO,425,1068,643,0.7153382451440053
63033,BLACK JACK,MO,6543,6037,-506,0.4798887122416534
63033,FLORISSANT,MO,9743,8842,-901,0.4757600215227334
63034,FLORISSANT,MO,4789,5356,567,0.5279448003942829
63036,FRENCH VILLAGE,MO,395,442,47,0.5280764635603346
63037,GERALD,MO,1244,1117,-127,0.47310461668784415
63038,GLENCOE,MO,370,417,47,0.5298602287166455
63038,WILDWOOD,MO,1244,1526,282,0.5509025270758122
63039,GRAY SUMMIT,MO,73,75,2,0.5067567567567568
63040,GROVER,MO,360,377,17,0.5115332428765265
63040,WILDWOOD,MO,2012,2204,192,0.5227703984819735
63042,HAZELWOOD,MO,9208,8141,-1067,0.46924894806617096
63042,MARYLAND HEIGHTS,MO,203,155,-48,0.4329608938547486
63043,MARYLAND HEIGHTS,MO,9084,8328,-756,0.47829083390764987
63043,MARYLAND HTS,MO,617,567,-50,0.47888513513513514
63044,BRIDGETON,MO,3886,3949,63,0.5040204211869815
63045,EARTH CITY,MO,13,29,16,0.6904761904761905
63048,HERCULANEUM,MO,1374,1476,102,0.5178947368421053
63049,HIGH RIDGE,MO,5679,5233,-446,0.47956378299120234
63050,HILLSBORO,MO,5043,5240,197,0.5095789166585627
63051,BYRNES MILL,MO,1411,1344,-67,0.48784029038112525
63051,HOUSE SPRINGS,MO,3225,3189,-36,0.4971936389148737
63052,IMPERIAL,MO,7850,8733,883,0.5266236507266477
63055,LABADIE,MO,713,762,49,0.5166101694915254
63056,LESLIE,MO,447,291,-156,0.3943089430894309
63060,LONEDELL,MO,521,603,82,0.5364768683274022
63068,NEW HAVEN,MO,1218,1328,110,0.5216025137470542
63069,PACIFIC,MO,5739,5160,-579,0.4734379300853289
63070,PEVELY,MO,3031,3066,35,0.5028702640642939
63071,RICHWOODS,MO,130,137,7,0.5131086142322098
63072,ROBERTSVILLE,MO,792,973,181,0.5512747875354108
63073,SAINT ALBANS,MO,36,57,21,0.6129032258064516
63074,NORTHWEST PLAZA,MO,135,94,-41,0.4104803493449782
63074,SAINT ANN,MO,6599,6106,-493,0.4805981896890988
63077,SAINT CLAIR,MO,5017,4798,-219,0.4888436067244014
63080,SULLIVAN,MO,6818,6104,-714,0.4723726977248104
63084,UNION,MO,7934,7492,-442,0.48567353818228964
63087,VALLES MINES,MO,100,148,48,0.5967741935483871
63088,MANCHESTER,MO,527,423,-104,0.44526315789473686
63088,VALLEY PARK,MO,4112,3063,-1049,0.42689895470383277
63089,VILLA RIDGE,MO,2012,2102,90,0.5109382596013612
63090,WASHINGTON,MO,7541,8029,488,0.5156711624919718
63091,ROSEBUD,MO,97,221,124,0.6949685534591195
63101,SAINT LOUIS,MO,4473,3675,-798,0.45103092783505155
63102,SAINT LOUIS,MO,2232,1947,-285,0.46590093323761667
63103,SAINT LOUIS,MO,7316,5849,-1467,0.44428408659323965
63103,ST LOUIS,MO,159,146,-13,0.4786885245901639
63104,SAINT LOUIS,MO,12843,9786,-3057,0.4324539307967652
63105,CLAYTON,MO,757,600,-157,0.4421518054532056
63105,SAINT LOUIS,MO,8694,7589,-1105,0.46606890622121233
63106,SAINT LOUIS,MO,4175,3313,-862,0.4424412393162393
63106,ST LOUIS,MO,82,62,-20,0.4305555555555556
63107,SAINT LOUIS,MO,3701,3097,-604,0.45557516916740215
63108,SAINT LOUIS,MO,17104,12897,-4207,0.42988567047765075
63109,SAINT LOUIS,MO,11472,10185,-1287,0.4702867433162488
63109,ST LOUIS,MO,315,287,-28,0.47674418604651164
63110,SAINT LOUIS,MO,12004,10450,-1554,0.4653959205486773
63110,ST LOUIS,MO,409,356,-53,0.465359477124183
63111,SAINT LOUIS,MO,10312,8931,-1381,0.4641168217013979
63112,SAINT LOUIS,MO,10599,7800,-2799,0.423936083482798
63113,SAINT LOUIS,MO,4458,3891,-567,0.46604383758533957
63114,BRECKENRIDGE HILLS,MO,363,346,-17,0.48801128349788436
63114,OVERLAND,MO,2092,1869,-223,0.47185054279222416
63114,SAINT LOUIS,MO,10641,9525,-1116,0.47232966379053853
63115,SAINT LOUIS,MO,6905,6045,-860,0.4667953667953668
63116,SAINT LOUIS,MO,19851,16684,-3167,0.45665799917886957
63117,CLAYTON,MO,180,221,41,0.5511221945137157
63117,RICHMOND HEIGHTS,MO,992,891,-101,0.4731810939989379
63117,RICHMOND HTS,MO,86,77,-9,0.4723926380368098
63117,SAINT LOUIS,MO,3959,3705,-254,0.48342901878914407
63118,SAINT LOUIS,MO,14692,12529,-2163,0.4602696447595606
63119,SAINT LOUIS,MO,7919,7886,-33,0.498956026573869
63119,ST LOUIS,MO,224,274,50,0.5502008032128514
63119,WEBSTER GROVES,MO,2424,2511,87,0.5088145896656535
63120,SAINT LOUIS,MO,2893,2460,-433,0.4595553895012143
63120,ST LOUIS,MO,39,39,0,0.5
63121,NORMANDY,MO,192,185,-7,0.4907161803713528
63121,SAINT LOUIS,MO,9136,8166,-970,0.47196855854814473
63122,KIRKWOOD,MO,3239,3446,207,0.5154824233358265
63122,SAINT LOUIS,MO,8735,8936,201,0.5056872842510328
63123,AFFTON,MO,573,610,37,0.5156382079459002
63123,SAINT LOUIS,MO,16033,15053,-980,0.4842372772309078
63124,CLAYTON,MO,498,586,88,0.540590405904059
63124,SAINT LOUIS,MO,4039,4494,455,0.5266611977030353
63125,LEMAY,MO,249,204,-45,0.4503311258278146
63125,SAINT LOUIS,MO,11263,10613,-650,0.4851435362954836
63126,SAINT LOUIS,MO,4029,4250,221,0.5133470225872689
63127,SAINT LOUIS,MO,1783,1981,198,0.5263018065887354
63127,SAPPINGTON,MO,49,47,-2,0.4895833333333333
63128,SAINT LOUIS,MO,8674,8759,85,0.5024379051224689
63129,OAKVILLE,MO,334,350,16,0.5116959064327485
63129,SAINT LOUIS,MO,14886,14703,-183,0.49690763459393694
63130,SAINT LOUIS,MO,9752,8444,-1308,0.46405803473290835
63130,ST LOUIS,MO,221,201,-20,0.476303317535545
63130,UNIVERSITY CITY,MO,2695,2409,-286,0.47198275862068967
63131,DES PERES,MO,693,706,13,0.5046461758398856
63131,FRONTENAC,MO,68,96,28,0.5853658536585366
63131,SAINT LOUIS,MO,4120,4898,778,0.543135950321579
63132,OLIVETTE,MO,1213,1145,-68,0.4855810008481764
63132,SAINT LOUIS,MO,5607,5102,-505,0.4764217013726772
63133,SAINT LOUIS,MO,2730,2276,-454,0.4546544147023572
63134,BERKELEY,MO,1445,1267,-178,0.4671828908554572
63134,SAINT LOUIS,MO,3791,3310,-481,0.46613153077031405
63135,FERGUSON,MO,183,151,-32,0.45209580838323354
63135,SAINT LOUIS,MO,7986,7499,-487,0.48427510494026477
63136,CHESTERFIELD,MO,347,291,-56,0.4561128526645768
63136,JENNINGS,MO,1281,1128,-153,0.46824408468244083
63136,SAINT LOUIS,MO,16553,15722,-831,0.48712625871417503
63137,NORTH COUNTY,MO,362,290,-72,0.4447852760736196
63137,SAINT LOUIS,MO,7506,7048,-458,0.48426549402226193
63138,SAINT LOUIS,MO,9508,7670,-1838,0.4465013389218768
63139,SAINT LOUIS,MO,11433,9695,-1738,0.4588697463082166
63141,CREVE COEUR,MO,2823,2837,14,0.5012367491166078
63141,SAINT LOUIS,MO,7751,7536,-215,0.4929678812062537
63143,MAPLEWOOD,MO,2246,1929,-317,0.4620359281437126
63143,SAINT LOUIS,MO,3249,2859,-390,0.4680746561886051
63144,BRENTWOOD,MO,1805,1600,-205,0.4698972099853157
63144,SAINT LOUIS,MO,3780,2949,-831,0.4382523406152474
63146,SAINT LOUIS,MO,16310,14544,-1766,0.4713813443961885
63147,SAINT LOUIS,MO,3293,3055,-238,0.4812539382482672
63151,SAINT LOUIS,MO,51,112,61,0.6871165644171779
63156,SAINT LOUIS,MO,99,342,243,0.7755102040816326
63158,SAINT LOUIS,MO,0,11,11,1
63166,SAINT LOUIS,MO,28,782,754,0.9654320987654321
63177,SAINT LOUIS,MO,175,685,510,0.7965116279069767
63179,SAINT LOUIS,MO,15,0,-15,0
63195,SAINT LOUIS,MO,0,27,27,1
63301,SAINT CHARLES,MO,20848,19403,-1445,0.48205013540036273
63302,SAINT CHARLES,MO,362,742,380,0.6721014492753623
63303,SAINT CHARLES,MO,17258,16330,-928,0.48618554245563894
63303,SAINT PETERS,MO,1317,1359,42,0.507847533632287
63304,COTTLEVILLE,MO,202,281,79,0.5817805383022774
63304,SAINT CHARLES,MO,8204,8691,487,0.5144125480911512
63304,SAINT PETERS,MO,2330,2476,146,0.5151893466500208
63304,WELDON SPRING,MO,720,772,52,0.517426273458445
63332,AUGUSTA,MO,60,134,74,0.6907216494845361
63333,BELLFLOWER,MO,115,63,-52,0.3539325842696629
63334,BOWLING GREEN,MO,2972,2815,-157,0.4864351131847244
63336,CLARKSVILLE,MO,303,161,-142,0.34698275862068967
63338,COTTLEVILLE,MO,13,53,40,0.803030303030303
63339,CURRYVILLE,MO,189,132,-57,0.411214953271028
63341,DEFIANCE,MO,711,1057,346,0.5978506787330317
63343,ELSBERRY,MO,1825,1590,-235,0.465592972181552
63344,EOLIA,MO,221,348,127,0.6115992970123023
63345,FARBER,MO,88,25,-63,0.22123893805309736
63347,FOLEY,MO,1268,1214,-54,0.48912167606768736
63348,FORISTELL,MO,1659,2156,497,0.5651376146788991
63349,HAWK POINT,MO,948,752,-196,0.4423529411764706
63350,HIGH HILL,MO,0,18,18,1
63351,JONESBURG,MO,600,627,27,0.511002444987775
63352,LADDONIA,MO,105,38,-67,0.26573426573426573
63353,LOUISIANA,MO,2085,1989,-96,0.4882179675994109
63357,LAKE SHERWOOD,MO,164,191,27,0.5380281690140845
63357,MARTHASVILLE,MO,1234,1347,113,0.5218907400232468
63359,MIDDLETOWN,MO,116,142,26,0.5503875968992248
63359,NEW HARTFORD,MO,11,18,7,0.6206896551724138
63361,MONTGOMERY CITY,MO,2159,1855,-304,0.46213253612356753
63362,MOSCOW MILLS,MO,3329,3973,644,0.544097507532183
63363,NEW FLORENCE,MO,384,428,44,0.5270935960591133
63366,O FALLON,MO,13759,14790,1031,0.5180566744894742
63366,SAINT PAUL,MO,339,422,83,0.5545335085413929
63366,SAINT PETERS,MO,1644,1995,351,0.5482275350370981
63367,LAKE SAINT LOUIS,MO,8166,9714,1548,0.5432885906040269
63367,LAKE ST LOUIS,MO,1234,1433,199,0.5373078365204349
63368,DARDENNE PR,MO,222,217,-5,0.49430523917995445
63368,DARDENNE PRAIRIE,MO,813,938,125,0.5356938892061679
63368,O FALLON,MO,12582,13530,948,0.5181525735294118
63369,OLD MONROE,MO,693,968,275,0.5827814569536424
63373,PORTAGE DES SIOUX,MO,70,13,-57,0.1566265060240964
63376,SAINT PETERS,MO,23051,23365,314,0.5033824543260944
63377,SILEX,MO,500,757,257,0.6022275258552108
63379,TROY,MO,10132,10247,115,0.502821531969184
63380,TRUESDALE,MO,130,135,5,0.5094339622641509
63380,WARRENTON,MO,11,17,6,0.6071428571428571
63382,VANDALIA,MO,1660,1471,-189,0.46981794953688916
63383,WARRENTON,MO,6027,6423,396,0.5159036144578313
63384,WELLSVILLE,MO,724,628,-96,0.46449704142011833
63385,WENTZVILLE,MO,15015,17645,2630,0.540263319044703
63386,WEST ALTON,MO,42,11,-31,0.20754716981132076
63388,WILLIAMSBURG,MO,24,41,17,0.6307692307692307
63389,WINFIELD,MO,2651,2708,57,0.5053181563724576
63390,WRIGHT CITU,MO,78,92,14,0.5411764705882353
63390,WRIGHT CITY,MO,4249,4802,553,0.5305491105955144
63401,HANNIBAL,MO,13302,10249,-3053,0.43518321939620397
63430,ALEXANDRIA,MO,38,11,-27,0.22448979591836735
63434,BETHEL,MO,23,24,1,0.5106382978723404
63435,CANTON,MO,1707,1376,-331,0.4463185209211807
63436,CENTER,MO,80,199,119,0.7132616487455197
63437,CLARENCE,MO,560,273,-287,0.3277310924369748
63440,EWING,MO,213,204,-9,0.4892086330935252
63441,FRANKFORD,MO,162,188,26,0.5371428571428571
63443,HUNNEWELL,MO,24,11,-13,0.3142857142857143
63445,KAHOKA,MO,1521,1467,-54,0.49096385542168675
63446,KNOX CITY,MO,14,14,0,0.5
63447,LA BELLE,MO,171,177,6,0.5086206896551724
63447,STEFFENVILLE,MO,28,12,-16,0.3
63448,LA GRANGE,MO,231,354,123,0.6051282051282051
63452,LEWISTOWN,MO,315,252,-63,0.4444444444444444
63454,MAYWOOD,MO,0,13,13,1
63456,MONROE CITY,MO,1819,1626,-193,0.47198838896952106
63459,NEW LONDON,MO,1349,1323,-26,0.49513473053892215
63461,PALMYRA,MO,2222,1913,-309,0.4626360338573156
63462,PERRY,MO,380,469,89,0.552414605418139
63463,PHILADELPHIA,MO,12,0,-12,0
63468,SHELBINA,MO,1037,934,-103,0.47387113140537795
63469,SHELBYVILLE,MO,101,126,25,0.5550660792951542
63472,WAYLAND,MO,22,11,-11,0.3333333333333333
63474,WYACONDA,MO,36,13,-23,0.2653061224489796
63501,KIRKSVILLE,MO,13838,10117,-3721,0.4223335420580255
63530,ATLANTA,MO,117,81,-36,0.4090909090909091
63531,BARING,MO,37,26,-11,0.4126984126984127
63532,BEVIER,MO,321,292,-29,0.4763458401305057
63533,BRASHEAR,MO,47,23,-24,0.32857142857142857
63534,CALLAO,MO,49,52,3,0.5148514851485149
63536,DOWNING,MO,25,0,-25,0
63537,EDINA,MO,635,624,-11,0.49563145353455124
63539,ETHEL,MO,23,11,-12,0.3235294117647059
63544,GREEN CASTLE,MO,36,36,0,0.5
63545,GREEN CITY,MO,142,187,45,0.5683890577507599
63546,GREENTOP,MO,241,230,-11,0.4883227176220807
63548,LANCASTER,MO,370,298,-72,0.44610778443113774
63549,LA PLATA,MO,965,887,-78,0.4789416846652268
63552,MACON,MO,3665,3535,-130,0.4909722222222222
63555,MEMPHIS,MO,1210,1103,-107,0.47686986597492437
63556,MILAN,MO,1442,1397,-45,0.49207467418104966
63558,NEW CAMBRIA,MO,15,11,-4,0.4230769230769231
63559,NOVINGER,MO,184,205,21,0.5269922879177378
63561,QUEEN CITY,MO,246,167,-79,0.4043583535108959
63563,RUTLEDGE,MO,12,0,-12,0
63565,UNIONVILLE,MO,1741,1802,61,0.5086085238498448
63601,DESLOGE,MO,4877,3893,-984,0.44389965792474345
63601,PARK HILLS,MO,4551,3658,-893,0.4456084784992082
63620,ANNAPOLIS,MO,253,290,37,0.5340699815837937
63621,ARCADIA,MO,323,370,47,0.5339105339105339
63622,BELGRADE,MO,12,12,0,0.5
63623,BELLEVIEW,MO,48,25,-23,0.3424657534246575
63624,BISMARCK,MO,1426,1482,56,0.5096286107290234
63626,BLACKWELL,MO,11,57,46,0.8382352941176471
63627,BLOOMSDALE,MO,666,743,77,0.5273243435060326
63628,BONNE TERRE,MO,5268,5502,234,0.5108635097493036
63628,DESLOGE,MO,91,108,17,0.542713567839196
63629,BUNKER,MO,172,229,57,0.571072319201995
63630,CADET,MO,1354,1425,71,0.5127743792731199
63631,CALEDONIA,MO,11,0,-11,0
63633,CENTERVILLE,MO,65,41,-24,0.3867924528301887
63637,DOE RUN,MO,93,42,-51,0.3111111111111111
63638,ELLINGTON,MO,1025,988,-37,0.49080973671137607
63640,FARMINGTON,MO,12039,12079,40,0.500829256157227
63645,FREDERICKTOWN,MO,5135,5110,-25,0.4987798926305515
63648,IRONDALE,MO,187,155,-32,0.45321637426900585
63650,IRONTON,MO,1720,1848,128,0.5179372197309418
63653,LEADWOOD,MO,242,225,-17,0.4817987152034261
63654,LESTERVILLE,MO,12,17,5,0.5862068965517241
63655,MARQUAND,MO,200,252,52,0.5575221238938053
63656,MIDDLE BROOK,MO,13,15,2,0.5357142857142857
63660,MINERAL POINT,MO,1010,1089,79,0.5188184849928538
63662,PATTON,MO,177,253,76,0.5883720930232558
63663,PILOT KNOB,MO,247,225,-22,0.4766949152542373
63664,POTOSI,MO,3611,3513,-98,0.49312184166198764
63670,SAINTE GENEVIEVE,MO,3499,3521,22,0.5015669515669515
63670,STE GENEVIEVE,MO,332,315,-17,0.4868624420401855
63673,SAINT MARY,MO,373,376,3,0.5020026702269693
63701,CAPE GIRARDEAU,MO,16036,13379,-2657,0.4548359680435152
63701,CPE GIRARDEAU,MO,2377,1832,-545,0.43525778094559275
63702,CAPE GIRARDEAU,MO,1069,665,-404,0.38350634371395614
63703,CAPE GIRARDEAU,MO,5133,4157,-976,0.44747039827771795
63703,CPE GIRARDEAU,MO,1037,817,-220,0.4406688241639698
63730,ADVANCE,MO,1419,1190,-229,0.45611345343043314
63735,BELL CITY,MO,66,40,-26,0.37735849056603776
63736,BENTON,MO,1184,1220,36,0.5074875207986689
63739,BURFORDVILLE,MO,0,11,11,1
63740,CHAFFEE,MO,2350,1880,-470,0.4444444444444444
63744,DELTA,MO,27,12,-15,0.3076923076923077
63748,FROHNA,MO,15,0,-15,0
63751,GLENALLEN,MO,121,171,50,0.5856164383561644
63755,JACKSON,MO,9543,9931,388,0.5099620006162062
63760,LEOPOLD,MO,0,11,11,1
63764,MARBLE HILL,MO,2156,2200,44,0.5050505050505051
63766,MILLERSVILLE,MO,60,90,30,0.6
63767,MORLEY,MO,36,23,-13,0.3898305084745763
63769,OAK RIDGE,MO,108,142,34,0.568
63771,ORAN,MO,930,823,-107,0.4694808899030234
63775,PERRYVILLE,MO,7431,6325,-1106,0.4597993602791509
63780,SCOTT CITY,MO,2592,2498,-94,0.4907662082514735
63781,SEDGEWICKVILLE,MO,172,188,16,0.5222222222222223
63781,SEDGEWICKVLLE,MO,0,13,13,1
63785,WHITEWATER,MO,11,39,28,0.78
63787,ZALMA,MO,13,27,14,0.675
63801,SIKESTON,MO,11991,9736,-2255,0.44810604317209
63821,ARBYRD,MO,89,36,-53,0.288
63822,BERNIE,MO,1179,1065,-114,0.47459893048128343
63823,BERTRAND,MO,402,298,-104,0.4257142857142857
63824,BLODGETT,MO,11,0,-11,0
63825,BLOOMFIELD,MO,1564,1369,-195,0.4667575860893283
63827,BRAGG CITY,MO,14,11,-3,0.44
63829,CARDWELL,MO,213,212,-1,0.4988235294117647
63830,CARUTHERSVILLE,MO,4142,3345,-797,0.44677440897555765
63834,CHARLESTON,MO,1614,1598,-16,0.4975093399750934
63837,CLARKTON,MO,535,455,-80,0.4595959595959596
63839,COOTER,MO,0,11,11,1
63841,DEXTER,MO,6675,6395,-280,0.4892884468247896
63845,EAST PRAIRIE,MO,2301,2220,-81,0.49104180491041804
63846,ESSEX,MO,439,296,-143,0.40272108843537413
63848,GIDEON,MO,302,169,-133,0.35881104033970274
63851,HAYTI,MO,3520,2259,-1261,0.39089807925246584
63852,HOLCOMB,MO,288,306,18,0.5151515151515151
63855,HORNERSVILLE,MO,88,65,-23,0.42483660130718953
63857,KENNETT,MO,8084,6615,-1469,0.4500306143275053
63862,LILBOURN,MO,470,295,-175,0.38562091503267976
63863,MALDEN,MO,2504,2305,-199,0.4793096277812435
63866,MARSTON,MO,12,0,-12,0
63867,MATTHEWS,MO,98,117,19,0.5441860465116279
63869,NEW MADRID,MO,1556,1381,-175,0.47020769492679604
63870,PARMA,MO,48,62,14,0.5636363636363636
63873,PORTAGEVILLE,MO,1694,1616,-78,0.4882175226586103
63874,RISCO,MO,0,11,11,1
63876,SENATH,MO,613,579,-34,0.48573825503355705
63877,STEELE,MO,2119,1455,-664,0.40710688304420817
63879,WARDELL,MO,0,12,12,1
63880,WHITEOAK,MO,0,12,12,1
63901,POPLAR BLUFF,MO,18317,16566,-1751,0.47490181463750253
63902,POPLAR BLUFF,MO,404,634,230,0.6107899807321773
63932,BROSELEY,MO,75,25,-50,0.25
63933,CAMPBELL,MO,1399,1327,-72,0.4867938371239912
63935,DONIPHAN,MO,4150,3875,-275,0.48286604361370716
63936,DUDLEY,MO,24,39,15,0.6190476190476191
63937,ELLSINORE,MO,1314,1069,-245,0.44859420898027697
63939,FAIRDEALING,MO,385,455,70,0.5416666666666666
63940,FISK,MO,292,301,9,0.5075885328836425
63942,GATEWOOD,MO,11,0,-11,0
63943,GRANDIN,MO,40,52,12,0.5652173913043478
63944,GREENVILLE,MO,302,323,21,0.5168
63945,HARVIELL,MO,322,338,16,0.5121212121212121
63953,NAYLOR,MO,533,397,-136,0.4268817204301075
63954,NEELYVILLE,MO,227,174,-53,0.4339152119700748
63956,PATTERSON,MO,95,125,30,0.5681818181818182
63957,PIEDMONT,MO,2404,2329,-75,0.49207690682442423
63960,PUXICO,MO,1134,1109,-25,0.4944271065537227
63961,QULIN,MO,489,337,-152,0.40799031476997577
63964,SILVA,MO,13,12,-1,0.48
63965,VAN BUREN,MO,812,891,79,0.5231943628890193
63966,WAPPAPELLO,MO,1283,1350,67,0.5127231295100646
63967,WILLIAMSVILLE,MO,369,420,51,0.532319391634981
64001,ALMA,MO,0,11,11,1
64011,BATES CITY,MO,1047,1184,137,0.5307037203047961
64012,BELTON,MO,11464,12011,547,0.5116506922257721
64012,VILLAGE OF LOCH LLOYD,MO,194,249,55,0.5620767494356659
64013,BLUE SPRINGS,MO,407,693,286,0.63
64014,BLUE SPRINGS,MO,10974,11323,349,0.5078261649549267
64015,BLUE SPRINGS,MO,11915,11704,-211,0.49553325712350227
64016,BUCKNER,MO,1503,1582,79,0.512803889789303
64017,CAMDEN,MO,28,0,-28,0
64018,CAMDEN POINT,MO,22,12,-10,0.35294117647058826
64019,CENTERVIEW,MO,833,602,-231,0.4195121951219512
64020,CONCORDIA,MO,1619,1373,-246,0.4588903743315508
64021,CORDER,MO,12,11,-1,0.4782608695652174
64024,EXCELSIOR SPG,MO,252,275,23,0.5218216318785579
64024,EXCELSIOR SPRINGS,MO,5895,5975,80,0.5033698399326032
64024,MOSBY,MO,114,138,24,0.5476190476190477
64029,BLUE SPRINGS,MO,118,90,-28,0.4326923076923077
64029,GRAIN VALLEY,MO,6806,7601,795,0.527590754494343
64030,GRANDVIEW,MO,13319,12329,-990,0.48070024953212726
64034,GREENWOOD,MO,1987,2485,498,0.5556797853309481
64034,LAKE WINNEBAGO,MO,350,425,75,0.5483870967741935
64034,LK WINNEBAGO,MO,37,31,-6,0.45588235294117646
64035,HARDIN,MO,120,163,43,0.5759717314487632
64036,HENRIETTA,MO,22,22,0,0.5
64037,HIGGINSVILLE,MO,2508,2527,19,0.5018867924528302
64040,HOLDEN,MO,2344,2472,128,0.5132890365448505
64048,HOLT,MO,1176,1104,-72,0.4842105263157895
64050,INDEPENDENCE,MO,9695,9150,-545,0.48553993101618464
64050,SUGAR CREEK,MO,185,216,31,0.5386533665835411
64051,INDEPENDENCE,MO,417,750,333,0.6426735218508998
64052,INDEPENDENCE,MO,9964,8851,-1113,0.4704225352112676
64053,INDEPENDENCE,MO,2169,1996,-173,0.47923169267707083
64053,SUGAR CREEK,MO,195,168,-27,0.4628099173553719
64054,INDEPENDENCE,MO,660,598,-62,0.4753577106518283
64054,SUGAR CREEK,MO,890,837,-53,0.4846554719166184
64055,INDEPENDENCE,MO,15376,15071,-305,0.4949912963510362
64056,INDEPENDENCE,MO,6544,6120,-424,0.4832596336070752
64057,BLUE SPRINGS,MO,182,143,-39,0.44
64057,INDEPENDENCE,MO,6791,6115,-676,0.4738106307143964
64058,INDEPENDENCE,MO,1963,1998,35,0.5044180762433729
64060,KEARNEY,MO,5100,5440,340,0.5161290322580645
64061,KINGSVILLE,MO,1035,1008,-27,0.4933920704845815
64062,LAWSON,MO,1973,2011,38,0.5047690763052208
64063,LEES SUMMIT,MO,8820,8554,-266,0.492344883158743
64064,BLUE SPRINGS,MO,296,381,85,0.5627769571639586
64064,LEES SUMMIT,MO,6235,7662,1427,0.5513420162625027
64067,LEXINGTON,MO,3039,2569,-470,0.458095577746077
64068,LIBERTY,MO,9809,10047,238,0.5059931506849316
64068,PLEASANT VALLEY,MO,3128,3213,85,0.5067024128686327
64069,LIBERTY,MO,922,679,-243,0.4241099312929419
64070,LONE JACK,MO,996,1171,175,0.5403784033225658
64071,MAYVIEW,MO,38,25,-13,0.3968253968253968
64075,OAK GROVE,MO,4734,4557,-177,0.49047465288989345
64076,ODESSA,MO,3899,3902,3,0.5001922830406358
64077,ORRICK,MO,714,468,-246,0.39593908629441626
64078,PECULIAR,MO,3299,3918,619,0.5428848552029929
64079,PLATTE CITY,MO,6452,6368,-84,0.4967238689547582
64080,PLEASANT HILL,MO,5091,4978,-113,0.4943887178468567
64081,LEES SUMMIT,MO,8361,9399,1038,0.5292229729729729
64082,LEES SUMMIT,MO,5132,6616,1484,0.5631596867551923
64082,RAYMORE,MO,96,103,7,0.5175879396984925
64083,RAYMORE,MO,8886,10139,1253,0.5329303547963207
64084,RAYVILLE,MO,234,249,15,0.515527950310559
64085,RICHMOND,MO,4352,3892,-460,0.4721009218825813
64086,LAKE LOTAWANA,MO,1229,1224,-5,0.49898083978801466
64086,LEES SUMMIT,MO,8167,8388,221,0.506674720628209
64088,SIBLEY,MO,77,162,85,0.6778242677824268
64089,SMITHVILLE,MO,4548,5024,476,0.5248641872127037
64093,WARRENSBURG,MO,15351,13188,-2163,0.46210448859455483
64096,WAVERLY,MO,99,70,-29,0.41420118343195267
64097,WELLINGTON,MO,135,111,-24,0.45121951219512196
64098,WESTON,MO,1095,1096,1,0.5002282062984938
64101,KANSAS CITY,MO,74,194,120,0.7238805970149254
64102,KANSAS CITY,MO,158,258,100,0.6201923076923077
64105,KANSAS CITY,MO,9865,8310,-1555,0.45722145804676756
64106,KANSAS CITY,MO,8142,7200,-942,0.4692999608916699
64108,KANSAS CITY,MO,9383,9129,-254,0.49313958513396716
64109,KANSAS CITY,MO,7047,5994,-1053,0.45962732919254656
64110,KANSAS CITY,MO,8967,7342,-1625,0.45018088172174875
64111,KANSAS CITY,MO,17937,14640,-3297,0.44939681370291923
64112,KANSAS CITY,MO,8228,6715,-1513,0.44937428896473264
64113,KANSAS CITY,MO,3405,3879,474,0.5325370675453048
64114,BLUE SPRINGS,MO,355,306,-49,0.4629349470499244
64114,KANSAS CITY,MO,12718,11867,-851,0.48269269880008137
64116,KANSAS CITY,MO,10815,10764,-51,0.49881829556513274
64116,NORTH KANSAS CITY,MO,248,204,-44,0.45132743362831856
64117,AVONDALE,MO,139,135,-4,0.4927007299270073
64117,KANSAS CITY,MO,6290,5829,-461,0.4809802789008994
64117,NORTH KANSAS CITY,MO,171,142,-29,0.4536741214057508
64117,RANDOLPH,MO,149,110,-39,0.4247104247104247
64118,GLADSTONE,MO,1019,869,-150,0.4602754237288136
64118,KANSAS CITY,MO,21665,18935,-2730,0.4663793103448276
64119,GLADSTONE,MO,1299,1373,74,0.5138473053892215
64119,KANSAS CITY,MO,10886,10882,-4,0.49990812201396545
64120,KANSAS CITY,MO,951,1103,152,0.5370009737098345
64121,KANSAS CITY,MO,0,237,237,1
64123,KANSAS CITY,MO,3554,2882,-672,0.4477936606587943
64124,KANSAS CITY,MO,5111,3953,-1158,0.43612091791703445
64125,KANSAS CITY,MO,659,291,-368,0.3063157894736842
64126,KANSAS CITY,MO,2278,1861,-417,0.449625513409036
64127,KANSAS CITY,MO,6674,6171,-503,0.48042039704165046
64128,KANSAS CITY,MO,5506,4853,-653,0.46848151365961965
64129,KANSAS CITY,MO,4256,3547,-709,0.45456875560681786
64129,RAYTOWN,MO,95,82,-13,0.4632768361581921
64130,KANSAS CITY,MO,12104,9617,-2487,0.4427512545462916
64131,K C,MO,204,197,-7,0.4912718204488778
64131,KANSAS CITY,MO,11579,10562,-1017,0.47703355765322253
64132,KANSAS CITY,MO,6920,5976,-944,0.4633995037220844
64133,KANSAS CITY,MO,3480,3209,-271,0.4797428614142622
64133,RAYTOWN,MO,12087,11247,-840,0.4820005142710208
64134,KANSAS CITY,MO,12080,10791,-1289,0.4718202089982948
64136,KANSAS CITY,MO,886,789,-97,0.471044776119403
64137,KANSAS CITY,MO,6096,5300,-796,0.4650754650754651
64138,KANSAS CITY,MO,9296,8111,-1185,0.4659619693226863
64138,RAYTOWN,MO,3680,2988,-692,0.4481103779244151
64139,KANSAS CITY,MO,1133,992,-141,0.4668235294117647
64141,KANSAS CITY,MO,274,556,282,0.6698795180722892
64145,KANSAS CITY,MO,1860,1976,116,0.5151199165797706
64146,KANSAS CITY,MO,390,456,66,0.5390070921985816
64147,KANSAS CITY,MO,215,0,-215,0
64148,KANSAS CITY,MO,25,70,45,0.7368421052631579
64150,KANSAS CITY,MO,90,102,12,0.53125
64150,RIVERSIDE,MO,2482,1794,-688,0.4195509822263798
64151,KANSAS CITY,MO,14230,13603,-627,0.48873639205259944
64152,KANSAS CITY,MO,8827,10068,1241,0.532839375496163
64152,PARKVILLE,MO,1486,1470,-16,0.4972936400541272
64153,KANSAS CITY,MO,3789,3523,-266,0.48181072210065645
64154,KANSAS,MO,147,125,-22,0.45955882352941174
64154,KANSAS CITY,MO,7381,7947,566,0.5184629436325678
64155,KANSAS CITY,MO,10795,11360,565,0.5127510719927781
64156,KANSAS CITY,MO,2711,3410,699,0.5570985133148179
64157,KANSAS CITY,MO,5687,6957,1270,0.5502214489085733
64158,KANSAS CITY,MO,3198,3279,81,0.5062528948587309
64163,FERRELVIEW,MO,246,323,77,0.5676625659050967
64163,KANSAS CITY,MO,396,485,89,0.5505107832009081
64168,KANSAS CITY,MO,15,0,-15,0
64168,RIVERSIDE,MO,0,15,15,1
64171,KANSAS CITY,MO,144,383,239,0.7267552182163188
64188,KANSAS CITY,MO,146,521,375,0.7811094452773614
64190,KANSAS CITY,MO,158,281,123,0.6400911161731208
64401,AGENCY,MO,142,140,-2,0.49645390070921985
64402,ALBANY,MO,1037,1007,-30,0.4926614481409002
64421,AMAZONIA,MO,48,26,-22,0.35135135135135137
64423,BARNARD,MO,26,0,-26,0
64424,BETHANY,MO,2114,1978,-136,0.4833822091886608
64427,BOLCKOW,MO,13,0,-13,0
64428,BURLINGTON JUNCTION,MO,27,60,33,0.6896551724137931
64429,CAMERON,MO,4536,4676,140,0.5075987841945289
64430,CLARKSDALE,MO,0,11,11,1
64436,COSBY,MO,0,11,11,1
64437,CRAIG,MO,209,59,-150,0.22014925373134328
64439,DEARBORN,MO,307,385,78,0.5563583815028902
64440,DE KALB,MO,35,17,-18,0.3269230769230769
64442,EAGLEVILLE,MO,0,11,11,1
64443,EASTON,MO,36,69,33,0.6571428571428571
64444,EDGERTON,MO,111,228,117,0.672566371681416
64446,FAIRFAX,MO,158,154,-4,0.4935897435897436
64448,FAUCETT,MO,81,128,47,0.6124401913875598
64451,FOREST CITY,MO,12,0,-12,0
64453,GENTRY,MO,29,0,-29,0
64454,GOWER,MO,495,699,204,0.585427135678392
64456,GRANT CITY,MO,425,400,-25,0.48484848484848486
64459,HELENA,MO,13,11,-2,0.4583333333333333
64461,HOPKINS,MO,57,70,13,0.5511811023622047
64463,KING CITY,MO,556,530,-26,0.4880294659300184
64465,LATHROP,MO,1970,1634,-336,0.45338512763596006
64466,MAITLAND,MO,42,15,-27,0.2631578947368421
64468,MARYVILLE,MO,7129,5822,-1307,0.44954057601729597
64469,MAYSVILLE,MO,713,706,-7,0.4975334742776603
64470,MOUND CITY,MO,477,434,-43,0.47639956092206365
64471,NEW HAMPTON,MO,43,25,-18,0.36764705882352944
64473,OREGON,MO,127,151,24,0.5431654676258992
64474,OSBORN,MO,40,24,-16,0.375
64477,PLATTSBURG,MO,1300,1420,120,0.5220588235294118
64479,RAVENWOOD,MO,38,68,30,0.6415094339622641
64481,RIDGEWAY,MO,91,145,54,0.614406779661017
64482,ROCK PORT,MO,532,538,6,0.502803738317757
64483,ROSENDALE,MO,0,11,11,1
64484,RUSHVILLE,MO,199,65,-134,0.24621212121212122
64485,SAVANNAH,MO,3166,2652,-514,0.45582674458576833
64486,SHERIDAN,MO,23,11,-12,0.3235294117647059
64487,SKIDMORE,MO,18,35,17,0.660377358490566
64489,STANBERRY,MO,497,625,128,0.5570409982174688
64490,STEWARTSVILLE,MO,265,327,62,0.5523648648648649
64491,TARKIO,MO,660,632,-28,0.4891640866873065
64492,TRIMBLE,MO,409,636,227,0.6086124401913876
64493,TURNEY,MO,13,0,-13,0
64494,UNION STAR,MO,12,27,15,0.6923076923076923
64497,WEATHERBY,MO,0,12,12,1
64501,SAINT JOSEPH,MO,7373,5489,-1884,0.4267610013994713
64502,SAINT JOSEPH,MO,206,371,165,0.6429809358752167
64503,SAINT JOSEPH,MO,5995,4937,-1058,0.45160995243322355
64504,SAINT JOSEPH,MO,4652,3602,-1050,0.43639447540586385
64505,COUNTRY CLUB,MO,291,282,-9,0.49214659685863876
64505,SAINT JOSEPH,MO,4416,4266,-150,0.49136143745680716
64505,ST JOSEPH,MO,112,92,-20,0.45098039215686275
64506,SAINT JOSEPH,MO,10070,8681,-1389,0.46296197536131406
64506,ST JOSEPH,MO,223,169,-54,0.43112244897959184
64507,SAINT JOSEPH,MO,5305,4702,-603,0.4698710902368342
64507,ST JOSEPH,MO,152,113,-39,0.42641509433962266
64508,SAINT JOSEPH,MO,161,360,199,0.690978886756238
64601,CHILLICOTHE,MO,5997,5510,-487,0.4788389675849483
64620,ALTAMONT,MO,22,23,1,0.5111111111111111
64622,BOGARD,MO,0,14,14,1
64623,BOSWORTH,MO,11,0,-11,0
64624,BRAYMER,MO,426,399,-27,0.48363636363636364
64625,BRECKENRIDGE,MO,11,12,1,0.5217391304347826
64628,BROOKFIELD,MO,3040,2618,-422,0.4627076705549664
64631,BUCKLIN,MO,36,53,17,0.5955056179775281
64632,CAINSVILLE,MO,22,29,7,0.5686274509803921
64633,CARROLLTON,MO,2250,2022,-228,0.47331460674157305
64636,COFFEY,MO,0,12,12,1
64637,COWGILL,MO,35,0,-35,0
64638,DAWN,MO,11,0,-11,0
64640,GALLATIN,MO,1390,1459,69,0.512109512109512
64642,GILMAN CITY,MO,13,31,18,0.7045454545454546
64643,HALE,MO,146,100,-46,0.4065040650406504
64644,HAMILTON,MO,1249,1223,-26,0.4947411003236246
64647,JAMESON,MO,45,11,-34,0.19642857142857142
64648,JAMESPORT,MO,402,256,-146,0.3890577507598784
64649,KIDDER,MO,59,107,48,0.6445783132530121
64650,KINGSTON,MO,0,56,56,1
64651,LACLEDE,MO,29,26,-3,0.4727272727272727
64652,LAREDO,MO,12,0,-12,0
64653,LINNEUS,MO,0,11,11,1
64658,MARCELINE,MO,1304,1257,-47,0.49082389691526745
64659,MEADVILLE,MO,24,28,4,0.5384615384615384
64661,MERCER,MO,13,25,12,0.6578947368421053
64668,NORBORNE,MO,220,244,24,0.5258620689655172
64670,PATTONSBURG,MO,163,157,-6,0.490625
64671,POLO,MO,889,787,-102,0.46957040572792363
64673,PRINCETON,MO,988,887,-101,0.4730666666666667
64674,PURDIN,MO,15,0,-15,0
64679,SPICKARD,MO,35,65,30,0.65
64682,TINA,MO,11,0,-11,0
64683,TRENTON,MO,3845,3585,-260,0.48250336473755046
64688,WHEELING,MO,39,11,-28,0.22
64689,WINSTON,MO,22,0,-22,0
64701,HARRISONVILLE,MO,5578,5586,8,0.5003582945180939
64720,ADRIAN,MO,1162,1198,36,0.5076271186440678
64723,AMSTERDAM,MO,13,0,-13,0
64724,APPLETON CITY,MO,454,554,100,0.5496031746031746
64725,ARCHIE,MO,866,1005,139,0.5371459112773918
64726,BLAIRSTOWN,MO,11,0,-11,0
64728,BRONAUGH,MO,11,0,-11,0
64730,BUTLER,MO,3138,2902,-236,0.4804635761589404
64733,CHILHOWEE,MO,61,107,46,0.6369047619047619
64734,CLEVELAND,MO,436,547,111,0.5564598168870803
64734,WEST LINE,MO,0,17,17,1
64735,CLINTON,MO,8168,7043,-1125,0.46302018276247453
64738,COLLINS,MO,164,322,158,0.6625514403292181
64739,CREIGHTON,MO,163,92,-71,0.3607843137254902
64740,DEEPWATER,MO,671,754,83,0.5291228070175439
64742,DREXEL,MO,631,655,24,0.5093312597200622
64743,EAST LYNNE,MO,17,0,-17,0
64744,EL DORADO SPRINGS,MO,4222,3721,-501,0.4684627974317009
64746,FREEMAN,MO,226,289,63,0.5611650485436893
64746,LAKE ANNETTE,MO,15,0,-15,0
64747,GARDEN CITY,MO,1475,1400,-75,0.48695652173913045
64748,GOLDEN CITY,MO,370,280,-90,0.4307692307692308
64750,HARWOOD,MO,26,0,-26,0
64752,HUME,MO,18,11,-7,0.3793103448275862
64755,JASPER,MO,995,841,-154,0.45806100217864926
64756,JERICO SPRINGS,MO,113,68,-45,0.3756906077348066
64759,LAMAR,MO,3406,3172,-234,0.48221343873517786
64761,LEETON,MO,326,233,-93,0.41681574239713776
64761,WARRENSBURG,MO,14,13,-1,0.48148148148148145
64762,LIBERAL,MO,417,386,-31,0.4806973848069738
64763,LOWRY CITY,MO,508,538,30,0.51434034416826
64767,MILO,MO,25,82,57,0.7663551401869159
64769,MINDENMINES,MO,13,14,1,0.5185185185185185
64770,MONTROSE,MO,56,71,15,0.5590551181102362
64772,NEVADA,MO,8606,7157,-1449,0.45403793694093764
64776,OSCEOLA,MO,1590,1724,134,0.52021726010863
64779,RICH HILL,MO,887,782,-105,0.46854403834631514
64783,SCHELL CITY,MO,13,0,-13,0
64784,SHELDON,MO,467,526,59,0.5297079556898288
64788,URICH,MO,297,300,3,0.5025125628140703
64790,WALKER,MO,40,44,4,0.5238095238095238
64801,JOPLIN,MO,21400,17402,-3998,0.4484820370084016
64802,JOPLIN,MO,546,596,50,0.521891418563923
64803,JOPLIN,MO,670,702,32,0.5116618075801749
64804,JOPLIN,MO,18777,17223,-1554,0.47841666666666666
64804,LOMA LINDA,MO,426,365,-61,0.461441213653603
64830,ALBA,MO,0,26,26,1
64831,ANDERSON,MO,2307,2082,-225,0.47436773752563227
64832,ASBURY,MO,38,30,-8,0.4411764705882353
64834,CARL JUNCTION,MO,3913,4142,229,0.5142147734326505
64835,CARTERVILLE,MO,1041,863,-178,0.4532563025210084
64836,CARTHAGE,MO,9860,9022,-838,0.4778095540726618
64840,DIAMOND,MO,730,786,56,0.5184696569920845
64841,DUENWEG,MO,425,517,92,0.5488322717622081
64842,FAIRVIEW,MO,230,167,-63,0.42065491183879095
64843,GOODMAN,MO,1319,1547,228,0.5397766922540126
64844,GRANBY,MO,1733,1680,-53,0.4922355698798711
64847,LANAGAN,MO,22,11,-11,0.3333333333333333
64848,LA RUSSELL,MO,0,24,24,1
64850,NEOSHO,MO,10031,9738,-293,0.49258940765845516
64854,NOEL,MO,1524,1452,-72,0.4879032258064516
64855,ORONOGO,MO,760,933,173,0.5510927347903131
64856,JANE,MO,171,165,-6,0.49107142857142855
64856,PINEVILLE,MO,1414,1358,-56,0.4898989898989899
64857,PURCELL,MO,0,11,11,1
64859,REEDS,MO,175,130,-45,0.4262295081967213
64861,ROCKY COMFORT,MO,189,234,45,0.5531914893617021
64862,SARCOXIE,MO,1424,1315,-109,0.4801022270901789
64863,SOUTH WEST CITY,MO,149,97,-52,0.3943089430894309
64864,SAGINAW,MO,13,0,-13,0
64865,SENECA,MO,1716,1825,109,0.5153911324484609
64866,STARK CITY,MO,132,166,34,0.5570469798657718
64867,STELLA,MO,308,258,-50,0.4558303886925795
64870,WEBB CITY,MO,8943,7823,-1120,0.4665990695455088
64873,WENTWORTH,MO,66,52,-14,0.4406779661016949
64874,WHEATON,MO,99,52,-47,0.3443708609271523
65010,ASHLAND,MO,2499,2748,249,0.5237278444825615
65011,BARNETT,MO,677,600,-77,0.46985121378230227
65013,BELLE,MO,1100,1230,130,0.5278969957081545
65014,BLAND,MO,588,685,97,0.5380989787902593
65016,BONNOTS MILL,MO,42,51,9,0.5483870967741935
65017,BRUMLEY,MO,181,182,1,0.5013774104683195
65018,CALIFORNIA,MO,2671,2700,29,0.5026996834853845
65020,CAMDENTON,MO,7603,7593,-10,0.4996709660436957
65023,CENTERTOWN,MO,340,237,-103,0.41074523396880414
65024,CHAMOIS,MO,61,102,41,0.6257668711656442
65025,CLARKSBURG,MO,79,24,-55,0.23300970873786409
65026,ELDON,MO,4922,4956,34,0.5017209961530674
65032,EUGENE,MO,68,65,-3,0.48872180451127817
65034,FORTUNA,MO,0,12,12,1
65035,FREEBURG,MO,118,66,-52,0.358695652173913
65037,GRAVOIS MILLS,MO,2940,2964,24,0.5020325203252033
65038,LAURIE,MO,50,38,-12,0.4318181818181818
65039,HARTSBURG,MO,529,610,81,0.5355575065847235
65040,HENLEY,MO,0,41,41,1
65041,HERMANN,MO,1886,1905,19,0.5025059351094698
65043,HOLTS SUMMIT,MO,4349,4174,-175,0.4897336618561539
65046,JAMESTOWN,MO,106,119,13,0.5288888888888889
65047,KAISER,MO,927,755,-172,0.44887039239001186
65049,FOUR SEASONS,MO,130,98,-32,0.4298245614035088
65049,LAKE OZARK,MO,5982,5377,-605,0.47336913460691965
65051,LINN,MO,1444,1348,-96,0.4828080229226361
65052,LINN CREEK,MO,1361,1347,-14,0.49741506646971934
65053,LOHMAN,MO,56,99,43,0.6387096774193548
65058,META,MO,0,24,24,1
65059,MOKANE,MO,81,75,-6,0.4807692307692308
65061,GASCONADE,MO,0,11,11,1
65061,MORRISON,MO,13,11,-2,0.4583333333333333
65063,NEW BLOOMFIELD,MO,940,1097,157,0.5385370643102602
65064,OLEAN,MO,18,25,7,0.5813953488372093
65065,OSAGE BEACH,MO,4965,4789,-176,0.4909780602829608
65066,OWENSVILLE,MO,2213,2379,166,0.518074912891986
65068,PRAIRIE HOME,MO,15,34,19,0.6938775510204082
65069,RHINELAND,MO,0,22,22,1
65072,ROCKY MOUNT,MO,805,848,43,0.5130066545674531
65074,RUSSELLVILLE,MO,659,730,71,0.5255579553635709
65078,STOVER,MO,1694,1776,82,0.5118155619596542
65079,SUNRISE BEACH,MO,3224,3218,-6,0.499534306116113
65080,TEBBETTS,MO,26,39,13,0.6
65081,TIPTON,MO,1058,1043,-15,0.4964302712993812
65082,TUSCUMBIA,MO,48,64,16,0.5714285714285714
65084,VERSAILLES,MO,2772,2602,-170,0.4841831038332713
65085,WESTPHALIA,MO,27,11,-16,0.2894736842105263
65101,JEFFERSON CITY,MO,11703,9735,-1968,0.4541001959137979
65102,JEFFERSON CITY,MO,207,805,598,0.7954545454545454
65109,JEFFERSON CITY,MO,16620,15029,-1591,0.4748649246421688
65110,JEFFERSON CITY,MO,420,357,-63,0.4594594594594595
65110,JEFFERSON CTY,MO,14,23,9,0.6216216216216216
65110,ST LOUIS,MO,16,18,2,0.5294117647058824
65201,COLUMBIA,MO,27301,21060,-6241,0.43547486611112257
65202,COLUMBIA,MO,24985,22537,-2448,0.47424350826985395
65203,COLUMBIA,MO,30880,27009,-3871,0.4665653232911261
65205,COLUMBIA,MO,2175,2447,272,0.5294244915620944
65230,ARMSTRONG,MO,13,11,-2,0.4583333333333333
65231,AUXVASSE,MO,1337,1207,-130,0.4744496855345912
65233,BOONVILLE,MO,5536,4888,-648,0.4689178818112049
65236,BRUNSWICK,MO,484,404,-80,0.45495495495495497
65237,BUNCETON,MO,65,33,-32,0.336734693877551
65239,CAIRO,MO,245,365,120,0.5983606557377049
65240,CENTRALIA,MO,2775,2936,161,0.5140956049728594
65243,CLARK,MO,339,365,26,0.5184659090909091
65248,FAYETTE,MO,1565,1458,-107,0.4823023486602713
65250,FRANKLIN,MO,0,11,11,1
65251,FULTON,MO,8403,8142,-261,0.49211242067089755
65254,GLASGOW,MO,337,277,-60,0.4511400651465798
65255,HALLSVILLE,MO,1543,1567,24,0.5038585209003216
65256,HARRISBURG,MO,546,455,-91,0.45454545454545453
65257,HIGBEE,MO,279,273,-6,0.4945652173913043
65259,HUNTSVILLE,MO,917,1057,140,0.5354609929078015
65261,KEYTESVILLE,MO,265,214,-51,0.44676409185803756
65262,KINGDOM CITY,MO,158,223,65,0.5853018372703412
65263,MADISON,MO,511,389,-122,0.43222222222222223
65264,MARTINSBURG,MO,12,23,11,0.6571428571428571
65265,MEXICO,MO,7611,7456,-155,0.49485630848875023
65270,MOBERLY,MO,8964,8049,-915,0.47310879915358844
65274,NEW FRANKLIN,MO,448,373,-75,0.4543239951278928
65275,PARIS,MO,1087,927,-160,0.4602780536246276
65276,PILOT GROVE,MO,453,291,-162,0.3911290322580645
65279,ROCHEPORT,MO,229,287,58,0.5562015503875969
65281,SALISBURY,MO,821,801,-20,0.4938347718865598
65283,STOUTSVILLE,MO,12,23,11,0.6571428571428571
65284,STURGEON,MO,806,743,-63,0.47966429954809553
65301,SEDALIA,MO,18979,15893,-3086,0.45575246616196374
65302,SEDALIA,MO,318,512,194,0.6168674698795181
65305,WHITEMAN AFB,MO,349,452,103,0.5642946317103621
65305,WHITEMAN AIR FORCE BASE,MO,1501,1710,209,0.5325443786982249
65321,BLACKBURN,MO,11,12,1,0.5217391304347826
65322,BLACKWATER,MO,24,14,-10,0.3684210526315789
65323,CALHOUN,MO,79,120,41,0.6030150753768844
65324,CLIMAX SPRGS,MO,28,39,11,0.582089552238806
65324,CLIMAX SPRINGS,MO,491,486,-5,0.49744114636642783
65325,COLE CAMP,MO,1023,1117,94,0.52196261682243
65326,EDWARDS,MO,837,984,147,0.5403624382207578
65329,FLORENCE,MO,0,14,14,1
65330,GILLIAM,MO,41,11,-30,0.21153846153846154
65332,GREEN RIDGE,MO,404,407,3,0.5018495684340321
65334,HUGHESVILLE,MO,12,39,27,0.7647058823529411
65336,KNOB NOSTER,MO,3288,2965,-323,0.4741723972493203
65337,LA MONTE,MO,494,421,-73,0.4601092896174863
65338,LINCOLN,MO,1341,1375,34,0.5062592047128129
65339,MALTA BEND,MO,13,11,-2,0.4583333333333333
65340,MARSHALL,MO,6839,6225,-614,0.4765003061849357
65348,OTTERVILLE,MO,280,137,-143,0.328537170263789
65349,SLATER,MO,1109,924,-185,0.4545007378258731
65350,SMITHTON,MO,261,234,-27,0.4727272727272727
65351,SWEET SPRINGS,MO,745,787,42,0.5137075718015666
65354,SYRACUSE,MO,0,11,11,1
65355,WARSAW,MO,5270,5946,676,0.5301355206847361
65360,WINDSOR,MO,2003,1938,-65,0.49175336209083986
65401,ROLLA,MO,15306,14068,-1238,0.4789269421937768
65402,ROLLA,MO,816,853,37,0.5110844817255842
65438,BIRCH TREE,MO,1091,1097,6,0.5013711151736746
65441,BOURBON,MO,2001,1927,-74,0.4905804480651731
65444,BUCYRUS,MO,62,121,59,0.6612021857923497
65446,CHERRYVILLE,MO,13,11,-2,0.4583333333333333
65452,CROCKER,MO,1295,1239,-56,0.4889502762430939
65453,CUBA,MO,3944,3805,-139,0.49103110078719836
65456,DAVISVILLE,MO,11,0,-11,0
65459,DIXON,MO,2940,2989,49,0.5041322314049587
65462,EDGAR SPRINGS,MO,264,391,127,0.5969465648854961
65463,ELDRIDGE,MO,45,67,22,0.5982142857142857
65464,ELK CREEK,MO,11,0,-11,0
65466,EMINENCE,MO,415,542,127,0.5663531870428422
65470,FALCON,MO,25,87,62,0.7767857142857143
65473,FORT LEONARD WOOD,MO,5973,4312,-1661,0.4192513368983957
65473,FT LEONARD WD,MO,146,120,-26,0.45112781954887216
65479,HARTSHORN,MO,15,27,12,0.6428571428571429
65483,HOUSTON,MO,2519,2482,-37,0.4963007398520296
65484,HUGGINS,MO,14,0,-14,0
65486,IBERIA,MO,1038,995,-43,0.4894244958189867
65534,LAQUEY,MO,160,253,93,0.612590799031477
65535,LEASBURG,MO,525,435,-90,0.453125
65536,LEBANON,MO,14836,14044,-792,0.48628808864265927
65542,LICKING,MO,2019,2110,91,0.5110196173407605
65548,MOUNTAIN VIEW,MO,2599,2772,173,0.5161050083783281
65550,NEWBURG,MO,734,738,4,0.501358695652174
65552,PLATO,MO,760,798,38,0.5121951219512195
65555,RAYMONDVILLE,MO,230,263,33,0.5334685598377282
65555,RAYTOWN,MO,11,0,-11,0
65556,RICHLAND,MO,2068,2152,84,0.5099526066350711
65556,SWEDEBORG,MO,41,36,-5,0.4675324675324675
65559,SAINT JAMES,MO,3925,3626,-299,0.4802012978413455
65560,SALEM,MO,6448,5938,-510,0.4794122396253835
65565,STEELVILLE,MO,2255,2179,-76,0.4914298601714028
65566,VIBURNUM,MO,197,85,-112,0.30141843971631205
65567,STOUTLAND,MO,210,168,-42,0.4444444444444444
65571,SUMMERSVILLE,MO,623,651,28,0.510989010989011
65580,VICHY,MO,45,73,28,0.6186440677966102
65582,VIENNA,MO,493,556,63,0.5300285986653956
65583,WAYNESVILLE,MO,8239,7814,-425,0.486762598891173
65584,SAINT ROBERT,MO,8488,7392,-1096,0.4654911838790932
65588,EMINENCE,MO,47,38,-9,0.4470588235294118
65588,WINONA,MO,849,822,-27,0.4919210053859964
65590,LONG LANE,MO,56,237,181,0.8088737201365188
65591,MONTREAL,CA,18,16,-2,0.47058823529411764
65591,MONTREAL,MO,293,349,56,0.543613707165109
65601,ALDRICH,MO,46,49,3,0.5157894736842106
65604,ASH GROVE,MO,1328,1379,51,0.509420022164758
65605,AURORA,MO,6035,5533,-502,0.47830221300138315
65606,ALTON,MO,1488,1430,-58,0.4900616860863605
65608,AVA,MO,3321,3504,183,0.5134065934065934
65609,BAKERSFIELD,MO,11,23,12,0.6764705882352942
65610,BILLINGS,MO,1755,1957,202,0.5272090517241379
65611,BLUE EYE,MO,1054,1079,25,0.5058602906704173
65612,BOIS D ARC,MO,134,262,128,0.6616161616161617
65613,BOLIVAR,MO,10418,8904,-1514,0.4608218610909844
65614,BRADLEYVILLE,MO,0,28,28,1
65615,BRANSON,MO,969,1041,72,0.517910447761194
65616,BRANON,MO,296,299,3,0.5025210084033613
65616,BRANSON,MO,16103,15330,-773,0.48770400534470143
65617,BRIGHTON,MO,650,402,-248,0.3821292775665399
65619,BATTLEFIELD,MO,2350,2518,168,0.5172555464256368
65619,BROOKLINE,MO,1170,1268,98,0.5200984413453651
65619,BROOKLINE STA,MO,51,69,18,0.575
65622,BUFFALO,MO,4048,4073,25,0.501539219307967
65624,CAPE FAIR,MO,514,782,268,0.6033950617283951
65625,CASSVILLE,MO,3291,3534,243,0.5178021978021978
65626,CAULFIELD,MO,354,390,36,0.5241935483870968
65627,CEDARCREEK,MO,0,35,35,1
65629,CHADWICK,MO,11,23,12,0.6764705882352942
65630,CHESTNUTRIDGE,MO,0,12,12,1
65630,SADDLEBROOKE,MO,0,11,11,1
65631,CLEVER,MO,2060,2219,159,0.5185791072680532
65632,CONWAY,MO,990,1040,50,0.5123152709359606
65633,CRANE,MO,1481,1461,-20,0.4966009517335146
65634,CROSS TIMBERS,MO,24,46,22,0.6571428571428571
65635,DADEVILLE,MO,32,33,1,0.5076923076923077
65637,DORA,MO,50,99,49,0.6644295302013423
65638,DRURY,MO,0,11,11,1
65640,DUNNEGAN,MO,24,26,2,0.52
65641,EAGLE ROCK,MO,333,482,149,0.5914110429447853
65644,ELKLAND,MO,765,888,123,0.5372050816696915
65646,EVERTON,MO,403,463,60,0.5346420323325635
65647,EXETER,MO,737,727,-10,0.49658469945355194
65648,FAIR GROVE,MO,1950,1998,48,0.506079027355623
65649,FAIR PLAY,MO,562,604,42,0.5180102915951973
65650,FLEMINGTON,MO,486,454,-32,0.4829787234042553
65652,FORDLAND,MO,1335,1397,62,0.5113469985358712
65653,FORSYTH,MO,2530,2896,366,0.5337265020272761
65655,GAINESVILLE,MO,1216,1264,48,0.5096774193548387
65656,GALENA,MO,1841,1881,40,0.5053734551316497
65658,GOLDEN,MO,353,392,39,0.5261744966442953
65661,GREENFIELD,MO,1016,1063,47,0.5113035113035113
65662,GROVESPRING,MO,137,243,106,0.6394736842105263
65663,GOODSON,MO,59,94,35,0.6143790849673203
65663,HALF WAY,MO,398,457,59,0.5345029239766081
65666,HARDENVILLE,MO,11,0,-11,0
65667,HARTVILLE,MO,1336,1314,-22,0.4958490566037736
65668,HERMITAGE,MO,668,738,70,0.5248933143669986
65669,HIGHLANDVILLE,MO,645,832,187,0.5633039945836155
65672,HOLLISTER,MO,5762,4325,-1437,0.4287697035788639
65673,HOLLISTER,MO,1683,700,-983,0.2937473772555602
65674,HUMANSVILLE,MO,1273,1135,-138,0.47134551495016613
65679,KIRBYVILLE,MO,1042,1112,70,0.5162488393686165
65680,KISSEE MILLS,MO,297,457,160,0.6061007957559682
65681,LAMPE,MO,868,1120,252,0.5633802816901409
65682,LOCKWOOD,MO,557,595,38,0.5164930555555556
65685,LOUISBURG,MO,45,55,10,0.55
65686,KIMBERLING CITY,MO,2582,2555,-27,0.4973720070079813
65686,KIMBERLING CY,MO,48,45,-3,0.4838709677419355
65689,CABOOL,MO,2080,2111,31,0.5036984013361966
65692,KOSHKONONG,MO,179,145,-34,0.44753086419753085
65704,MANSFIELD,MO,1509,1524,15,0.5024727992087042
65705,MARIONVILLE,MO,1581,1699,118,0.5179878048780487
65706,MARSHFIELD,MO,6357,6496,139,0.5054072979071034
65707,MILLER,MI,29,25,-4,0.46296296296296297
65707,MILLER,MO,854,716,-138,0.45605095541401275
65708,MONETT,MO,5514,4958,-556,0.4734530175706646
65710,MORRISVILLE,MO,241,227,-14,0.48504273504273504
65711,MOUNTAIN GROVE,MO,5003,5018,15,0.5007484283005688
65712,MOUNT VERNON,MO,3602,3605,3,0.5002081309837658
65713,NIANGUA,MO,713,820,107,0.5348988910632746
65714,NIXA,MO,14705,14969,264,0.5044483386129271
65717,NORWOOD,MO,835,851,16,0.5047449584816133
65720,OLDFIELD,MO,13,22,9,0.6285714285714286
65721,OZARK,MO,15255,14554,-701,0.48824180616592305
65722,PHILLIPSBURG,MO,400,520,120,0.5652173913043478
65723,PIERCE CITY,MO,1414,1336,-78,0.4858181818181818
65724,PITTSBURG,MO,595,746,151,0.5563012677106637
65725,PLEASANT HOPE,MO,777,865,88,0.5267965895249695
65726,POINT LOOKOUT,MO,2217,159,-2058,0.06691919191919192
65732,PRESTON,MO,11,52,41,0.8253968253968254
65733,PROTEM,MO,12,58,46,0.8285714285714286
65734,PURDY,MO,1009,1002,-7,0.49825957235206364
65734,SPOKANE,MO,19,21,2,0.525
65737,BRANSON WEST,MO,745,881,136,0.541820418204182
65737,REEDS SPRING,MO,3236,3474,238,0.5177347242921013
65738,REPUBLIC,MO,8474,9437,963,0.5268829211099324
65738,SPRFD,MO,170,176,6,0.5086705202312138
65739,RIDGEDALE,MO,318,366,48,0.5350877192982456
65740,MERRIAM WOODS VILLAGE,MO,496,413,-83,0.45434543454345433
65740,ROCKAWAY BCH,MO,204,79,-125,0.2791519434628975
65740,ROCKAWAY BEACH,MO,1833,1469,-364,0.4448818897637795
65742,ROGERSVILLE,MO,5217,5322,105,0.5049814972957586
65745,SELIGMAN,MO,817,995,178,0.5491169977924945
65746,SEYMOUR,MO,2362,2411,49,0.505133040016761
65747,SHELL KNOB,MO,1575,1750,175,0.5263157894736842
65752,SOUTH GREENFIELD,MO,0,23,23,1
65753,SPARTA,MO,1806,1902,96,0.5129449838187702
65754,SPOKANE,MO,41,101,60,0.7112676056338029
65756,STOTTS CITY,MO,36,28,-8,0.4375
65757,STRAFFORD,MO,2819,3073,254,0.5215546503733877
65759,TANEYVILLE,MO,188,223,35,0.5425790754257908
65760,TECUMSEH,MO,0,16,16,1
65761,THEODOSIA,MO,262,527,265,0.6679340937896071
65764,TUNAS,MO,88,133,45,0.6018099547511312
65767,URBANA,MO,759,814,55,0.5174825174825175
65768,VANZANT,MO,0,11,11,1
65769,VERONA,MO,799,738,-61,0.4801561483409239
65770,WALNUT GROVE,MO,821,973,152,0.5423634336677815
65771,WALNUT SHADE,MO,214,220,6,0.5069124423963134
65772,WASHBURN,MO,578,645,67,0.5273916598528209
65773,WASOLA,MO,12,11,-1,0.4782608695652174
65774,WEAUBLEAU,MO,170,184,14,0.519774011299435
65775,WEST PLAINS,MO,13307,12260,-1047,0.4795243869049947
65779,WHEATLAND,MO,931,991,60,0.5156087408949012
65781,WILLARD,MO,3529,3575,46,0.5032376126126126
65785,STOCKTON,MO,2262,2447,185,0.5196432363559143
65786,MACKS CREEK,MO,730,799,69,0.5225637671680837
65787,ROACH,MO,785,626,-159,0.443656980864635
65788,PEACE VALLEY,MO,12,11,-1,0.4782608695652174
65789,POMONA,MO,628,555,-73,0.4691462383770076
65790,POTTERSVILLE,MO,11,24,13,0.6857142857142857
65791,THAYER,MO,2145,2157,12,0.50139470013947
65793,WILLOW SPGS,MO,48,59,11,0.5514018691588785
65793,WILLOW SPRINGS,MO,2735,2565,-170,0.4839622641509434
65801,SPRINGFIELD,MO,2675,2690,15,0.5013979496738118
65802,SPRINGFIELD,MO,28735,23597,-5138,0.4509095773140717
65803,SPRINGFIELD,MO,24533,21559,-2974,0.467738436171136
65804,SPRINGFIELD,MO,25668,20559,-5109,0.444740086962165
65806,SPRINGFIELD,MO,9417,7186,-2231,0.43281334698548457
65807,SPRINGFIELD,MO,44239,30321,-13918,0.40666577253218883
65808,SPRINGFIELD,MO,930,688,-242,0.4252163164400494
65809,SPRINGFIELD,MO,3476,3998,522,0.5349210596735349
65810,SPRINGFIELD,MO,9845,9663,-182,0.4953352470781218
65814,SPRINGFIELD,MO,771,527,-244,0.40600924499229585
66002,ATCHISON,KS,6248,5124,-1124,0.45058037284558566
66006,BALDWIN CITY,KS,2551,2603,52,0.5050446255335662
66007,BASEHOR,KS,2849,3621,772,0.5596599690880989
66010,BLUE MOUND,KS,0,12,12,1
66012,BONNER SPGS,KS,259,295,36,0.5324909747292419
66012,BONNER SPRINGS,KS,3233,3199,-34,0.49735696517412936
66013,BUCYRUS,KS,416,818,402,0.6628849270664505
66013,OVERLAND PARK,KS,13,70,57,0.8433734939759037
66014,CENTERVILLE,KS,0,13,13,1
66015,COLONY,KS,35,49,14,0.5833333333333334
66018,DE SOTO,KS,2100,2384,284,0.5316681534344335
66020,EASTON,KS,57,134,77,0.7015706806282722
66021,EDGERTON,KS,829,746,-83,0.47365079365079366
66023,EFFINGHAM,KS,103,101,-2,0.4950980392156863
66024,ELWOOD,KS,76,13,-63,0.14606741573033707
66025,EUDORA,KS,2940,2741,-199,0.48248547790881885
66026,FONTANA,KS,38,0,-38,0
66027,FORT LEAVENWORTH,KS,4803,4101,-702,0.46057951482479786
66027,FT LEAVNWRTH,KS,65,45,-20,0.4090909090909091
66030,GARDNER,KS,10860,10350,-510,0.48797736916548795
66032,GARNETT,KS,2022,1900,-122,0.4844467108618052
66033,GREELEY,KS,25,23,-2,0.4791666666666667
66035,HIGHLAND,KS,239,103,-136,0.30116959064327486
66040,LA CYGNE,KS,1377,1275,-102,0.4807692307692308
66040,LINN VALLEY,KS,356,305,-51,0.46142208774583965
66042,LANE,KS,22,39,17,0.639344262295082
66043,LANSING,KS,3624,3782,158,0.5106670267350797
66044,LAWRENCE,KS,15784,12823,-2961,0.44824693256895165
66046,LAWRENCE,KS,11453,9532,-1921,0.45422921134143435
66047,LAWRENCE,KS,12073,10044,-2029,0.45413030700366236
66048,LEAVENWORTH,KS,17027,16599,-428,0.49363587699994055
66049,LAWRENCE,KS,16704,16517,-187,0.49718551518617743
66050,LECOMPTON,KS,222,306,84,0.5795454545454546
66051,OLATHE,KS,63,115,52,0.6460674157303371
66052,LINWOOD,KS,401,642,241,0.6155321188878236
66053,LOUISBURG,KS,2572,2659,87,0.5083158095966355
66054,MC LOUTH,KS,765,782,17,0.5054945054945055
66056,MOUND CITY,KS,644,717,73,0.526818515797208
66060,NORTONVILLE,KS,74,77,3,0.5099337748344371
66061,OLATHE,KS,20325,22252,1927,0.5226295887450971
66062,OLATHE,KS,25691,26103,412,0.503977294667336
66063,OLATHE,KS,495,536,41,0.5198836081474297
66064,OSAWATOMIE,KS,2621,2305,-316,0.46792529435647584
66066,OSKALOOSA,KS,888,906,18,0.5050167224080268
66067,OTTAWA,KS,7909,7159,-750,0.4751128218741704
66070,OZAWKIE,KS,725,792,67,0.5220830586684245
66071,PAOLA,KS,4098,4233,135,0.5081022686352179
66072,PARKER,KS,34,57,23,0.6263736263736264
66073,PERRY,KS,512,712,200,0.5816993464052288
66075,PLEASANTON,KS,668,717,49,0.5176895306859206
66076,POMONA,KS,681,660,-21,0.49217002237136465
66078,PRINCETON,KS,91,77,-14,0.4583333333333333
66079,RANTOUL,KS,13,25,12,0.6578947368421053
66080,RICHMOND,KS,165,131,-34,0.44256756756756754
66083,SPRING HILL,KS,3619,4678,1059,0.5638182475593588
66085,OVERLAND PARK,KS,1267,1701,434,0.5731132075471698
66085,STILWELL,KS,1834,2373,539,0.5640599001663894
66086,TONGANOXIE,KS,3152,3678,526,0.538506588579795
66087,SEVERANCE,KS,16,24,8,0.6
66087,TROY,KS,360,344,-16,0.48863636363636365
66088,VALLEY FALLS,KS,770,770,0,0.5
66090,ELWOOD,KS,30,14,-16,0.3181818181818182
66090,WATHENA,KS,834,827,-7,0.49789283564118003
66092,WELLSVILLE,KS,1234,1238,4,0.5008090614886731
66094,WHITE CLOUD,KS,11,11,0,0.5
66095,WILLIAMSBURG,KS,154,150,-4,0.4934210526315789
66097,WINCHESTER,KS,109,36,-73,0.2482758620689655
66101,KANSAS CITY,KS,4225,3680,-545,0.465528146742568
66102,KANSAS CITY,KS,10254,8151,-2103,0.44286878565607174
66103,KANSAS CITY,KS,9372,6583,-2789,0.412597931682858
66104,KANSAS CITY,KS,8608,7785,-823,0.47489782224120053
66104,KC,KS,316,391,75,0.553041018387553
66105,KANSAS CITY,KS,790,364,-426,0.31542461005199307
66106,KANSAS CITY,KS,7767,6577,-1190,0.45851924149470163
66109,KANSAS CITY,KS,9039,9707,668,0.5178171343219887
66110,KANSAS CITY,KS,0,33,33,1
66111,EDWARDSVILLE,KS,1230,1177,-53,0.48899044453676777
66111,KANSAS CITY,KS,2160,1970,-190,0.47699757869249393
66112,KANSAS CITY,KS,7115,6204,-911,0.4658007357909753
66113,EDWARDSVILLE,KS,409,443,34,0.5199530516431925
66113,KANSAS CITY,KS,12,16,4,0.5714285714285714
66117,KANSAS CITY,KS,0,107,107,1
66201,MISSION,KS,293,263,-30,0.47302158273381295
66201,SHAWNEE MISSION,KS,64,53,-11,0.452991452991453
66201,SHAWNEE MSN,KS,11,0,-11,0
66202,MERRIAM,KS,549,485,-64,0.4690522243713733
66202,MISSION,KS,8291,7239,-1052,0.46613007083065033
66202,OVERLAND PARK,KS,774,761,-13,0.49576547231270357
66202,ROELAND PARK,KS,193,180,-13,0.48257372654155495
66202,SHAWNEE MSN,KS,269,240,-29,0.4715127701375246
66203,MERRIAM,KS,715,631,-84,0.4687964338781575
66203,OVERLAND PARK,KS,186,199,13,0.5168831168831168
66203,SHAWNEE,KS,7322,6869,-453,0.48403917976182087
66204,MERRIAM,KS,630,578,-52,0.478476821192053
66204,OVERLAND PARK,KS,10397,9451,-946,0.4761688835147118
66205,FAIRWAY,KS,1534,1494,-40,0.49339498018494055
66205,MISSION,KS,567,615,48,0.5203045685279187
66205,ROELAND PARK,KS,1870,1652,-218,0.4690516751845542
66205,WESTWOOD,KS,1182,1188,6,0.5012658227848101
66205,WESTWOOD HILLS,KS,621,636,15,0.5059665871121718
66206,LEAWOOD,KS,2796,3323,527,0.5430625919267854
66206,OVERLAND PARK,KS,40,45,5,0.5294117647058824
66206,PRAIRIE VILLAGE,KS,213,235,22,0.5245535714285714
66207,OVERLAND PARK,KS,4580,4924,344,0.5180976430976431
66207,PRAIRIE VILLAGE,KS,1481,1558,77,0.512668641000329
66208,MISSION HILLS,KS,601,654,53,0.5211155378486055
66208,PRAIRIE VILLAGE,KS,7423,7491,68,0.5022797371597157
66208,SHAWNEE MISSION,KS,167,187,20,0.5282485875706214
66209,LEAWOOD,KS,4022,4169,147,0.5089732633378098
66209,OVERLAND PARK,KS,3252,3532,280,0.5206367924528302
66210,LENEXA,KS,182,175,-7,0.49019607843137253
66210,OVERLAND PARK,KS,11109,10455,-654,0.484835837506956
66211,LEAWOOD,KS,3984,4422,438,0.5260528194147038
66211,OVERLAND PARK,KS,197,209,12,0.5147783251231527
66212,OVERLAND PARK,KS,16574,14828,-1746,0.47219922297942807
66213,OVERLAND PARK,KS,15233,14925,-308,0.49489356058094036
66214,LENEXA,KS,142,159,17,0.5282392026578073
66214,OVERLAND PARK,KS,4760,4075,-685,0.46123372948500285
66214,SHAWNEE,KS,1584,1475,-109,0.48218372016999017
66214,SHAWNEE MISSION,KS,256,214,-42,0.4553191489361702
66215,LENEXA,KS,10339,9634,-705,0.48235117408501477
66215,OLATHE,KS,1420,1272,-148,0.4725111441307578
66215,OVERLAND PARK,KS,765,619,-146,0.4472543352601156
66216,LENEXA,KS,1118,1149,31,0.5068372298191443
66216,SHAWNEE,KS,6529,6661,132,0.5050037907505686
66217,LAKE QUIVIRA,KS,535,421,-114,0.44037656903765693
66217,SHAWNEE,KS,2457,2338,-119,0.48759124087591244
66218,SHAWNEE,KS,2306,2680,374,0.5375050140393101
66219,LENEXA,KS,9455,9484,29,0.5007656159248113
66220,LENEXA,KS,2039,2473,434,0.5480939716312057
66221,OVERLAND PARK,KS,6328,7832,1504,0.5531073446327683
66223,OVERLAND PARK,KS,13165,12635,-530,0.48972868217054266
66224,LEAWOOD,KS,1595,2047,452,0.5620538165842943
66224,OVERLAND PARK,KS,2199,2782,583,0.5585223850632404
66225,OVERLAND PARK,KS,185,504,319,0.7314949201741655
66225,SHAWNEE MSN,KS,0,19,19,1
66226,SHAWNEE,KS,3509,4283,774,0.5496663244353183
66227,LENEXA,KS,1629,2477,848,0.603263516804676
66227,SHAWNEE,KS,901,1481,580,0.6217464315701091
66227,SHAWNEE MISSION,KS,124,112,-12,0.4745762711864407
66282,OVERLAND PARK,KS,60,193,133,0.7628458498023716
66283,OVERLAND PARK,KS,92,197,105,0.6816608996539792
66283,SHAWNEE MSN,KS,0,12,12,1
66285,LENEXA,KS,456,587,131,0.5627996164908916
66286,SHAWNEE,KS,22,100,78,0.819672131147541
66401,ALMA,KS,325,330,5,0.5038167938931297
66402,AUBURN,KS,937,918,-19,0.4948787061994609
66403,AXTELL,KS,33,0,-33,0
66406,BEATTIE,KS,0,13,13,1
66408,BERN,KS,27,0,-27,0
66409,BERRYTON,KS,628,749,121,0.5439360929557008
66411,BLUE RAPIDS,KS,207,202,-5,0.4938875305623472
66413,BURLINGAME,KS,515,554,39,0.5182413470533208
66414,CARBONDALE,KS,1012,978,-34,0.4914572864321608
66415,CENTRALIA,KS,24,28,4,0.5384615384615384
66416,CIRCLEVILLE,KS,12,0,-12,0
66419,DENISON,KS,11,0,-11,0
66423,ESKRIDGE,KS,120,125,5,0.5102040816326531
66424,EVEREST,KS,11,0,-11,0
66425,FAIRVIEW,KS,11,13,2,0.5416666666666666
66427,FRANKFORT,KS,146,83,-63,0.3624454148471616
66429,GRANTVILLE,KS,11,11,0,0.5
66431,HARVEYVILLE,KS,28,40,12,0.5882352941176471
66434,HIAWATHA,KS,2301,2093,-208,0.47633136094674555
66436,HOLTON,KS,2243,2256,13,0.5014447655034452
66438,HOME,KS,12,0,-12,0
66439,HORTON,KS,1067,1162,95,0.5213100044863167
66440,HOYT,KS,368,419,51,0.5324015247776366
66441,JUNCTION CITY,KS,21901,17208,-4693,0.4400010227824797
66442,FORT RILEY,KS,9720,7148,-2572,0.4237609675124496
66442,FT RILEY,KS,484,388,-96,0.44495412844036697
66449,LEONARDVILLE,KS,51,25,-26,0.32894736842105265
66451,LYNDON,KS,635,537,-98,0.45819112627986347
66502,MANHATTAN,KS,39393,24186,-15207,0.38040862548954846
66503,MANHATTAN,KS,10950,8481,-2469,0.43646750038598114
66505,MANHATTAN,KS,445,483,38,0.5204741379310345
66506,MANHATTAN,KS,0,11,11,1
66507,MAPLE HILL,KS,93,139,46,0.5991379310344828
66508,MARYSVILLE,KS,3085,2055,-1030,0.39980544747081714
66509,MAYETTA,KS,733,575,-158,0.4396024464831804
66510,MELVERN,KS,116,87,-29,0.42857142857142855
66512,MERIDEN,KS,883,1030,147,0.538421327757449
66514,MILFORD,KS,716,598,-118,0.4550989345509893
66516,NETAWAKA,KS,11,0,-11,0
66517,OGDEN,KS,1510,1369,-141,0.47551233067037163
66520,OLSBURG,KS,0,11,11,1
66521,DULUTH,KS,0,13,13,1
66521,ONAGA,KS,250,328,78,0.5674740484429066
66521,WHEATON,KS,41,31,-10,0.4305555555555556
66523,OSAGE CITY,KS,1768,1853,85,0.5117370892018779
66524,OVERBROOK,KS,804,802,-2,0.49937733499377335
66526,PAXICO,KS,24,11,-13,0.3142857142857143
66528,QUENEMO,KS,49,81,32,0.6230769230769231
66531,RILEY,KS,226,299,73,0.5695238095238095
66532,ROBINSON,KS,22,0,-22,0
66533,ROSSVILLE,KS,582,408,-174,0.4121212121212121
66534,SABETHA,KS,1337,1256,-81,0.4843810258387968
66535,SAINT GEORGE,KS,1177,1187,10,0.5021150592216582
66536,SAINT MARYS,KS,1177,1034,-143,0.46766169154228854
66537,SCRANTON,KS,189,301,112,0.6142857142857143
66538,SENECA,KS,1274,1155,-119,0.4755043227665706
66539,SILVER LAKE,KS,798,769,-29,0.4907466496490108
66541,SUMMERFIELD,KS,11,0,-11,0
66542,TECUMSEH,KS,801,853,52,0.5157194679564692
66543,VASSAR,KS,131,106,-25,0.4472573839662447
66546,WAKARUSA,KS,62,61,-1,0.4959349593495935
66547,WAMEGO,KS,3401,3399,-2,0.4998529411764706
66548,MARYSVILLE,KS,0,13,13,1
66548,WATERVILLE,KS,157,128,-29,0.44912280701754387
66549,WESTMORELAND,KS,324,419,95,0.5639300134589502
66550,WETMORE,KS,11,0,-11,0
66554,RANDOLPH,KS,11,0,-11,0
66601,TOPEKA,KS,338,544,206,0.6167800453514739
66603,TOPEKA,KS,1381,1216,-165,0.46823257604928764
66604,TOPEKA,KS,14545,11760,-2785,0.44706329595134003
66605,TOPEKA,KS,9552,8378,-1174,0.4672615727830452
66606,TOPEKA,KS,6969,5487,-1482,0.4405105973025048
66607,TOPEKA,KS,4542,3638,-904,0.4447432762836186
66608,TOPEKA,KS,3193,3366,173,0.5131879859734716
66609,TOPEKA,KS,4055,3921,-134,0.4915997993981946
66610,TOPEKA,KS,2397,2791,394,0.5379722436391673
66611,TOPEKA,KS,5880,5042,-838,0.46163706280900935
66612,TOPEKA,KS,2303,1586,-717,0.4078169195165852
66614,TOPEKA,KS,16919,13544,-3375,0.44460493057151296
66615,TOPEKA,KS,1441,1448,7,0.5012114918656975
66616,TOPEKA,KS,2152,2071,-81,0.49040966137816716
66617,TOPEKA,KS,2728,2751,23,0.5020989231611608
66618,TOPEKA,KS,2775,2724,-51,0.49536279323513366
66619,TOPEKA,KS,2581,2020,-561,0.43903499239295807
66667,TOPEKA,KS,11,0,-11,0
66675,TOPEKA,KS,0,57,57,1
66701,FORT SCOTT,KS,5811,5186,-625,0.47158315904337544
66710,ALTOONA,KS,93,76,-17,0.44970414201183434
66711,ARCADIA,KS,23,56,33,0.7088607594936709
66712,ARMA,KS,1017,814,-203,0.4445658110322228
66713,BAXTER SPRINGS,KS,2712,2303,-409,0.459222333000997
66716,BRONSON,KS,24,12,-12,0.3333333333333333
66717,BUFFALO,KS,0,11,11,1
66720,CHANUTE,KS,5300,4797,-503,0.4750916113697138
66724,CHEROKEE,KS,119,73,-46,0.3802083333333333
66725,COLUMBUS,KS,2250,2131,-119,0.48641862588450124
66732,ELSMORE,KS,0,13,13,1
66733,ERIE,KS,602,536,-66,0.4710017574692443
66735,FRANKLIN,KS,40,39,-1,0.4936708860759494
66736,FREDONIA,KS,1716,1479,-237,0.4629107981220657
66738,FULTON,KS,0,11,11,1
66739,GALENA,KS,2304,1947,-357,0.4580098800282287
66742,GAS,KS,0,13,13,1
66743,GIRARD,KS,1713,1628,-85,0.48727925770727326
66748,HUMBOLDT,KS,968,916,-52,0.4861995753715499
66749,IOLA,KS,4536,3615,-921,0.44350386455649615
66751,LA HARPE,KS,118,66,-52,0.358695652173913
66753,MC CUNE,KS,143,99,-44,0.4090909090909091
66754,MAPLETON,KS,0,11,11,1
66755,MORAN,KS,374,378,4,0.5026595744680851
66756,MULBERRY,KS,212,155,-57,0.4223433242506812
66757,NEODESHA,KS,1744,1555,-189,0.47135495604728705
66762,PITTSBURG,KS,16113,12329,-3784,0.43347865832219956
66763,FRONTENAC,KS,1590,1351,-239,0.4593675620537232
66767,PRESCOTT,KS,0,11,11,1
66770,RIVERTON,KS,191,112,-79,0.3696369636963696
66771,SAINT PAUL,KS,11,38,27,0.7755102040816326
66773,SCAMMON,KS,66,34,-32,0.34
66776,THAYER,KS,275,136,-139,0.3309002433090024
66777,TORONTO,KS,59,118,59,0.6666666666666666
66779,UNIONTOWN,KS,0,12,12,1
66781,WEIR,KS,424,178,-246,0.2956810631229236
66783,YATES CENTER,KS,1103,783,-320,0.4151643690349947
66801,EMPORIA,KS,17696,12736,-4960,0.4185068349106204
66833,ALLEN,KS,12,0,-12,0
66834,ALTA VISTA,KS,141,82,-59,0.36771300448430494
66835,AMERICUS,KS,148,135,-13,0.47703180212014135
66839,BURLINGTON,KS,1625,1601,-24,0.4962802231866088
66839,NEW STRAWN,KS,121,111,-10,0.47844827586206895
66840,BURNS,KS,37,0,-37,0
66845,COTTONWD FLS,KS,0,27,27,1
66845,COTTONWOOD FALLS,KS,220,167,-53,0.4315245478036176
66846,COUNCIL GROVE,KS,1617,1531,-86,0.4863405336721728
66849,DWIGHT,KS,14,0,-14,0
66851,FLORENCE,KS,26,22,-4,0.4583333333333333
66852,GRIDLEY,KS,34,25,-9,0.423728813559322
66854,HARTFORD,KS,97,113,16,0.5380952380952381
66856,LEBO,KS,499,552,53,0.5252140818268316
66857,LE ROY,KS,105,87,-18,0.453125
66858,LINCOLNVILLE,KS,31,0,-31,0
66859,LOST SPRINGS,KS,0,11,11,1
66860,MADISON,KS,242,178,-64,0.4238095238095238
66861,MARION,KS,1205,1227,22,0.5045230263157895
66864,NEOSHO RAPIDS,KS,13,22,9,0.6285714285714286
66865,OLPE,KS,20,12,-8,0.375
66866,PEABODY,KS,526,484,-42,0.4792079207920792
66868,READING,KS,0,11,11,1
66869,STRONG CITY,KS,68,89,21,0.5668789808917197
66871,WAVERLY,KS,126,117,-9,0.48148148148148145
66872,WHITE CITY,KS,108,145,37,0.5731225296442688
66901,CONCORDIA,KS,2993,2915,-78,0.49339878131347326
66935,BELLEVILLE,KS,1141,1086,-55,0.48765154916928605
66937,CLIFTON,KS,23,0,-23,0
66938,CLYDE,KS,42,34,-8,0.4473684210526316
66943,GREENLEAF,KS,15,24,9,0.6153846153846154
66945,HANOVER,KS,59,12,-47,0.16901408450704225
66948,JAMESTOWN,KS,13,0,-13,0
66949,JEWELL,KS,26,13,-13,0.3333333333333333
66951,KENSINGTON,KS,31,14,-17,0.3111111111111111
66953,LINN,KS,58,0,-58,0
66956,MANKATO,KS,297,315,18,0.5147058823529411
66966,SCANDIA,KS,16,26,10,0.6190476190476191
66967,SMITH CENTER,KS,860,865,5,0.5014492753623189
66968,WASHINGTON,KS,334,224,-110,0.4014336917562724
67001,ANDALE,KS,250,284,34,0.5318352059925093
67002,ANDOVER,KS,7194,6768,-426,0.48474430597335627
67003,ANTHONY,KS,1486,1357,-129,0.4773126978543792
67004,ARGONIA,KS,51,31,-20,0.3780487804878049
67005,ARKANSAS CITY,KS,8229,6842,-1387,0.4539844734921372
67008,ATLANTA,KS,12,12,0,0.5
67009,ATTICA,KS,12,50,38,0.8064516129032258
67010,AUGUSTA,KS,5795,5280,-515,0.4767494356659142
67013,BELLE PLAINE,KS,1222,1037,-185,0.45905267817618417
67016,BENTLEY,KS,25,23,-2,0.4791666666666667
67017,BENTON,KS,580,681,101,0.5400475812846947
67019,BURDEN,KS,59,11,-48,0.15714285714285714
67020,BURRTON,KS,855,632,-223,0.4250168123739072
67022,CALDWELL,KS,522,370,-152,0.4147982062780269
67024,CEDAR VALE,KS,86,80,-6,0.4819277108433735
67025,CHENEY,KS,1403,1358,-45,0.49185077870336835
67026,CLEARWATER,KS,1776,1720,-56,0.4919908466819222
67029,COLDWATER,KS,74,72,-2,0.4931506849315068
67030,COLWICH,KS,887,897,10,0.5028026905829597
67031,CONWAY SPRINGS,KS,498,429,-69,0.4627831715210356
67035,CUNNINGHAM,KS,60,28,-32,0.3181818181818182
67037,DERBY,KS,13313,13150,-163,0.4969202282432075
67038,DEXTER,KS,11,0,-11,0
67039,DOUGLASS,KS,1049,1049,0,0.5
67041,ELBING,KS,14,0,-14,0
67042,EL DORADO,KS,9015,7399,-1616,0.4507737297429024
67045,EUREKA,KS,1754,1526,-228,0.4652439024390244
67047,FALL RIVER,KS,64,26,-38,0.28888888888888886
67050,GARDEN PLAIN,KS,310,381,71,0.5513748191027497
67052,GODDARD,KS,3079,3364,285,0.5221170262300171
67053,GOESSEL,KS,22,0,-22,0
67054,GREENSBURG,KS,503,314,-189,0.3843329253365973
67056,HALSTEAD,KS,1359,1215,-144,0.47202797202797203
67058,HARPER,KS,764,754,-10,0.49670619235836627
67059,HAVILAND,KS,69,29,-40,0.29591836734693877
67060,HAYSVILLE,KS,6246,5748,-498,0.4792396198099049
67062,HESSTON,KS,1773,1680,-93,0.48653344917463076
67063,HILLSBORO,KS,1565,1252,-313,0.4444444444444444
67067,KECHI,KS,792,959,167,0.5476870359794404
67068,KINGMAN,KS,1883,1895,12,0.5015881418740075
67070,KIOWA,KS,328,191,-137,0.36801541425818884
67074,LEON,KS,389,354,-35,0.47644683714670255
67101,MAIZE,KS,3671,3451,-220,0.48455490030890197
67104,MEDICINE LDG,KS,136,110,-26,0.44715447154471544
67104,MEDICINE LODGE,KS,1099,936,-163,0.45995085995085994
67106,MILTON,KS,0,23,23,1
67107,MOUNDRIDGE,KS,1265,1249,-16,0.4968178202068417
67108,MOUNT HOPE,KS,255,220,-35,0.4631578947368421
67109,MULLINVILLE,KS,38,11,-27,0.22448979591836735
67110,MULVANE,KS,2973,2919,-54,0.4954175152749491
67114,NEWTON,KS,11911,9393,-2518,0.4409031167855802
67117,NORTH NEWTON,KS,510,535,25,0.5119617224880383
67118,NORWICH,KS,12,36,24,0.75
67119,OXFORD,KS,481,328,-153,0.4054388133498146
67120,PECK,KS,111,171,60,0.6063829787234043
67124,PRATT,KS,4084,3630,-454,0.4705729841845994
67133,ROSE HILL,KS,2124,2283,159,0.5180394826412525
67135,SEDGWICK,KS,1162,1117,-45,0.4901272487933304
67137,SEVERY,KS,13,29,16,0.6904761904761905
67138,SHARON,KS,11,0,-11,0
67140,SOUTH HAVEN,KS,56,37,-19,0.3978494623655914
67144,TOWANDA,KS,1097,1198,101,0.5220043572984749
67146,UDALL,KS,426,576,150,0.5748502994011976
67147,VALLEY CENTER,KS,3897,3731,-166,0.4891190351337179
67149,VIOLA,KS,0,14,14,1
67152,WELLINGTON,KS,5348,4397,-951,0.4512057465366855
67154,WHITEWATER,KS,161,86,-75,0.3481781376518219
67156,WINFIELD,KS,7593,6369,-1224,0.4561667382896433
67201,WICHITA,KS,1318,902,-416,0.4063063063063063
67202,WICHITA,KS,6473,4724,-1749,0.42189872287219793
67203,WICHITA,KS,18558,14898,-3660,0.4453012912482066
67204,PARK CITY,KS,523,492,-31,0.48472906403940885
67204,WICHITA,KS,8420,6416,-2004,0.43246157994068485
67205,WICHITA,KS,6741,7915,1174,0.5400518558951966
67206,EASTBOROUGH,KS,190,212,22,0.527363184079602
67206,WICHITA,KS,9320,8827,-493,0.48641648757370365
67207,WICHITA,KS,23373,15047,-8326,0.39164497657470065
67208,WICHITA,KS,12804,9395,-3409,0.4232172620388306
67209,WICHITA,KS,6175,5754,-421,0.48235392740380584
67210,WICHITA,KS,6176,4700,-1476,0.4321441706509746
67211,WICHITA,KS,15359,10226,-5133,0.39968731678718
67212,WICHITA,KS,23477,18099,-5378,0.43532326342120453
67213,WICHITA,KS,13148,10742,-2406,0.44964420259522814
67214,WICHITA,KS,12960,7982,-4978,0.3811479323846815
67215,WICHITA,KS,1626,1903,277,0.5392462453952961
67216,WICHITA,KS,14805,12481,-2324,0.4574140584915341
67217,WICHITA,KS,20624,14894,-5730,0.41933667436229516
67218,WICHITA,KS,20412,11943,-8469,0.3691237830319889
67219,PARK CITY,KS,2111,1719,-392,0.44882506527415145
67219,WICHITA,KS,5745,4263,-1482,0.4259592326139089
67220,BEL AIRE,KS,2197,1154,-1043,0.3443748134885109
67220,BELAIRE,KS,234,128,-106,0.35359116022099446
67220,WICHITA,KS,7506,4236,-3270,0.36075625958099133
67221,MCCONNELL AFB,KS,935,546,-389,0.36866981769074947
67221,WICHITA,KS,69,31,-38,0.31
67226,WICHITA,KS,11914,11467,-447,0.49044095633206447
67228,WICHITA,KS,283,440,157,0.6085753803596127
67230,WICHITA,KS,3102,3985,883,0.5622971638210809
67235,WICHITA,KS,3432,4564,1132,0.5707853926963482
67275,WICHITA,KS,97,0,-97,0
67277,WICHITA,KS,326,212,-114,0.3940520446096654
67278,WICHITA,KS,483,794,311,0.6217697729052467
67301,INDEPENDENCE,KS,6865,6041,-824,0.468076863474353
67330,ALTAMONT,KS,457,404,-53,0.4692218350754936
67333,CANEY,KS,1470,1109,-361,0.430011632415665
67335,CHERRYVALE,KS,1529,1257,-272,0.45118449389806176
67336,CHETOPA,KS,410,400,-10,0.49382716049382713
67337,COFFEYVILLE,KS,7396,4753,-2643,0.3912256152769775
67340,DEARING,KS,11,0,-11,0
67342,EDNA,KS,83,53,-30,0.3897058823529412
67344,ELK CITY,KS,38,72,34,0.6545454545454545
67349,HOWARD,KS,171,131,-40,0.4337748344370861
67352,LONGTON,KS,69,59,-10,0.4609375
67353,MOLINE,KS,24,24,0,0.5
67354,MOUND VALLEY,KS,56,51,-5,0.4766355140186916
67356,OSWEGO,KS,1196,987,-209,0.4521300961978928
67357,PARSONS,KS,7223,5646,-1577,0.43872872795088974
67361,SEDAN,KS,709,612,-97,0.46328538985616957
67364,TYRO,KS,13,0,-13,0
67401,SALINA,KS,27292,22104,-5188,0.4474856263665074
67402,SALINA,KS,926,929,3,0.5008086253369273
67410,ABILENE,KS,4877,4229,-648,0.4644190643531737
67416,ASSARIA,KS,247,115,-132,0.31767955801104975
67416,MENTOR,KS,15,0,-15,0
67420,BELOIT,KS,1579,1636,57,0.5088646967340591
67422,BENNINGTON,KS,202,154,-48,0.43258426966292135
67425,BROOKVILLE,KS,12,0,-12,0
67428,CANTON,KS,334,263,-71,0.440536013400335
67430,CAWKER CITY,KS,11,12,1,0.5217391304347826
67431,CHAPMAN,KS,1388,1070,-318,0.435313262815297
67432,CLAY CENTER,KS,2380,2084,-296,0.4668458781362007
67436,DELPHOS,KS,64,0,-64,0
67437,DOWNS,KS,159,134,-25,0.45733788395904434
67439,ELLSWORTH,KS,1501,1272,-229,0.4587089794446448
67441,ENTERPRISE,KS,271,173,-98,0.38963963963963966
67443,GALVA,KS,267,211,-56,0.44142259414225943
67445,GLASCO,KS,23,45,22,0.6617647058823529
67446,GLEN ELDER,KS,13,22,9,0.6285714285714286
67448,CARLTON,KS,22,32,10,0.5925925925925926
67448,GYPSUM,KS,137,160,23,0.5387205387205387
67449,HERINGTON,KS,1690,1467,-223,0.46468165980361104
67450,HOLYROOD,KS,82,25,-57,0.2336448598130841
67451,HOPE,KS,68,60,-8,0.46875
67454,KANOPOLIS,KS,42,58,16,0.58
67455,LINCOLN,KS,932,691,-241,0.425754775107825
67456,LINDSBORG,KS,1671,1577,-94,0.48552955665024633
67457,LITTLE RIVER,KS,77,36,-41,0.3185840707964602
67460,MC PHERSON,KS,858,817,-41,0.48776119402985074
67460,MCPHERSON,KS,7032,6238,-794,0.4700828937452901
67464,MARQUETTE,KS,215,71,-144,0.24825174825174826
67466,MILTONVALE,KS,82,26,-56,0.24074074074074073
67467,MINNEAPOLIS,KS,1102,972,-130,0.4686595949855352
67470,NEW CAMBRIA,KS,0,12,12,1
67473,OSBORNE,KS,774,641,-133,0.4530035335689046
67480,SOLOMON,KS,328,289,-39,0.4683954619124797
67481,SYLVAN GROVE,KS,12,22,10,0.6470588235294118
67484,TESCOTT,KS,12,0,-12,0
67487,WAKEFIELD,KS,564,581,17,0.5074235807860262
67490,WILSON,KS,95,88,-7,0.4808743169398907
67501,HUTCHINSON,KS,17291,13099,-4192,0.43102994406054623
67502,HUTCHINSON,KS,10564,9608,-956,0.4763037874281182
67504,HUTCHINSON,KS,296,593,297,0.6670416197975253
67505,HUTCHINSON,KS,29,27,-2,0.48214285714285715
67505,S HUTCHINSON,KS,38,12,-26,0.24
67505,SOUTH HUTCHINSON,KS,1660,1213,-447,0.4222067525234946
67510,ABBYVILLE,KS,15,11,-4,0.4230769230769231
67514,ARLINGTON,KS,74,65,-9,0.4676258992805755
67522,BUHLER,KS,657,612,-45,0.48226950354609927
67523,BURDETT,KS,11,0,-11,0
67524,CHASE,KS,12,13,1,0.52
67525,CLAFLIN,KS,64,42,-22,0.39622641509433965
67526,ELLINWOOD,KS,1164,949,-215,0.4491244675816375
67530,GREAT BEND,KS,8735,7742,-993,0.46986708745524064
67543,HAVEN,KS,750,699,-51,0.4824016563146998
67544,HOISINGTON,KS,1775,1323,-452,0.42704970948999355
67546,INMAN,KS,977,942,-35,0.49088066701406985
67547,KINSLEY,KS,750,517,-233,0.4080505130228887
67548,LA CROSSE,KS,598,602,4,0.5016666666666667
67550,LARNED,KS,3150,2438,-712,0.43629205440229063
67554,LYONS,KS,1880,1790,-90,0.4877384196185286
67556,MC CRACKEN,KS,12,0,-12,0
67557,MACKSVILLE,KS,22,27,5,0.5510204081632653
67560,NESS CITY,KS,747,515,-232,0.4080824088748019
67561,NICKERSON,KS,619,443,-176,0.4171374764595104
67563,OFFERLE,KS,12,0,-12,0
67565,GALATIA,KS,11,0,-11,0
67565,OTIS,KS,12,0,-12,0
67566,PARTRIDGE,KS,12,26,14,0.6842105263157895
67567,PAWNEE ROCK,KS,34,23,-11,0.40350877192982454
67570,PRETTY PRAIRE,KS,0,28,28,1
67570,PRETTY PRAIRIE,KS,163,196,33,0.5459610027855153
67576,SAINT JOHN,KS,45,25,-20,0.35714285714285715
67576,SEWARD,KS,55,56,1,0.5045045045045045
67576,ST JOHN,KS,503,420,-83,0.4550379198266522
67578,STAFFORD,KS,757,477,-280,0.386547811993517
67579,STERLING,KS,1078,1025,-53,0.4873989538754161
67581,SYLVIA,KS,0,11,11,1
67583,LANGDON,KS,0,32,32,1
67583,PRESTON,KS,16,27,11,0.627906976744186
67583,TURON,KS,113,56,-57,0.33136094674556216
67601,HAYS,KS,13071,10810,-2261,0.4526611113437461
67622,ALMENA,KS,48,44,-4,0.4782608695652174
67625,BOGUE,KS,17,0,-17,0
67632,DAMAR,KS,12,0,-12,0
67637,ELLIS,KS,1027,958,-69,0.4826196473551637
67640,GORHAM,KS,39,0,-39,0
67642,HILL CITY,KS,950,790,-160,0.4540229885057471
67645,LENORA,KS,13,0,-13,0
67646,LOGAN,KS,37,0,-37,0
67648,LUCAS,KS,11,24,13,0.6857142857142857
67649,LURAY,KS,13,0,-13,0
67651,NATOMA,KS,22,0,-22,0
67653,NORCATUR,KS,13,0,-13,0
67654,NORTON,KS,1860,1832,-28,0.4962080173347779
67657,PALCO,KS,0,13,13,1
67661,PHILLIPSBURG,KS,1508,1240,-268,0.4512372634643377
67663,CODELL,KS,18,24,6,0.5714285714285714
67663,PLAINVILLE,KS,949,933,-16,0.4957492029755579
67663,ZURICH,KS,25,17,-8,0.40476190476190477
67665,RUSSELL,KS,2869,2516,-353,0.46722376973073354
67669,STOCKTON,KS,658,591,-67,0.4731785428342674
67671,VICTORIA,KS,321,286,-35,0.471169686985173
67672,WA KEENEY,KS,16,15,-1,0.4838709677419355
67672,WAKEENEY,KS,1052,884,-168,0.45661157024793386
67701,COLBY,KS,3399,2636,-763,0.4367854183927092
67701,REXFORD,KS,91,58,-33,0.38926174496644295
67730,ATWOOD,KS,611,461,-150,0.4300373134328358
67731,BIRD CITY,KS,24,23,-1,0.48936170212765956
67732,BREWSTER,KS,0,12,12,1
67735,GOODLAND,KS,2605,2408,-197,0.4803510871733493
67738,GRINNELL,KS,11,0,-11,0
67740,HOXIE,KS,473,346,-127,0.42246642246642246
67748,OAKLEY,KS,1199,1019,-180,0.4594229035166817
67749,OBERLIN,KS,1238,991,-247,0.4445939883355765
67751,PARK,KS,67,61,-6,0.4765625
67752,QUINTER,KS,139,114,-25,0.4505928853754941
67753,REXFORD,KS,42,14,-28,0.25
67756,SAINT FRANCIS,KS,705,605,-100,0.4618320610687023
67758,SHARON SPRINGS,KS,117,122,5,0.5104602510460251
67801,DODGE CITY,KS,13074,9751,-3323,0.4272070098576123
67831,ASHLAND,KS,158,11,-147,0.0650887573964497
67834,BUCKLIN,KS,173,46,-127,0.2100456621004566
67835,CIMARRON,KS,727,703,-24,0.4916083916083916
67837,COPELAND,KS,36,25,-11,0.4098360655737705
67838,DEERFIELD,KS,218,35,-183,0.1383399209486166
67839,DIGHTON,KS,166,186,20,0.5284090909090909
67844,FOWLER,KS,96,48,-48,0.3333333333333333
67846,GARDEN CITY,KS,15950,12084,-3866,0.4310480131269173
67849,HANSTON,KS,23,0,-23,0
67850,HEALY,KS,15,0,-15,0
67851,HOLCOMB,KS,676,673,-3,0.4988880652335063
67853,INGALLS,KS,11,0,-11,0
67854,JETMORE,KS,270,199,-71,0.42430703624733473
67855,JOHNSON,KS,292,34,-258,0.10429447852760736
67859,KISMET,KS,23,0,-23,0
67860,LAKIN,KS,1001,665,-336,0.39915966386554624
67861,LEOTI,KS,813,545,-268,0.4013254786450663
67864,MEADE,KS,555,449,-106,0.44721115537848605
67865,MINNEOLA,KS,281,128,-153,0.31295843520782396
67867,MONTEZUMA,KS,120,46,-74,0.27710843373493976
67869,PLAINS,KS,200,71,-129,0.26199261992619927
67870,SATANTA,KS,133,46,-87,0.2569832402234637
67871,SCOTT CITY,KS,2555,2061,-494,0.4464904679376083
67876,GARDEN CITY,KS,19,0,-19,0
67876,SPEARVILLE,KS,110,141,31,0.5617529880478087
67877,SUBLETTE,KS,968,789,-179,0.44906089926010245
67878,SYRACUSE,KS,660,98,-562,0.12928759894459102
67879,TRIBUNE,KS,285,238,-47,0.45506692160611856
67880,ULYSSES,KS,2179,1947,-232,0.47188560349006303
67901,LIBERAL,KS,6348,5191,-1157,0.44986567293526303
67905,LIBERAL,KS,669,341,-328,0.33762376237623765
67950,ELKHART,KS,286,225,-61,0.44031311154598823
67951,HUGOTON,KS,1567,1246,-321,0.44294347671525064
67952,MOSCOW,KS,0,11,11,1
67954,ROLLA,KS,11,0,-11,0
68001,ABIE,NE,29,24,-5,0.4528301886792453
68002,ARLINGTON,NE,717,533,-184,0.4264
68003,ASHLAND,NE,1857,2126,269,0.5337685161938237
68004,BANCROFT,NE,27,0,-27,0
68005,BELLEVUE,NE,12757,10558,-2199,0.4528415183358353
68007,BENNINGTON,NE,3933,6316,2383,0.6162552444140892
68008,BLAIR,NE,4967,4659,-308,0.48400166216496987
68010,BOYS TOWN,NE,160,179,19,0.528023598820059
68010,BOYSTOWN,NE,0,12,12,1
68015,CEDAR BLUFFS,NE,312,161,-151,0.3403805496828753
68017,CERESCO,NE,344,218,-126,0.3879003558718861
68019,CRAIG,NE,28,0,-28,0
68020,DECATUR,NE,49,63,14,0.5625
68022,ELKHORN,NE,11910,15925,4015,0.5721214298544998
68023,FORT CALHOUN,NE,686,768,82,0.5281980742778541
68025,FREMONT,NE,14343,12820,-1523,0.4719655413614107
68026,FREMONT,NE,387,216,-171,0.3582089552238806
68028,GRETNA,NE,4167,5128,961,0.5516944593867671
68029,HERMAN,NE,65,13,-52,0.16666666666666666
68030,HOMER,NE,34,0,-34,0
68031,HOOPER,NE,548,514,-34,0.4839924670433145
68033,ITHACA,NE,11,0,-11,0
68034,KENNARD,NE,25,11,-14,0.3055555555555556
68037,LOUISVILLE,NE,865,891,26,0.5074031890660592
68038,LYONS,NE,401,225,-176,0.35942492012779553
68039,MACY,NE,169,138,-31,0.4495114006514658
68041,MEAD,NE,98,85,-13,0.4644808743169399
68044,NICKERSON,NE,125,55,-70,0.3055555555555556
68045,OAKLAND,NE,536,536,0,0.5
68046,PAPILLION,NE,11275,13176,1901,0.5388736656987444
68047,PENDER,NE,414,401,-13,0.4920245398773006
68048,PLATTSMOUTH,NE,5171,5179,8,0.5003864734299517
68050,PRAGUE,NE,15,0,-15,0
68057,SCRIBNER,NE,257,273,16,0.5150943396226415
68059,RICHFIELD,NE,14,17,3,0.5483870967741935
68059,SPRINGFIELD,NE,773,960,187,0.5539526832083093
68061,TEKAMAH,NE,787,794,7,0.502213788741303
68062,THURSTON,NE,0,13,13,1
68063,UEHLING,NE,12,0,-12,0
68064,LESHARA,NE,42,32,-10,0.43243243243243246
68064,VALLEY,NE,1723,2021,298,0.5397970085470085
68065,VALPARAISO,NE,51,128,77,0.7150837988826816
68066,WAHOO,NE,1959,2052,93,0.5115931189229619
68067,WALTHILL,NE,154,72,-82,0.3185840707964602
68069,WATERLOO,NE,1112,1184,72,0.5156794425087108
68070,WESTON,NE,12,18,6,0.6
68071,WINNEBAGO,NE,272,170,-102,0.38461538461538464
68073,YUTAN,NE,564,638,74,0.5307820299500832
68101,OMAHA,NE,75,92,17,0.5508982035928144
68102,OMAHA,NE,11227,8513,-2714,0.4312563323201621
68103,OMAHA,NE,48,673,625,0.9334257975034674
68104,OMAHA,NE,19927,16031,-3896,0.44582568552199786
68105,OMAHA,NE,15065,10141,-4924,0.4023248432912799
68106,OMAHA,NE,13089,10936,-2153,0.4551925078043704
68107,OMAHA,NE,10268,7876,-2392,0.4340828924162258
68108,OMAHA,NE,7446,6879,-567,0.48020942408376965
68110,OMAHA,NE,4200,3540,-660,0.4573643410852713
68111,OMAHA,NE,14508,12865,-1643,0.46998867497168745
68112,OMAHA,NE,4625,4151,-474,0.47299453053783047
68113,OFFUTT AFB,NE,395,434,39,0.5235223160434258
68114,OMAHA,NE,11310,9337,-1973,0.4522206615973265
68116,OMAHA,NE,12920,13372,452,0.5085957705766012
68117,OMAHA,NE,2578,2238,-340,0.46470099667774084
68118,OMAHA,NE,2925,3065,140,0.511686143572621
68122,OMAHA,NE,5158,5570,412,0.5192020879940343
68123,BELLEVUE,NE,16572,15326,-1246,0.4804689949213117
68124,OMAHA,NE,7317,7002,-315,0.48900062853551224
68127,OMAHA,NE,14947,11604,-3343,0.437045685661557
68127,RALSTON,NE,302,235,-67,0.4376163873370577
68128,LA VISTA,NE,8796,8090,-706,0.47909510837380076
68128,LAVISTA,NE,203,203,0,0.5
68130,OMAHA,NE,7529,7835,306,0.5099583441812028
68131,OMAHA,NE,14271,8937,-5334,0.38508273009307137
68132,OMAHA,NE,9074,6863,-2211,0.4306331179017381
68133,BELLEVUE,NE,60,114,54,0.6551724137931034
68133,PAPILLION,NE,4024,4787,763,0.543298150039723
68134,OMAHA,NE,17588,14233,-3355,0.4472832406272587
68135,OMAHA,NE,8372,8639,267,0.5078478631473752
68136,OMAHA,NE,5748,7525,1777,0.5669404053341369
68137,OMAHA,NE,12926,11140,-1786,0.4628937089670074
68138,LA VISTA,NE,385,367,-18,0.488031914893617
68138,OMAHA,NE,4724,5073,349,0.5178115749719302
68139,OMAHA,NE,11,125,114,0.9191176470588235
68142,OMAHA,NE,1838,2080,242,0.5308831036242981
68144,OMAHA,NE,11480,10108,-1372,0.4682230869001297
68145,MILLARD,NE,13,0,-13,0
68145,OMAHA,NE,60,65,5,0.52
68147,BELLEVUE,NE,3565,3330,-235,0.48295866569978246
68152,OMAHA,NE,2182,2631,449,0.5466445044670684
68154,OMAHA,NE,13596,11985,-1611,0.4685117860912396
68157,BELLEVUE,NE,250,247,-3,0.4969818913480885
68157,OMAHA,NE,1648,1462,-186,0.470096463022508
68164,OMAHA,NE,14475,13292,-1183,0.4786977347210718
68301,ADAMS,NE,158,184,26,0.5380116959064327
68305,AUBURN,NE,2135,1976,-159,0.4806616395037704
68307,AVOCA,NE,36,23,-13,0.3898305084745763
68310,BEATRICE,NE,7718,6390,-1328,0.4529345052452509
68313,BEAVER CROSSING,NE,13,22,9,0.6285714285714286
68314,BEE,NE,0,11,11,1
68317,BENNET,NE,329,366,37,0.5266187050359712
68318,BLUE SPRINGS,NE,46,22,-24,0.3235294117647059
68322,BRUNING,NE,41,13,-28,0.24074074074074073
68328,CLATONIA,NE,16,0,-16,0
68329,COOK,NE,13,0,-13,0
68331,CORTLAND,NE,23,39,16,0.6290322580645161
68333,CRETE,NE,4505,2701,-1804,0.3748265334443519
68335,DAVENPORT,NE,24,28,4,0.5384615384615384
68338,DAYKIN,NE,11,0,-11,0
68339,DENTON,NE,47,195,148,0.8057851239669421
68340,DESHLER,NE,356,107,-249,0.23110151187904968
68341,DE WITT,NE,88,39,-49,0.30708661417322836
68342,DILLER,NE,28,29,1,0.5087719298245614
68343,DORCHESTER,NE,86,25,-61,0.22522522522522523
68347,EAGLE,NE,553,722,169,0.5662745098039216
68349,ELMWOOD,NE,36,79,43,0.6869565217391305
68351,EXETER,NE,0,41,41,1
68352,FAIRBURY,NE,2671,2244,-427,0.4565615462868769
68354,FAIRMONT,NE,76,72,-4,0.4864864864864865
68355,FALLS CITY,NE,2219,2097,-122,0.48586654309545874
68358,FIRTH,NE,214,340,126,0.6137184115523465
68359,FRIEND,NE,336,279,-57,0.45365853658536587
68360,GARLAND,NE,22,0,-22,0
68361,GENEVA,NE,1219,1135,-84,0.4821580288870008
68364,GOEHNER,NE,11,14,3,0.56
68366,GREENWOOD,NE,113,64,-49,0.3615819209039548
68368,HALLAM,NE,13,11,-2,0.4583333333333333
68370,BELVIDERE,NE,21,13,-8,0.38235294117647056
68370,HEBRON,NE,881,817,-64,0.48115429917550057
68371,HENDERSON,NE,128,112,-16,0.4666666666666667
68372,HICKMAN,NE,938,1321,383,0.584772023019035
68372,HOLLAND,NE,58,56,-2,0.49122807017543857
68375,HUBBELL,NE,11,0,-11,0
68376,HUMBOLDT,NE,448,233,-215,0.342143906020558
68378,JOHNSON,NE,38,12,-26,0.24
68381,LIBERTY,NE,11,0,-11,0
68401,MC COOL JUNCTION,NE,24,82,58,0.7735849056603774
68402,MALCOLM,NE,122,122,0,0.5
68404,MARTELL,NE,25,23,-2,0.4791666666666667
68405,MILFORD,NE,1183,1093,-90,0.4802284710017575
68406,MILLIGAN,NE,11,0,-11,0
68407,MURDOCK,NE,0,61,61,1
68409,MURRAY,NE,124,34,-90,0.21518987341772153
68410,NEBRASKA CITY,NE,4850,3903,-947,0.4459042613960928
68413,NEHAWKA,NE,23,0,-23,0
68415,ODELL,NE,100,0,-100,0
68418,PALMYRA,NE,35,148,113,0.8087431693989071
68420,PAWNEE CITY,NE,497,504,7,0.5034965034965035
68421,PERU,NE,155,38,-117,0.19689119170984457
68422,PICKRELL,NE,27,0,-27,0
68423,PLEASANT DALE,NE,59,74,15,0.556390977443609
68424,PLYMOUTH,NE,0,12,12,1
68428,RAYMOND,NE,244,267,23,0.5225048923679061
68430,ROCA,NE,139,511,372,0.7861538461538462
68434,SEWARD,NE,3580,2930,-650,0.4500768049155146
68436,SHICKLEY,NE,84,72,-12,0.46153846153846156
68437,SHUBERT,NE,0,11,11,1
68438,SPRAGUE,NE,12,0,-12,0
68439,STAPLEHURST,NE,15,0,-15,0
68443,STERLING,NE,92,62,-30,0.4025974025974026
68446,SYRACUSE,NE,782,832,50,0.5154894671623296
68450,TECUMSEH,NE,1081,912,-169,0.45760160561966884
68455,UNION,NE,34,14,-20,0.2916666666666667
68456,UTICA,NE,160,128,-32,0.4444444444444444
68460,WACO,NE,26,34,8,0.5666666666666667
68461,WALTON,NE,0,23,23,1
68462,WAVERLY,NE,1390,1454,64,0.5112517580872011
68463,WEEPING WATER,NE,224,213,-11,0.4874141876430206
68465,WILBER,NE,915,779,-136,0.45985832349468714
68466,WYMORE,NE,730,628,-102,0.46244477172312226
68467,YORK,NE,4929,4268,-661,0.4640643688159182
68501,LINCOLN,NE,3466,1765,-1701,0.3374115847830243
68502,LINCOLN,NE,16341,12049,-4292,0.424410003522367
68503,LINCOLN,NE,11621,7692,-3929,0.39828095065499924
68504,LINCOLN,NE,13654,10307,-3347,0.4301573390092233
68505,LINCOLN,NE,9236,7532,-1704,0.4491889312977099
68506,LINCOLN,NE,17729,12655,-5074,0.4165021063717746
68507,LINCOLN,NE,7840,6896,-944,0.46796959826275786
68508,LINCOLN,NE,11658,6067,-5591,0.3422849083215797
68510,LINCOLN,NE,12456,9183,-3273,0.4243726604741439
68512,LINCOLN,NE,6874,6126,-748,0.47123076923076923
68516,LINCOLN,NE,20652,19868,-784,0.49032576505429415
68517,LINCOLN,NE,18,12,-6,0.4
68520,LINCOLN,NE,791,1602,811,0.6694525699958211
68521,LINCOLN,NE,20083,17232,-2851,0.46179820447541203
68522,LINCOLN,NE,5248,4929,-319,0.4843274049326914
68523,LINCOLN,NE,183,770,587,0.8079748163693599
68524,LINCOLN,NE,2311,1972,-339,0.4604249357926687
68526,LINCOLN,NE,3235,3648,413,0.5300014528548598
68527,LINCOLN,NE,119,951,832,0.888785046728972
68528,LINCOLN,NE,4712,3719,-993,0.4411101885897284
68529,LINCOLN,NE,24,13,-11,0.35135135135135137
68542,LINCOLN,NE,235,319,84,0.575812274368231
68601,COLUMBUS,NE,13398,11565,-1833,0.46328566278091576
68602,COLUMBUS,NE,759,296,-463,0.28056872037914693
68620,ALBION,NE,1112,979,-133,0.4681970349115256
68621,AMES,NE,0,12,12,1
68623,BELGRADE,NE,129,125,-4,0.4921259842519685
68624,BELLWOOD,NE,75,63,-12,0.45652173913043476
68627,CEDAR RAPIDS,NE,15,0,-15,0
68628,CLARKS,NE,38,69,31,0.6448598130841121
68629,CLARKSON,NE,45,22,-23,0.3283582089552239
68632,DAVID CITY,NE,1299,1252,-47,0.49078792630341045
68633,DODGE,NE,80,184,104,0.696969696969697
68636,ELGIN,NE,197,164,-33,0.45429362880886426
68638,FULLERTON,NE,580,438,-142,0.4302554027504912
68640,GENOA,NE,296,158,-138,0.34801762114537443
68641,HOWELLS,NE,35,27,-8,0.43548387096774194
68642,HUMPHREY,NE,13,71,58,0.8452380952380952
68642,TARNOV,NE,0,11,11,1
68643,LEIGH,NE,81,58,-23,0.4172661870503597
68647,MONROE,NE,36,11,-25,0.23404255319148937
68649,NORTH BEND,NE,640,421,-219,0.39679547596606973
68651,OSCEOLA,NE,291,164,-127,0.36043956043956044
68653,PLATTE CENTER,NE,38,32,-6,0.45714285714285713
68654,POLK,NE,43,12,-31,0.21818181818181817
68658,RISING CITY,NE,11,0,-11,0
68660,SAINT EDWARD,NE,210,96,-114,0.3137254901960784
68661,SCHUYLER,NE,2180,1876,-304,0.4625246548323471
68662,SHELBY,NE,140,72,-68,0.33962264150943394
68663,SILVER CREEK,NE,14,11,-3,0.44
68665,SPALDING,NE,11,0,-11,0
68666,STROMSBURG,NE,429,438,9,0.5051903114186851
68669,ULYSSES,NE,11,0,-11,0
68701,NORFOLK,NE,15622,12260,-3362,0.4397102073022021
68702,NORFOLK,NE,285,103,-182,0.2654639175257732
68710,ALLEN,NE,25,11,-14,0.3055555555555556
68713,ATKINSON,NE,606,495,-111,0.44959128065395093
68714,BASSETT,NE,325,202,-123,0.38330170777988615
68715,BATTLE CREEK,NE,309,288,-21,0.4824120603015075
68716,BEEMER,NE,262,136,-126,0.3417085427135678
68717,BELDEN,NE,0,11,11,1
68718,BLOOMFIELD,NE,484,478,-6,0.4968814968814969
68722,BUTTE,NE,11,12,1,0.5217391304347826
68723,CARROLL,NE,41,14,-27,0.2545454545454545
68725,CHAMBERS,NE,11,0,-11,0
68726,CLEARWATER,NE,38,28,-10,0.42424242424242425
68727,COLERIDGE,NE,26,12,-14,0.3157894736842105
68729,CREIGHTON,NE,491,395,-96,0.445823927765237
68730,CROFTON,NE,535,416,-119,0.4374342797055731
68731,DAKOTA CITY,NE,839,658,-181,0.4395457581830327
68733,EMERSON,NE,239,126,-113,0.3452054794520548
68735,EWING,NE,49,59,10,0.5462962962962963
68736,FORDYCE,NE,17,0,-17,0
68739,HARTINGTON,NE,648,615,-33,0.48693586698337293
68740,HOSKINS,NE,12,12,0,0.5
68745,LAUREL,NE,434,327,-107,0.4296977660972405
68746,LYNCH,NE,0,12,12,1
68748,MADISON,NE,733,605,-128,0.4521674140508221
68752,MEADOW GROVE,NE,11,22,11,0.6666666666666666
68756,NELIGH,NE,681,708,27,0.509719222462203
68757,NEWCASTLE,NE,11,13,2,0.5416666666666666
68758,NEWMAN GROVE,NE,123,97,-26,0.4409090909090909
68760,NIOBRARA,NE,232,173,-59,0.4271604938271605
68761,OAKDALE,NE,77,40,-37,0.3418803418803419
68763,ONEILL,NE,2511,2039,-472,0.4481318681318681
68764,ORCHARD,NE,47,72,25,0.6050420168067226
68765,FOSTER,NE,13,0,-13,0
68765,OSMOND,NE,182,104,-78,0.36363636363636365
68767,PIERCE,NE,940,792,-148,0.45727482678983833
68769,PLAINVIEW,NE,743,563,-180,0.43108728943338437
68770,PONCA,NE,319,170,-149,0.3476482617586912
68771,RANDOLPH,NE,322,146,-176,0.31196581196581197
68776,S SIOUX CITY,NE,901,676,-225,0.42866201648700064
68776,SOUTH SIOUX CITY,NE,6484,4882,-1602,0.42952665845504134
68779,STANTON,NE,748,549,-199,0.42328450269853507
68780,STUART,NE,61,62,1,0.5040650406504065
68781,TILDEN,NE,161,63,-98,0.28125
68783,VERDIGRE,NE,102,91,-11,0.47150259067357514
68784,WAKEFIELD,NE,352,264,-88,0.42857142857142855
68786,WAUSA,NE,131,132,1,0.5019011406844106
68787,WAYNE,NE,3521,1959,-1562,0.3574817518248175
68788,WEST POINT,NE,1698,1518,-180,0.47201492537313433
68790,WINSIDE,NE,43,26,-17,0.37681159420289856
68791,WISNER,NE,548,570,22,0.5098389982110912
68801,GRAND ISLAND,NE,16275,11862,-4413,0.4215801258129865
68802,GRAND ISLAND,NE,754,1067,313,0.585941790225151
68803,GRAND ISLAND,NE,12988,10290,-2698,0.4420482859352178
68810,ALDA,NE,448,208,-240,0.3170731707317073
68812,AMHERST,NE,27,0,-27,0
68814,ANSLEY,NE,77,72,-5,0.48322147651006714
68814,BERWYN,NE,23,0,-23,0
68815,ARCADIA,NE,22,0,-22,0
68817,ASHTON,NE,13,0,-13,0
68818,AURORA,NE,2172,2000,-172,0.4793863854266539
68820,BOELUS,NE,12,25,13,0.6756756756756757
68822,BROKEN BOW,NE,2053,2011,-42,0.49483267716535434
68823,BURWELL,NE,610,626,16,0.5064724919093851
68824,CAIRO,NE,118,99,-19,0.45622119815668205
68825,CALLAWAY,NE,166,74,-92,0.30833333333333335
68826,CENTRAL CITY,NE,1736,1608,-128,0.48086124401913877
68827,CHAPMAN,NE,46,11,-35,0.19298245614035087
68831,DANNEBROG,NE,45,13,-32,0.22413793103448276
68832,DONIPHAN,NE,280,335,55,0.5447154471544715
68833,DUNNING,NE,11,0,-11,0
68835,ELBA,NE,22,11,-11,0.3333333333333333
68836,ELM CREEK,NE,603,357,-246,0.371875
68840,GIBBON,NE,1382,1261,-121,0.477109345440787
68843,HAMPTON,NE,35,24,-11,0.4067796610169492
68845,KEARNEY,NE,11071,8561,-2510,0.4360737571312143
68846,HORDVILLE,NE,11,0,-11,0
68847,KEARNEY,NE,8565,7426,-1139,0.4643862172472015
68848,KEARNEY,NE,802,409,-393,0.33773740710156896
68850,LEXINGTON,NE,5717,4379,-1338,0.4337361331220285
68853,LOUP CITY,NE,551,587,36,0.515817223198594
68854,MARQUETTE,NE,112,72,-40,0.391304347826087
68855,MASON CITY,NE,11,0,-11,0
68856,MERNA,NE,0,22,22,1
68859,NORTH LOUP,NE,11,0,-11,0
68862,ORD,NE,1395,1178,-217,0.4578313253012048
68863,OVERTON,NE,69,60,-9,0.46511627906976744
68864,PALMER,NE,133,55,-78,0.2925531914893617
68865,PHILLIPS,NE,25,62,37,0.7126436781609196
68866,PLEASANTON,NE,0,34,34,1
68869,RAVENNA,NE,816,728,-88,0.47150259067357514
68870,RIVERDALE,NE,13,0,-13,0
68872,SAINT LIBORY,NE,12,33,21,0.7333333333333333
68873,SAINT PAUL,NE,1071,1051,-20,0.49528746465598494
68874,SARGENT,NE,197,77,-120,0.28102189781021897
68875,SCOTIA,NE,12,12,0,0.5
68876,SHELTON,NE,397,293,-104,0.4246376811594203
68878,SUMNER,NE,11,11,0,0.5
68882,WOLBACH,NE,0,11,11,1
68883,PROSSER,NE,26,13,-13,0.3333333333333333
68883,WOOD RIVER,NE,518,442,-76,0.46041666666666664
68901,HASTINGS,NE,13585,10387,-3198,0.43329718004338397
68902,HASTINGS,NE,223,145,-78,0.39402173913043476
68920,ALMA,NE,292,275,-17,0.48500881834215165
68922,ARAPAHOE,NE,451,284,-167,0.38639455782312926
68924,AXTELL,NE,131,165,34,0.5574324324324325
68926,BEAVER CITY,NE,152,118,-34,0.43703703703703706
68927,BERTRAND,NE,64,69,5,0.518796992481203
68928,BLADEN,NE,15,0,-15,0
68930,BLUE HILL,NE,273,240,-33,0.4678362573099415
68932,CAMPBELL,NE,12,0,-12,0
68933,CLAY CENTER,NE,178,90,-88,0.3358208955223881
68935,EDGAR,NE,87,11,-76,0.11224489795918367
68936,EDISON,NE,22,0,-22,0
68937,ELWOOD,NE,483,468,-15,0.4921135646687697
68937,JOHNSON LAKE,NE,293,216,-77,0.4243614931237721
68938,FAIRFIELD,NE,11,13,2,0.5416666666666666
68939,FRANKLIN,NE,358,383,25,0.5168690958164642
68942,GUIDE ROCK,NE,12,0,-12,0
68944,HARVARD,NE,301,281,-20,0.48281786941580757
68947,HILDRETH,NE,37,0,-37,0
68948,HEARTWELL,NE,0,13,13,1
68949,HOLDREGE,NE,2759,2697,-62,0.4943181818181818
68955,JUNIATA,NE,386,328,-58,0.45938375350140054
68956,KENESAW,NE,129,104,-25,0.44635193133047213
68958,LOOMIS,NE,24,39,15,0.6190476190476191
68959,MINDEN,NE,1462,1283,-179,0.4673952641165756
68961,NELSON,NE,93,83,-10,0.4715909090909091
68966,ORLEANS,NE,24,62,38,0.7209302325581395
68967,OXFORD,NE,256,87,-169,0.2536443148688047
68970,RED CLOUD,NE,704,569,-135,0.4469756480754124
68971,REPUBLICAN CITY,NE,11,12,1,0.5217391304347826
68978,SUPERIOR,NE,1096,922,-174,0.4568880079286422
68979,SUTTON,NE,819,587,-232,0.4174964438122333
69001,MC COOK,NE,3210,2725,-485,0.45914069081718617
69001,MCCOOK,NE,1257,1067,-190,0.4591222030981067
69021,BENKELMAN,NE,603,383,-220,0.38843813387423937
69022,CAMBRIDGE,NE,472,406,-66,0.4624145785876993
69023,CHAMPION,NE,0,11,11,1
69024,CULBERTSON,NE,92,59,-33,0.39072847682119205
69025,CURTIS,NE,476,296,-180,0.38341968911917096
69028,EUSTIS,NE,123,62,-61,0.33513513513513515
69029,FARNAM,NE,12,11,-1,0.4782608695652174
69030,HAIGLER,NE,23,0,-23,0
69032,HAYES CENTER,NE,12,0,-12,0
69033,IMPERIAL,NE,799,534,-265,0.4006001500375094
69034,INDIANOLA,NE,187,61,-126,0.24596774193548387
69038,MAYWOOD,NE,12,11,-1,0.4782608695652174
69040,PALISADE,NE,16,11,-5,0.4074074074074074
69043,STRATTON,NE,11,23,12,0.6764705882352942
69044,TRENTON,NE,155,40,-115,0.20512820512820512
69045,WAUNETA,NE,135,54,-81,0.2857142857142857
69046,WILSONVILLE,NE,0,11,11,1
69101,NORTH PLATTE,NE,15099,12458,-2641,0.4520811409079363
69103,NORTH PLATTE,NE,740,446,-294,0.3760539629005059
69120,ARNOLD,NE,176,120,-56,0.40540540540540543
69122,BIG SPRINGS,NE,23,0,-23,0
69123,BRADY,NE,60,43,-17,0.4174757281553398
69127,BRULE,NE,103,81,-22,0.44021739130434784
69129,CHAPPELL,NE,415,351,-64,0.45822454308093996
69130,COZAD,NE,2893,2212,-681,0.43330068560235063
69131,DALTON,NE,13,0,-13,0
69133,DIX,NE,27,12,-15,0.3076923076923077
69138,GOTHENBURG,NE,2148,1954,-194,0.4763529985372989
69140,GRANT,NE,316,246,-70,0.4377224199288256
69143,HERSHEY,NE,258,192,-66,0.4266666666666667
69145,KIMBALL,NE,1679,1328,-351,0.44163618224143664
69146,LEMOYNE,NE,24,11,-13,0.3142857142857143
69147,LEWELLEN,NE,131,167,36,0.5604026845637584
69149,LODGEPOLE,NE,22,50,28,0.6944444444444444
69151,MAXWELL,NE,59,39,-20,0.3979591836734694
69152,MULLEN,NE,0,15,15,1
69153,OGALLALA,NE,2841,2452,-389,0.4632533534857359
69154,OSHKOSH,NE,412,251,-161,0.37858220211161386
69155,PAXTON,NE,115,63,-52,0.3539325842696629
69156,POTTER,NE,132,81,-51,0.38028169014084506
69162,SIDNEY,NE,3914,3727,-187,0.4877633817563146
69163,STAPLETON,NE,53,62,9,0.5391304347826087
69165,SUTHERLAND,NE,661,458,-203,0.4092940125111707
69166,THEDFORD,NE,22,15,-7,0.40540540540540543
69167,TRYON,NE,17,0,-17,0
69169,WALLACE,NE,11,23,12,0.6764705882352942
69170,WELLFLEET,NE,12,0,-12,0
69201,VALENTINE,NE,1966,1710,-256,0.46517954298150166
69210,AINSWORTH,NE,1214,1083,-131,0.4714845450587723
69217,LONG PINE,NE,0,24,24,1
69301,ALLIANCE,NE,4786,4111,-675,0.46206586489828033
69334,BAYARD,NE,613,548,-65,0.4720068906115418
69336,BRIDGEPORT,NE,709,648,-61,0.47752394988946206
69337,CHADRON,NE,3212,2355,-857,0.42302856116400217
69339,CRAWFORD,NE,470,442,-28,0.48464912280701755
69341,GERING,NE,4667,4291,-376,0.4790131725831659
69343,GORDON,NE,904,827,-77,0.4777585210860774
69345,HARRISBURG,NE,11,0,-11,0
69346,HARRISON,NE,0,11,11,1
69347,HAY SPRINGS,NE,110,126,16,0.5338983050847458
69348,HEMINGFORD,NE,159,133,-26,0.4554794520547945
69352,LYMAN,NE,43,23,-20,0.3484848484848485
69356,MINATARE,NE,584,446,-138,0.4330097087378641
69357,MITCHELL,NE,1182,1144,-38,0.49183147033533964
69358,HENRY,NE,117,113,-4,0.49130434782608695
69358,MORRILL,NE,770,576,-194,0.4279346210995542
69360,RUSHVILLE,NE,70,36,-34,0.33962264150943394
69361,SCOTTSBLUFF,NE,8062,6987,-1075,0.46428334108578645
69363,SCOTTSBLUFF,NE,962,528,-434,0.35436241610738256
70001,METAIRIE,LA,15158,11900,-3258,0.4397959937911154
70002,METAIRIE,LA,7482,6553,-929,0.46690416815105096
70003,METAIRIE,LA,9510,8326,-1184,0.466808701502579
70004,METAIRIE,LA,64,509,445,0.8883071553228621
70005,METAIRIE,LA,8700,7335,-1365,0.45743685687558466
70006,METAIRIE,LA,4535,3893,-642,0.4619126720455624
70009,METAIRIE,LA,27,232,205,0.8957528957528957
70010,METAIRIE,LA,0,100,100,1
70011,METAIRIE,LA,18,47,29,0.7230769230769231
70030,DES ALLEMANDS,LA,887,1001,114,0.5301906779661016
70031,AMA,LA,15,104,89,0.8739495798319328
70032,ARABI,LA,1435,1713,278,0.5441550190597204
70033,METAIRIE,LA,36,179,143,0.8325581395348837
70036,BARATARIA,LA,153,23,-130,0.13068181818181818
70037,BELLE CHASSE,LA,5029,4816,-213,0.48918232605383444
70039,BOUTTE,LA,653,656,3,0.5011459129106188
70040,BRAITHWAITE,LA,24,62,38,0.7209302325581395
70041,BURAS,LA,485,333,-152,0.4070904645476773
70043,CHALMETTE,LA,6691,6233,-458,0.4822810275456515
70044,CHALMETTE,LA,159,566,407,0.7806896551724138
70047,DESTREHAN,LA,3100,2739,-361,0.46908717246103787
70049,EDGARD,LA,24,14,-10,0.3684210526315789
70051,GARYVILLE,LA,177,238,61,0.5734939759036145
70052,GRAMERCY,LA,299,430,131,0.5898491083676269
70053,GRETNA,LA,6119,4233,-1886,0.4089064914992272
70054,GRETNA,LA,257,858,601,0.7695067264573991
70055,METAIRIE,LA,12,89,77,0.8811881188118812
70056,GRETNA,LA,8187,6079,-2108,0.4261180428992009
70056,TERRYTOWN,LA,3787,2934,-853,0.4365421812230323
70057,HAHNVILLE,LA,759,873,114,0.5349264705882353
70057,KILLONA,LA,56,36,-20,0.391304347826087
70058,HARVEY,LA,11504,9991,-1513,0.464805768783438
70059,HARVEY,LA,318,1198,880,0.7902374670184696
70062,KENNER,LA,4941,4211,-730,0.460118006993007
70063,KENNER,LA,254,727,473,0.7410805300713558
70064,KENNER,LA,120,613,493,0.8362892223738063
70065,KENNER,LA,13805,12040,-1765,0.4658541303927259
70065,METAIRIE,LA,322,261,-61,0.44768439108061747
70067,JEAN LAFITTE,LA,37,39,2,0.5131578947368421
70067,LAFITTE,LA,767,486,-281,0.38786911412609737
70068,LA PLACE,LA,8788,7278,-1510,0.453006348811154
70069,LA PLACE,LA,833,713,-120,0.4611901681759379
70070,LULING,LA,2892,2860,-32,0.4972183588317107
70071,LUTCHER,LA,384,339,-45,0.46887966804979253
70072,MARRERO,LA,13090,12663,-427,0.491709703723838
70073,MARRERO,LA,319,810,491,0.7174490699734278
70075,MERAUX,LA,1199,1407,208,0.5399079048349962
70079,NORCO,LA,887,681,-206,0.4343112244897959
70080,PARADIS,LA,267,158,-109,0.37176470588235294
70083,PORT SULPHUR,LA,298,180,-118,0.37656903765690375
70084,RESERVE,LA,1657,1618,-39,0.49404580152671757
70085,SAINT BERNARD,LA,996,1065,69,0.5167394468704513
70086,SAINT JAMES,LA,27,13,-14,0.325
70087,SAINT ROSE,LA,1797,1726,-71,0.48992336077206927
70090,VACHERIE,LA,931,850,-81,0.4772599663110612
70092,VIOLET,LA,2631,1812,-819,0.40783254557731263
70094,AVONDALE,LA,812,704,-108,0.46437994722955145
70094,WESTWEGO,LA,8031,7296,-735,0.4760227050303386
70096,WESTWEGO,LA,840,352,-488,0.2953020134228188
70112,NEW ORLEANS,LA,4639,3433,-1206,0.4252973240832507
70113,NEW ORLEANS,LA,4388,3788,-600,0.46330724070450097
70114,NEW ORLEANS,LA,8317,7044,-1273,0.4585638955797149
70115,NEW ORLEANS,LA,16074,13391,-2683,0.4544714067537757
70116,NEW ORLEANS,LA,5885,5267,-618,0.4722919655667145
70117,NEW ORLEANS,LA,12840,11860,-980,0.4801619433198381
70118,NEW ORLEANS,LA,12732,9929,-2803,0.4381536560610741
70119,NEW ORLEANS,LA,18557,15773,-2784,0.45945237401689487
70121,JEFFERSON,LA,1258,1098,-160,0.46604414261460103
70121,NEW ORLEANS,LA,2865,2333,-532,0.44882647171989226
70122,NEW ORLEANS,LA,10485,10209,-276,0.4933314004059148
70123,HARAHAN,LA,413,391,-22,0.486318407960199
70123,NEW ORLEANS,LA,7169,6137,-1032,0.46122050202915976
70123,RIVER RIDGE,LA,2691,2510,-181,0.48259950009613534
70124,NEW ORLEANS,LA,7097,7249,152,0.5052976439425624
70125,NEW ORLEANS,LA,6778,5630,-1148,0.45373952288845903
70126,NEW ORLEANS,LA,8949,7794,-1155,0.46550797348145495
70127,NEW ORLEANS,LA,7695,6620,-1075,0.46245197345441846
70128,NEW ORLEANS,LA,4698,4077,-621,0.4646153846153846
70129,NEW ORLEANS,LA,2100,1843,-257,0.4674106010651788
70130,NEW ORLEANS,LA,11531,9900,-1631,0.4619476459334609
70131,NEW ORLEANS,LA,8191,6964,-1227,0.4595183107885186
70152,NEW ORLEANS,LA,0,63,63,1
70156,NEW ORLEANS,LA,0,222,222,1
70157,NEW ORLEANS,LA,13,130,117,0.9090909090909091
70158,NEW ORLEANS,LA,26,144,118,0.8470588235294118
70163,NEW ORLEANS,LA,27,0,-27,0
70170,NEW ORLEANS,LA,12,71,59,0.8554216867469879
70174,NEW ORLEANS,LA,211,934,723,0.8157205240174672
70175,NEW ORLEANS,LA,180,540,360,0.75
70177,NEW ORLEANS,LA,131,475,344,0.7838283828382838
70179,NEW ORLEANS,LA,362,740,378,0.6715063520871143
70181,NEW ORLEANS,LA,12,137,125,0.9194630872483222
70182,NEW ORLEANS,LA,113,463,350,0.8038194444444444
70183,NEW ORLEANS,LA,0,83,83,1
70184,NEW ORLEANS,LA,0,29,29,1
70185,NEW ORLEANS,LA,28,409,381,0.9359267734553776
70186,NEW ORLEANS,LA,0,124,124,1
70187,NEW ORLEANS,LA,201,1379,1178,0.8727848101265823
70301,THIBODAUX,LA,11541,11047,-494,0.4890649902603152
70302,THIBODAUX,LA,184,509,325,0.7344877344877345
70310,THIBODAUX,LA,54,0,-54,0
70339,PIERRE PART,LA,1208,1258,50,0.5101378751013788
70340,AMELIA,LA,27,27,0,0.5
70341,BELLE ROSE,LA,527,482,-45,0.47770069375619423
70342,BERWICK,LA,1741,1356,-385,0.43784307394252503
70343,BOURG,LA,1362,1287,-75,0.48584371460928655
70344,CHAUVIN,LA,1547,1232,-315,0.4433249370277078
70345,CUT OFF,LA,2414,2027,-387,0.4564287322675073
70346,DONALDSONVILLE,LA,2527,2279,-248,0.4741989180191427
70353,DULAC,LA,314,217,-97,0.4086629001883239
70354,GALLIANO,LA,1315,1208,-107,0.47879508521601266
70355,GHEENS,LA,24,11,-13,0.3142857142857143
70356,GIBSON,LA,476,457,-19,0.48981779206859594
70357,GOLDEN MEADOW,LA,905,554,-351,0.37971213159698425
70358,GRAND ISLE,LA,141,78,-63,0.3561643835616438
70359,GRAY,LA,3139,2905,-234,0.48064195896757117
70360,HOUMA,LA,9539,8238,-1301,0.46340777409011646
70361,HOUMA,LA,1018,1286,268,0.5581597222222222
70363,HOUMA,LA,7623,6142,-1481,0.4462041409371595
70364,HOUMA,LA,9651,8257,-1394,0.4610788474424838
70372,LABADIEVILLE,LA,313,338,25,0.5192012288786483
70373,LAROSE,LA,1614,1472,-142,0.4769928710304601
70374,LOCKPORT,LA,2140,1800,-340,0.45685279187817257
70375,MATHEWS,LA,0,52,52,1
70377,MONTEGUT,LA,861,670,-191,0.43762246897452645
70380,MORGAN CITY,LA,5711,5333,-378,0.48288663527707354
70381,MORGAN CITY,LA,585,214,-371,0.26783479349186484
70390,NAPOLEONVILLE,LA,1158,1224,66,0.5138539042821159
70392,PATTERSON,LA,2609,2428,-181,0.4820329561246774
70393,PLATTENVILLE,LA,23,12,-11,0.34285714285714286
70394,RACELAND,LA,3072,3042,-30,0.4975466143277723
70395,MATHEWS,LA,21,28,7,0.5714285714285714
70395,SCHRIEVER,LA,1186,1381,195,0.5379820802493183
70397,THERIOT,LA,72,38,-34,0.34545454545454546
70401,HAMMOND,LA,7174,5929,-1245,0.45249179577196064
70403,HAMMOND,LA,9201,8814,-387,0.48925895087427146
70404,HAMMOND,LA,825,1295,470,0.6108490566037735
70420,ABITA SPRINGS,LA,2209,2532,323,0.5340645433452859
70422,AMITE,LA,2522,2813,291,0.5272727272727272
70426,ANGIE,LA,1089,1087,-2,0.49954044117647056
70427,BOGALUSA,LA,7542,5696,-1846,0.4302764768091857
70429,BOGALUSA,LA,58,110,52,0.6547619047619048
70431,BUSH,LA,1286,1294,8,0.5015503875968992
70433,COVINGTON,LA,14915,15736,821,0.5133927114939154
70434,COVINGTON,LA,510,582,72,0.532967032967033
70435,COVINGTON,LA,4246,5752,1506,0.5753150630126025
70437,FOLSOM,LA,1717,2008,291,0.5390604026845638
70438,FRANKLINTON,LA,4945,4861,-84,0.4957169080155007
70441,GREENSBURG,LA,692,834,142,0.546526867627785
70442,HUSSER,LA,0,14,14,1
70443,COVINGTON,LA,28,48,20,0.631578947368421
70443,INDEPENDENCE,LA,2125,2188,63,0.5073035010433573
70444,KENTWOOD,LA,2063,2138,75,0.5089264460842656
70445,LACOMBE,LA,2756,3022,266,0.523018345448252
70446,LORANGER,LA,1416,1782,366,0.5572232645403377
70447,MADISONVILLE,LA,4241,5449,1208,0.5623323013415893
70448,MANDEVILLE,LA,7323,7654,331,0.5110502770915404
70449,MAUREPAS,LA,1022,1104,82,0.5192850423330198
70450,MOUNT HERMON,LA,498,559,61,0.5288552507095553
70451,NATALBANY,LA,72,237,165,0.7669902912621359
70452,PEARL RIVER,LA,3561,3845,284,0.5191736429921685
70453,PINE GROVE,LA,11,78,67,0.8764044943820225
70454,PONCHATOULA,LA,9446,11137,1691,0.5410775883010251
70455,ROBERT,LA,592,1145,553,0.6591824985607369
70456,ROSELAND,LA,339,376,37,0.5258741258741259
70457,SAINT BENEDICT,LA,24,0,-24,0
70458,SLIDELL,LA,14380,14143,-237,0.4958454580513971
70459,SLIDELL,LA,832,1263,431,0.6028639618138425
70460,SLIDELL,LA,6922,6219,-703,0.47325165512518075
70461,SLIDELL,LA,10092,11032,940,0.5222495739443287
70462,SPRINGFIELD,LA,1748,2097,349,0.5453836150845254
70465,TANGIPAHOA,LA,16,0,-16,0
70466,TICKFAW,LA,2350,2197,-153,0.48317572025511324
70469,SLIDELL,LA,319,564,245,0.638731596828992
70470,MANDEVILLE,LA,1636,830,-806,0.33657745336577455
70471,MANDEVILLE,LA,7333,7601,268,0.5089728137136735
70501,LAFAYETTE,LA,9584,8650,-934,0.47438850499067675
70502,LAFAYETTE,LA,73,28,-45,0.27722772277227725
70503,LAFAYETTE,LA,10192,9351,-841,0.4784833444199969
70505,LAFAYETTE,LA,294,289,-5,0.4957118353344768
70506,LAFAYETTE,LA,16929,14982,-1947,0.46949327817993797
70507,LAFAYETTE,LA,5394,5378,-16,0.4992573338284441
70508,LAFAYETTE,LA,16741,16750,9,0.5001343644561226
70509,LAFAYETTE,LA,187,767,580,0.8039832285115304
70510,ABBEVILLE,LA,7481,6921,-560,0.48055825579780587
70511,ABBEVILLE,LA,529,571,42,0.519090909090909
70512,ARNAUDVILLE,LA,1707,1960,253,0.5344968639214617
70514,BALDWIN,LA,191,163,-28,0.4604519774011299
70515,BASILE,LA,689,816,127,0.5421926910299003
70516,BRANCH,LA,114,142,28,0.5546875
70517,BREAUX BRIDGE,LA,6936,6360,-576,0.47833935018050544
70518,BROUSSARD,LA,5268,6080,812,0.5357772294677476
70520,CARENCRO,LA,5482,5517,35,0.5015910537321575
70521,CECILIA,LA,0,12,12,1
70525,CHURCH POINT,LA,3145,3369,224,0.5171937365673933
70526,CROWLEY,LA,5904,5212,-692,0.4688736955739475
70527,CROWLEY,LA,97,379,282,0.7962184873949579
70528,DELCAMBRE,LA,763,616,-147,0.4467005076142132
70529,DUSON,LA,3288,3336,48,0.5036231884057971
70531,EGAN,LA,95,233,138,0.7103658536585366
70532,ELTON,LA,372,410,38,0.5242966751918159
70533,ERATH,LA,2931,2025,-906,0.4085956416464891
70534,ESTHERWOOD,LA,67,11,-56,0.14102564102564102
70535,EUNICE,LA,5563,5151,-412,0.48077282060854953
70538,FRANKLIN,LA,3015,2886,-129,0.48906964921199797
70541,GRAND COTEAU,LA,0,60,60,1
70542,GUEYDAN,LA,746,773,27,0.5088874259381172
70543,IOTA,LA,876,924,48,0.5133333333333333
70544,JEANERETTE,LA,2339,2270,-69,0.49251464525927535
70546,JENNINGS,LA,5246,5020,-226,0.4889927917397234
70548,KAPLAN,LA,3933,3431,-502,0.46591526344378054
70549,LAKE ARTHUR,LA,1381,1378,-3,0.4994563247553461
70550,LAWTELL,LA,23,44,21,0.6567164179104478
70551,LEONVILLE,LA,23,0,-23,0
70552,LOREAUVILLE,LA,80,148,68,0.6491228070175439
70554,MAMOU,LA,2180,2019,-161,0.48082876875446534
70555,MAURICE,LA,2141,2793,652,0.5660721524118363
70556,MERMENTAU,LA,0,11,11,1
70558,MILTON,LA,37,0,-37,0
70559,MORSE,LA,346,399,53,0.5355704697986577
70560,NEW IBERIA,LA,12656,11126,-1530,0.4678328147338323
70562,NEW IBERIA,LA,1186,1007,-179,0.45918832649338803
70563,NEW IBERIA,LA,4279,4399,120,0.5069140354920488
70569,LYDIA,LA,11,0,-11,0
70570,OPELOUSAS,LA,9407,8751,-656,0.48193633660094726
70571,OPELOUSAS,LA,1437,784,-653,0.3529941467807294
70576,PINE PRAIRIE,LA,141,110,-31,0.43824701195219123
70577,PORT BARRE,LA,1070,1132,62,0.5140781108083561
70578,RAYNE,LA,5129,4874,-255,0.48725382385284416
70581,ROANOKE,LA,40,52,12,0.5652173913043478
70582,PARKS,LA,144,161,17,0.5278688524590164
70582,SAINT MARTINVILLE,LA,3754,3604,-150,0.48980701277521066
70582,ST MARTINVLLE,LA,244,245,1,0.5010224948875256
70583,SCOTT,LA,3759,3594,-165,0.48878008975928194
70584,SUNSET,LA,2397,2108,-289,0.4679245283018868
70586,VILLE PLATTE,LA,5451,5060,-391,0.4814004376367615
70589,WASHINGTON,LA,595,675,80,0.531496062992126
70591,WELSH,LA,1751,1439,-312,0.45109717868338556
70592,YOUNGSVILLE,LA,8905,10295,1390,0.5361979166666667
70596,LAFAYETTE,LA,369,636,267,0.6328358208955224
70598,LAFAYETTE,LA,353,716,363,0.6697848456501403
70601,LAKE CHARLES,LA,17101,12109,-4992,0.41454981170831906
70602,LAKE CHARLES,LA,682,1465,783,0.6823474615742897
70605,LAKE CHARLES,LA,16723,13982,-2741,0.4553655756391467
70606,LAKE CHARLES,LA,645,1138,493,0.638250140213124
70607,LAKE CHARLES,LA,13891,10310,-3581,0.42601545390686335
70611,LAKE CHARLES,LA,5896,5802,-94,0.4959822191827663
70611,MOSS BLUFF,LA,732,672,-60,0.47863247863247865
70612,LAKE CHARLES,LA,433,399,-34,0.4795673076923077
70615,LAKE CHARLES,LA,5385,4425,-960,0.4510703363914373
70616,LAKE CHARLES,LA,78,80,2,0.5063291139240507
70630,BELL CITY,LA,69,50,-19,0.42016806722689076
70631,CAMERON,LA,656,293,-363,0.3087460484720759
70632,CREOLE,LA,35,0,-35,0
70633,DEQUINCY,LA,2270,2226,-44,0.4951067615658363
70634,DERIDDER,LA,9284,8373,-911,0.4742028657189783
70637,DRY CREEK,LA,11,25,14,0.6944444444444444
70638,ELIZABETH,LA,34,39,5,0.5342465753424658
70643,GRAND CHENIER,LA,53,0,-53,0
70645,HACKBERRY,LA,307,169,-138,0.3550420168067227
70646,HAYES,LA,14,0,-14,0
70647,IOWA,LA,3227,3606,379,0.5277330601492756
70648,KINDER,LA,1739,1862,123,0.5170785892807553
70650,LACASSINE,LA,0,25,25,1
70652,LONGVILLE,LA,557,700,143,0.5568814638027049
70653,MERRYVILLE,LA,945,910,-35,0.49056603773584906
70655,OBERLIN,LA,513,486,-27,0.4864864864864865
70655,SULPHUR,LA,28,24,-4,0.46153846153846156
70656,PITKIN,LA,822,925,103,0.529479107040641
70657,RAGLEY,LA,1441,1519,78,0.5131756756756757
70658,REEVES,LA,48,64,16,0.5714285714285714
70659,ROSEPINE,LA,377,396,19,0.5122897800776197
70660,SINGER,LA,235,210,-25,0.47191011235955055
70661,MOSS BLUFF,LA,0,13,13,1
70661,STARKS,LA,389,425,36,0.5221130221130221
70663,SULPHUR,LA,11934,9611,-2323,0.44608957994894405
70664,SULPHUR,LA,585,952,367,0.6193884189980482
70665,SULPHUR,LA,3645,3970,325,0.5213394615889692
70668,VINTON,LA,2212,2153,-59,0.493241695303551
70669,WESTLAKE,LA,4074,3859,-215,0.48644901046262445
70704,BAKER,LA,35,313,278,0.8994252873563219
70706,DENHAM SPGS,LA,714,653,-61,0.4776883686905633
70706,DENHAM SPRINGS,LA,4555,5306,751,0.5380793023019977
70707,GONZALES,LA,225,908,683,0.8014121800529568
70710,ADDIS,LA,2100,2515,415,0.5449620801733478
70711,ALBANY,LA,1690,1681,-9,0.49866508454464553
70714,BAKER,LA,5174,4925,-249,0.48767204673730075
70715,BATCHELOR,LA,36,0,-36,0
70719,BRUSLY,LA,1004,1021,17,0.5041975308641975
70721,CARVILLE,LA,0,55,55,1
70722,CLINTON,LA,1072,1222,150,0.5326939843068875
70723,CONVENT,LA,120,107,-13,0.4713656387665198
70725,DARROW,LA,131,258,127,0.6632390745501285
70726,DENHAM SPGS,LA,700,759,59,0.5202193283070596
70726,DENHAM SPRINGS,LA,17590,18531,941,0.5130256637413139
70727,DENHAM SPGS,LA,11,12,1,0.5217391304347826
70727,DENHAM SPRINGS,LA,1017,554,-463,0.3526416295353278
70728,DUPLESSIS,LA,16,13,-3,0.4482758620689655
70729,BUECHE,LA,11,12,1,0.5217391304347826
70729,ERWINVILLE,LA,0,25,25,1
70730,ETHEL,LA,544,597,53,0.523225241016652
70732,FORDOCHE,LA,24,11,-13,0.3142857142857143
70733,FRENCH SETTLEMENT,LA,520,377,-143,0.42028985507246375
70734,GEISMAR,LA,1929,2303,374,0.5441871455576559
70736,GLYNN,LA,16,0,-16,0
70737,GONZALES,LA,13405,14213,808,0.5146281410674198
70739,GREENWEL SPGS,LA,72,69,-3,0.48936170212765956
70739,GREENWELL SPRINGS,LA,2827,2953,126,0.5108996539792388
70744,HOLDEN,LA,1528,1518,-10,0.4983585029546947
70748,JACKSON,LA,1185,939,-246,0.442090395480226
70749,JARREAU,LA,189,130,-59,0.40752351097178685
70750,KROTZ SPRINGS,LA,73,129,56,0.6386138613861386
70754,LIVINGSTON,LA,2750,2916,166,0.5146487822096717
70754,PONCHATOULA,LA,66,68,2,0.5074626865671642
70755,LIVONIA,LA,110,251,141,0.6952908587257618
70757,MARINGOUIN,LA,248,245,-3,0.4969574036511156
70759,MORGANZA,LA,42,69,27,0.6216216216216216
70760,NEW ROADS,LA,2195,1923,-272,0.4669742593491986
70762,OSCAR,LA,13,70,57,0.8433734939759037
70762,TORBERT,LA,0,24,24,1
70763,PAULINA,LA,183,210,27,0.5343511450381679
70764,PLAQUEMINE,LA,4241,3691,-550,0.46533030761472516
70765,PLAQUEMINE,LA,137,312,175,0.6948775055679287
70767,PORT ALLEN,LA,3780,3770,-10,0.49933774834437084
70769,PRAIRIEVILLE,LA,11195,12960,1765,0.5365348789070585
70770,PRIDE,LA,856,877,21,0.5060588574725908
70774,SAINT AMANT,LA,2456,2495,39,0.5039385982629772
70774,ST AMANT,LA,63,65,2,0.5078125
70775,SAINT FRANCISVILLE,LA,1734,2057,323,0.5426008968609866
70775,ST FRANCISVLE,LA,37,34,-3,0.4788732394366197
70776,SAINT GABRIEL,LA,848,1176,328,0.5810276679841897
70777,SLAUGHTER,LA,756,785,29,0.509409474367294
70778,SORRENTO,LA,919,713,-206,0.4368872549019608
70780,SUNSHINE,LA,23,43,20,0.6515151515151515
70783,VENTRESS,LA,594,452,-142,0.4321223709369025
70785,WALKER,LA,6921,7518,597,0.5206731768127987
70786,WATSON,LA,207,193,-14,0.4825
70788,BAYOU GOULA,LA,16,20,4,0.5555555555555556
70788,WHITE CASTLE,LA,797,714,-83,0.47253474520185307
70791,ZACHARY,LA,8042,8780,738,0.5219355605754369
70801,BATON ROUGE,LA,183,115,-68,0.3859060402684564
70802,BATON ROUGE,LA,10686,8274,-2412,0.43639240506329113
70805,BATON ROUGE,LA,10637,9130,-1507,0.46188091263216474
70806,BATON ROUGE,LA,12640,10546,-2094,0.4548434400069007
70806,LAFAYETTE,LA,308,268,-40,0.4652777777777778
70807,BATON ROUGE,LA,4596,3621,-975,0.44067177802117563
70807,SAINT CHARLES,LA,77,78,1,0.5032258064516129
70808,BATON ROUGE,LA,12099,10253,-1846,0.4587061560486757
70809,BATON ROUGE,LA,12489,11035,-1454,0.4690953919401462
70810,BATON ROUGE,LA,14853,14573,-280,0.49524230272548087
70811,BATON ROUGE,LA,3753,3351,-402,0.4717060810810811
70812,BATON ROUGE,LA,2815,2648,-167,0.4847153578619806
70814,BATON ROUGE,LA,3693,3486,-207,0.48558295027162557
70815,BATON ROUGE,LA,9302,8002,-1300,0.4624364308830328
70816,BATON ROUGE,LA,18929,15766,-3163,0.4544170629773743
70817,BATON ROUGE,LA,10354,10834,480,0.5113271663205589
70818,BATON ROUGE,LA,2669,3109,440,0.5380754586362063
70819,BATON ROUGE,LA,1552,1216,-336,0.4393063583815029
70820,BATON ROUGE,LA,9158,6246,-2912,0.40547909633861334
70821,BATON ROUGE,LA,343,782,439,0.6951111111111111
70831,BATON ROUGE,LA,0,36,36,1
70835,BATON ROUGE,LA,313,857,544,0.7324786324786324
70836,BATON ROUGE,LA,397,272,-125,0.40657698056801195
70837,BATON ROUGE,LA,30,22,-8,0.4230769230769231
70874,BATON ROUGE,LA,154,441,287,0.7411764705882353
70879,BATON ROUGE,LA,216,628,412,0.7440758293838863
70884,BATON ROUGE,LA,440,840,400,0.65625
70892,BATON ROUGE,LA,219,643,424,0.7459396751740139
70895,BATON ROUGE,LA,34,86,52,0.7166666666666667
70896,BATON ROUGE,LA,398,750,352,0.6533101045296167
70898,BATON ROUGE,LA,194,400,206,0.6734006734006734
71001,ARCADIA,LA,1217,1221,4,0.5008203445447088
71003,ATHENS,LA,48,0,-48,0
71006,BENTON,LA,4239,4921,682,0.5372270742358078
71007,BETHANY,LA,73,99,26,0.5755813953488372
71007,PRINCETON,LA,11,0,-11,0
71009,BLANCHARD,LA,94,27,-67,0.2231404958677686
71016,CASTOR,LA,329,238,-91,0.41975308641975306
71018,COTTON VALLEY,LA,301,366,65,0.5487256371814093
71019,COUSHATTA,LA,1710,1749,39,0.5056374674761491
71021,CULLEN,LA,29,0,-29,0
71023,DOYLINE,LA,1928,1171,-757,0.377863827040981
71024,DUBBERLY,LA,236,97,-139,0.2912912912912913
71027,FRIERSON,LA,412,525,113,0.5602988260405549
71028,GIBSLAND,LA,12,68,56,0.85
71030,GLOSTER,LA,512,153,-359,0.23007518796992482
71031,GOLDONNA,LA,12,18,6,0.6
71032,GRAND CANE,LA,292,462,170,0.6127320954907162
71033,GREENWOOD,LA,1101,1146,45,0.5100133511348465
71037,HAUGHTON,LA,7036,7083,47,0.50166442382605
71038,HAYNESVILLE,LA,960,896,-64,0.4827586206896552
71039,HEFLIN,LA,238,259,21,0.5211267605633803
71040,HOMER,LA,1958,1929,-29,0.4962696166709545
71045,JAMESTOWN,LA,0,13,13,1
71046,KEATCHIE,LA,274,90,-184,0.24725274725274726
71047,KEITHVILLE,LA,3130,3021,-109,0.4911396520890912
71049,LOGANSPORT,LA,1032,932,-100,0.4745417515274949
71051,ELM GROVE,LA,469,552,83,0.5406464250734574
71052,MANSFIELD,LA,2648,2447,-201,0.4802747791952895
71055,MINDEN,LA,7053,6206,-847,0.4680594313296629
71058,MINDEN,LA,217,297,80,0.5778210116731517
71060,MOORINGSPORT,LA,894,841,-53,0.4847262247838617
71061,OIL CITY,LA,491,438,-53,0.4714747039827772
71064,PLAIN DEALING,LA,805,896,91,0.5267489711934157
71065,PLEASANT HILL,LA,70,61,-9,0.46564885496183206
71067,PRINCETON,LA,1789,1298,-491,0.420472951085196
71068,RINGGOLD,LA,808,866,58,0.5173237753882916
71070,CRESTON,LA,0,14,14,1
71070,SALINE,LA,305,288,-17,0.4856661045531197
71071,SAREPTA,LA,890,707,-183,0.4427050720100188
71072,SHONGALOO,LA,145,132,-13,0.47653429602888087
71073,SIBLEY,LA,1206,712,-494,0.37122002085505734
71075,SPRINGHILL,LA,3004,2515,-489,0.45569849610436675
71078,STONEWALL,LA,2017,2279,262,0.5304934823091247
71082,VIVIAN,LA,1447,1341,-106,0.48098995695839314
71101,SHREVEPORT,LA,4203,3512,-691,0.45521710952689565
71103,SHREVEPORT,LA,2490,2174,-316,0.46612349914236706
71104,SHREVEPORT,LA,7838,6582,-1256,0.4564493758668516
71105,SHREVEPORT,LA,11369,10182,-1187,0.4724606746786692
71106,SHREVEPORT,LA,11423,11733,310,0.506693729486958
71107,SHREVEPORT,LA,10487,9752,-735,0.4818419882405257
71108,SHREVEPORT,LA,7799,6497,-1302,0.45446278679350866
71109,SHREVEPORT,LA,7446,6773,-673,0.4763344820310852
71110,BARKSDALE AFB,LA,3888,2597,-1291,0.4004626060138782
71111,BOSSIER CITY,LA,20420,19934,-486,0.49397829211478417
71112,BOSSIER CITY,LA,14866,13199,-1667,0.4703010867628719
71113,BOSSIER CITY,LA,63,156,93,0.7123287671232876
71115,SHREVEPORT,LA,6542,6073,-469,0.48141101862861674
71118,SHREVEPORT,LA,9789,8976,-813,0.4783373301358913
71119,SHREVEPORT,LA,3356,3225,-131,0.49004710530314544
71129,SHREVEPORT,LA,5464,4718,-746,0.4633667255941858
71133,SHREVEPORT,LA,203,449,246,0.6886503067484663
71134,SHREVEPORT,LA,39,26,-13,0.4
71135,SHREVEPORT,LA,278,511,233,0.6476552598225602
71136,SHREVEPORT,LA,61,233,172,0.7925170068027211
71137,SHREVEPORT,LA,28,66,38,0.7021276595744681
71138,SHREVEPORT,LA,0,70,70,1
71148,SHREVEPORT,LA,48,224,176,0.8235294117647058
71149,SHREVEPORT,LA,146,525,379,0.7824143070044709
71171,BOSSIER CITY,LA,365,704,339,0.6585594013096352
71201,MONROE,LA,10170,8918,-1252,0.4672045264040235
71202,MONROE,LA,9090,8459,-631,0.4820217676220867
71203,MONROE,LA,14141,13358,-783,0.48576311865886035
71207,MONROE,LA,210,96,-114,0.3137254901960784
71210,MONROE,LA,100,104,4,0.5098039215686274
71211,MONROE,LA,494,1034,540,0.6767015706806283
71219,BASKIN,LA,85,29,-56,0.2543859649122807
71220,BASTROP,LA,7416,6848,-568,0.48008973639932695
71221,BASTROP,LA,12,121,109,0.9097744360902256
71222,BERNICE,LA,779,746,-33,0.48918032786885246
71225,CALHOUN,LA,2594,2797,203,0.5188276757558894
71226,CHATHAM,LA,470,298,-172,0.3880208333333333
71227,CHOUDRANT,LA,1260,1231,-29,0.4941790445604175
71229,COLLINSTON,LA,160,261,101,0.6199524940617577
71232,DELHI,LA,2025,1785,-240,0.468503937007874
71233,DELTA,LA,0,14,14,1
71234,DOWNSVILLE,LA,1343,1267,-76,0.4854406130268199
71235,DUBACH,LA,1284,1182,-102,0.4793187347931874
71237,EPPS,LA,85,51,-34,0.375
71238,EROS,LA,720,769,49,0.5164539959704499
71241,FARMERVILLE,LA,2807,2882,75,0.5065916681314818
71245,GRAMBLING,LA,1073,679,-394,0.3875570776255708
71247,HODGE,LA,208,140,-68,0.40229885057471265
71251,JONESBORO,LA,2844,2474,-370,0.46521248589695374
71254,LAKE PROVIDENCE,LA,1667,1525,-142,0.47775689223057644
71256,LILLIE,LA,0,22,22,1
71259,MANGHAM,LA,385,386,1,0.5006485084306096
71260,MARION,LA,283,533,250,0.6531862745098039
71261,MER ROUGE,LA,401,350,-51,0.46604527296937415
71263,OAK GROVE,LA,2202,2256,54,0.506056527590848
71264,OAK RIDGE,LA,11,46,35,0.8070175438596491
71266,PIONEER,LA,227,241,14,0.5149572649572649
71268,QUITMAN,LA,472,452,-20,0.48917748917748916
71269,RAYVILLE,LA,3420,3469,49,0.5035563942517056
71270,RUSTON,LA,13102,10067,-3035,0.43450299969787215
71273,RUSTON,LA,342,635,293,0.6499488229273286
71275,SIMSBORO,LA,587,529,-58,0.47401433691756273
71277,SPEARSVILLE,LA,333,169,-164,0.33665338645418325
71280,STERLINGTON,LA,1972,1828,-144,0.48105263157894734
71281,SWARTZ,LA,0,12,12,1
71282,TALLULAH,LA,2871,2337,-534,0.44873271889400923
71284,TALLULAH,LA,220,92,-128,0.2948717948717949
71291,WEST MONROE,LA,15754,13124,-2630,0.45446360551284715
71292,WEST MONROE,LA,8882,7607,-1275,0.4613378616047062
71294,WEST MONROE,LA,724,795,71,0.5233706385780118
71295,WINNSBORO,LA,5734,4295,-1439,0.42825805165021436
71301,ALEXANDRIA,LA,9431,8271,-1160,0.46723534063947575
71302,ALEXANDRIA,LA,5212,4352,-860,0.45503973232956924
71303,ALEXANDRIA,LA,9536,8867,-669,0.4818236157148291
71306,ALEXANDRIA,LA,236,491,255,0.6753782668500687
71307,ALEXANDRIA,LA,62,176,114,0.7394957983193278
71309,ALEXANDRIA,LA,52,0,-52,0
71315,ALEXANDRIA,LA,233,371,138,0.6142384105960265
71322,BUNKIE,LA,1911,1852,-59,0.4921605102311985
71323,CENTER POINT,LA,82,139,57,0.6289592760180995
71325,CHENEYVILLE,LA,46,61,15,0.5700934579439252
71326,CLAYTON,LA,117,62,-55,0.3463687150837989
71327,COTTONPORT,LA,1203,1125,-78,0.4832474226804124
71328,DEVILLE,LA,1986,2055,69,0.5085374907201188
71331,EFFIE,LA,23,64,41,0.735632183908046
71333,EVERGREEN,LA,11,0,-11,0
71334,FERRIDAY,LA,2386,1941,-445,0.4485786919343656
71334,RIDGECREST,LA,157,153,-4,0.4935483870967742
71336,GILBERT,LA,140,176,36,0.5569620253164557
71339,HAMBURG,LA,11,0,-11,0
71340,HARRISONBURG,LA,35,14,-21,0.2857142857142857
71341,HESSMER,LA,910,940,30,0.5081081081081081
71342,JENA,LA,2032,2049,17,0.5020828228375398
71343,JONESVILLE,LA,2137,1895,-242,0.46999007936507936
71346,LECOMPTE,LA,292,428,136,0.5944444444444444
71348,LIBUSE,LA,11,0,-11,0
71350,MANSURA,LA,1325,1486,161,0.528637495553184
71351,MARKSVILLE,LA,3792,3436,-356,0.47537354731599335
71353,MELVILLE,LA,22,22,0,0.5
71354,MONTEREY,LA,480,292,-188,0.37823834196891193
71355,MOREAUVILLE,LA,594,588,-6,0.49746192893401014
71357,NEWELLTON,LA,179,137,-42,0.43354430379746833
71358,PALMETTO,LA,25,13,-12,0.34210526315789475
71360,PINEVILLE,LA,12746,11835,-911,0.4814694276066881
71361,PINEVILLE,LA,413,692,279,0.6262443438914027
71362,PLAUCHEVILLE,LA,232,323,91,0.581981981981982
71366,SAINT JOSEPH,LA,469,344,-125,0.4231242312423124
71367,SAINT LANDRY,LA,29,75,46,0.7211538461538461
71368,SICILY ISLAND,LA,112,114,2,0.504424778761062
71369,SIMMESPORT,LA,239,299,60,0.5557620817843866
71371,TROUT,LA,375,387,12,0.5078740157480315
71373,VIDALIA,LA,2532,2351,-181,0.48146631169363097
71375,WATERPROOF,LA,50,35,-15,0.4117647058823529
71378,WISNER,LA,415,393,-22,0.4863861386138614
71403,ANACOCO,LA,1293,1343,50,0.5094840667678301
71404,ATLANTA,LA,24,12,-12,0.3333333333333333
71405,BALL,LA,2377,2065,-312,0.464880684376407
71407,BENTLEY,LA,68,24,-44,0.2608695652173913
71409,BOYCE,LA,1927,1686,-241,0.46664821477996127
71411,CAMPTI,LA,921,851,-70,0.4802483069977427
71415,CLARKS,LA,12,0,-12,0
71417,COLFAX,LA,1333,1348,15,0.5027974636329727
71418,COLUMBIA,LA,2475,2185,-290,0.4688841201716738
71419,CONVERSE,LA,415,521,106,0.5566239316239316
71422,DODSON,LA,203,136,-67,0.40117994100294985
71423,DRY PRONG,LA,1660,1612,-48,0.49266503667481665
71424,ELMER,LA,155,156,1,0.5016077170418006
71429,FLORIEN,LA,821,798,-23,0.4928968499073502
71430,FOREST HILL,LA,380,328,-52,0.4632768361581921
71432,GEORGETOWN,LA,96,0,-96,0
71433,GLENMORA,LA,847,789,-58,0.48227383863080686
71433,MELDER,LA,19,23,4,0.5476190476190477
71434,GORUM,LA,0,11,11,1
71435,GRAYSON,LA,1124,1137,13,0.502874834144184
71438,HINESTON,LA,118,112,-6,0.48695652173913045
71439,HORNBECK,LA,331,323,-8,0.4938837920489297
71441,KELLY,LA,0,14,14,1
71446,LEESVILLE,LA,10526,8998,-1528,0.46086867445195656
71447,CLIFTON,LA,0,17,17,1
71447,LENA,LA,0,13,13,1
71449,MANY,LA,3130,3108,-22,0.4982366142994549
71450,MARTHAVILLE,LA,0,12,12,1
71454,MONTGOMERY,LA,689,590,-99,0.4612978889757623
71456,NATCHEZ,LA,34,137,103,0.8011695906432749
71457,NATCHITOCHES,LA,10100,8781,-1319,0.46507070600074146
71458,NATCHITOCHES,LA,0,71,71,1
71459,FORT POLK,LA,6567,5178,-1389,0.4408684546615581
71461,NEW LLANO,LA,1300,1208,-92,0.48165869218500795
71462,NOBLE,LA,263,314,51,0.5441941074523396
71463,OAKDALE,LA,2591,2277,-314,0.46774856203779785
71465,OLLA,LA,889,923,34,0.5093818984547461
71466,OTIS,LA,11,0,-11,0
71467,POLLOCK,LA,1775,1814,39,0.5054332683198662
71468,PROVENCAL,LA,14,24,10,0.631578947368421
71469,ROBELINE,LA,665,743,78,0.5276988636363636
71473,SIKES,LA,0,17,17,1
71474,SIMPSON,LA,0,11,11,1
71477,TIOGA,LA,157,145,-12,0.48013245033112584
71479,TULLOS,LA,13,14,1,0.5185185185185185
71480,URANIA,LA,12,12,0,0.5
71483,WINNFIELD,LA,2769,2702,-67,0.4938768049716688
71485,WOODWORTH,LA,613,555,-58,0.4751712328767123
71486,ZWOLLE,LA,1214,1265,51,0.5102864058087939
71496,LEESVILLE,LA,124,91,-33,0.4232558139534884
71601,PINE BLUFF,AR,5096,4309,-787,0.458160552897395
71602,PINE BLUFF,AR,390,354,-36,0.47580645161290325
71602,WHITE HALL,AR,5338,4602,-736,0.4629778672032193
71603,PINE BLUFF,AR,10069,9093,-976,0.47453292975681033
71611,PINE BLUFF,AR,264,624,360,0.7027027027027027
71612,PINE BLUFF,AR,0,12,12,1
71612,WHITE HALL,AR,0,184,184,1
71613,PINE BLUFF,AR,24,306,282,0.9272727272727272
71635,CROSSETT,AR,4733,4354,-379,0.47914603279410145
71638,DERMOTT,AR,1207,1181,-26,0.4945561139028476
71639,DUMAS,AR,1758,1611,-147,0.4781834372217275
71640,EUDORA,AR,987,820,-167,0.45379081350304373
71642,FOUNTAIN HILL,AR,12,25,13,0.6756756756756757
71643,GOULD,AR,28,48,20,0.631578947368421
71644,GRADY,AR,12,13,1,0.52
71646,HAMBURG,AR,1758,1709,-49,0.4929333717911739
71647,HERMITAGE,AR,134,204,70,0.6035502958579881
71652,KINGSLAND,AR,130,81,-49,0.38388625592417064
71653,LAKE VILLAGE,AR,1784,1606,-178,0.4737463126843658
71654,MC GEHEE,AR,2254,1776,-478,0.44069478908188586
71654,MCGEHEE,AR,84,65,-19,0.436241610738255
71655,MONTICELLO,AR,6097,4746,-1351,0.43770174306003873
71657,MONTICELLO,AR,309,468,159,0.6023166023166023
71658,MONTROSE,AR,14,0,-14,0
71660,NEW EDINBURG,AR,12,37,25,0.7551020408163265
71665,RISON,AR,1341,1310,-31,0.4941531497548095
71667,STAR CITY,AR,2280,2211,-69,0.4923179692718771
71670,TILLAR,AR,72,35,-37,0.32710280373831774
71671,WARREN,AR,2941,2356,-585,0.44478006418727584
71675,WILMAR,AR,180,255,75,0.5862068965517241
71701,CAMDEN,AR,6703,5840,-863,0.4655983417045364
71711,CAMDEN,AR,407,201,-206,0.3305921052631579
71720,BEARDEN,AR,362,368,6,0.5041095890410959
71726,CHIDESTER,AR,105,112,7,0.5161290322580645
71730,EL DORADO,AR,11581,10237,-1344,0.4691997433311944
71740,EMERSON,AR,407,366,-41,0.47347994825355755
71742,FORDYCE,AR,1642,1516,-126,0.48005066497783405
71743,GURDON,AR,1360,1300,-60,0.48872180451127817
71744,HAMPTON,AR,709,888,179,0.5560425798371947
71747,HUTTIG,AR,16,23,7,0.5897435897435898
71749,JUNCTION CITY,AR,195,244,49,0.5558086560364465
71751,LOUANN,AR,14,11,-3,0.44
71752,MC NEIL,AR,25,26,1,0.5098039215686274
71753,MAGNOLIA,AR,5104,4603,-501,0.47419388070464613
71754,MAGNOLIA,AR,717,254,-463,0.2615859938208033
71762,SMACKOVER,AR,789,686,-103,0.46508474576271186
71763,SPARKMAN,AR,95,124,29,0.5662100456621004
71764,STEPHENS,AR,184,137,-47,0.42679127725856697
71765,STRONG,AR,476,135,-341,0.220949263502455
71766,THORNTON,AR,11,0,-11,0
71770,STEPHENS,AR,17,18,1,0.5142857142857142
71770,WALDO,AR,600,726,126,0.5475113122171946
71801,HOPE,AR,5454,4393,-1061,0.44612572357063063
71802,HOPE,AR,74,319,245,0.811704834605598
71822,ASHDOWN,AR,2903,2843,-60,0.49477897667942916
71825,BLEVINS,AR,0,11,11,1
71826,BRADLEY,AR,117,44,-73,0.2732919254658385
71832,DE QUEEN,AR,3191,2740,-451,0.46197943011296577
71833,DIERKS,AR,478,363,-115,0.43162901307966706
71834,DODDRIDGE,AR,0,85,85,1
71835,EMMET,AR,155,54,-101,0.2583732057416268
71836,FOREMAN,AR,813,700,-113,0.46265697290152014
71837,FOUKE,AR,1362,1490,128,0.5224403927068724
71838,FULTON,AR,29,12,-17,0.2926829268292683
71841,GILLHAM,AR,46,53,7,0.5353535353535354
71842,HORATIO,AR,522,524,2,0.5009560229445507
71845,LEWISVILLE,AR,450,454,4,0.5022123893805309
71846,LOCKESBURG,AR,855,765,-90,0.4722222222222222
71851,MINERAL SPGS,AR,0,14,14,1
71851,MINERAL SPRINGS,AR,534,407,-127,0.43251859723698194
71852,NASHVILLE,AR,4832,3766,-1066,0.4380088392649453
71854,TEXARKANA,AR,15809,13364,-2445,0.4580948136975971
71857,PRESCOTT,AR,2299,2063,-236,0.4729481889041724
71858,ROSSTON,AR,73,79,6,0.5197368421052632
71860,STAMPS,AR,670,536,-134,0.4444444444444444
71861,TAYLOR,AR,586,586,0,0.5
71862,WASHINGTON,AR,23,13,-10,0.3611111111111111
71866,WINTHROP,AR,0,11,11,1
71901,HOT SPRINGS,AR,606,461,-145,0.4320524835988753
71901,HOT SPRINGS NATIONAL PARK,AR,14439,12768,-1671,0.46929099128900653
71902,HOT SPRINGS,AR,113,171,58,0.602112676056338
71902,HOT SPRINGS NATIONAL PARK,AR,229,348,119,0.6031195840554593
71902,HOT SPRINGS VILLAGE,AR,17,12,-5,0.41379310344827586
71903,HOT SPRINGS,AR,296,379,83,0.5614814814814815
71903,HOT SPRINGS NATIONAL PARK,AR,746,884,138,0.5423312883435583
71909,HOT SPRINGS NATIONAL PARK,AR,1062,1090,28,0.5065055762081785
71909,HOT SPRINGS VILLAGE,AR,7442,8019,577,0.5186598538257551
71910,HOT SPRINGS,AR,11,53,42,0.828125
71910,HOT SPRINGS NATIONAL PARK,AR,13,29,16,0.6904761904761905
71910,HOT SPRINGS VILLAGE,AR,282,473,191,0.6264900662251656
71913,HOT SPRINGS,AR,2490,2177,-313,0.4664666809513606
71913,HOT SPRINGS NATIONAL PARK,AR,22682,20623,-2059,0.47622676365315786
71914,HOT SPRINGS,AR,175,116,-59,0.39862542955326463
71914,HOT SPRINGS NATIONAL PARK,AR,892,658,-234,0.42451612903225805
71921,AMITY,AR,1087,1182,95,0.5209343323049802
71923,ARKADELPHIA,AR,7945,6194,-1751,0.43807907207016056
71929,BISMARCK,AR,1870,1773,-97,0.4866867965962119
71933,BONNERDALE,AR,123,291,168,0.7028985507246377
71935,CADDO GAP,AR,11,0,-11,0
71937,COVE,AR,648,530,-118,0.44991511035653653
71940,DELIGHT,AR,543,490,-53,0.4743465634075508
71941,DONALDSON,AR,259,235,-24,0.4757085020242915
71943,GLENWOOD,AR,1806,1577,-229,0.46615430091634646
71944,GRANNIS,AR,27,0,-27,0
71945,HATFIELD,AR,478,433,-45,0.47530186608122943
71949,JESSIEVILLE,AR,382,488,106,0.5609195402298851
71950,KIRBY,AR,36,37,1,0.5068493150684932
71953,MENA,AR,6355,6073,-282,0.488654650788542
71956,MOUNTAIN PINE,AR,549,602,53,0.5230234578627281
71957,MOUNT IDA,AR,1263,1526,263,0.5471495159555396
71958,MURFREESBORO,AR,1130,812,-318,0.4181256436663234
71960,NORMAN,AR,251,408,157,0.6191198786039454
71961,ODEN,AR,40,12,-28,0.23076923076923078
71964,PEARCY,AR,1182,1203,21,0.5044025157232704
71968,ROYAL,AR,1428,1608,180,0.5296442687747036
71969,SIMS,AR,0,13,13,1
71973,WICKES,AR,332,157,-175,0.3210633946830266
72001,ADONA,AR,25,12,-13,0.32432432432432434
72002,ALEXANDER,AR,5825,6809,984,0.5389425360139307
72004,ALTHEIMER,AR,36,11,-25,0.23404255319148937
72005,AMAGON,AR,18,11,-7,0.3793103448275862
72006,AUGUSTA,AR,951,863,-88,0.4757442116868798
72007,AUSTIN,AR,3211,3700,489,0.5353783822891043
72010,BALD KNOB,AR,3117,2711,-406,0.4651681537405628
72011,BAUXITE,AR,1560,1813,253,0.5375037058997925
72012,BEEBE,AR,6203,6164,-39,0.49842322309371717
72013,BEE BRANCH,AR,408,439,31,0.5182998819362455
72015,BENTON,AR,10879,10730,-149,0.49655236244157525
72016,BIGELOW,AR,631,779,148,0.5524822695035461
72016,JACKSONVILLE,AR,33,33,0,0.5
72017,BISCOE,AR,32,0,-32,0
72018,BENTON,AR,717,976,259,0.5764914353219137
72019,BENTON,AR,9326,9879,553,0.5143972923717782
72019,BRYANT,AR,134,166,32,0.5533333333333333
72020,BRADFORD,AR,1458,1458,0,0.5
72021,BRINKLEY,AR,1401,1411,10,0.501778093883357
72022,BRYANT,AR,8107,7249,-858,0.47206303724928367
72023,CABOT,AR,16380,16060,-320,0.49506781750924783
72024,CARLISLE,AR,1213,1029,-184,0.45896520963425513
72025,CASA,AR,91,54,-37,0.3724137931034483
72027,CENTER RIDGE,AR,164,282,118,0.6322869955156951
72029,CLARENDON,AR,771,750,-21,0.4930966469428008
72030,CLEVELAND,AR,14,56,42,0.8
72031,CLINTON,AR,2637,2921,284,0.5255487585462396
72032,CONWAY,AR,14391,14222,-169,0.49704679691049525
72033,CONWAY,AR,771,1211,440,0.6109989909182644
72034,CONWAY,AR,22376,20426,-1950,0.47722069062193356
72036,COTTON PLANT,AR,66,73,7,0.5251798561151079
72039,DAMASCUS,AR,1007,742,-265,0.42424242424242425
72040,DES ARC,AR,616,620,4,0.5016181229773463
72041,DE VALLS BLUFF,AR,206,173,-33,0.45646437994722955
72042,DE WITT,AR,1507,1477,-30,0.4949731903485255
72042,DEWITT,AR,271,240,-31,0.46966731898238745
72044,EDGEMONT,AR,13,108,95,0.8925619834710744
72045,EL PASO,AR,190,287,97,0.6016771488469602
72046,ENGLAND,AR,1924,1672,-252,0.4649610678531702
72047,ENOLA,AR,25,76,51,0.7524752475247525
72051,FOX,AR,12,11,-1,0.4782608695652174
72057,GRAPEVINE,AR,77,52,-25,0.40310077519379844
72058,GREENBRIER,AR,6143,7019,876,0.5332776173833764
72060,GRIFFITHVILLE,AR,12,11,-1,0.4782608695652174
72063,HATTIEVILLE,AR,255,286,31,0.5286506469500925
72064,HAZEN,AR,554,606,52,0.5224137931034483
72065,HENSLEY,AR,1483,1584,101,0.5164656015650473
72067,GREERS FERRY,AR,225,235,10,0.5108695652173914
72067,HIGDEN,AR,1031,1145,114,0.5261948529411765
72068,HIGGINSON,AR,35,24,-11,0.4067796610169492
72069,HOLLY GROVE,AR,86,24,-62,0.21818181818181817
72070,HOUSTON,AR,1355,773,-582,0.3632518796992481
72073,HUMPHREY,AR,110,74,-36,0.40217391304347827
72076,JACKSONVILLE,AR,19967,18874,-1093,0.48592981643109084
72078,JACKSONVILLE,AR,1355,993,-362,0.4229131175468484
72079,JEFFERSON,AR,27,56,29,0.6746987951807228
72080,JERUSALEM,AR,24,61,37,0.7176470588235294
72081,JUDSONIA,AR,2896,2897,1,0.5000863110650785
72082,KENSETT,AR,762,825,63,0.5198487712665406
72084,LEOLA,AR,226,181,-45,0.44471744471744473
72086,LONOKE,AR,3559,3487,-72,0.4948907181379506
72087,LONSDALE,AR,199,309,110,0.6082677165354331
72088,FAIRFIELD BAY,AR,1288,1254,-34,0.49331235247836347
72089,BRYANT,AR,639,521,-118,0.44913793103448274
72099,LITTLE ROCK AIR FORCE BASE,AR,27,0,-27,0
72101,MC CRORY,AR,1168,976,-192,0.4552238805970149
72101,MCCRORY,AR,221,171,-50,0.4362244897959184
72102,MC RAE,AR,931,848,-83,0.47667228780213605
72103,MABELVALE,AR,4577,4538,-39,0.49786066922654965
72104,MALVERN,AR,8969,8607,-362,0.48970186618115613
72106,MAYFLOWER,AR,2285,2308,23,0.5025038101458742
72110,MORRILTON,AR,5404,5087,-317,0.4848918120293585
72111,LITTLE ROCK,AR,0,12,12,1
72111,MOUNT VERNON,AR,119,166,47,0.5824561403508772
72112,NEWPORT,AR,5262,4238,-1024,0.4461052631578947
72113,MAUMELLE,AR,7682,7407,-275,0.4908874014182517
72113,NORTH LITTLE ROCK,AR,5193,5142,-51,0.49753265602322205
72114,N LITTLE ROCK,AR,657,563,-94,0.46147540983606555
72114,NORTH LITTLE ROCK,AR,7281,6589,-692,0.47505407354001444
72115,N LITTLE ROCK,AR,18,24,6,0.5714285714285714
72115,NORTH LITTLE ROCK,AR,247,726,479,0.7461459403905447
72116,NORTH LITTLE ROCK,AR,9949,9496,-453,0.4883517613782463
72117,NORTH LITTLE ROCK,AR,7035,6757,-278,0.4899216937354988
72118,NORTH LITTLE ROCK,AR,9475,8515,-960,0.4733185102834908
72120,N LITTLE ROCK,AR,213,213,0,0.5
72120,NORTH LITTLE ROCK,AR,581,558,-23,0.48990342405618964
72120,SHERWOOD,AR,12206,12863,657,0.5131038334197615
72121,PANGBURN,AR,965,986,21,0.5053818554587391
72122,PARON,AR,155,223,68,0.58994708994709
72123,PATTERSON,AR,13,0,-13,0
72124,NORTH LITTLE ROCK,AR,115,261,146,0.6941489361702128
72124,SHERWOOD,AR,181,373,192,0.6732851985559567
72125,PERRY,AR,111,111,0,0.5
72126,PERRYVILLE,AR,1954,1558,-396,0.44362186788154895
72127,PLUMERVILLE,AR,592,674,82,0.5323854660347551
72128,POYEN,AR,158,73,-85,0.31601731601731603
72129,PRATTSVILLE,AR,128,205,77,0.6156156156156156
72131,QUITMAN,AR,1572,1811,239,0.5353236772095773
72132,REDFIELD,AR,1368,1241,-127,0.47566117286316595
72135,ROLAND,AR,709,749,40,0.5137174211248285
72136,ROMANCE,AR,461,648,187,0.5843101893597836
72137,ROSE BUD,AR,744,910,166,0.5501813784764208
72139,RUSSELL,AR,24,22,-2,0.4782608695652174
72141,SCOTLAND,AR,0,15,15,1
72142,SCOTT,AR,670,816,146,0.5491251682368775
72143,SEARCY,AR,14959,13466,-1493,0.47373790677220756
72145,SEARCY,AR,378,756,378,0.6666666666666666
72150,SHERIDAN,AR,4697,4769,72,0.5038030847242764
72152,SHERRILL,AR,11,13,2,0.5416666666666666
72153,SHIRLEY,AR,827,910,83,0.5238917674150835
72156,SOLGOHACHIA,AR,0,17,17,1
72157,SPRINGFIELD,AR,260,284,24,0.5220588235294118
72160,STUTTGART,AR,4877,3706,-1171,0.4317837585925667
72167,TRASKWOOD,AR,187,300,113,0.6160164271047228
72173,VILONIA,AR,3552,3651,99,0.506872136609746
72176,WARD,AR,4006,4336,330,0.5197794293934308
72179,WILBURN,AR,12,0,-12,0
72190,N LITTLE ROCK,AR,14,54,40,0.7941176470588235
72190,NORTH LITTLE ROCK,AR,549,545,-4,0.49817184643510054
72201,LITTLE ROCK,AR,1374,1208,-166,0.4678543764523625
72202,LITTLE ROCK,AR,7344,6195,-1149,0.45756702858409043
72203,FORT SMITH,AR,0,23,23,1
72203,LITTLE ROCK,AR,631,980,349,0.6083178150217257
72204,LITTLE ROCK,AR,12802,12089,-713,0.4856775541360331
72205,LITTLE ROCK,AR,14735,11418,-3317,0.4365847130348335
72206,LITTLE ROCK,AR,7802,7193,-609,0.47969323107702566
72207,CAMMACK VILLAGE,AR,716,708,-8,0.49719101123595505
72207,LITTLE ROCK,AR,4196,4111,-85,0.49488383291200194
72209,LITTLE ROCK,AR,14023,11092,-2931,0.44164841728050963
72210,LITTLE ROCK,AR,6830,6234,-596,0.47718922229026334
72211,LITTLE ROCK,AR,14086,11962,-2124,0.4592291154791155
72212,LITTLE ROCK,AR,4002,4109,107,0.5065959807668599
72214,LITTLE ROCK,AR,258,699,441,0.7304075235109718
72215,LITTLE ROCK,AR,660,828,168,0.5564516129032258
72216,LITTLE ROCK,AR,163,410,247,0.7155322862129145
72216,NORTH LITTLE ROCK,AR,11,21,10,0.65625
72217,GREENBRIER,AR,0,13,13,1
72217,LITTLE ROCK,AR,61,173,112,0.7393162393162394
72219,LITTLE ROCK,AR,154,563,409,0.7852161785216178
72221,LITTLE ROCK,AR,626,877,251,0.5834996673320026
72223,LITTLE ROCK,AR,12764,13646,882,0.5166982203710716
72225,LITTLE ROCK,AR,54,61,7,0.5304347826086957
72227,LITTLE ROCK,AR,5617,5021,-596,0.471987215642038
72231,LITTLE ROCK,AR,35,120,85,0.7741935483870968
72260,LITTLE ROCK,AR,0,25,25,1
72301,WEST MEMPHIS,AR,9617,8393,-1224,0.4660188784008884
72303,WEST MEMPHIS,AR,305,1216,911,0.799474030243261
72315,BLYTHEVILLE,AR,9458,7754,-1704,0.4504996514059958
72316,BLYTHEVILLE,AR,383,439,56,0.5340632603406326
72324,CHERRY VALLEY,AR,709,470,-239,0.3986429177268872
72326,COLT,AR,667,655,-12,0.49546142208774585
72327,CRAWFORDSVILLE,AR,129,69,-60,0.3484848484848485
72330,DYESS,AR,11,0,-11,0
72331,EARLE,AR,763,662,-101,0.46456140350877195
72333,ELAINE,AR,13,19,6,0.59375
72335,FORREST CITY,AR,4798,4442,-356,0.48073593073593074
72336,FORREST CITY,AR,87,590,503,0.8714918759231906
72342,HELENA,AR,1729,1459,-270,0.45765370138017564
72346,HETH,AR,30,12,-18,0.2857142857142857
72347,HICKORY RIDGE,AR,12,36,24,0.75
72348,HORSESHOE LAKE,AR,32,43,11,0.5733333333333334
72348,HUGHES,AR,439,379,-60,0.4633251833740831
72350,JOINER,AR,54,53,-1,0.4953271028037383
72351,KEISER,AR,72,12,-60,0.14285714285714285
72354,LEPANTO,AR,1001,764,-237,0.43286118980169974
72355,LEXA,AR,197,276,79,0.5835095137420718
72358,LUXORA,AR,82,73,-9,0.47096774193548385
72360,MARIANNA,AR,2535,1607,-928,0.38797682279092227
72364,MARION,AR,8269,5860,-2409,0.41474980536485245
72365,MARKED TREE,AR,1320,1090,-230,0.45228215767634855
72366,MARVELL,AR,296,53,-243,0.1518624641833811
72368,MORO,AR,54,24,-30,0.3076923076923077
72370,OSCEOLA,AR,3754,2910,-844,0.4366746698679472
72372,PALESTINE,AR,240,129,-111,0.34959349593495936
72373,PARKIN,AR,459,459,0,0.5
72376,PROCTOR,AR,224,230,6,0.5066079295154186
72384,TURRELL,AR,85,11,-74,0.11458333333333333
72386,TYRONZA,AR,208,214,6,0.5071090047393365
72390,WEST HELENA,AR,3538,3093,-445,0.4664454833358468
72392,WHEATLEY,AR,43,35,-8,0.44871794871794873
72395,WILSON,AR,131,72,-59,0.35467980295566504
72396,WYNNE,AR,5119,4738,-381,0.4806736329512022
72401,JONESBORO,AR,27048,19096,-7952,0.41383495145631066
72403,JONESBORO,AR,1347,1833,486,0.5764150943396227
72404,JONESBORO,AR,12809,11975,-834,0.4831746287927695
72405,JONESBORO,AR,6319,6789,470,0.5179279829111992
72410,ALICIA,AR,0,13,13,1
72411,BAY,AR,1005,958,-47,0.4880285277636271
72412,BEECH GROVE,AR,27,0,-27,0
72413,BIGGERS,AR,11,25,14,0.6944444444444444
72415,BLACK ROCK,AR,222,209,-13,0.48491879350348027
72416,BONO,AR,1995,2103,108,0.513177159590044
72417,BROOKLAND,AR,2733,2901,168,0.5149094781682642
72419,CARAWAY,AR,290,273,-17,0.4849023090586146
72421,CASH,AR,39,24,-15,0.38095238095238093
72422,CORNING,AR,2099,1914,-185,0.4769499127834538
72425,DELAPLAINE,AR,11,0,-11,0
72429,FISHER,AR,0,36,36,1
72432,HARRISBURG,AR,2291,2167,-124,0.4860924181247196
72433,HOXIE,AR,1129,1069,-60,0.48635122838944495
72434,IMBODEN,AR,781,735,-46,0.48482849604221634
72435,KNOBEL,AR,12,0,-12,0
72436,LAFE,AR,56,49,-7,0.4666666666666667
72437,LAKE CITY,AR,1649,1174,-475,0.4158696422245838
72438,LEACHVILLE,AR,779,771,-8,0.4974193548387097
72442,MANILA,AR,1400,1516,116,0.5198902606310014
72443,MARMADUKE,AR,1257,1200,-57,0.4884004884004884
72444,MAYNARD,AR,447,599,152,0.5726577437858509
72447,MONETTE,AR,603,593,-10,0.49581939799331104
72450,PARAGOULD,AR,17704,16734,-970,0.48591671990243335
72451,PARAGOULD,AR,907,635,-272,0.41180285343709466
72454,PIGGOTT,AR,2321,2419,98,0.510337552742616
72455,POCAHONTAS,AR,7788,6057,-1731,0.4374864572047671
72456,POLLARD,AR,24,0,-24,0
72457,PORTIA,AR,11,0,-11,0
72458,POWHATAN,AR,24,43,19,0.6417910447761194
72459,IMBODEN,AR,0,13,13,1
72459,RAVENDEN,AR,175,276,101,0.6119733924611973
72460,RAVENDEN SPRINGS,AR,25,59,34,0.7023809523809523
72461,RECTOR,AR,1307,1243,-64,0.48745098039215684
72462,REYNO,AR,35,0,-35,0
72466,SMITHVILLE,AR,60,126,66,0.6774193548387096
72467,STATE UNIV,AR,38,0,-38,0
72467,STATE UNIVERSITY,AR,947,16,-931,0.016614745586708203
72469,STRAWBERRY,AR,77,195,118,0.7169117647058824
72471,SWIFTON,AR,185,216,31,0.5386533665835411
72472,TRUMANN,AR,5283,4613,-670,0.46614793856103476
72473,TUCKERMAN,AR,921,770,-151,0.4553518628030751
72476,WALNUT RIDGE,AR,2961,2953,-8,0.4993236388231316
72479,WEINER,AR,257,152,-105,0.37163814180929094
72482,WILLIFORD,AR,404,621,217,0.6058536585365853
72501,BATESVILLE,AR,7830,7270,-560,0.4814569536423841
72501,SOUTHSIDE,AR,2790,2460,-330,0.4685714285714286
72503,BATESVILLE,AR,528,627,99,0.5428571428571428
72512,HORSESHOE BEND,AR,1260,1365,105,0.52
72512,HORSESHOE BND,AR,62,63,1,0.504
72513,ASH FLAT,AR,1188,1276,88,0.5178571428571429
72519,CALICO ROCK,AR,1090,1123,33,0.5074559421599638
72519,JORDAN,AR,13,14,1,0.5185185185185185
72521,CAVE CITY,AR,2303,2171,-132,0.4852481001341082
72522,CHARLOTTE,AR,22,12,-10,0.35294117647058826
72523,CONCORD,AR,38,82,44,0.6833333333333333
72525,CHEROKEE VILLAGE,AR,27,28,1,0.509090909090909
72525,CHEROKEE VLG,AR,11,0,-11,0
72526,CUSHMAN,AR,0,12,12,1
72527,DESHA,AR,0,15,15,1
72529,CHEROKEE VILLAGE,AR,2520,2557,37,0.503643884183573
72529,CHEROKEE VLG,AR,48,39,-9,0.4482758620689655
72530,DRASCO,AR,293,436,143,0.598079561042524
72531,ELIZABETH,AR,37,53,16,0.5888888888888889
72532,EVENING SHADE,AR,485,562,77,0.5367717287488061
72534,FLORAL,AR,106,153,47,0.5907335907335908
72536,FRANKLIN,AR,24,0,-24,0
72537,GAMALIEL,AR,166,243,77,0.5941320293398533
72538,GEPP,AR,0,15,15,1
72539,GLENCOE,AR,15,0,-15,0
72542,HARDY,AR,1806,1977,171,0.5226011102299762
72542,HIGHLAND,AR,150,184,34,0.5508982035928144
72543,HEBER SPRINGS,AR,6543,6346,-197,0.49235782450151294
72544,HENDERSON,AR,52,48,-4,0.48
72550,LOCUST GROVE,AR,88,69,-19,0.4394904458598726
72554,MAMMOTH SPG,AR,226,274,48,0.548
72554,MAMMOTH SPRING,AR,1208,1148,-60,0.4872665534804754
72556,MELBOURNE,AR,1680,1435,-245,0.4606741573033708
72560,MOUNTAIN VIEW,AR,3517,3979,462,0.5308164354322306
72561,MOUNT PLEASANT,AR,28,39,11,0.582089552238806
72562,NEWARK,AR,1027,969,-58,0.48547094188376755
72564,OIL TROUGH,AR,0,15,15,1
72565,OXFORD,AR,231,273,42,0.5416666666666666
72566,PINEVILLE,AR,26,12,-14,0.3157894736842105
72567,PLEASANT GROVE,AR,0,11,11,1
72568,PLEASANT PLAINS,AR,524,536,12,0.5056603773584906
72568,PLEASANT PLNS,AR,11,0,-11,0
72569,POUGHKEEPSIE,AR,13,0,-13,0
72571,ROSIE,AR,0,12,12,1
72573,SAGE,AR,0,12,12,1
72576,SALEM,AR,1853,1777,-76,0.48953168044077133
72577,SIDNEY,AR,41,77,36,0.652542372881356
72579,SULPHUR ROCK,AR,671,535,-136,0.44361525704809285
72581,TUMBLING SHOALS,AR,170,118,-52,0.4097222222222222
72583,VIOLA,AR,398,350,-48,0.4679144385026738
72584,VIOLET HILL,AR,11,23,12,0.6764705882352942
72601,HARRISON,AR,12644,11811,-833,0.4829687180535678
72602,HARRISON,AR,694,949,255,0.5776019476567255
72611,ALPENA,AR,460,515,55,0.5282051282051282
72611,ALPENA,AZ,12,19,7,0.6129032258064516
72615,BERGMAN,AR,0,11,11,1
72616,BERRYVILLE,AR,3865,3580,-285,0.48085963734049697
72617,BIG FLAT,AR,0,11,11,1
72619,BULL SHOALS,AR,1058,1035,-23,0.4945054945054945
72623,CLARKRIDGE,AR,40,0,-40,0
72624,COMPTON,AR,11,0,-11,0
72626,COTTER,AR,411,465,54,0.5308219178082192
72629,DENNARD,AR,14,26,12,0.65
72631,EUREKA SPGS,AR,76,71,-5,0.48299319727891155
72631,EUREKA SPRINGS,AR,1341,1426,85,0.5153595952294904
72631,HOLIDAY ISLAND,AR,649,694,45,0.5167535368577811
72632,EUREKA SPRINGS,AR,2842,2675,-167,0.4848649628421243
72633,EVERTON,AR,450,337,-113,0.42820838627700125
72634,FLIPPIN,AR,2179,2208,29,0.5033052199680875
72635,GASSVILLE,AR,1438,1667,229,0.5368760064412238
72638,GREEN FOREST,AR,3030,2556,-474,0.45757250268528465
72639,HARRIET,AR,0,26,26,1
72641,JASPER,AR,767,792,25,0.5080179602309173
72642,LAKEVIEW,AR,889,930,41,0.5112699285321606
72644,DIAMOND CITY,AR,64,69,5,0.518796992481203
72644,LEAD HILL,AR,1114,1211,97,0.5208602150537635
72645,LESLIE,AR,452,620,168,0.5783582089552238
72648,MARBLE FALLS,AR,45,36,-9,0.4444444444444444
72650,MARSHALL,AR,1459,1445,-14,0.4975895316804408
72651,MIDWAY,AR,521,566,45,0.5206991720331187
72653,MOUNTAIN HOME,AR,13754,13243,-511,0.49053598547986815
72654,MOUNTAIN HOME,AR,1339,1076,-263,0.4455486542443064
72655,MOUNT JUDEA,AR,11,0,-11,0
72658,NORFORK,AR,445,540,95,0.5482233502538071
72660,OAK GROVE,AR,0,28,28,1
72661,OAKLAND,AR,23,40,17,0.6349206349206349
72662,OMAHA,AR,1150,1307,157,0.531949531949532
72668,PEEL,AR,21,36,15,0.631578947368421
72672,PYATT,AR,11,13,2,0.5416666666666666
72675,SAINT JOE,AR,154,167,13,0.5202492211838006
72677,SUMMIT,AR,22,63,41,0.7411764705882353
72680,TIMBO,AR,0,11,11,1
72685,WESTERN GROVE,AR,79,172,93,0.6852589641434262
72687,YELLVILLE,AR,2139,2594,455,0.5480667652651595
72701,FAYETTEVILLE,AR,22256,17851,-4405,0.44508439923205423
72702,FAYETTEVILLE,AR,687,1063,376,0.6074285714285714
72703,FAYETTEVILLE,AR,22267,17650,-4617,0.4421674975574317
72704,FAYETTEVILLE,AR,16836,14922,-1914,0.4698658605705649
72712,BENTONVILLE,AR,23710,20846,-2864,0.4678606697190053
72713,BENTONVILLE,AR,14304,16332,2028,0.5330983157070114
72714,BELLA VISTA,AR,5267,5979,712,0.5316556998043749
72715,BELLA VISTA,AR,7449,8639,1190,0.5369840875186475
72717,CANEHILL,AR,28,71,43,0.7171717171717171
72718,CAVE SPRINGS,AR,1608,2275,667,0.5858872006180788
72719,CENTERTON,AR,8428,10282,1854,0.5495456974879743
72722,DECATUR,AR,1560,1100,-460,0.41353383458646614
72727,ELKINS,AR,2407,2530,123,0.5124569576665992
72728,ELM SPRINGS,AR,0,12,12,1
72730,FARMINGTON,AR,4631,5087,456,0.5234616176167936
72732,GARFIELD,AR,1977,1955,-22,0.4972024415055951
72734,GENTRY,AR,2964,3350,386,0.5305669939816281
72736,GRAVETTE,AR,2640,2760,120,0.5111111111111111
72738,HINDSVILLE,AR,394,782,388,0.6649659863945578
72739,HIWASSE,AR,78,23,-55,0.22772277227722773
72740,HUNTSVILLE,AR,3358,3769,411,0.5288340115055423
72742,KINGSTON,AR,11,0,-11,0
72744,LINCOLN,AR,2173,2216,43,0.5048986101617681
72745,LOWELL,AR,5280,5730,450,0.5204359673024523
72751,PEA RIDGE,AR,3312,4225,913,0.5605678651983548
72753,PRAIRIE GROVE,AR,4799,4969,170,0.5087018837018837
72756,ROGERS,AR,16461,15222,-1239,0.48044692737430167
72757,ROGERS,AR,1560,1159,-401,0.4262596542846635
72758,ROGERS,AR,18540,19474,934,0.5122849476508655
72761,SILOAM SPRINGS,AR,10093,9644,-449,0.4886254243299387
72762,SPRINGDALE,AR,12279,13034,755,0.514913285663493
72762,TONTITOWN,AR,2799,2990,191,0.5164968042839869
72764,BETHEL HEIGHTS,AR,455,423,-32,0.48177676537585423
72764,FAYETTEVILLE,AR,2164,2072,-92,0.48914069877242683
72764,SPRINGDALE,AR,18711,16832,-1879,0.47356722842753846
72765,SPRINGDALE,AR,183,190,7,0.5093833780160858
72766,SPRINGDALE,AR,783,1213,430,0.6077154308617234
72768,SULPHUR SPGS,AR,16,13,-3,0.4482758620689655
72768,SULPHUR SPRINGS,AR,271,294,23,0.5203539823008849
72769,SUMMERS,AR,116,118,2,0.5042735042735043
72770,TONTITOWN,AR,26,136,110,0.8395061728395061
72773,WESLEY,AR,105,167,62,0.6139705882352942
72774,WEST FORK,AR,2253,2249,-4,0.4995557529986673
72776,WITTER,AR,0,55,55,1
72801,RUSSELLVILLE,AR,11869,7744,-4125,0.39484015703869885
72802,RUSSELLVILLE,AR,7681,7599,-82,0.49731675392670155
72811,RUSSELLVILLE,AR,296,556,260,0.6525821596244131
72812,RUSSELLVILLE,AR,224,363,139,0.6183986371379898
72821,ALTUS,AR,825,622,-203,0.42985487214927437
72823,ATKINS,AR,2614,2532,-82,0.49203264671589586
72824,BELLEVILLE,AR,185,189,4,0.5053475935828877
72830,CLARKSVILLE,AR,6870,6690,-180,0.49336283185840707
72832,COAL HILL,AR,146,206,60,0.5852272727272727
72833,DANVILLE,AR,1439,1279,-160,0.47056659308314935
72834,DARDANELLE,AR,3674,3481,-193,0.486512928022362
72835,DELAWARE,AR,143,163,20,0.5326797385620915
72837,DOVER,AR,2983,2961,-22,0.4981493943472409
72840,HARTMAN,AR,645,713,68,0.5250368188512519
72842,HAVANA,AR,188,272,84,0.591304347826087
72843,HECTOR,AR,685,637,-48,0.48184568835098335
72845,KNOXVILLE,AR,242,280,38,0.5363984674329502
72846,LAMAR,AR,1715,1503,-212,0.4670602858918583
72847,LONDON,AR,842,990,148,0.5403930131004366
72851,NEW BLAINE,AR,38,111,73,0.7449664429530202
72852,OARK,AR,0,12,12,1
72853,OLA,AR,959,903,-56,0.4849624060150376
72854,OZONE,AR,11,34,23,0.7555555555555555
72855,PARIS,AR,2569,2405,-164,0.4835142742259751
72857,PLAINVIEW,AR,239,205,-34,0.4617117117117117
72858,POTTSVILLE,AR,1336,1163,-173,0.4653861544617847
72860,ROVER,AR,0,12,12,1
72863,SCRANTON,AR,431,261,-170,0.37716763005780346
72865,SUBIACO,AR,67,36,-31,0.34951456310679613
72901,FORT SMITH,AR,15352,11838,-3514,0.43538065465244574
72902,FORT SMITH,AR,688,1038,350,0.6013904982618772
72902,FT SMITH,AR,11,28,17,0.717948717948718
72903,FORT SMITH,AR,18466,11866,-6600,0.39120400896742713
72903,FT SMITH,AR,329,232,-97,0.41354723707664887
72904,FORT SMITH,AR,10596,7591,-3005,0.4173860449771815
72906,FORT SMITH,AR,28,0,-28,0
72908,FORT SMITH,AR,7666,6272,-1394,0.4499928253694935
72914,FORT SMITH,AR,47,11,-36,0.1896551724137931
72916,BONANZA,AR,76,80,4,0.5128205128205128
72916,FORT SMITH,AR,3702,4251,549,0.5345152772538665
72917,FORT SMITH,AR,799,582,-217,0.4214337436640116
72918,FORT SMITH,AR,98,100,2,0.5050505050505051
72921,ALMA,AR,5619,5788,169,0.507407732094328
72923,BARLING,AR,3638,2282,-1356,0.38547297297297295
72926,BOLES,AR,24,0,-24,0
72927,BOONEVILLE,AR,3860,3888,28,0.5018069179143004
72932,CEDARVILLE,AR,277,482,205,0.6350461133069829
72933,CHARLESTON,AR,1442,1548,106,0.5177257525083612
72934,CHESTER,AR,37,30,-7,0.44776119402985076
72935,DYER,AR,16,11,-5,0.4074074074074074
72936,GREENWOOD,AR,5042,5230,188,0.5091510903426791
72937,HACKETT,AR,2243,1150,-1093,0.3389330975537872
72938,HARTFORD,AR,231,266,35,0.5352112676056338
72940,HUNTINGTON,AR,553,739,186,0.5719814241486069
72941,CENTRAL CITY,AR,24,33,9,0.5789473684210527
72941,LAVACA,AR,1707,1722,15,0.5021872265966754
72943,MAGAZINE,AR,876,1021,145,0.5382182393252504
72944,MANSFIELD,AR,1011,1091,80,0.5190294957183634
72945,MIDLAND,AR,12,0,-12,0
72946,MOUNTAINBURG,AR,1262,1156,-106,0.47808105872622003
72947,MULBERRY,AR,1433,1453,20,0.5034650034650034
72949,OZARK,AR,4084,4169,85,0.5051496425542227
72951,RATCLIFF,AR,87,76,-11,0.4662576687116564
72952,RUDY,AR,482,670,188,0.5815972222222222
72955,UNIONTOWN,AR,30,49,19,0.620253164556962
72956,VAN BUREN,AR,14960,13782,-1178,0.47950734117319604
72957,VAN BUREN,AR,136,169,33,0.5540983606557377
72958,WALDRON,AR,3063,3082,19,0.5015459723352319
72959,WINSLOW,AR,758,896,138,0.5417170495767836
73002,ALEX,OK,33,35,2,0.5147058823529411
73003,EDMOND,OK,10486,9829,-657,0.4838296825006153
73004,AMBER,OK,314,54,-260,0.14673913043478262
73005,ANADARKO,OK,2499,2420,-79,0.4919699125838585
73006,APACHE,OK,760,742,-18,0.4940079893475366
73007,ARCADIA,OK,896,1571,675,0.6368058370490475
73008,BETHANY,OK,11266,7975,-3291,0.41447949690764513
73009,BINGER,OK,232,144,-88,0.3829787234042553
73010,BLANCHARD,OK,5858,6882,1024,0.5401883830455259
73012,EDMOND,OK,13763,16438,2675,0.5442866130260587
73013,EDMOND,OK,21637,23437,1800,0.5199671651062697
73014,CALUMET,OK,300,168,-132,0.358974358974359
73015,CARNEGIE,OK,530,523,-7,0.49667616334283
73016,CASHION,OK,358,634,276,0.6391129032258065
73016,EDMOND,OK,17,14,-3,0.45161290322580644
73017,CEMENT,OK,128,214,86,0.6257309941520468
73018,CHICKASHA,OK,8403,7811,-592,0.4817441717034661
73020,CHOCTAW,OK,7274,7832,558,0.518469482324904
73022,CONCHO,OK,31,0,-31,0
73023,CHICKASHA,OK,610,538,-72,0.4686411149825784
73024,CORN,OK,59,38,-21,0.3917525773195876
73025,EDMOND,OK,3319,4677,1358,0.5849174587293647
73026,NORMAN,OK,2239,3204,965,0.5886459672974462
73027,COYLE,OK,62,139,77,0.6915422885572139
73028,CRESCENT,OK,1011,1200,189,0.5427408412483039
73029,CYRIL,OK,184,223,39,0.547911547911548
73030,DAVIS,OK,2563,1976,-587,0.4353381802159066
73034,EDMOND,OK,16611,18254,1643,0.5235623117739854
73036,EL RENO,OK,10332,7955,-2377,0.4350084759665336
73038,FORT COBB,OK,361,438,77,0.5481852315394243
73040,GEARY,OK,528,382,-146,0.4197802197802198
73042,GRACEMONT,OK,11,22,11,0.6666666666666666
73044,EDMOND,OK,208,195,-13,0.4838709677419355
73044,GUTHRIE,OK,8101,8989,888,0.5259801053247514
73045,HARRAH,OK,3901,4103,202,0.5126186906546727
73047,HINTON,OK,1973,1482,-491,0.42894356005788714
73048,HYDRO,OK,560,429,-131,0.43377148634984836
73049,JONES,OK,2031,2285,254,0.5294253938832252
73050,LANGSTON,OK,38,0,-38,0
73051,LEXINGTON,OK,2277,2457,180,0.5190114068441065
73052,LINDSAY,OK,2158,2207,49,0.5056128293241695
73053,LOOKEBA,OK,98,39,-59,0.2846715328467153
73054,LUTHER,OK,1184,1377,193,0.537680593518157
73055,MARLOW,OK,3670,3316,-354,0.47466361294016607
73057,MAYSVILLE,OK,601,624,23,0.5093877551020408
73059,MINCO,OK,626,719,93,0.5345724907063197
73061,MORRISON,OK,187,202,15,0.519280205655527
73062,MOUNTAIN VIEW,OK,320,173,-147,0.3509127789046653
73063,MULHALL,OK,0,22,22,1
73064,MUSTANG,OK,8894,10495,1601,0.5412862963536026
73065,NEWCASTLE,OK,3451,5006,1555,0.5919356745890978
73066,NICOMA PARK,OK,13,0,-13,0
73067,NINNEKAH,OK,235,279,44,0.5428015564202334
73068,NOBLE,OK,4989,5481,492,0.5234957020057307
73069,NORMAN,OK,13112,11646,-1466,0.4703934081912917
73070,NORMAN,OK,1740,2177,437,0.5557824865968853
73071,NORMAN,OK,22648,18812,-3836,0.45373854317414375
73072,NORMAN,OK,19666,18149,-1517,0.47994182202829566
73074,PAOLI,OK,102,157,55,0.6061776061776062
73075,PAULS VALLEY,OK,3918,3552,-366,0.4755020080321285
73077,PERRY,OK,2236,2333,97,0.5106150142263077
73078,PIEDMONT,OK,3204,4324,1120,0.5743889479277364
73080,PURCELL,OK,3880,3376,-504,0.4652701212789416
73082,RUSH SPRINGS,OK,1007,823,-184,0.44972677595628413
73083,EDMOND,OK,1604,1909,305,0.5434101907201822
73084,SPENCER,OK,2259,2167,-92,0.4896068685042928
73085,YUKON,OK,1199,848,-351,0.4142647777234978
73086,SULPHUR,OK,2987,3085,98,0.5080698287220027
73089,TUTTLE,OK,3553,4345,792,0.5501392757660167
73090,UNION CITY,OK,37,77,40,0.6754385964912281
73092,VERDEN,OK,35,34,-1,0.4927536231884058
73093,GOLDSBY,OK,90,168,78,0.6511627906976745
73093,WASHINGTON,OK,858,917,59,0.5166197183098592
73095,WAYNE,OK,362,493,131,0.5766081871345029
73096,WEATHERFORD,OK,8012,6164,-1848,0.4348194130925508
73097,WHEATLAND,OK,11,11,0,0.5
73098,WYNNEWOOD,OK,1603,1546,-57,0.4909495077802477
73099,YUKON,OK,31783,37289,5506,0.5398569608524438
73101,OKLAHOMA CITY,OK,1355,850,-505,0.3854875283446712
73102,OKLAHOMA CITY,OK,2742,2304,-438,0.45659928656361476
73103,OKLAHOMA CITY,OK,4191,3345,-846,0.44386942675159236
73104,OKLAHOMA CITY,OK,3631,3100,-531,0.46055563809240824
73105,OKLAHOMA CITY,OK,3889,3533,-356,0.4760172460253301
73106,OKLAHOMA CITY,OK,7198,6149,-1049,0.4607027796508579
73107,OKLAHOMA CITY,OK,11148,8385,-2763,0.42927353709107663
73108,OKLAHOMA CITY,OK,4195,3563,-632,0.45926785253931424
73109,OKLAHOMA CITY,OK,5290,4296,-994,0.44815355727102024
73110,MIDWEST CITY,OK,5054,4158,-896,0.4513677811550152
73110,OKLAHOMA CITY,OK,13657,11175,-2482,0.450024162371134
73111,OKLAHOMA CITY,OK,4778,4397,-381,0.4792370572207085
73112,OKLAHOMA CITY,OK,17901,15132,-2769,0.45808736717827625
73113,OKLAHOMA CITY,OK,850,586,-264,0.40807799442896936
73114,OKLAHOMA CITY,OK,10169,9294,-875,0.47752145095822845
73115,DEL CITY,OK,4516,3940,-576,0.46594134342478716
73115,OKLAHOMA CITY,OK,4209,3859,-350,0.47830937035200793
73116,NICHOLS HILLS,OK,1487,1635,148,0.5237027546444587
73116,OKLAHOMA CITY,OK,3774,3715,-59,0.49606088930431297
73117,OKLAHOMA CITY,OK,2826,2623,-203,0.4813727289410901
73118,OKLAHOMA CITY,OK,8065,6627,-1438,0.4510618023414103
73119,OKLAHOMA CITY,OK,8465,7057,-1408,0.45464501997165313
73120,NICHOLS HILLS,OK,433,438,5,0.5028702640642939
73120,OKLAHOMA CITY,OK,22385,19200,-3185,0.461704941685704
73121,FOREST PARK,OK,91,168,77,0.6486486486486487
73121,LAKE ALUMA,OK,18,16,-2,0.47058823529411764
73121,OKLAHOMA CITY,OK,541,655,114,0.5476588628762542
73122,OKLAHOMA CITY,OK,3505,2476,-1029,0.4139775957197793
73122,WARR ACRES,OK,2760,1985,-775,0.4183350895679663
73123,OKLAHOMA CITY,OK,232,438,206,0.6537313432835821
73123,WARR ACRES,OK,12,61,49,0.8356164383561644
73126,OKLAHOMA CITY,OK,0,30,30,1
73127,OKC,OK,220,197,-23,0.4724220623501199
73127,OKLAHOMA CITY,OK,13449,9745,-3704,0.4201517633870829
73128,OKLAHOMA CITY,OK,2779,2730,-49,0.49555273189326554
73129,OKLAHOMA CITY,OK,5585,4948,-637,0.469761701319662
73130,MIDWEST CITY,OK,2299,2173,-126,0.485912343470483
73130,OKLAHOMA CITY,OK,5655,5406,-249,0.48874423650664495
73131,OKLAHOMA CITY,OK,906,1312,406,0.5915238954012624
73132,OKLAHOMA CITY,OK,18696,12902,-5794,0.4083169820874739
73132,WARR ACRES,OK,833,562,-271,0.4028673835125448
73134,OKLAHOMA CITY,OK,7988,6819,-1169,0.4605254271628284
73135,OKLAHOMA CITY,OK,11000,9769,-1231,0.4703644855313207
73136,OKLAHOMA CITY,OK,28,157,129,0.8486486486486486
73137,OKLAHOMA CITY,OK,703,399,-304,0.3620689655172414
73139,OKLAHOMA CITY,OK,9462,7749,-1713,0.4502353146243681
73140,MIDWEST CITY,OK,1441,930,-511,0.392239561366512
73141,OKLAHOMA CITY,OK,808,877,69,0.5204747774480712
73142,OKC,OK,171,174,3,0.5043478260869565
73142,OKLAHOMA CITY,OK,9086,9236,150,0.5040934395808317
73143,OKLAHOMA CITY,OK,402,805,403,0.6669428334714167
73145,OKLAHOMA CITY,OK,1261,871,-390,0.40853658536585363
73145,TINKER AFB,OK,1556,1019,-537,0.3957281553398058
73146,OKLAHOMA CITY,OK,0,85,85,1
73147,OKLAHOMA CITY,OK,202,319,117,0.6122840690978887
73148,OKLAHOMA CITY,OK,149,0,-149,0
73149,OKLAHOMA CITY,OK,2096,1840,-256,0.46747967479674796
73150,OKLAHOMA CITY,OK,1192,1419,227,0.5434699348908464
73151,OKLAHOMA CITY,OK,56,163,107,0.7442922374429224
73153,MOORE,OK,1783,903,-880,0.3361876396128071
73154,OKLAHOMA CITY,OK,443,496,53,0.5282215122470714
73155,DEL CITY,OK,43,62,19,0.5904761904761905
73155,OKLAHOMA CITY,OK,81,104,23,0.5621621621621622
73156,OKLAHOMA CITY,OK,1354,904,-450,0.4003542958370239
73157,OKLAHOMA CITY,OK,462,718,256,0.6084745762711864
73159,OKLAHOMA CITY,OK,12974,10216,-2758,0.4405347132384649
73160,MOORE,OK,26199,21511,-4688,0.45086983860825824
73160,OKLAHOMA CITY,OK,1846,1614,-232,0.4664739884393064
73162,OKLAHOMA CITY,OK,11514,11138,-376,0.49170051209606214
73165,OKLAHOMA CITY,OK,2074,1984,-90,0.4889107934943322
73169,OKC,OK,12,11,-1,0.4782608695652174
73169,OKLAHOMA CITY,OK,1083,1148,65,0.5145674585387718
73170,MOORE,OK,483,492,9,0.5046153846153846
73170,OKLAHOMA CITY,OK,13281,13208,-73,0.4986220695382989
73172,OKLAHOMA CITY,OK,557,864,307,0.6080225193525686
73173,OKLAHOMA CITY,OK,979,1294,315,0.5692916849978003
73179,OKLAHOMA CITY,OK,2729,3719,990,0.5767679900744417
73189,OKLAHOMA CITY,OK,810,990,180,0.55
73195,OKLAHOMA CITY,OK,57,65,8,0.5327868852459017
73401,ARDMORE,OK,16470,14495,-1975,0.4681091554981431
73402,ARDMORE,OK,373,608,235,0.6197757390417941
73430,BURNEYVILLE,OK,176,249,73,0.5858823529411765
73432,COLEMAN,OK,23,35,12,0.603448275862069
73433,ELMORE CITY,OK,992,798,-194,0.44581005586592176
73434,FOSTER,OK,17,23,6,0.575
73438,HEALDTON,OK,1342,1128,-214,0.45668016194331984
73439,KINGSTON,OK,3085,3457,372,0.5284316722714766
73440,LEBANON,OK,12,11,-1,0.4782608695652174
73443,LONE GROVE,OK,1150,1259,109,0.522623495226235
73443,MEAD,OK,14,12,-2,0.46153846153846156
73446,MADILL,OK,2918,2160,-758,0.4253643166601024
73447,MANNSVILLE,OK,352,151,-201,0.30019880715705766
73448,MARIETTA,OK,2078,2139,61,0.5072326298316339
73449,MEAD,OK,1749,1521,-228,0.4651376146788991
73450,MILBURN,OK,141,222,81,0.6115702479338843
73453,OVERBROOK,OK,48,23,-25,0.323943661971831
73455,RAVIA,OK,46,29,-17,0.38666666666666666
73456,RINGLING,OK,468,363,-105,0.4368231046931408
73458,SPRINGER,OK,47,25,-22,0.3472222222222222
73459,THACKERVILLE,OK,815,762,-53,0.48319594166138236
73460,TISHOMINGO,OK,1916,1897,-19,0.4975085234723315
73461,WAPANUCKA,OK,56,62,6,0.5254237288135594
73463,WILSON,OK,1217,1094,-123,0.47338814366075294
73481,RATLIFF CITY,OK,45,104,59,0.697986577181208
73491,VELMA,OK,11,14,3,0.56
73501,LAWTON,OK,9437,8338,-1099,0.4690857946554149
73502,LAWTON,OK,400,637,237,0.6142719382835101
73503,FORT SILL,OK,4791,3884,-907,0.4477233429394813
73503,LAWTON,OK,110,103,-7,0.4835680751173709
73505,LAWTON,OK,26080,23091,-2989,0.46960606861768117
73506,LAWTON,OK,302,550,248,0.6455399061032864
73507,LAWTON,OK,10979,10212,-767,0.48190269454013496
73521,ALTUS,OK,9229,8717,-512,0.48573498272595567
73522,ALTUS,OK,296,24,-272,0.075
73526,BLAIR,OK,282,389,107,0.5797317436661699
73527,CACHE,OK,1825,1829,4,0.5005473453749316
73528,CHATTANOOGA,OK,28,24,-4,0.46153846153846156
73529,COMANCHE,OK,1776,1593,-183,0.4728406055209261
73530,DAVIDSON,OK,13,14,1,0.5185185185185185
73532,DUKE,OK,23,23,0,0.5
73533,DUNCAN,OK,13251,11362,-1889,0.46162597001584527
73534,DUNCAN,OK,670,520,-150,0.4369747899159664
73537,ELDORADO,OK,14,11,-3,0.44
73538,ELGIN,OK,2890,3131,241,0.5200132868294304
73541,FLETCHER,OK,1045,1163,118,0.5267210144927537
73541,LAWTON,OK,24,39,15,0.6190476190476191
73542,FREDERICK,OK,1393,1317,-76,0.4859778597785978
73543,GERONIMO,OK,589,501,-88,0.4596330275229358
73546,GRANDFIELD,OK,114,127,13,0.5269709543568465
73547,GRANITE,OK,260,321,61,0.5524956970740104
73548,HASTINGS,OK,13,34,21,0.723404255319149
73550,HOLLIS,OK,931,719,-212,0.43575757575757573
73552,INDIAHOMA,OK,62,134,72,0.6836734693877551
73554,MANGUM,OK,1835,1491,-344,0.44828622970535176
73557,MEDICINE PARK,OK,76,11,-65,0.12643678160919541
73560,OLUSTEE,OK,26,0,-26,0
73562,RANDLETT,OK,23,27,4,0.54
73564,ROOSEVELT,OK,0,11,11,1
73565,RYAN,OK,89,79,-10,0.47023809523809523
73566,SNYDER,OK,425,310,-115,0.4217687074829932
73567,STERLING,OK,70,63,-7,0.47368421052631576
73568,TEMPLE,OK,373,304,-69,0.44903988183161003
73569,TERRAL,OK,0,12,12,1
73570,TIPTON,OK,71,85,14,0.5448717948717948
73572,WALTERS,OK,1450,1211,-239,0.4550920706501315
73573,WAURIKA,OK,1034,961,-73,0.4817042606516291
73601,CLINTON,OK,5389,3822,-1567,0.4149386602974704
73620,ARAPAHO,OK,75,86,11,0.5341614906832298
73622,BESSIE,OK,11,0,-11,0
73624,BURNS FLAT,OK,701,391,-310,0.35805860805860806
73626,CANUTE,OK,115,115,0,0.5
73627,CARTER,OK,12,0,-12,0
73628,CHEYENNE,OK,386,344,-42,0.4712328767123288
73632,CORDELL,OK,1824,1418,-406,0.43738433066008636
73639,CUSTER CITY,OK,11,28,17,0.717948717948718
73641,DILL CITY,OK,48,64,16,0.5714285714285714
73644,ELK CITY,OK,6514,5613,-901,0.4628514884142822
73645,ERICK,OK,327,233,-94,0.4160714285714286
73647,BURNS FLAT,OK,30,31,1,0.5081967213114754
73647,FOSS,OK,351,399,48,0.532
73648,ELK CITY,OK,769,455,-314,0.37173202614379086
73650,HAMMON,OK,27,11,-16,0.2894736842105263
73651,HOBART,OK,2218,1761,-457,0.44257351093239505
73651,HORTON,OK,47,51,4,0.5204081632653061
73654,LEEDEY,OK,81,61,-20,0.4295774647887324
73655,LONE WOLF,OK,93,46,-47,0.33093525179856115
73661,ROCKY,OK,22,0,-22,0
73662,SAYRE,OK,2397,1810,-587,0.43023532208224385
73663,SEILING,OK,237,113,-124,0.32285714285714284
73664,SENTINEL,OK,117,62,-55,0.3463687150837989
73669,THOMAS,OK,498,296,-202,0.37279596977329976
73701,ENID,OK,10550,8489,-2061,0.44587425810179104
73702,ENID,OK,884,303,-581,0.2552653748946925
73703,ENID,OK,14167,12790,-1377,0.4744593241087658
73705,ENID,OK,0,16,16,1
73716,ALINE,OK,0,11,11,1
73717,ALVA,OK,3254,2269,-985,0.4108274488502625
73724,CANTON,OK,131,70,-61,0.3482587064676617
73728,CHEROKEE,OK,626,625,-1,0.49960031974420466
73729,CLEO SPRINGS,OK,12,12,0,0.5
73734,DOVER,OK,131,78,-53,0.37320574162679426
73737,FAIRVIEW,OK,1851,1430,-421,0.4358427308747333
73738,GARBER,OK,59,87,28,0.5958904109589042
73741,HELENA,OK,23,0,-23,0
73742,HENNESSEY,OK,1356,961,-395,0.41476046611998274
73750,KINGFISHER,OK,2609,2240,-369,0.4619509177149928
73753,KREMLIN,OK,0,26,26,1
73754,LAHOMA,OK,124,97,-27,0.43891402714932126
73755,LONGDALE,OK,0,11,11,1
73759,MEDFORD,OK,321,312,-9,0.4928909952606635
73762,OKARCHE,OK,360,305,-55,0.45864661654135336
73763,OKEENE,OK,296,204,-92,0.408
73766,POND CREEK,OK,76,127,51,0.625615763546798
73768,RINGWOOD,OK,173,105,-68,0.3776978417266187
73771,WAKITA,OK,0,24,24,1
73772,WATONGA,OK,1631,1252,-379,0.4342698577870274
73773,WAUKOMIS,OK,521,433,-88,0.45387840670859536
73801,WOODWARD,OK,7638,5929,-1709,0.43701628952605587
73802,WOODWARD,OK,936,419,-517,0.3092250922509225
73832,ARNETT,OK,74,22,-52,0.22916666666666666
73834,BUFFALO,OK,130,16,-114,0.1095890410958904
73838,CHESTER,OK,0,11,11,1
73840,FARGO,OK,41,38,-3,0.4810126582278481
73843,GAGE,OK,51,44,-7,0.4631578947368421
73848,LAVERNE,OK,285,209,-76,0.4230769230769231
73852,MOORELAND,OK,371,449,78,0.5475609756097561
73857,SHARON,OK,33,16,-17,0.32653061224489793
73858,SHATTUCK,OK,796,539,-257,0.4037453183520599
73859,VICI,OK,146,275,129,0.6532066508313539
73860,WAYNOKA,OK,420,396,-24,0.4852941176470588
73932,BEAVER,OK,653,537,-116,0.4512605042016807
73933,BOISE CITY,OK,92,37,-55,0.2868217054263566
73939,GOODWELL,OK,276,56,-220,0.1686746987951807
73942,GUYMON,OK,4964,3589,-1375,0.41961884718812115
73945,HOOKER,OK,676,514,-162,0.4319327731092437
73945,OPTIMA,OK,54,38,-16,0.41304347826086957
73947,KEYES,OK,0,11,11,1
73949,TEXHOMA,OK,112,25,-87,0.18248175182481752
73950,TURPIN,OK,156,154,-2,0.4967741935483871
73951,TYRONE,OK,72,60,-12,0.45454545454545453
74001,AVANT,OK,0,11,11,1
74002,BARNSDALL,OK,380,385,5,0.5032679738562091
74003,BARTLESVILLE,OK,7760,5799,-1961,0.42768640755217935
74005,BARTLESVILLE,OK,111,307,196,0.7344497607655502
74006,BARTLESVILLE,OK,10034,10486,452,0.5110136452241716
74008,BIXBY,OK,10855,13572,2717,0.5556146886641831
74010,BRISTOW,OK,3310,3417,107,0.5079530251226401
74011,BROKEN ARROW,OK,9788,11385,1597,0.5377131252066311
74012,BROKEN ARROW,OK,26840,23936,-2904,0.4714038128249567
74013,BROKEN ARROW,OK,834,1325,491,0.6137100509495137
74014,BROKEN ARROW,OK,12047,15669,3622,0.5653413190936644
74015,CATOOSA,OK,3440,3175,-265,0.4799697656840514
74016,CHELSEA,OK,2160,1985,-175,0.47889022919179736
74017,CLAREMORE,OK,10517,10564,47,0.5011147478772354
74018,CLAREMORE,OK,733,1066,333,0.5925514174541412
74019,CLAREMORE,OK,5046,6107,1061,0.5475656773962163
74019,TULSA,OK,104,140,36,0.5737704918032787
74020,CLEVELAND,OK,3616,2642,-974,0.4221796100990732
74021,COLLINSVILLE,OK,6572,7448,876,0.5312410841654779
74022,COPAN,OK,297,363,66,0.55
74023,CUSHING,OK,5168,4272,-896,0.45254237288135596
74026,DAVENPORT,OK,24,78,54,0.7647058823529411
74027,DELAWARE,OK,37,28,-9,0.4307692307692308
74028,DEPEW,OK,193,355,162,0.6478102189781022
74029,DEWEY,OK,1743,1730,-13,0.49812841923409157
74030,CUSHING,OK,21,19,-2,0.475
74030,DRUMRIGHT,OK,1277,1216,-61,0.4877657440834336
74032,GLENCOE,OK,403,596,193,0.5965965965965966
74033,GLENPOOL,OK,5459,5394,-65,0.4970054362848982
74035,HOMINY,OK,1680,1118,-562,0.3995711222301644
74036,INOLA,OK,2487,2108,-379,0.458759521218716
74037,JENKS,OK,8164,9448,1284,0.53645241880536
74038,JENNINGS,OK,314,439,125,0.5830013280212484
74039,KELLYVILLE,OK,1074,1059,-15,0.4964838255977497
74041,KIEFER,OK,845,855,10,0.5029411764705882
74044,MANNFORD,OK,2890,2446,-444,0.45839580209895053
74045,MARAMEC,OK,0,12,12,1
74046,MILFAY,OK,0,16,16,1
74047,MOUNDS,OK,1928,2205,277,0.5335107669973385
74048,NOWATA,OK,2559,2248,-311,0.4676513417932182
74050,OAKHURST,OK,258,15,-243,0.054945054945054944
74051,OCHELATA,OK,373,393,20,0.5130548302872062
74052,OILTON,OK,266,17,-249,0.06007067137809187
74053,OOLOGAH,OK,1494,1596,102,0.516504854368932
74054,OSAGE,OK,78,0,-78,0
74055,OWASSO,OK,20492,19643,-849,0.4894231967111
74056,PAWHUSKA,OK,1744,1769,25,0.5035582123541132
74058,BLACKBURN,OK,68,46,-22,0.40350877192982454
74058,PAWNEE,OK,1088,1214,126,0.527367506516073
74058,SKEDEE,OK,27,30,3,0.5263157894736842
74059,PERKINS,OK,2185,2417,232,0.525206431986093
74061,RAMONA,OK,428,474,46,0.5254988913525499
74062,RIPLEY,OK,133,111,-22,0.45491803278688525
74063,SAND SPRINGS,OK,10185,10731,546,0.5130522088353414
74066,SAPULPA,OK,11111,10298,-813,0.4810126582278481
74067,SAPULPA,OK,1168,838,-330,0.41774675972083747
74070,SKIATOOK,OK,5808,5587,-221,0.4903027643703379
74072,S COFFEYVILLE,OK,78,300,222,0.7936507936507936
74072,SOUTH COFFEYVILLE,OK,0,11,11,1
74073,SPERRY,OK,1723,1746,23,0.5033150763908908
74074,STILLWATER,OK,17692,13398,-4294,0.4309424252171116
74075,STILLWATER,OK,14018,10728,-3290,0.4335246100379859
74076,STILLWATER,OK,769,756,-13,0.49573770491803276
74077,STILLWATER,OK,0,12,12,1
74079,STROUD,OK,1766,1866,100,0.5137665198237885
74080,TALALA,OK,729,766,37,0.5123745819397993
74081,TERLTON,OK,257,395,138,0.6058282208588958
74083,WANN,OK,12,23,11,0.6571428571428571
74084,WYNONA,OK,0,13,13,1
74085,YALE,OK,693,786,93,0.5314401622718052
74101,TULSA,OK,377,814,437,0.6834592779177162
74103,TULSA,OK,2615,2878,263,0.5239395594392864
74104,TULSA,OK,5951,5077,-874,0.46037359448676096
74105,TULSA,OK,14932,12144,-2788,0.4485152902939873
74106,TULSA,OK,6632,6038,-594,0.4765588003157064
74107,TULSA,OK,8190,7146,-1044,0.465962441314554
74108,TULSA,OK,3608,2020,-1588,0.35891968727789625
74110,TULSA,OK,4565,4118,-447,0.4742600483703789
74112,TULSA,OK,9507,8084,-1423,0.4595531806037178
74114,TULSA,OK,6563,6229,-334,0.4869449656035022
74115,TULSA,OK,7331,6388,-943,0.46563160580217217
74116,TULSA,OK,1519,1404,-115,0.4803284296955183
74119,TULSA,OK,4076,3621,-455,0.47044302975185137
74120,TULSA,OK,3561,3094,-467,0.46491359879789634
74121,TULSA,OK,11,0,-11,0
74126,TULSA,OK,3461,3346,-115,0.4915528132804466
74127,TULSA,OK,6247,5793,-454,0.48114617940199333
74128,TULSA,OK,4594,3627,-967,0.44118720350322344
74129,TULSA,OK,6424,5639,-785,0.46746248860150874
74130,TULSA,OK,444,593,149,0.5718418514946962
74131,TULSA,OK,703,914,211,0.5652442795299938
74132,TULSA,OK,4269,4439,170,0.5097611391823611
74133,TULSA,OK,25325,23964,-1361,0.48619367404491876
74134,TULSA,OK,8308,7968,-340,0.48955517326124354
74135,TULSA,OK,11002,10450,-552,0.48713406675368265
74136,TULSA,OK,20756,16631,-4125,0.4448337657474523
74137,TULSA,OK,11607,11678,71,0.5015245866437621
74145,TULSA,OK,8615,7675,-940,0.47114794352363415
74146,TULSA,OK,5963,4828,-1135,0.44740987860253917
74147,TULSA,OK,426,693,267,0.6193029490616622
74148,TULSA,OK,345,267,-78,0.4362745098039216
74152,TULSA,OK,121,346,225,0.7408993576017131
74153,TULSA,OK,589,972,383,0.6226777706598334
74157,TULSA,OK,74,135,61,0.645933014354067
74158,TULSA,OK,123,452,329,0.7860869565217391
74159,TULSA,OK,287,477,190,0.6243455497382199
74169,TULSA,OK,451,523,72,0.5369609856262834
74170,TULSA,OK,726,1174,448,0.6178947368421053
74301,PENSACOLA,OK,108,82,-26,0.43157894736842106
74301,VINITA,OK,3942,3910,-32,0.4979623025980642
74330,ADAIR,OK,1051,926,-125,0.4683864441072332
74331,AFTON,OK,2884,2656,-228,0.47942238267148013
74331,BERNICE,OK,156,202,46,0.5642458100558659
74331,MONKEY ISLAND,OK,67,75,8,0.528169014084507
74332,BIG CABIN,OK,291,452,161,0.6083445491251682
74333,BLUEJACKET,OK,81,102,21,0.5573770491803278
74337,CHOUTEAU,OK,1826,1643,-183,0.4736235226289997
74338,COLCORD,OK,1317,1473,156,0.5279569892473118
74339,COMMERCE,OK,1061,750,-311,0.41413583655438985
74340,DISNEY,OK,49,69,20,0.5847457627118644
74342,EUCHA,OK,587,609,22,0.5091973244147158
74343,FAIRLAND,OK,1208,983,-225,0.44865358283888634
74344,GROVE,OK,6698,6936,238,0.5087281795511222
74345,GROVE,OK,1327,1048,-279,0.44126315789473686
74346,JAY,OK,3260,2710,-550,0.4539363484087102
74347,KANSAS,OK,959,1019,60,0.5151668351870576
74349,KETCHUM,OK,429,106,-323,0.19813084112149532
74350,LANGLEY,OK,285,170,-115,0.37362637362637363
74352,LOCUST GROVE,OK,1718,1904,186,0.5256764218663722
74354,MIAMI,OK,8063,6643,-1420,0.45172038623691013
74355,MIAMI,OK,256,246,-10,0.4900398406374502
74358,NORTH MIAMI,OK,25,0,-25,0
74359,OAKS,OK,0,13,13,1
74361,PRYOR,OK,6174,5984,-190,0.49218621483796676
74362,PRYOR,OK,230,427,197,0.649923896499239
74363,QUAPAW,OK,1097,1076,-21,0.49516797054763
74364,ROSE,OK,216,180,-36,0.45454545454545453
74365,SALINA,OK,1398,1348,-50,0.49089584850691914
74366,SPAVINAW,OK,207,206,-1,0.49878934624697335
74369,WELCH,OK,457,386,-71,0.4578884934756821
74370,WYANDOTTE,OK,1090,1158,68,0.5151245551601423
74401,MUSKOGEE,OK,7814,6299,-1515,0.4463260823354354
74402,MUSKOGEE,OK,1022,1048,26,0.506280193236715
74403,MUSKOGEE,OK,15525,10770,-4755,0.40958357102110665
74421,BEGGS,OK,1046,1363,317,0.5657949356579494
74422,BOYNTON,OK,11,16,5,0.5925925925925926
74423,BRAGGS,OK,59,104,45,0.6380368098159509
74425,CANADIAN,OK,211,321,110,0.6033834586466166
74425,COWETA,OK,0,14,14,1
74426,CHECOTAH,OK,3665,3650,-15,0.4989747095010253
74427,COOKSON,OK,251,407,156,0.6185410334346505
74428,COUNCIL HILL,OK,60,60,0,0.5
74429,COWETA,OK,6241,5792,-449,0.48134297348957034
74431,DEWAR,OK,13,0,-13,0
74432,EUFAULA,OK,4225,4442,217,0.5125187492788739
74434,FORT GIBSON,OK,2852,3084,232,0.5195417789757413
74435,GORE,OK,983,1010,27,0.5067737079779228
74436,HASKELL,OK,1578,1580,2,0.5003166561114629
74437,HENRYETTA,OK,3292,3415,123,0.5091695243775161
74441,HULBERT,OK,1521,1538,17,0.5027786858450474
74442,INDIANOLA,OK,0,12,12,1
74445,MORRIS,OK,852,984,132,0.5359477124183006
74446,OKAY,OK,0,38,38,1
74447,OKMULGEE,OK,6703,6150,-553,0.47848751264296274
74450,OKTAHA,OK,187,198,11,0.5142857142857142
74451,PARK HILL,OK,1343,1599,256,0.5435078178110129
74454,PORTER,OK,828,973,145,0.5402554136590783
74455,PORUM,OK,675,801,126,0.5426829268292683
74457,PROCTOR,OK,13,12,-1,0.48
74462,STIGLER,OK,3167,3223,56,0.5043818466353678
74464,TAHLEQUAH,OK,10991,10418,-573,0.48661777757018077
74465,TAHLEQUAH,OK,570,712,142,0.5553822152886115
74467,WAGONER,OK,5236,5346,110,0.5051975051975052
74469,WARNER,OK,744,757,13,0.5043304463690873
74470,WEBBERS FALLS,OK,203,123,-80,0.3773006134969325
74471,WELLING,OK,180,171,-9,0.48717948717948717
74472,WHITEFIELD,OK,0,38,38,1
74477,WAGONER,OK,540,450,-90,0.45454545454545453
74501,MCALESTER,OK,11332,9831,-1501,0.464537163918159
74502,MCALESTER,OK,1133,1049,-84,0.48075160403299727
74523,ANTLERS,OK,2330,2329,-1,0.49989268083279675
74525,ATOKA,OK,3306,3306,0,0.5
74531,CALVIN,OK,0,66,66,1
74533,CANEY,OK,13,12,-1,0.48
74536,CLAYTON,OK,773,456,-317,0.371033360455655
74538,COALGATE,OK,1398,1432,34,0.5060070671378092
74540,DAISY,OK,12,13,1,0.52
74546,HAILEYVILLE,OK,34,67,33,0.6633663366336634
74547,HARTSHORNE,OK,1148,1062,-86,0.4805429864253394
74552,KINTA,OK,58,65,7,0.5284552845528455
74553,KIOWA,OK,205,167,-38,0.4489247311827957
74554,KREBS,OK,526,521,-5,0.4976122254059217
74555,LANE,OK,0,11,11,1
74561,QUINTON,OK,505,375,-130,0.42613636363636365
74562,RATTAN,OK,45,52,7,0.5360824742268041
74563,RED OAK,OK,284,321,37,0.5305785123966942
74565,SAVANNA,OK,348,111,-237,0.24183006535947713
74569,STRINGTOWN,OK,63,11,-52,0.14864864864864866
74570,STUART,OK,187,65,-122,0.25793650793650796
74571,TALIHINA,OK,1343,1321,-22,0.4958708708708709
74572,TUPELO,OK,110,51,-59,0.3167701863354037
74574,TUSKAHOMA,OK,99,79,-20,0.4438202247191011
74578,WILBURTON,OK,2667,2419,-248,0.47561934722768384
74601,PONCA CITY,OK,10370,8249,-2121,0.44304205381599443
74602,PONCA CITY,OK,192,112,-80,0.3684210526315789
74604,PONCA CITY,OK,4541,3795,-746,0.4552543186180422
74630,BILLINGS,OK,0,38,38,1
74631,BLACKWELL,OK,3702,3114,-588,0.45686619718309857
74632,BRAMAN,OK,11,0,-11,0
74633,BURBANK,OK,13,12,-1,0.48
74637,FAIRFAX,OK,208,303,95,0.5929549902152642
74640,HUNTER,OK,11,0,-11,0
74641,KAW CITY,OK,18,23,5,0.5609756097560976
74643,LAMONT,OK,0,22,22,1
74647,NEWKIRK,OK,1229,1275,46,0.509185303514377
74650,RALSTON,OK,0,34,34,1
74651,RED ROCK,OK,73,22,-51,0.23157894736842105
74652,SHIDLER,OK,53,26,-27,0.3291139240506329
74653,TONKAWA,OK,1198,1184,-14,0.49706129303106633
74701,DURANT,OK,12852,11385,-1467,0.46973635350909765
74702,DURANT,OK,1654,949,-705,0.3645793315405302
74723,BENNINGTON,OK,245,330,85,0.5739130434782609
74726,BOKCHITO,OK,538,611,73,0.5317667536988686
74727,BOSWELL,OK,434,518,84,0.5441176470588235
74728,BROKEN BOW,OK,4219,3546,-673,0.4566645202833226
74729,CADDO,OK,1033,910,-123,0.4683479155944416
74730,CALERA,OK,2597,2778,181,0.5168372093023256
74731,CARTWRIGHT,OK,398,655,257,0.6220322886989553
74733,COLBERT,OK,1012,1131,119,0.5277648156789547
74734,EAGLETOWN,OK,145,107,-38,0.4246031746031746
74735,FORT TOWSON,OK,459,356,-103,0.4368098159509202
74735,FT TOWSON,OK,0,15,15,1
74736,GARVIN,OK,93,77,-16,0.45294117647058824
74740,HAWORTH,OK,267,384,117,0.5898617511520737
74741,HENDRIX,OK,75,25,-50,0.25
74743,HUGO,OK,3084,3241,157,0.5124110671936759
74745,IDABEL,OK,4825,3547,-1278,0.4236741519350215
74748,KENEFIC,OK,0,27,27,1
74756,SAWYER,OK,40,88,48,0.6875
74759,SOPER,OK,22,51,29,0.6986301369863014
74764,VALLIANT,OK,1168,973,-195,0.4544605324614666
74766,WRIGHT CITY,OK,109,61,-48,0.3588235294117647
74801,SHAWNEE,OK,9120,7858,-1262,0.4628342560961244
74802,SHAWNEE,OK,561,713,152,0.5596546310832025
74804,SHAWNEE,OK,8303,7838,-465,0.48559568799950437
74818,SEMINOLE,OK,369,202,-167,0.35376532399299476
74820,ADA,OK,12603,11756,-847,0.48261422882712757
74821,ADA,OK,575,722,147,0.5566692367000771
74824,AGRA,OK,177,201,24,0.5317460317460317
74825,ALLEN,OK,456,507,51,0.5264797507788161
74826,ASHER,OK,137,125,-12,0.4770992366412214
74831,BYARS,OK,40,23,-17,0.36507936507936506
74832,CARNEY,OK,177,148,-29,0.4553846153846154
74833,CASTLE,OK,15,0,-15,0
74833,WELTY,OK,11,0,-11,0
74834,CHANDLER,OK,2939,2550,-389,0.46456549462561486
74839,DUSTIN,OK,39,66,27,0.6285714285714286
74840,EARLSBORO,OK,340,459,119,0.574468085106383
74844,FRANCIS,OK,11,11,0,0.5
74845,HANNA,OK,0,12,12,1
74848,HOLDENVILLE,OK,2296,2359,63,0.5067669172932331
74849,KONAWA,OK,1036,1110,74,0.5172413793103449
74851,MCLOUD,OK,3168,3251,83,0.5064651814924443
74852,MACOMB,OK,161,268,107,0.6247086247086248
74854,MAUD,OK,342,249,-93,0.4213197969543147
74855,MEEKER,OK,1598,1562,-36,0.49430379746835446
74856,MILL CREEK,OK,11,14,3,0.56
74857,NEWALLA,OK,2873,2963,90,0.5077107607950652
74859,OKEMAH,OK,2347,2091,-256,0.4711581793600721
74860,PADEN,OK,110,115,5,0.5111111111111111
74864,PRAGUE,OK,1689,1849,160,0.5226116449971735
74865,ROFF,OK,145,167,22,0.5352564102564102
74867,SASAKWA,OK,29,59,30,0.6704545454545454
74868,SEMINOLE,OK,4117,4195,78,0.5046920115495669
74869,SPARKS,OK,0,40,40,1
74871,STONEWALL,OK,552,529,-23,0.48936170212765956
74872,STRATFORD,OK,1433,1272,-161,0.4702402957486137
74873,TECUMSEH,OK,3838,4135,297,0.518625360591998
74875,TRYON,OK,61,115,54,0.6534090909090909
74878,WANETTE,OK,322,416,94,0.5636856368563685
74880,WELEETKA,OK,272,194,-78,0.41630901287553645
74881,WARWICK,OK,16,24,8,0.6
74881,WELLSTON,OK,1400,1433,33,0.5058242146134839
74883,WETUMKA,OK,754,739,-15,0.49497655726724715
74884,WEWOKA,OK,2063,2012,-51,0.49374233128834355
74901,ARKOMA,OK,1091,682,-409,0.38465877044557245
74902,POCOLA,OK,1480,1518,38,0.5063375583722481
74930,BOKOSHE,OK,650,781,131,0.5457721872816212
74931,BUNCH,OK,38,11,-27,0.22448979591836735
74932,CAMERON,OK,537,719,182,0.572452229299363
74936,GANS,OK,137,172,35,0.5566343042071198
74937,HEAVENER,OK,1849,1593,-256,0.4628123184195235
74939,HODGEN,OK,39,11,-28,0.22
74940,HOWE,OK,560,725,165,0.5642023346303502
74941,KEOTA,OK,480,610,130,0.5596330275229358
74944,MCCURTAIN,OK,69,108,39,0.6101694915254238
74948,MULDROW,OK,3977,3994,17,0.5010663655752101
74951,PANAMA,OK,264,298,34,0.5302491103202847
74953,POTEAU,OK,5439,5177,-262,0.4876601356443105
74954,ROLAND,OK,2709,2247,-462,0.4533898305084746
74955,SALLISAW,OK,5247,5429,182,0.508523791682278
74955,VIAN,OK,123,137,14,0.5269230769230769
74956,SHADY POINT,OK,508,529,21,0.5101253616200578
74957,SMITHVILLE,OK,62,27,-35,0.30337078651685395
74959,SPIRO,OK,2332,2598,266,0.5269776876267749
74960,STILWELL,OK,4487,3310,-1177,0.42452225214826217
74962,VIAN,OK,1609,1414,-195,0.46774727092292423
74963,WATSON,OK,11,24,13,0.6857142857142857
74964,WATTS,OK,462,701,239,0.6027515047291487
74965,WESTVILLE,OK,1446,1536,90,0.5150905432595574
74966,WISTER,OK,1383,1245,-138,0.4737442922374429
75001,ADDISON,TX,20204,18488,-1716,0.4778248733588339
75002,ALLEN,TX,19855,21970,2115,0.5252839210998207
75006,CARROLLTON,TX,20446,19238,-1208,0.48477976010482815
75007,CARROLLTON,TX,19740,18243,-1497,0.4802938156543717
75009,CELINA,TX,6947,13635,6688,0.6624720629676416
75010,CARROLLTON,TX,17724,18423,699,0.5096688521869035
75011,CARROLLTON,TX,1483,1961,478,0.5693960511033682
75013,ALLEN,TX,19175,24415,5240,0.5601055287910071
75014,IRVING,TX,387,795,408,0.6725888324873096
75015,IRVING,TX,135,670,535,0.8322981366459627
75016,IRVING,TX,726,1265,539,0.6353591160220995
75016,KAUFMAN,TX,19,41,22,0.6833333333333333
75017,IRVING,TX,156,506,350,0.7643504531722054
75019,COPPELL,TX,18243,20061,1818,0.5237312030075187
75020,DENISON,TX,10940,11195,255,0.5057601084255704
75021,DENISON,TX,3837,3729,-108,0.492862807295797
75022,FLOWER MOUND,TX,7276,8477,1201,0.5381197232273218
75022,FLOWERMOUND,TX,135,157,22,0.5376712328767124
75023,PLANO,TX,20250,19745,-505,0.49368671083885485
75024,PLANO,TX,31245,30642,-603,0.49512821755780695
75025,PLANO,TX,20960,21675,715,0.5083851295883663
75026,PLANO,TX,492,801,309,0.6194895591647331
75027,FLOWER MOUND,TX,731,830,99,0.5317104420243434
75027,FLOWERMOUND,TX,11,0,-11,0
75028,FLOWER MOUND,TX,14873,17842,2969,0.5453767384991594
75029,LEWISVILLE,TX,542,977,435,0.6431863067807768
75030,ROWLETT,TX,1230,940,-290,0.43317972350230416
75032,HEATH,TX,1533,1862,329,0.5484536082474227
75032,ROCKWALL,TX,9383,11882,2499,0.5587585233952505
75033,FRISCO,TX,15594,20319,4725,0.5657839779467045
75034,FRISCO,TX,33817,38950,5133,0.535270108703121
75035,FRISCO,TX,25241,34213,8972,0.5754532916204124
75036,FRISCO,TX,10674,12810,2136,0.5454777721001532
75038,IRVING,TX,28640,24218,-4422,0.45817094857921226
75039,IRVING,TX,28307,25991,-2316,0.47867324763343033
75040,GARLAND,TX,18649,18026,-623,0.4915064758009543
75041,GARLAND,TX,9275,7493,-1782,0.44686307251908397
75042,GARLAND,TX,12220,9402,-2818,0.4348348903894182
75043,GARLAND,TX,24750,21783,-2967,0.46811939913609696
75044,GARLAND,TX,20272,18188,-2084,0.47290691627665105
75045,GARLAND,TX,254,586,332,0.6976190476190476
75046,GARLAND,TX,462,522,60,0.5304878048780488
75047,GARLAND,TX,50,163,113,0.7652582159624414
75047,WESTON,TX,0,12,12,1
75048,GARLAND,TX,162,192,30,0.5423728813559322
75048,SACHSE,TX,7236,9407,2171,0.5652226161148831
75049,GARLAND,TX,514,1064,550,0.6742712294043093
75050,GRAND PRAIRIE,TX,19823,16108,-3715,0.44830369318972474
75051,GRAND PRAIRIE,TX,12572,10450,-2122,0.4539136478151333
75052,GRAND PRAIRIE,TX,33228,32098,-1130,0.4913510700180633
75053,GRAND PRAIRIE,TX,1980,1502,-478,0.43136128661688683
75054,GRAND PRAIRIE,TX,5340,6978,1638,0.5664880662445202
75056,LEWISVILLE,TX,9058,10230,1172,0.5303815844048113
75056,THE COLONY,TX,25460,26376,916,0.5088355582992515
75057,LEWISVILLE,TX,9971,9261,-710,0.48154118136439267
75058,GUNTER,TX,886,1412,526,0.6144473455178416
75060,IRVING,TX,10723,9130,-1593,0.4598801188737219
75061,IRVING,TX,19779,16276,-3503,0.45142143946748026
75062,IRVING,TX,23154,19419,-3735,0.4561341695440772
75063,IRVING,TX,30623,28062,-2561,0.4781801141688677
75065,HICKORY CREEK,TX,921,1062,141,0.5355521936459909
75065,LAKE DALLAS,TX,4415,4438,23,0.5012989946910652
75067,LEWISVILLE,TX,45223,34408,-10815,0.43209302909670855
75068,LITTLE ELM,TX,23031,28352,5321,0.551777825350797
75068,OAK POINT,TX,470,621,151,0.5692025664527957
75069,MCKINNEY,TX,21058,16556,-4502,0.4401552613388632
75070,MC KINNEY,TX,4275,5173,898,0.5475232853513972
75070,MCKINNEY,TX,28288,31982,3694,0.5306454289032686
75071,MC KINNEY,TX,1122,1773,651,0.6124352331606218
75071,MCKINNEY,TX,20846,28992,8146,0.5817247883141378
75072,MCKINNEY,TX,17542,18856,1314,0.5180504423319963
75074,PLANO,TX,21894,19907,-1987,0.47623262601373173
75075,PLANO,TX,16425,16166,-259,0.49602651038630297
75076,POTTSBORO,TX,3341,3999,658,0.5448228882833788
75077,DOUBLE OAK,TX,288,315,27,0.5223880597014925
75077,HIGHLAND VILLAGE,TX,4312,4850,538,0.5293604016590264
75077,LEWISVILLE,TX,7344,8328,984,0.5313935681470138
75078,PROSPER,TX,12284,21504,9220,0.6364389724162425
75080,RICHARDSON,TX,21363,19374,-1989,0.47558730392517856
75081,RICHARDSON,TX,18847,16514,-2333,0.46701167953394984
75082,RICHARDSON,TX,15215,15731,516,0.5083371033413042
75083,RICHARDSON,TX,1106,1760,654,0.6140963014654571
75085,RICHARDSON,TX,426,706,280,0.6236749116607774
75086,PLANO,TX,884,1388,504,0.6109154929577465
75087,FATE,TX,2139,2876,737,0.5734795613160518
75087,ROCKWALL,TX,11006,15019,4013,0.5770989433237271
75088,ROWLETT,TX,9749,11224,1475,0.5351642588089448
75089,ROWLETT,TX,10196,11098,902,0.5211796750258288
75090,SHERMAN,TX,8745,8283,-462,0.48643410852713176
75091,SHERMAN,TX,842,1192,350,0.5860373647984267
75092,KNOLLWOOD,TX,1084,1244,160,0.5343642611683849
75092,SHERMAN,TX,11562,11976,414,0.5087942900841192
75093,PLANO,TX,22921,23355,434,0.5046892557697295
75094,MURPHY,TX,1722,2181,459,0.5588009223674096
75094,PARKER,TX,250,333,83,0.5711835334476844
75094,PLANO,TX,2580,3171,591,0.5513823682837767
75097,WESTON,TX,11,0,-11,0
75098,WYLIE,TX,20477,24184,3707,0.5415015337766732
75101,BARDWELL,TX,11,0,-11,0
75102,BARRY,TX,136,292,156,0.6822429906542056
75103,CANTON,TX,4946,5560,614,0.5292213972967827
75104,CEDAR HILL,TX,16488,15994,-494,0.49239578843667264
75106,CEDAR HILL,TX,1045,1934,889,0.6492111446794226
75109,CORSICANA,TX,1251,1726,475,0.5797783003023178
75110,CORSICANA,TX,9155,9053,-102,0.4971990333919156
75114,CRANDALL,TX,2013,3773,1760,0.6520912547528517
75115,DESOTO,TX,20701,19401,-1300,0.483791332103137
75116,DUNCANVILLE,TX,5883,5111,-772,0.46488993996725486
75117,EDGEWOOD,TX,1403,1664,261,0.5425497228562113
75119,ENNIS,TX,9018,9030,12,0.5003324468085106
75120,ENNIS,TX,275,847,572,0.7549019607843137
75123,DESOTO,TX,920,1476,556,0.6160267111853088
75124,EUSTACE,TX,1982,1960,-22,0.4972095383054287
75125,FERRIS,TX,1902,2066,164,0.5206653225806451
75126,FORNEY,TX,21179,34257,13078,0.617955840969767
75126,HEARTLAND,TX,2243,3985,1742,0.6398522800256904
75127,FRUITVALE,TX,534,489,-45,0.4780058651026393
75132,FATE,TX,14,41,27,0.7454545454545455
75134,LANCASTER,TX,6535,5858,-677,0.47268619381909144
75135,CADDO MILLS,TX,2285,4017,1732,0.6374166931132974
75137,DUNCANVILLE,TX,6006,5185,-821,0.46331873827182557
75138,DUNCANVILLE,TX,709,1261,552,0.6401015228426395
75140,GRAND SALINE,TX,2340,2491,151,0.5156282343200166
75141,HUTCHINS,TX,1838,1582,-256,0.4625730994152047
75142,KAUFMAN,TX,5917,6313,396,0.5161896974652493
75143,KEMP,TX,4181,4618,437,0.5248323673144676
75143,TOOL,TX,1680,1961,281,0.538588299917605
75144,KERENS,TX,1207,1346,139,0.527222875048962
75146,LANCASTER,TX,9286,8691,-595,0.48345107637536855
75147,MABANK,TX,4228,4402,174,0.5100811123986095
75148,MALAKOFF,TX,3708,2531,-1177,0.4056739862157397
75149,MESQUITE,TX,17830,15441,-2389,0.4640978630038171
75150,MESQUITE,TX,24306,21149,-3157,0.46527334726652736
75151,CORSICANA,TX,505,755,250,0.5992063492063492
75152,PALESTINE,TX,41,40,-1,0.49382716049382713
75152,PALMER,TX,1441,1548,107,0.5178989628638341
75153,POWELL,TX,15,0,-15,0
75154,GLENN HEIGHTS,TX,5470,7164,1694,0.5670413170808928
75154,OVILLA,TX,580,721,141,0.5541890853189854
75154,RED OAK,TX,8105,9956,1851,0.5512430098001219
75155,RICE,TX,889,830,-59,0.4828388598022106
75156,GUN BARREL CITY,TX,4976,5203,227,0.5111504077021318
75156,MABANK,TX,1955,2020,65,0.5081761006289308
75158,SCURRY,TX,1228,1511,283,0.551661190215407
75159,COMBINE,TX,106,150,44,0.5859375
75159,SEAGOVILLE,TX,4922,5673,751,0.5354412458706937
75160,TERRELL,TX,9921,9975,54,0.501357056694813
75161,TERRELL,TX,1807,2370,563,0.5673928656930811
75163,TRINIDAD,TX,1034,1094,60,0.5140977443609023
75164,JOSEPHINE,TX,0,11,11,1
75165,WAXAHACHIE,TX,17726,21254,3528,0.5452539763981529
75166,LAVON,TX,1894,3105,1211,0.621124224844969
75167,WAXAHACHIE,TX,3098,5115,2017,0.6227931328381834
75168,WAXAHACHIE,TX,792,1139,347,0.5898498187467633
75169,WILLS POINT,TX,5711,6260,549,0.5229304151699942
75172,WILMER,TX,2387,2169,-218,0.4760755048287972
75173,JOSEPHINE,TX,153,214,61,0.5831062670299727
75173,NEVADA,TX,1946,2449,503,0.5572241183162685
75180,BALCH SPRINGS,TX,6757,6300,-457,0.482499808531822
75180,MESQUITE,TX,122,122,0,0.5
75181,MESQUITE,TX,6962,7271,309,0.5108550551535165
75182,SUNNYVALE,TX,1377,2247,870,0.6200331125827815
75185,MESQUITE,TX,1409,1526,117,0.519931856899489
75187,MESQUITE,TX,530,463,-67,0.4662638469284995
75189,FATE,TX,304,576,272,0.6545454545454545
75189,ROYSE CITY,TX,11864,19216,7352,0.6182754182754183
75201,DALLAS,TX,27651,23379,-4272,0.45814226925338036
75202,DALLAS,TX,3936,4061,125,0.507815430786545
75203,DALLAS,TX,5974,4912,-1062,0.4512217527099026
75204,DALLAS,TX,39735,34447,-5288,0.4643579304952684
75205,DALLAS,TX,11506,11660,154,0.50332383665717
75206,DALLAS,TX,37237,31552,-5685,0.4586779863059501
75207,DALLAS,TX,5473,4655,-818,0.45961690363349134
75208,DALLAS,TX,13808,15007,1199,0.5208051362137776
75209,DALLAS,TX,7993,7726,-267,0.4915070933265475
75210,DALLAS,TX,2702,2293,-409,0.4590590590590591
75211,DALLAS,TX,15310,13380,-1930,0.466364586964099
75212,DALLAS,TX,7064,6814,-250,0.4909929384637556
75214,DALLAS,TX,18249,16851,-1398,0.4800854700854701
75215,DALLAS,TX,8290,7621,-669,0.47897680849726604
75216,DALLAS,TX,15219,13796,-1423,0.47547820093055315
75217,DALLAS,TX,16311,14409,-1902,0.46904296875
75218,DALLAS,TX,9596,10040,444,0.5113057649215726
75219,DALLAS,TX,31325,29726,-1599,0.4869043914104601
75220,DALLAS,TX,11569,9358,-2211,0.4471735079084436
75221,DALLAS,TX,11,47,36,0.8103448275862069
75222,DALLAS,TX,891,1221,330,0.578125
75223,DALLAS,TX,3432,3015,-417,0.4676593764541647
75224,DALLAS,TX,8192,6720,-1472,0.45064377682403434
75225,DALLAS,TX,9578,10887,1309,0.5319814317126802
75226,DALLAS,TX,5485,5311,-174,0.4919414597999259
75227,DALLAS,TX,14290,12541,-1749,0.46740710372330513
75228,DALLAS,TX,25176,20882,-4294,0.4533848625645925
75229,DALLAS,TX,9950,9248,-702,0.4817168455047401
75229,FARMERS BRANCH,TX,399,380,-19,0.4878048780487805
75230,DALLAS,TX,14499,13943,-556,0.4902257225230293
75231,DALLAS,TX,27947,22071,-5876,0.44126114598744454
75232,DALLAS,TX,7874,6992,-882,0.47033499260056505
75233,DALLAS,TX,3817,3305,-512,0.4640550407188992
75234,DALLAS,TX,9603,10482,879,0.5218820014936519
75234,FARMERS BRANCH,TX,7144,8552,1408,0.5448521916411825
75234,FARMERS BRNCH,TX,996,1139,143,0.5334894613583138
75235,DALLAS,TX,13583,11485,-2098,0.45815382160523377
75236,DALLAS,TX,6696,5796,-900,0.46397694524495675
75237,DALLAS,TX,10787,8504,-2283,0.44082732880617903
75238,DALLAS,TX,14345,12730,-1615,0.47017543859649125
75240,DALLAS,TX,14112,11702,-2410,0.453319903928101
75241,DALLAS,TX,10456,9593,-863,0.4784777295625717
75243,DALLAS,TX,39823,31893,-7930,0.4447124769925819
75244,DALLAS,TX,6506,7319,813,0.5294032549728752
75244,FARMERS BRANCH,TX,2037,2377,340,0.5385138196647032
75244,FARMERS BRNCH,TX,324,356,32,0.5235294117647059
75246,DALLAS,TX,1522,1428,-94,0.48406779661016947
75247,DALLAS,TX,1423,1789,366,0.5569738480697385
75248,DALLAS,TX,19096,17765,-1331,0.4819456878543718
75249,DALLAS,TX,3847,3450,-397,0.47279703987940247
75251,DALLAS,TX,5747,5505,-242,0.4892463562033416
75252,DALLAS,TX,16616,14743,-1873,0.4701361650562837
75253,DALLAS,TX,5853,5070,-783,0.4641581982971711
75254,DALLAS,TX,19057,16455,-2602,0.4633644965082226
75261,DALLAS,TX,87,206,119,0.7030716723549488
75261,DFW,TX,0,15,15,1
75265,DALLAS,TX,0,87,87,1
75266,DALLAS,TX,177,524,347,0.7475035663338089
75267,DALLAS,TX,0,13,13,1
75287,DALLAS,TX,45131,35039,-10092,0.43705875015591866
75313,DALLAS,TX,277,635,358,0.6962719298245614
75315,DALLAS,TX,197,671,474,0.7730414746543779
75336,DALLAS,TX,33,186,153,0.8493150684931506
75339,DALLAS,TX,140,739,599,0.8407281001137656
75354,DALLAS,TX,275,662,387,0.7065101387406617
75355,DALLAS,TX,48,214,166,0.816793893129771
75356,DALLAS,TX,83,217,134,0.7233333333333334
75357,DALLAS,TX,175,857,682,0.8304263565891473
75360,DALLAS,TX,250,640,390,0.7191011235955056
75367,DALLAS,TX,113,343,230,0.7521929824561403
75370,DALLAS,TX,828,1407,579,0.6295302013422819
75374,DALLAS,TX,528,1149,621,0.6851520572450805
75376,DALLAS,TX,771,1434,663,0.6503401360544218
75379,DALLAS,TX,501,917,416,0.6466854724964739
75380,DALLAS,TX,692,1450,758,0.676937441643324
75381,DALLAS,TX,214,784,570,0.7855711422845691
75382,DALLAS,TX,321,773,452,0.706581352833638
75401,GREENVILLE,TX,7740,8021,281,0.5089144089842015
75402,GREENVILLE,TX,7433,8177,744,0.5238308776425369
75403,GREENVILLE,TX,94,264,170,0.7374301675977654
75404,GREENVILLE,TX,211,208,-3,0.4964200477326969
75407,PRINCETON,TX,9565,16461,6896,0.6324829017136709
75409,ANNA,TX,7909,11962,4053,0.601982788988979
75410,ALBA,TX,1759,2093,334,0.5433541017653167
75411,ARTHUR CITY,TX,339,264,-75,0.43781094527363185
75414,BELLS,TX,1134,1211,77,0.5164179104477612
75416,BLOSSOM,TX,1018,994,-24,0.49403578528827036
75417,BOGATA,TX,891,867,-24,0.4931740614334471
75418,BONHAM,TX,5717,5330,-387,0.4824839322893093
75420,BRASHEAR,TX,90,196,106,0.6853146853146853
75421,BROOKSTON,TX,48,66,18,0.5789473684210527
75422,CAMPBELL,TX,648,980,332,0.601965601965602
75423,CELESTE,TX,846,1172,326,0.5807730426164519
75424,BLUE RIDGE,TX,1259,1542,283,0.5505176722599072
75426,CLARKSVILLE,TX,1663,1798,135,0.5195030338052586
75428,COMMERCE,TX,6124,4255,-1869,0.4099624241256383
75429,COMMERCE,TX,228,242,14,0.5148936170212766
75431,COMO,TX,438,474,36,0.5197368421052632
75432,COOPER,TX,1259,1341,82,0.5157692307692308
75433,CUMB,TX,16,36,20,0.6923076923076923
75433,CUMBY,TX,794,865,71,0.5213984327908379
75435,DEPORT,TX,193,155,-38,0.4454022988505747
75436,DETROIT,TX,688,492,-196,0.41694915254237286
75437,DIKE,TX,35,68,33,0.6601941747572816
75438,DODD CITY,TX,23,116,93,0.8345323741007195
75439,ECTOR,TX,192,240,48,0.5555555555555556
75440,EMORY,TX,2451,2990,539,0.5495313361514428
75442,FARMERSVILLE,TX,3744,4355,611,0.5377207062600321
75446,HONEY GROVE,TX,967,1163,196,0.5460093896713615
75447,IVANHOE,TX,99,98,-1,0.49746192893401014
75448,KLONDIKE,TX,0,14,14,1
75449,LADONIA,TX,182,207,25,0.532133676092545
75451,LEESBURG,TX,275,372,97,0.5749613601236476
75452,LEONARD,TX,1575,1915,340,0.5487106017191977
75453,LONE OAK,TX,1474,1534,60,0.5099734042553191
75454,MELISSA,TX,4926,8932,4006,0.6445374512916727
75455,MOUNT PLEASANT,TX,4753,4735,-18,0.49905143338954466
75455,MT PLEASANT,TX,1667,1698,31,0.5046062407132244
75456,MOUNT PLEASANT,TX,400,547,147,0.5776135163674763
75456,MT PLEASANT,TX,70,65,-5,0.48148148148148145
75457,MOUNT VERNON,TX,2094,2183,89,0.5104044891278934
75457,MT VERNON,TX,297,322,25,0.5201938610662359
75458,MERIT,TX,13,0,-13,0
75459,DORCHESTER,TX,51,30,-21,0.37037037037037035
75459,HOWE,TX,1831,1985,154,0.5201781970649895
75460,PARIS,TX,11919,10169,-1750,0.46038572980804054
75461,PARIS,TX,626,1039,413,0.624024024024024
75462,PARIS,TX,2795,3149,354,0.529777927321669
75462,RENO,TX,945,950,5,0.5013192612137203
75468,PATTONVILLE,TX,40,11,-29,0.21568627450980393
75469,PECAN GAP,TX,59,56,-3,0.48695652173913045
75471,PICKTON,TX,66,175,109,0.7261410788381742
75472,EAST TAWAKONI,TX,117,155,38,0.5698529411764706
75472,POINT,TX,1335,1645,310,0.552013422818792
75473,POWDERLY,TX,1204,1362,158,0.5307872174590803
75474,QUINLAN,TX,5560,6103,543,0.5232787447483495
75474,WEST TAWAKONI,TX,130,140,10,0.5185185185185185
75475,RANDOLPH,TX,11,0,-11,0
75476,RAVENNA,TX,62,146,84,0.7019230769230769
75477,ROXTON,TX,84,34,-50,0.288135593220339
75478,SALTILLO,TX,0,71,71,1
75479,SAVOY,TX,594,847,253,0.5877862595419847
75480,SCROGGINS,TX,391,501,110,0.5616591928251121
75482,SULPHUR SPGS,TX,400,378,-22,0.48586118251928023
75482,SULPHUR SPRINGS,TX,9526,9371,-155,0.4958988199185056
75483,SULPHUR SPGS,TX,0,15,15,1
75483,SULPHUR SPRINGS,TX,355,549,194,0.6073008849557522
75486,SUMNER,TX,329,501,172,0.6036144578313253
75487,TALCO,TX,264,262,-2,0.49809885931558934
75488,TELEPHONE,TX,88,133,45,0.6018099547511312
75489,TOM BEAN,TX,53,11,-42,0.171875
75490,TRENTON,TX,878,1084,206,0.5524974515800204
75491,WHITEWRIGHT,TX,1617,2035,418,0.5572289156626506
75492,WINDOM,TX,11,0,-11,0
75493,MILLERS COVE,TX,11,0,-11,0
75494,WINNSBORO,TX,4356,4479,123,0.5069609507640068
75495,VAN ALSTYNE,TX,2889,4811,1922,0.6248051948051948
75496,WOLFE CITY,TX,878,1140,262,0.5649157581764123
75497,PAYNE SPRINGS,TX,40,41,1,0.5061728395061729
75497,YANTIS,TX,1401,1832,431,0.5666563563253944
75501,SOUTH TEXARKANA,TX,288,299,11,0.5093696763202725
75501,TEXARKANA,TX,13821,12156,-1665,0.4679524194479732
75501,WAKE VILLAGE,TX,992,742,-250,0.4279123414071511
75503,TEXARKANA,TX,13506,11026,-2480,0.4494537746616664
75504,TEXARKANA,TX,333,297,-36,0.4714285714285714
75505,TEXARKANA,TX,794,1208,414,0.6033966033966034
75550,ANNONA,TX,31,34,3,0.5230769230769231
75551,ATLANTA,TX,3834,3781,-53,0.49652002626395275
75554,AVERY,TX,257,336,79,0.5666104553119731
75555,BIVINS,TX,157,351,194,0.6909448818897638
75556,BLOOMBURG,TX,117,226,109,0.6588921282798834
75558,COOKVILLE,TX,164,239,75,0.5930521091811415
75559,DE KALB,TX,1800,1906,106,0.5143011332973556
75560,DOUGLASSVILLE,TX,28,72,44,0.72
75561,HOOKS,TX,1920,1793,-127,0.48289792620522487
75563,LINDEN,TX,1986,1485,-501,0.4278305963699222
75566,MARIETTA,TX,12,0,-12,0
75567,MAUD,TX,1124,1178,54,0.5117289313640313
75568,NAPLES,TX,899,981,82,0.5218085106382979
75569,NASH,TX,3096,1949,-1147,0.3863230921704658
75570,NEW BOSTON,TX,4159,3365,-794,0.4472355130249867
75571,OMAHA,TX,729,865,136,0.5426599749058971
75572,QUEEN CITY,TX,1568,1300,-268,0.45327754532775455
75574,SIMMS,TX,234,379,145,0.6182707993474714
75601,LONGVIEW,TX,6271,5914,-357,0.4853508411981945
75602,LONGVIEW,TX,6633,6308,-325,0.487443010586508
75603,LONGVIEW,TX,1358,1705,347,0.5566438132549788
75604,LONGVIEW,TX,12020,11358,-662,0.4858413893404055
75605,LONGVIEW,TX,14258,13884,-374,0.49335512756733707
75606,LONGVIEW,TX,588,677,89,0.5351778656126482
75607,LONGVIEW,TX,412,889,477,0.6833205226748655
75608,LONGVIEW,TX,819,1018,199,0.5541643984757757
75630,AVINGER,TX,1043,1033,-10,0.4975915221579961
75631,BECKVILLE,TX,538,688,150,0.5611745513866232
75633,CARTHAGE,TX,4631,4505,-126,0.49310420315236425
75638,DAINGERFIELD,TX,1676,1761,85,0.5123654349723596
75639,DE BERRY,TX,482,662,180,0.5786713286713286
75640,DIANA,TX,1510,1881,371,0.5547036272485992
75643,GARY,TX,530,510,-20,0.49038461538461536
75644,GILMER,TX,5726,4856,-870,0.4588924588924589
75645,GILMER,TX,2932,3419,487,0.53834041883168
75647,GLADEWATER,TX,5626,5798,172,0.5075280112044818
75650,HALLSVILLE,TX,3763,4107,344,0.5218551461245236
75651,HARLETON,TX,1365,780,-585,0.36363636363636365
75652,HENDERSON,TX,3834,3411,-423,0.47080745341614905
75653,HENDERSON,TX,327,661,334,0.6690283400809717
75654,HENDERSON,TX,3815,3295,-520,0.46343178621659636
75656,HUGHES SPGS,TX,166,136,-30,0.4503311258278146
75656,HUGHES SPRINGS,TX,1340,1434,94,0.5169430425378515
75657,JEFFERSON,TX,2739,2900,161,0.5142755807767334
75660,JUDSON,TX,0,25,25,1
75661,KARNACK,TX,767,781,14,0.5045219638242894
75662,KILGORE,TX,8621,8074,-547,0.4836178496555855
75663,KILGORE,TX,844,629,-215,0.4270196877121521
75666,LAIRD HILL,TX,38,0,-38,0
75667,LANEVILLE,TX,23,212,189,0.902127659574468
75668,LONE STAR,TX,528,593,65,0.5289919714540589
75669,LONG BRANCH,TX,11,51,40,0.8225806451612904
75670,MARSHALL,TX,4890,4241,-649,0.4644617237980506
75671,MARSHALL,TX,294,473,179,0.6166883963494133
75672,MARSHALL,TX,4778,4518,-260,0.4860154905335628
75681,MOUNT ENTERPRISE,TX,745,821,76,0.5242656449553001
75681,MT ENTERPRISE,TX,47,58,11,0.5523809523809524
75683,ORE CITY,TX,1733,1548,-185,0.47180737580006094
75684,OVERTON,TX,1950,1951,1,0.5001281722635221
75686,PITTSBURG,TX,4684,4442,-242,0.4867411790488714
75688,SCOTTSVILLE,TX,0,12,12,1
75691,TATUM,TX,1270,1302,32,0.5062208398133748
75692,WASKOM,TX,1366,1508,142,0.5247042449547669
75693,WHITE OAK,TX,2511,2600,89,0.5087067110154568
75694,WOODLAWN,TX,12,0,-12,0
75701,TYLER,TX,13773,12433,-1340,0.47443333587728004
75702,TYLER,TX,7272,6516,-756,0.4725848563968668
75703,TYLER,TX,23505,21814,-1691,0.481343365917165
75704,TYLER,TX,3049,3099,50,0.5040663630448926
75705,TYLER,TX,292,488,196,0.6256410256410256
75706,TYLER,TX,2348,2553,205,0.520914099163436
75707,TYLER,TX,5598,5751,153,0.5067406819984139
75708,TYLER,TX,2459,2075,-384,0.4576532862814292
75709,TYLER,TX,2643,2670,27,0.502540937323546
75710,TYLER,TX,0,11,11,1
75711,TYLER,TX,1189,1966,777,0.6231378763866878
75712,TYLER,TX,253,731,478,0.7428861788617886
75713,TYLER,TX,489,625,136,0.5610412926391383
75750,ARP,TX,926,1148,222,0.553519768563163
75751,ATHENS,TX,6553,6632,79,0.5029958285930982
75752,ATHENS,TX,1861,2340,479,0.5570102356581766
75754,BEN WHEELER,TX,1708,1963,255,0.5347316807409426
75754,EDOM,TX,38,46,8,0.5476190476190477
75755,BIG SANDY,TX,2098,2094,-4,0.49952290076335876
75756,BROWNSBORO,TX,1444,1550,106,0.5177020708082832
75757,BULLARD,TX,4516,5983,1467,0.5698637965520525
75758,CHANDLER,TX,3957,4472,515,0.5305492941036897
75760,CUSHING,TX,525,705,180,0.573170731707317
75762,FLINT,TX,5040,5625,585,0.5274261603375527
75763,FRANKSTON,TX,1867,2234,367,0.5447451841014387
75765,HAWKINS,TX,1253,1554,301,0.5536159600997507
75765,HOLLY LAKE RANCH,TX,1193,1389,196,0.5379550735863672
75765,HOLLY LK RNCH,TX,188,240,52,0.5607476635514018
75765,RUSK,TX,50,54,4,0.5192307692307693
75766,JACKSONVILLE,TX,7967,7178,-789,0.4739517992736877
75770,LARUE,TX,602,880,278,0.5937921727395412
75771,HIDEAWAY,TX,1607,1971,364,0.5508664058133035
75771,LINDALE,TX,6693,7617,924,0.5322851153039833
75773,MINEOLA,TX,5007,5484,477,0.5227337718044037
75778,MURCHISON,TX,1180,1452,272,0.5516717325227963
75783,QUITMAN,TX,3061,3633,572,0.5427248282043621
75784,REKLAW,TX,11,11,0,0.5
75785,RUSK,TX,3212,3182,-30,0.49765405067250545
75789,TROUP,TX,2640,2582,-58,0.49444657219456145
75790,TYLER,TX,33,36,3,0.5217391304347826
75790,VAN,TX,1607,1869,262,0.5376869965477561
75791,WHITEHOUSE,TX,5011,5814,803,0.5370900692840647
75792,WINONA,TX,1344,1435,91,0.5163727959697733
75801,PALESTINE,TX,6725,6325,-400,0.4846743295019157
75802,PALESTINE,TX,746,858,112,0.5349127182044888
75803,PALESTINE,TX,4646,4776,130,0.506898747611972
75831,BUFFALO,TX,1399,1614,215,0.5356787255227348
75833,CENTERVILLE,TX,1584,1188,-396,0.42857142857142855
75835,CROCKETT,TX,3538,3776,238,0.5162701668033908
75838,DONIE,TX,11,24,13,0.6857142857142857
75839,ELKHART,TX,1682,1872,190,0.5267304445694991
75840,FAIRFIELD,TX,2232,2514,282,0.5297092288242731
75844,GRAPELAND,TX,1896,1784,-112,0.48478260869565215
75845,GROVETON,TX,868,909,41,0.5115362971299944
75846,GRAPELAND,TX,18,14,-4,0.4375
75846,JEWETT,TX,713,800,87,0.5287508261731659
75847,KENNARD,TX,126,179,53,0.5868852459016394
75850,LEONA,TX,0,12,12,1
75851,LOVELADY,TX,672,706,34,0.5123367198838897
75852,MIDWAY,TX,389,422,33,0.5203452527743526
75853,MONTALBA,TX,93,130,37,0.5829596412556054
75855,OAKWOOD,TX,395,702,307,0.6399270738377393
75859,STREETMAN,TX,521,887,366,0.6299715909090909
75860,TEAGUE,TX,1924,2036,112,0.5141414141414141
75861,TENN COLONY,TX,20,11,-9,0.3548387096774194
75861,TENNESSEE COLONY,TX,566,476,-90,0.45681381957773515
75862,TRINITY,TX,2994,3622,628,0.5474607013301088
75865,WOODLAKE,TX,12,11,-1,0.4782608695652174
75901,LUFKIN,TX,9704,8575,-1129,0.46911756660648835
75902,LUFKIN,TX,38,31,-7,0.4492753623188406
75904,LUFKIN,TX,11856,11451,-405,0.49131162311751836
75915,LUFKIN,TX,713,1178,465,0.6229508196721312
75925,ALTO,TX,984,1063,79,0.5192965315095261
75926,APPLE SPRINGS,TX,27,101,74,0.7890625
75928,BON WIER,TX,239,147,-92,0.38082901554404147
75928,BONWIER,TX,15,0,-15,0
75929,BROADDUS,TX,424,416,-8,0.49523809523809526
75930,BRONSON,TX,256,387,131,0.6018662519440124
75931,BROOKELAND,TX,879,1012,133,0.5351665785298784
75932,BURKEVILLE,TX,364,284,-80,0.4382716049382716
75933,CALL,TX,387,257,-130,0.39906832298136646
75935,CENTER,TX,3371,3217,-154,0.48831208257437764
75936,CHESTER,TX,28,14,-14,0.3333333333333333
75937,CHIRENO,TX,81,107,26,0.5691489361702128
75938,COLMESNEIL,TX,999,1012,13,0.5032322227747389
75939,CORRIGAN,TX,1014,1093,79,0.5187470336971998
75941,DIBOLL,TX,2506,2243,-263,0.47230995999157716
75943,DOUGLASS,TX,133,126,-7,0.4864864864864865
75944,ETOILE,TX,173,201,28,0.5374331550802139
75946,GARLAND,TX,48,57,9,0.5428571428571428
75946,GARRISON,TX,888,1040,152,0.5394190871369294
75948,HEMPHILL,TX,2575,2312,-263,0.4730918764067935
75949,HUNTINGTON,TX,2629,2867,238,0.5216521106259098
75951,JASPER,TX,4980,5020,40,0.502
75954,JOAQUIN,TX,920,849,-71,0.47993216506500846
75956,KIRBYVILLE,TX,2570,2319,-251,0.4743301288607077
75959,MILAM,TX,71,135,64,0.6553398058252428
75960,MOSCOW,TX,0,22,22,1
75961,NACOGDOCHES,TX,6065,4683,-1382,0.4357089691105322
75963,FRANKSTON,TX,19,24,5,0.5581395348837209
75963,NACOGDOCHES,TX,766,926,160,0.5472813238770685
75964,NACOGDOCHES,TX,4794,4466,-328,0.4822894168466523
75965,NACOGDOCHES,TX,7592,6058,-1534,0.4438095238095238
75966,NEWTON,TX,1584,1356,-228,0.46122448979591835
75968,PINELAND,TX,393,333,-60,0.45867768595041325
75969,POLLOK,TX,894,883,-11,0.49690489589195275
75972,SAN ANTONIO,TX,43,20,-23,0.31746031746031744
75972,SAN AUGUSTINE,TX,1756,1714,-42,0.49394812680115274
75973,SHELBYVILLE,TX,489,575,86,0.5404135338345865
75974,TENAHA,TX,669,576,-93,0.46265060240963857
75975,TIMPSON,TX,1092,1071,-21,0.49514563106796117
75976,WELLS,TX,0,15,15,1
75977,WIERGATE,TX,12,0,-12,0
75979,WOODVILLE,TX,3298,3350,52,0.5039109506618532
75980,ZAVALLA,TX,661,818,157,0.5530764029749831
76001,ARLINGTON,TX,10011,10193,182,0.504504058602257
76001,ARLINGTON HEIGHTS,TX,241,250,9,0.5091649694501018
76002,ARLINGTON,TX,9478,10261,783,0.5198338315010892
76003,ARLINGTON,TX,661,1007,346,0.6037170263788969
76004,ARLINGTON,TX,616,1201,585,0.6609796367638965
76005,ARLINGTON,TX,1980,4322,2342,0.6858140272929228
76006,ARLINGTON,TX,40956,19197,-21759,0.31913620268315795
76007,ARLINGTON,TX,22,306,284,0.9329268292682927
76008,ALEDO,TX,6020,9567,3547,0.6137807146981459
76008,WILLOW PARK,TX,81,165,84,0.6707317073170732
76009,ALVARADO,TX,6234,7529,1295,0.5470464288309235
76010,ARLINGTON,TX,22468,17092,-5376,0.4320525783619818
76011,ARLINGTON,TX,17520,14891,-2629,0.45944278177162073
76012,ARLINGTON,TX,11523,10211,-1312,0.4698168767829208
76013,ARLINGTON,TX,15293,12590,-2703,0.4515296058530287
76013,PANTEGO,TX,989,840,-149,0.4592673592126845
76014,ARLINGTON,TX,15234,11608,-3626,0.43245659786901125
76015,ARLINGTON,TX,9770,8644,-1126,0.46942543716737267
76016,ARLINGTON,TX,9599,9900,301,0.5077183445304887
76017,ARLINGTON,TX,17232,16315,-917,0.48633260798283007
76018,ARLINGTON,TX,8798,8173,-625,0.48158623534264333
76020,AZLE,TX,12869,15246,2377,0.54227280810955
76021,BEDFORD,TX,19916,18208,-1708,0.4775994124436051
76022,BEDFORD,TX,8970,8023,-947,0.4721355852409816
76023,BOYD,TX,2591,3276,685,0.5583773649224476
76028,BURLESON,TX,26120,28766,2646,0.5241045075246875
76031,CLEBURNE,TX,5233,5897,664,0.5298292902066487
76033,CLEBURNE,TX,11216,11422,206,0.5045498718968107
76034,COLLEYVILLE,TX,6563,8449,1886,0.562816413535838
76035,CRESSON,TX,1731,1742,11,0.501583645263461
76036,CROWLEY,TX,11552,15316,3764,0.5700461515557541
76039,EULESS,TX,26719,24826,-1893,0.4816374042099137
76040,EULESS,TX,17287,15408,-1879,0.4712647193760514
76041,FORRESTON,TX,0,13,13,1
76043,GLEN ROSE,TX,2154,2680,526,0.5544062887877534
76043,WEST GLEN ROSE,TX,41,50,9,0.5494505494505495
76044,GODLEY,TX,1779,3853,2074,0.6841264204545454
76048,GRANBURY,TX,12357,14287,1930,0.5362182855427113
76049,GRANBURY,TX,11585,14290,2705,0.5522705314009662
76050,GRANDVIEW,TX,1991,2473,482,0.5539874551971327
76051,GRAPEVINE,TX,27940,27132,-808,0.49266414875072634
76052,HASLET,TX,9740,15649,5909,0.6163692937886486
76053,HURST,TX,14611,14055,-556,0.49030210004883834
76054,HURST,TX,3817,4253,436,0.5270136307311029
76055,ITASCA,TX,933,1030,97,0.5247070809984717
76058,JOSHUA,TX,6572,7472,900,0.5320421532326972
76059,KEENE,TX,2382,2423,41,0.5042663891779396
76060,KENNEDALE,TX,2812,3133,321,0.5269974768713205
76061,LILLIAN,TX,13,24,11,0.6486486486486487
76063,MANSFIELD,TX,30934,32692,1758,0.5138151070317166
76064,MAYPEARL,TX,362,444,82,0.5508684863523573
76065,MIDLOTHIAN,TX,13060,17546,4486,0.5732862837352153
76066,MILLSAP,TX,1251,1835,584,0.5946208684381076
76067,MINERAL WELLS,TX,9067,8385,-682,0.4804606921842769
76068,MINERAL WELLS,TX,393,953,560,0.7080237741456167
76070,NEMO,TX,0,36,36,1
76071,NEWARK,TX,1655,2180,525,0.5684485006518905
76073,PARADISE,TX,1840,2618,778,0.5872588604755495
76077,LEWISVILLE,TX,0,12,12,1
76077,RAINBOW,TX,13,14,1,0.5185185185185185
76078,AURORA,TX,749,872,123,0.5379395434916718
76078,RHOME,TX,2707,2729,22,0.5020235467255335
76082,SPRINGTOWN,TX,7759,10496,2737,0.574965762804711
76084,MANSFIEL,TX,47,87,40,0.6492537313432836
76084,VENUS,TX,3086,5153,2067,0.6254399805801675
76085,WEATHERFORD,TX,3467,4896,1429,0.585435848379768
76086,WEATHERFORD,TX,12447,12549,102,0.5020403264522324
76087,BROCK,TX,958,1264,306,0.5688568856885688
76087,HUDSON OAKS,TX,164,196,32,0.5444444444444444
76087,WEATHERFORD,TX,7479,9770,2291,0.5664096469360542
76087,WILLOW PARK,TX,2337,3173,836,0.5758620689655173
76088,WEATHERFORD,TX,4384,5947,1563,0.5756461136385636
76092,GRAPEVINE,TX,332,435,103,0.5671447196870926
76092,SOUTH LAKE,TX,1050,1394,344,0.5703764320785597
76092,SOUTHLAKE,TX,7161,9206,2045,0.5624732693835156
76093,RIO VISTA,TX,1074,1155,81,0.5181695827725438
76094,ARLINGTON,TX,45,35,-10,0.4375
76095,BEDFORD,TX,969,1298,329,0.572562858403176
76096,ARLINGTON,TX,934,1596,662,0.6308300395256917
76097,BURLESON,TX,898,1309,411,0.5931128228364295
76098,AZLE,TX,1673,1168,-505,0.4111228440689898
76099,GRAPEVINE,TX,923,1178,255,0.5606853879105188
76101,ARLINGTON,TX,0,12,12,1
76101,FORT WORTH,TX,662,815,153,0.5517941773865944
76101,FT WORTH,TX,27,35,8,0.5645161290322581
76102,FORT WORTH,TX,10136,9714,-422,0.48937027707808567
76102,FT WORTH,TX,361,445,84,0.5521091811414393
76103,FORT WORTH,TX,4288,3707,-581,0.4636647904940588
76103,FT WORTH,TX,295,230,-65,0.4380952380952381
76104,FORT WORTH,TX,9233,9178,-55,0.4985063277388518
76104,FT WORTH,TX,842,968,126,0.5348066298342542
76105,FORT WORTH,TX,6385,6061,-324,0.48698376988590714
76105,FT WORTH,TX,289,249,-40,0.4628252788104089
76106,FORT WORTH,TX,7653,6694,-959,0.46657837875514047
76106,FT WORTH,TX,1062,805,-257,0.43117300482056775
76107,FORT WORTH,TX,18831,17484,-1347,0.4814539446509707
76107,FT WORTH,TX,2521,2304,-217,0.47751295336787564
76108,FORT WORTH,TX,15876,16754,878,0.5134538768004904
76108,FT WORTH,TX,2331,2384,53,0.5056203605514316
76108,WHITE SETTLEMENT,TX,1723,1751,28,0.5040299366724237
76109,BENBROOK,TX,3250,2825,-425,0.46502057613168724
76109,FORT WORTH,TX,10622,9733,-889,0.47816261360845
76109,FT WORTH,TX,344,348,4,0.5028901734104047
76110,FORT WORTH,TX,9206,7914,-1292,0.46226635514018694
76110,FT WORTH,TX,176,164,-12,0.4823529411764706
76111,FORT WORTH,TX,5858,5765,-93,0.4959993117095414
76111,FT WORTH,TX,213,214,1,0.5011709601873536
76112,FORT WORTH,TX,20616,17470,-3146,0.45869873444310244
76112,FT WORTH,TX,999,774,-225,0.4365482233502538
76114,FORT WORTH,TX,5712,5928,216,0.5092783505154639
76114,RIVER OAKS,TX,3733,3599,-134,0.4908619749045281
76114,WESTWORTH VILLAGE,TX,704,651,-53,0.48044280442804427
76115,FORT WORTH,TX,4564,4262,-302,0.48289145705869024
76115,FT WORTH,TX,327,266,-61,0.448566610455312
76116,BENBROOK,TX,1605,1330,-275,0.45315161839863716
76116,FORT WORTH,TX,27564,23682,-3882,0.4621238730827772
76116,FT WORTH,TX,1960,1711,-249,0.46608553527649144
76117,FORT WORTH,TX,235,201,-34,0.4610091743119266
76117,HALTOM CITY,TX,10870,9490,-1380,0.46611001964636545
76117,NORTH RICHLAND HILLS,TX,891,820,-71,0.4792518994739918
76118,FORT WORTH,TX,3402,3418,16,0.5011730205278593
76118,FT WORTH,TX,109,122,13,0.5281385281385281
76118,RICHLAND HILLS,TX,2406,2435,29,0.5029952489155133
76119,FOREST HILL,TX,2608,2356,-252,0.47461724415793716
76119,FORT WORTH,TX,11417,10861,-556,0.4875213214830775
76119,FT WORTH,TX,1258,1121,-137,0.4712063892391761
76120,FORT WORTH,TX,11397,10561,-836,0.4809636578923399
76121,FORT WORTH,TX,315,719,404,0.695357833655706
76121,FT WORTH,TX,91,124,33,0.5767441860465117
76123,FORT WORTH,TX,12052,15685,3633,0.5654901395248224
76123,FT WORTH,TX,530,723,193,0.5770151636073424
76124,FORT WORTH,TX,875,977,102,0.5275377969762419
76126,BENBROOK,TX,6799,9440,2641,0.5813165835334688
76126,FORT WORTH,TX,1514,2100,586,0.5810736026563365
76127,FORT WORTH,TX,11,36,25,0.7659574468085106
76127,NAVAL AIR STATION JRB,TX,36,23,-13,0.3898305084745763
76131,BLUE MOUND,TX,1088,1357,269,0.5550102249488753
76131,FORT WORTH,TX,14504,18596,4092,0.5618126888217523
76131,FT WORTH,TX,763,907,144,0.5431137724550898
76131,SAGINAW,TX,1298,1618,320,0.5548696844993142
76132,FORT WORTH,TX,19476,16610,-2866,0.46028930887324726
76133,FORT WORTH,TX,18333,16500,-1833,0.47368874343295153
76133,FT WORTH,TX,1050,957,-93,0.476831091180867
76134,EDGECLIFF VILLAGE,TX,640,528,-112,0.4520547945205479
76134,FORT WORTH,TX,6701,5825,-876,0.46503273191761135
76134,FT WORTH,TX,1129,1013,-116,0.472922502334267
76135,FORT WORTH,TX,6675,6349,-326,0.48748464373464373
76135,FT WORTH,TX,1072,1037,-35,0.4917022285443338
76135,LAKE WORTH,TX,811,772,-39,0.48768161718256475
76135,LAKESIDE,TX,515,504,-11,0.4946025515210991
76136,FORT WORTH,TX,434,645,211,0.597775718257646
76136,FT WORTH,TX,15,0,-15,0
76136,LAKE WORTH,TX,26,89,63,0.7739130434782608
76137,FORT WORTH,TX,20434,19655,-779,0.4902841178378109
76137,FT WORTH,TX,2880,2669,-211,0.480987565327086
76137,HALTOM CITY,TX,4886,4502,-384,0.47954835960801023
76140,EVERMAN,TX,686,726,40,0.5141643059490085
76140,FOREST HILL,TX,683,698,15,0.5054308472121651
76140,FORT WORTH,TX,8015,8056,41,0.5012755895712775
76140,FT WORTH,TX,437,437,0,0.5
76147,FORT WORTH,TX,267,581,314,0.6851415094339622
76147,FT WORTH,TX,85,48,-37,0.3609022556390977
76148,FORT WORTH,TX,149,134,-15,0.4734982332155477
76148,HALTOM CITY,TX,305,329,24,0.5189274447949527
76148,WATAUGA,TX,7344,7212,-132,0.49546578730420443
76155,FORT WORTH,TX,6194,5773,-421,0.482409960725328
76155,FT WORTH,TX,621,631,10,0.5039936102236422
76161,FORT WORTH,TX,1131,1554,423,0.5787709497206703
76162,FORT WORTH,TX,553,1182,629,0.6812680115273775
76162,FT WORTH,TX,28,102,74,0.7846153846153846
76163,FORT WORTH,TX,368,849,481,0.6976170912078883
76163,FT WORTH,TX,34,53,19,0.6091954022988506
76164,FORT WORTH,TX,2867,2636,-231,0.4790114483009268
76164,FT WORTH,TX,163,155,-8,0.48742138364779874
76177,FORT WORTH,TX,13373,15214,1841,0.5321999510266905
76177,FT WORTH,TX,757,904,147,0.5442504515352198
76179,FORT WORTH,TX,5397,6381,984,0.5417727967396841
76179,FT WORTH,TX,488,524,36,0.5177865612648221
76179,SAGINAW,TX,18961,22950,3989,0.5475889384648421
76180,FORT WORTH,TX,725,716,-9,0.49687716863289383
76180,N RICHLAND HILLS,TX,1976,1913,-63,0.4919002314219594
76180,NORTH RICHLAND HILLS,TX,17114,16798,-316,0.49534088228355744
76180,RICHLAND HILLS,TX,454,452,-2,0.4988962472406181
76181,FORT WORTH,TX,0,11,11,1
76182,N RICHLAND HILLS,TX,1518,1815,297,0.5445544554455446
76182,NORTH RICHLAND HILLS,TX,7723,8587,864,0.5264868179031269
76182,RICHLAND HILLS,TX,266,304,38,0.5333333333333333
76185,FORT WORTH,TX,435,690,255,0.6133333333333333
76185,FT WORTH,TX,12,58,46,0.8285714285714286
76201,DENTON,TX,16288,12868,-3420,0.4413499794210454
76202,DENTON,TX,807,1049,242,0.5651939655172413
76205,DENTON,TX,11415,8720,-2695,0.4330767320586044
76206,DENTON,TX,267,321,54,0.5459183673469388
76207,DENTON,TX,7958,10024,2066,0.557446335224113
76208,CORINTH,TX,893,1106,213,0.5532766383191596
76208,DENTON,TX,8019,9011,992,0.5291250733998826
76208,SHADY SHORES,TX,508,455,-53,0.4724818276220145
76209,DENTON,TX,14650,12456,-2194,0.45952925551538404
76210,CORINTH,TX,6818,7121,303,0.5108687854221967
76210,DENTON,TX,8807,9038,231,0.5064724012328383
76225,ALVORD,TX,1332,1636,304,0.5512129380053908
76226,ARGYLE,TX,8744,13862,5118,0.6132000353888348
76226,LANTANA,TX,1991,3321,1330,0.6251882530120482
76226,NORTHLAKE,TX,196,341,145,0.6350093109869647
76227,AUBREY,TX,15809,26191,10382,0.6235952380952381
76227,PROVIDENCE VILLAGE,TX,480,728,248,0.6026490066225165
76227,SAVANNAH,TX,5290,8769,3479,0.6237285724446974
76228,BELLEVUE,TX,71,106,35,0.5988700564971752
76230,BOWIE,TX,4384,4574,190,0.5106050457691449
76233,COLLINSVILLE,TX,1259,1435,176,0.5326651818856719
76234,DECATUR,TX,6867,8267,1400,0.5462534690101758
76239,FORESTBURG,TX,11,61,50,0.8472222222222222
76240,GAINESVILLE,TX,12595,10701,-1894,0.4593492445054945
76241,GAINESVILLE,TX,1022,959,-63,0.4840989399293286
76244,FORT WORTH,TX,26834,28605,1771,0.5159725103266654
76244,KELLER,TX,2293,2366,73,0.5078342992058381
76245,GORDONVILLE,TX,930,1035,105,0.5267175572519084
76247,JUSTIN,TX,6978,12185,5207,0.6358607733653394
76248,KELLER,TX,11977,13103,1126,0.5224481658692185
76249,KRUM,TX,3638,3868,230,0.5153210764721556
76250,LINDSAY,TX,12,33,21,0.7333333333333333
76251,MONTAGUE,TX,37,60,23,0.6185567010309279
76252,MUENSTER,TX,883,896,13,0.5036537380550872
76255,NOCONA,TX,2436,2430,-6,0.499383477188656
76258,PILOT POINT,TX,2448,3025,577,0.5527133199342226
76259,PONDER,TX,1972,2820,848,0.5884808013355592
76262,KELLER,TX,424,485,61,0.5335533553355336
76262,NORTHLAKE,TX,736,890,154,0.5473554735547356
76262,ROANOKE,TX,14973,16265,1292,0.5206799410973814
76262,TROPHY CLUB,TX,1747,1918,171,0.5233287858117326
76262,WESTLAKE,TX,318,421,103,0.5696887686062246
76264,SADLER,TX,273,473,200,0.6340482573726541
76265,SAINT JO,TX,278,434,156,0.6095505617977528
76266,SANGER,TX,6316,7164,848,0.5314540059347181
76270,SUNSET,TX,762,1053,291,0.5801652892561984
76271,TIOGA,TX,509,778,269,0.6045066045066045
76272,VALLEY VIEW,TX,1688,2031,343,0.5461145469212154
76273,WHITESBORO,TX,3786,4429,643,0.5391357273280585
76301,WICHITA FALLS,TX,9449,7594,-1855,0.44557883001818926
76302,WICHITA FALLS,TX,7071,6580,-491,0.48201596952604203
76305,WICHITA FALLS,TX,1785,1772,-13,0.4981726173741917
76306,WICHITA FALLS,TX,7083,6854,-229,0.49178445863528736
76307,WICHITA FALLS,TX,882,577,-305,0.39547635366689515
76308,WICHITA FALLS,TX,11647,9644,-2003,0.45296134516932035
76309,WICHITA FALLS,TX,5675,5547,-128,0.49429691677062915
76310,WICHITA FALLS,TX,8026,8224,198,0.5060923076923077
76311,SHEPPARD AFB,TX,49365,2027,-47338,0.03944193648816936
76351,ARCHER CITY,TX,287,378,91,0.5684210526315789
76354,BURKBURNETT,TX,5777,5302,-475,0.47856304720642656
76360,ELECTRA,TX,1200,1219,19,0.5039272426622571
76365,HENRIETTA,TX,1820,1840,20,0.5027322404371585
76366,HOLLIDAY,TX,588,644,56,0.5227272727272727
76367,IOWA PARK,TX,3174,3310,136,0.5104873534855028
76369,KAMAY,TX,11,0,-11,0
76370,MEGARGEL,TX,13,0,-13,0
76371,MUNDAY,TX,101,254,153,0.7154929577464789
76371,SAFB,TX,0,11,11,1
76372,ELBERT,TX,0,12,12,1
76372,NEWCASTLE,TX,141,205,64,0.5924855491329479
76374,OLNEY,TX,1704,1599,-105,0.4841053587647593
76377,PETROLIA,TX,13,17,4,0.5666666666666667
76379,SCOTLAND,TX,16,11,-5,0.4074074074074074
76380,SEYMOUR,TX,1627,1633,6,0.500920245398773
76384,VERNON,TX,5141,4407,-734,0.46156263091746963
76385,VERNON,TX,52,160,108,0.7547169811320755
76389,WINDTHORST,TX,12,13,1,0.52
76401,STEPHENVILLE,TX,14597,13182,-1415,0.47453112063069225
76424,BRECKENRIDGE,TX,4257,3062,-1195,0.4183631643667168
76426,BRIDGEPORT,TX,3570,3905,335,0.52240802675585285
76426,RUNAWAY BAY,TX,582,644,62,0.5252854812398042
76427,BRYSON,TX,16,37,21,0.6981132075471698
76430,ALBANY,TX,708,562,-146,0.44251968503937006
76431,CHICO,TX,1358,1503,145,0.5253407899335897
76432,BLANKET,TX,415,199,-216,0.3241042345276873
76433,BLUFF DALE,TX,326,883,557,0.7303556658395368
76435,CARBON,TX,34,26,-8,0.43333333333333335
76436,CARLTON,TX,16,0,-16,0
76437,CISCO,TX,2318,2384,66,0.5070182900893236
76442,COMANCHE,TX,2717,2866,149,0.5133440802435967
76443,CROSS PLAINS,TX,405,499,94,0.5519911504424779
76444,DE LEON,TX,1150,1255,105,0.5218295218295218
76445,DESDEMONA,TX,0,12,12,1
76446,DUBLIN,TX,2649,2854,205,0.5186262038887879
76448,EASTLAND,TX,2484,2584,100,0.5098658247829518
76449,GRAFORD,TX,1250,1389,139,0.526335733232285
76450,GRAHAM,TX,4760,4777,17,0.5008912655971479
76453,GORDON,TX,135,358,223,0.7261663286004056
76454,GORMAN,TX,895,459,-436,0.33899556868537667
76455,GUSTINE,TX,69,41,-28,0.37272727272727274
76457,HICO,TX,1426,1494,68,0.5116438356164383
76458,JACKSBORO,TX,2505,2033,-472,0.4479947113265756
76462,LIPAN,TX,1205,1340,135,0.5265225933202358
76464,MORAN,TX,30,33,3,0.5238095238095238
76465,MORGAN MILL,TX,38,0,-38,0
76470,RANGER,TX,1348,1315,-33,0.4938039804731506
76471,RISING STAR,TX,387,502,115,0.5646794150731158
76472,SANTO,TX,313,471,158,0.6007653061224489
76475,STRAWN,TX,90,45,-45,0.3333333333333333
76476,TOLAR,TX,1247,1412,165,0.5310267017675818
76483,THROCKMORTON,TX,281,160,-121,0.36281179138321995
76484,PALO PINTO,TX,106,167,61,0.6117216117216118
76486,PERRIN,TX,163,329,166,0.6686991869918699
76487,POOLVILLE,TX,1020,1627,607,0.6146581035134114
76491,WOODSON,TX,0,11,11,1
76501,TEMPLE,TX,6384,6649,265,0.5101665004220057
76502,TEMPLE,TX,21488,25599,4111,0.5436532376239727
76503,IRVING,TX,22,44,22,0.6666666666666666
76503,TEMPLE,TX,863,1306,443,0.6021207929921623
76504,TEMPLE,TX,14677,14051,-626,0.4891047062099694
76511,BARTLETT,TX,714,586,-128,0.45076923076923076
76511,SAFB,TX,14,15,1,0.5172413793103449
76513,BELTON,TX,16727,18684,1957,0.5276326565191607
76518,BUCKHOLTS,TX,72,197,125,0.7323420074349443
76519,BURLINGTON,TX,0,11,11,1
76520,CAMERON,TX,3093,2910,-183,0.4847576211894053
76522,COPPERAS COVE,TX,24186,22778,-1408,0.48500979473639383
76524,EDDY,TX,781,807,26,0.5081863979848866
76525,EVANT,TX,247,361,114,0.59375
76527,FLORENCE,TX,1563,1912,349,0.5502158273381295
76528,GATESVILLE,TX,8430,7364,-1066,0.4662530074711916
76530,GRANGER,TX,726,934,208,0.5626506024096386
76531,HAMILTON,TX,2041,2024,-17,0.49790897908979087
76531,HMILTON,TX,32,39,7,0.5492957746478874
76534,HOLLAND,TX,969,841,-128,0.46464088397790054
76537,JARRELL,TX,5498,9576,4078,0.635266020963248
76538,JONESBORO,TX,94,123,29,0.5668202764976958
76539,KEMPNER,TX,3191,3825,634,0.5451824401368301
76540,KILLEEN,TX,933,1391,458,0.5985370051635112
76541,KILLEEN,TX,16702,12371,-4331,0.42551508272280125
76542,KILLEEN,TX,31962,28666,-3296,0.47281783994194104
76543,KILLEEN,TX,24813,17938,-6875,0.41959252415148185
76544,FORT HOOD,TX,16729,11250,-5479,0.40208727974552344
76544,KILLEEN,TX,352,277,-75,0.44038155802861684
76547,KILLEEN,TX,957,1335,378,0.5824607329842932
76548,HARKER HEIGHTS,TX,14748,14807,59,0.5009981390627644
76548,HARKER HTS,TX,2583,2308,-275,0.47188713964424456
76549,KILLEEN,TX,40111,32125,-7986,0.4447228528711446
76550,LAMPASAS,TX,5018,5719,701,0.5326441277824345
76554,LITTLE RIVER ACADEMY,TX,908,793,-115,0.466196355085244
76556,MILANO,TX,272,318,46,0.5389830508474577
76557,MOODY,TX,1569,1978,409,0.5576543557936284
76559,NOLANVILLE,TX,3214,3521,307,0.5227913882702302
76561,OGLESBY,TX,142,123,-19,0.4641509433962264
76567,ROCKDALE,TX,4074,3660,-414,0.4732350659425912
76569,ROGERS,TX,677,829,152,0.550464807436919
76570,ROSEBUD,TX,760,832,72,0.5226130653266332
76571,SALADO,TX,3566,4530,964,0.5595355731225297
76574,TAYLOR,TX,6711,7220,509,0.5182686095757663
76577,THORNDALE,TX,1004,1186,182,0.5415525114155251
76578,THRALL,TX,344,539,195,0.6104190260475651
76579,TROY,TX,1904,2211,307,0.5373025516403402
76621,ABBOTT,TX,34,88,54,0.7213114754098361
76622,AQUILLA,TX,23,136,113,0.8553459119496856
76624,AXTELL,TX,590,637,47,0.5191524042379788
76626,BLOOMING GROVE,TX,221,319,98,0.5907407407407408
76627,BLUM,TX,240,334,94,0.5818815331010453
76629,BREMOND,TX,360,469,109,0.5657418576598311
76630,BOWMAN,TX,11,0,-11,0
76630,BRUCEVILLE,TX,231,401,170,0.634493670886076
76630,HONEA JR,TX,0,11,11,1
76631,BYNUM,TX,0,11,11,1
76632,CHILTON,TX,195,76,-119,0.28044280442804426
76633,CHINA SPRING,TX,1635,1940,305,0.5426573426573427
76634,CLIFTON,TX,2537,2886,349,0.5321777613866864
76635,COOLIDGE,TX,51,105,54,0.6730769230769231
76636,COVINGTON,TX,354,614,260,0.6342975206611571
76637,CRANFILLS GAP,TX,13,0,-13,0
76638,CRAWFORD,TX,752,876,124,0.538083538083538
76639,DAWSON,TX,532,589,57,0.5254237288135594
76640,ELM MOTT,TX,1544,1335,-209,0.46370267453977076
76641,FROST,TX,193,332,139,0.6323809523809524
76642,GROESBECK,TX,2213,2417,204,0.5220302375809935
76643,HEWITT,TX,7296,6810,-486,0.48277328796256913
76645,HILLSBORO,TX,4520,4250,-270,0.4846066134549601
76648,HUBBARD,TX,1154,1055,-99,0.4775916704391127
76649,IREDELL,TX,38,169,131,0.8164251207729468
76651,ITALY,TX,1201,1208,7,0.5014528850145289
76652,KOPPERL,TX,100,162,62,0.6183206106870229
76653,KOSSE,TX,265,400,135,0.6015037593984962
76655,LORENA,TX,2715,4197,1482,0.6072048611111112
76656,LOTT,TX,898,573,-325,0.389530931339225
76657,MC GREGOR,TX,3511,3805,294,0.520092946965555
76660,MALONE,TX,12,0,-12,0
76661,MARLIN,TX,4273,2405,-1868,0.36013776579814316
76664,MART,TX,1047,1123,76,0.5175115207373272
76665,MERIDIAN,TX,837,914,77,0.5219874357509994
76667,MEXIA,TX,3710,3431,-279,0.48046492087942866
76670,MILFORD,TX,472,299,-173,0.38780804150453957
76671,MORGAN,TX,471,707,236,0.6001697792869269
76673,MOUNT CALM,TX,40,92,52,0.696969696969697
76679,PURDON,TX,176,429,253,0.7090909090909091
76682,RIESEL,TX,954,1015,61,0.5154900964956831
76687,THORNTON,TX,361,344,-17,0.4879432624113475
76689,VALLEY MILLS,TX,1813,1374,-439,0.4311264512080326
76690,WALNUT SPGS,TX,44,35,-9,0.4430379746835443
76690,WALNUT SPRINGS,TX,80,192,112,0.7058823529411765
76691,WEST,TX,1686,1898,212,0.5295758928571429
76692,WHITNEY,TX,4748,5417,669,0.5329070339399902
76693,WORTHAM,TX,418,604,186,0.5909980430528375
76701,WACO,TX,1481,1062,-419,0.4176169878096736
76702,WACO,TX,697,916,219,0.5678859268443893
76703,WACO,TX,491,989,498,0.6682432432432432
76704,WACO,TX,3179,2742,-437,0.4630974497551089
76705,BELLMEAD,TX,629,514,-115,0.44969378827646544
76705,LACY LAKEVIEW,TX,232,230,-2,0.49783549783549785
76705,WACO,TX,10035,8518,-1517,0.45911712391526976
76706,ROBINSON,TX,9428,7759,-1669,0.4514458602432071
76706,WACO,TX,6989,5367,-1622,0.43436387180317254
76707,WACO,TX,5225,4596,-629,0.4679767844415029
76708,WACO,TX,10627,10371,-256,0.4939041813506048
76710,WACO,TX,11913,11037,-876,0.48091503267973856
76711,WACO,TX,4104,3484,-620,0.4591460200316289
76712,WACO,TX,4101,4240,139,0.5083323342524877
76712,WOODWAY,TX,6393,6684,291,0.5111264051387933
76714,WACO,TX,79,282,203,0.7811634349030471
76715,WACO,TX,181,620,439,0.7740324594257179
76798,WACO,TX,12,0,-12,0
76801,BROWNWOOD,TX,10456,10479,23,0.5005493193217101
76802,BROWNWOOD,TX,26,45,19,0.6338028169014085
76802,EARLY,TX,1927,2138,211,0.5259532595325953
76803,EARLY,TX,18,68,50,0.7906976744186046
76804,BROWNWOOD,TX,266,469,203,0.638095238095238
76821,BALLINGER,TX,1931,1637,-294,0.4588004484304933
76823,BANGS,TX,1038,1138,100,0.5229779411764706
76825,BRADY,TX,3938,2773,-1165,0.4132022053345254
76827,BROOKESMITH,TX,0,13,13,1
76832,CHEROKEE,TX,22,0,-22,0
76834,COLEMAN,TX,2408,2213,-195,0.4789006708504653
76837,EDEN,TX,98,176,78,0.6423357664233577
76844,GOLDTHWAITE,TX,977,1180,203,0.5470560964302271
76849,JUNCTION,TX,1370,1428,58,0.5103645461043602
76853,LOMETA,TX,173,510,337,0.746705710102489
76854,LONDON,TX,12,0,-12,0
76856,MASON,TX,762,913,151,0.5450746268656717
76857,MAY,TX,450,727,277,0.6176720475785896
76859,MENARD,TX,151,283,132,0.652073732718894
76861,MILES,TX,114,251,137,0.6876712328767123
76864,MULLIN,TX,12,0,-12,0
76866,PAINT ROCK,TX,0,24,24,1
76871,RICHLAND SPRINGS,TX,23,66,43,0.7415730337078652
76872,ROCHELLE,TX,46,11,-35,0.19298245614035087
76875,ROWENA,TX,13,0,-13,0
76877,SAN SABA,TX,1330,1412,82,0.5149525893508388
76878,SANTA ANNA,TX,332,382,50,0.5350140056022409
76890,ZEPHYR,TX,0,71,71,1
76901,SAN ANGELO,TX,11969,11153,-816,0.48235446760660844
76902,SAN ANGELO,TX,1773,1210,-563,0.4056319141803553
76903,SAN ANGELO,TX,11541,10195,-1346,0.46903754140596243
76904,SAN ANGELO,TX,17966,14962,-3004,0.45438532555879496
76905,SAN ANGELO,TX,4100,3946,-154,0.490430027342779
76906,SAN ANGELO,TX,499,667,168,0.5720411663807891
76908,GOODFELLOW AFB,TX,413,220,-193,0.34755134281200634
76932,BIG LAKE,TX,871,625,-246,0.4177807486631016
76933,BRONTE,TX,81,87,6,0.5178571428571429
76934,CARLSBAD,TX,17,130,113,0.8843537414965986
76935,CHRISTOVAL,TX,381,494,113,0.5645714285714286
76936,ELDORADO,TX,340,357,17,0.5121951219512195
76941,MERTZON,TX,78,132,54,0.6285714285714286
76943,OZONA,TX,700,270,-430,0.27835051546391754
76945,ROBERT LEE,TX,492,657,165,0.5718015665796344
76950,SONORA,TX,870,799,-71,0.4787297783103655
76951,STERLING CITY,TX,98,47,-51,0.32413793103448274
77001,HOUSTON,TX,145,717,572,0.8317865429234339
77002,HOUSTON,TX,14845,14428,-417,0.4928773955522153
77003,HOUSTON,TX,6890,5821,-1069,0.4579498072535599
77004,HOUSTON,TX,17839,15303,-2536,0.46174038983766824
77005,HOUSTON,TX,9230,9112,-118,0.4967833387853015
77005,WEST UNIVERSITY PLACE,TX,363,420,57,0.5363984674329502
77006,HOUSTON,TX,20645,17747,-2898,0.462257762033757
77007,HOUSTON,TX,35672,33924,-1748,0.48744180700040235
77008,HOUSTON,TX,21858,22203,345,0.5039150268945326
77009,HOUSTON,TX,13406,13116,-290,0.4945328406605837
77010,HOUSTON,TX,629,623,-6,0.4976038338658147
77011,HOUSTON,TX,3630,3219,-411,0.46999561979851073
77012,HOUSTON,TX,3423,2718,-705,0.4425989252564729
77013,HOUSTON,TX,4860,3848,-1012,0.4418925126320625
77014,HOUSTON,TX,13301,11158,-2143,0.45619199476675254
77015,HOUSTON,TX,14129,10839,-3290,0.43411566805511054
77016,HOUSTON,TX,7054,6992,-62,0.4977929659689591
77017,HOUSTON,TX,6807,5439,-1368,0.44414502694757474
77018,HOUSTON,TX,9725,10605,880,0.5216428922774226
77019,HOUSTON,TX,18357,17401,-956,0.48663236198892557
77020,HOUSTON,TX,6472,5677,-795,0.4672812577166845
77021,HOUSTON,TX,11875,10220,-1655,0.46254808780267026
77022,HOUSTON,TX,6439,5664,-775,0.467983144674874
77023,HOUSTON,TX,6567,5362,-1205,0.44949283259284095
77024,HOUSTON,TX,18449,18204,-245,0.4966578451968461
77025,HOUSTON,TX,15268,14189,-1079,0.48168516821129104
77026,HOUSTON,TX,7147,6093,-1054,0.4601963746223565
77027,HOUSTON,TX,19004,17033,-1971,0.47265310652940035
77028,HOUSTON,TX,4389,4564,175,0.509773260359656
77029,HOUSTON,TX,3082,2761,-321,0.47253123395516
77029,JACINTO CITY,TX,208,173,-35,0.4540682414698163
77030,HOUSTON,TX,9791,7962,-1829,0.44848757956401736
77031,HOUSTON,TX,4146,3698,-448,0.471443141254462
77032,HOUSTON,TX,4476,4094,-382,0.47771295215869314
77033,HOUSTON,TX,7824,7187,-637,0.47878222636733064
77034,HOUSTON,TX,11970,9962,-2008,0.45422214116359655
77035,HOUSTON,TX,12971,11230,-1741,0.4640304119664477
77036,HOUSTON,TX,25228,17511,-7717,0.409719459978006
77037,HOUSTON,TX,2491,1975,-516,0.44223018360949395
77038,HOUSTON,TX,6417,6004,-413,0.4833749295547862
77039,HOUSTON,TX,4095,3402,-693,0.453781512605042
77040,HOUSTON,TX,14092,12195,-1897,0.4639175257731959
77040,JERSEY VILLAGE,TX,2074,1828,-246,0.4684777037416709
77041,HOUSTON,TX,9913,9484,-429,0.4889415889055008
77042,HOUSTON,TX,31113,25077,-6036,0.4462893753336893
77043,HOUSTON,TX,10688,25969,15281,0.7084322230406198
77044,HOUSTON,TX,14259,16123,1864,0.5306760581923508
77045,HOUSTON,TX,7305,7006,-299,0.4895534903221298
77046,HOUSTON,TX,2467,1968,-499,0.44374295377677564
77047,HOUSTON,TX,9035,9538,503,0.5135411619016852
77047,PEARLAND,TX,191,210,19,0.5236907730673317
77048,HOUSTON,TX,6440,7056,616,0.5228215767634855
77049,HOUSTON,TX,9980,8796,-1184,0.4684703877290158
77050,HOUSTON,TX,616,484,-132,0.44
77051,HOUSTON,TX,6743,6715,-28,0.4989597265566949
77052,HOUSTON,TX,39,73,34,0.6517857142857143
77053,HOUSTON,TX,5761,5460,-301,0.48658764815970057
77054,HOUSTON,TX,22774,17525,-5249,0.43487431449911906
77055,HOUSTON,TX,16025,15192,-833,0.486657910753756
77056,HOUSTON,TX,20833,19041,-1792,0.47752921703365603
77057,HOUSTON,TX,27014,23001,-4013,0.45988203538938316
77058,HOUSTON,TX,13377,11613,-1764,0.4647058823529412
77059,HOUSTON,TX,3837,4955,1118,0.5635805277525022
77060,HOUSTON,TX,14405,10545,-3860,0.42264529058116235
77061,HOUSTON,TX,6884,5215,-1669,0.4310273576328622
77062,HOUSTON,TX,7540,7246,-294,0.49005816312728256
77063,HOUSTON,TX,27423,21490,-5933,0.43935150164577924
77064,HOUSTON,TX,15298,13478,-1820,0.46837642479844316
77064,JERSEY VILLAGE,TX,369,329,-40,0.4713467048710602
77065,HOUSTON,TX,13729,12292,-1437,0.4723876868682987
77065,JERSEY VILLAGE,TX,3255,2981,-274,0.47803078896728673
77066,HOUSTON,TX,8476,7776,-700,0.4784641890228895
77067,HOUSTON,TX,9676,7787,-1889,0.44591421863368264
77068,HOUSTON,TX,4978,5062,84,0.5041832669322709
77069,HOUSTON,TX,9712,9703,-9,0.49976822044810715
77070,HOUSTON,TX,25453,24098,-1355,0.4863272184214244
77071,HOUSTON,TX,8089,7146,-943,0.4690515260912373
77072,HOUSTON,TX,15937,12681,-3256,0.4431127262562024
77073,HOUSTON,TX,14072,12946,-1126,0.47916204012140057
77074,HOUSTON,TX,11111,8420,-2691,0.43110951820183296
77075,HOUSTON,TX,9257,8525,-732,0.47941738837026204
77076,HOUSTON,TX,5120,3943,-1177,0.4350656515502593
77077,HOUSTON,TX,40806,36597,-4209,0.472811131351498
77078,HOUSTON,TX,3852,3604,-248,0.4833690987124464
77079,HOUSTON,TX,18094,18660,566,0.507699842194047
77080,HOUSTON,TX,14186,13288,-898,0.483657275970008
77081,HOUSTON,TX,17716,12006,-5710,0.40394320705201536
77082,HOUSTON,TX,29746,25246,-4500,0.4590849578120454
77083,HOUSTON,TX,17336,15651,-1685,0.47445963561402976
77084,HOUSTON,TX,44428,39324,-5104,0.4695290858725762
77085,HOUSTON,TX,3106,2771,-335,0.471499064148375
77086,HOUSTON,TX,5800,4942,-858,0.46006330292310554
77086,HUSTON,TX,123,119,-4,0.49173553719008267
77087,HOUSTON,TX,6631,5518,-1113,0.4541937608033583
77088,HOUSTON,TX,11766,10492,-1274,0.4713810764668883
77089,HOUSTON,TX,14805,14300,-505,0.4913245146881979
77089,PEARLAND,TX,300,261,-39,0.46524064171123
77090,HOUSTON,TX,25784,21998,-3786,0.4603825708425767
77091,HOUSTON,TX,8645,7421,-1224,0.46190713307606124
77092,HOUSTON,TX,12896,11526,-1370,0.47195151912210304
77093,HOUSTON,TX,6714,5624,-1090,0.4558275247203761
77094,HOUSTON,TX,4563,5436,873,0.5436543654365437
77095,HOUSTON,TX,24841,23272,-1569,0.48369463554548664
77096,HOUSTON,TX,13984,13795,-189,0.496598149681414
77098,HOUSTON,TX,14918,13100,-1818,0.46755657077592977
77099,HOUSTON,TX,16016,12304,-3712,0.4344632768361582
77205,HOUSTON,TX,393,669,276,0.6299435028248588
77205,HUMBLE,TX,58,121,63,0.6759776536312849
77206,HOUSTON,TX,16,23,7,0.5897435897435898
77207,HOUSTON,TX,119,389,270,0.765748031496063
77208,HOUSTON,TX,0,13,13,1
77210,HOUSTON,TX,50,677,627,0.9312242090784044
77213,HOUSTON,TX,269,841,572,0.7576576576576577
77215,HOUSTON,TX,24,48,24,0.6666666666666666
77218,HOUSTON,TX,202,81,-121,0.2862190812720848
77219,HOUSTON,TX,435,986,551,0.6938775510204082
77220,HOUSTON,TX,35,336,301,0.9056603773584906
77221,HOUSTON,TX,331,893,562,0.7295751633986928
77222,HOUSTON,TX,11,293,282,0.9638157894736842
77223,HOUSTON,TX,26,202,176,0.8859649122807017
77224,HOUSTON,TX,69,431,362,0.862
77225,HOUSTON,TX,63,466,403,0.8809073724007561
77226,HOUSTON,TX,84,307,223,0.7851662404092071
77227,HOUSTON,TX,295,669,374,0.6939834024896265
77228,HOUSTON,TX,98,479,381,0.830155979202773
77229,HOUSTON,TX,111,490,379,0.8153078202995009
77230,HOUSTON,TX,284,940,656,0.7679738562091504
77231,HOUSTON,TX,203,435,232,0.6818181818181818
77233,DALLAS,TX,18,50,32,0.7352941176470589
77233,HOUSTON,TX,511,1193,682,0.7001173708920188
77234,HOUSTON,TX,26,92,66,0.7796610169491526
77235,HOUSTON,TX,12,12,0,0.5
77236,HOUSTON,TX,0,133,133,1
77237,HOUSTON,TX,22,49,27,0.6901408450704225
77238,HOUSTON,TX,99,652,553,0.8681757656458056
77240,HOUSTON,TX,69,402,333,0.8535031847133758
77241,HOUSTON,TX,39,280,241,0.877742946708464
77242,HOUSTON,TX,765,1392,627,0.6453407510431154
77243,HOUSTON,TX,0,287,287,1
77244,HOUSTON,TX,136,510,374,0.7894736842105263
77245,HOUSTON,TX,283,1082,799,0.7926739926739926
77248,HOUSTON,TX,0,40,40,1
77249,CYPRESS,TX,12,12,0,0.5
77249,HOUSTON,TX,107,426,319,0.799249530956848
77251,HOUSTON,TX,146,90,-56,0.3813559322033898
77252,HOUSTON,TX,12,26,14,0.6842105263157895
77253,HOUSTON,TX,33,64,31,0.6597938144329897
77254,HOUSTON,TX,66,304,238,0.8216216216216217
77255,HOUSTON,TX,304,717,413,0.702252693437806
77256,HOUSTON,TX,12,728,716,0.9837837837837838
77257,HOUSTON,TX,280,590,310,0.6781609195402298
77258,HOUSTON,TX,65,162,97,0.7136563876651982
77259,HOUSTON,TX,53,203,150,0.79296875
77261,HOUSTON,TX,0,11,11,1
77263,HOUSTON,TX,25,387,362,0.9393203883495146
77265,HOUSTON,TX,65,58,-7,0.4715447154471545
77266,HOUSTON,TX,227,490,263,0.6834030683403068
77267,HOUSTON,TX,757,1761,1004,0.6993645750595711
77268,HOUSTON,TX,495,1082,587,0.6861128725428028
77269,HOUSTON,TX,736,1221,485,0.6239141543178334
77270,HOUSTON,TX,104,413,309,0.7988394584139265
77271,HOUSTON,TX,333,568,235,0.6304106548279689
77272,HOUSTON,TX,561,1305,744,0.6993569131832797
77273,HOUSTON,TX,118,391,273,0.768172888015717
77274,HOUSTON,TX,22,25,3,0.5319148936170213
77275,HOUSTON,TX,186,691,505,0.7879133409350056
77277,HOUSTON,TX,53,191,138,0.7827868852459017
77279,HOUSTON,TX,43,400,357,0.9029345372460497
77280,HOUSTON,TX,24,117,93,0.8297872340425532
77282,HOUSTON,TX,68,239,171,0.7785016286644951
77284,HOUSTON,TX,731,1576,845,0.683138274815778
77287,HOUSTON,TX,13,41,28,0.7592592592592593
77288,HOUSTON,TX,40,170,130,0.8095238095238095
77289,HOUSTON,TX,13,12,-1,0.48
77290,HOUSTON,TX,148,811,663,0.8456725755995829
77291,HOUSTON,TX,0,157,157,1
77292,HOUSTON,TX,382,763,381,0.6663755458515284
77293,HOUSTON,TX,168,611,443,0.7843388960205392
77301,CONROE,TX,12012,11984,-28,0.49941656942823803
77302,CONROE,TX,5390,7176,1786,0.5710647779723063
77303,CONROE,TX,6156,7406,1250,0.5460846482819643
77304,CONROE,TX,18698,21671,2973,0.5368228095816097
77305,CONROE,TX,3690,2146,-1544,0.36771761480466075
77306,CONROE,TX,3118,4077,959,0.5666435024322446
77316,MONTGOMERY,TX,9364,13446,4082,0.5894782989916704
77318,WILLIS,TX,6586,8506,1920,0.5636098595282268
77320,HUNTSVILLE,TX,8013,8059,46,0.5014310602289697
77325,HUMBLE,TX,12,0,-12,0
77325,KINGWOOD,TX,1265,593,-672,0.3191603875134553
77327,CLEVELAND,TX,7297,12122,4825,0.6242339976311859
77328,CLEVELAND,TX,4513,5296,783,0.5399123254154348
77331,COLDSPRING,TX,2307,2938,631,0.5601525262154433
77335,GOODRICH,TX,546,664,118,0.5487603305785124
77336,HUFFMAN,TX,4848,5180,332,0.5165536497806142
77338,HUMBLE,TX,17064,15856,-1208,0.4816524908869988
77339,KINGWOOD,TX,18025,18231,206,0.5028409090909091
77340,HUNTSVILLE,TX,12035,11090,-945,0.4795675675675676
77342,HUNTSVILLE,TX,345,455,110,0.56875
77345,HUMBLE,TX,113,125,12,0.5252100840336135
77345,KINGWOOD,TX,7152,7618,466,0.5157752200406229
77346,ATASCOCITA,TX,1140,1601,461,0.5840933965705947
77346,HUMBLE,TX,19775,25642,5867,0.5645903516304468
77346,KINGWOOD,TX,348,482,134,0.5807228915662651
77347,HUMBLE,TX,929,2025,1096,0.6855111712931619
77350,LEGGETT,TX,12,0,-12,0
77351,LIVINGSTON,TX,11519,12394,875,0.5182954878099778
77353,MAGNOLIA,TX,511,395,-116,0.4359823399558499
77354,MAGNOLIA,TX,13659,17202,3543,0.5574025469038593
77355,MAGNOLIA,TX,7854,9449,1595,0.5460902733630006
77356,MONTGOMERY,TX,14446,15904,1458,0.5240197693574958
77357,NEW CANEY,TX,8588,12984,4396,0.6018913406267383
77358,NEW WAVERLY,TX,1632,1929,297,0.5417017691659646
77359,OAKHURST,TX,24,55,31,0.6962025316455697
77360,ONALASKA,TX,2840,3330,490,0.539708265802269
77362,PINEHURST,TX,2194,3085,891,0.5843909831407463
77363,PLANTERSVILLE,TX,1171,1386,215,0.5420414548298788
77363,TODD MISSION,TX,16,21,5,0.5675675675675675
77364,POINTBLANK,TX,915,1177,262,0.5626195028680688
77365,PORTER,TX,11329,14601,3272,0.5630929425376012
77367,RIVERSIDE,TX,180,169,-11,0.48424068767908307
77369,RYE,TX,35,145,110,0.8055555555555556
77371,SHEPHERD,TX,2594,2694,100,0.5094553706505295
77372,SPLENDORA,TX,3880,4257,377,0.5231657859161853
77373,SPRING,TX,22310,23956,1646,0.5177884407556305
77375,TOMBALL,TX,23478,25664,2186,0.5222416670058199
77377,TOMBALL,TX,11303,14374,3071,0.5598005997585388
77378,WILLIS,TX,6139,7495,1356,0.549728619627402
77379,SPRING,TX,26304,28296,1992,0.5182417582417582
77380,SHENANDOAH,TX,559,551,-8,0.4963963963963964
77380,SPRING,TX,14772,13315,-1457,0.47406273364901913
77380,THE WOODLANDS,TX,5883,5950,67,0.5028310656638215
77381,SHENANDOAH,TX,894,1050,156,0.5401234567901234
77381,SPRING,TX,9918,10259,341,0.5084502155920108
77381,THE WOODLANDS,TX,1017,1052,35,0.5084581923634606
77382,SPRING,TX,7279,7570,291,0.5097986396390329
77382,THE WOODLANDS,TX,5120,5366,246,0.5117299256151059
77383,SPRING,TX,1230,1858,628,0.6016839378238342
77384,CONROE,TX,13103,15335,2232,0.539243266052465
77384,THE WOODLANDS,TX,708,739,31,0.5107118175535591
77385,CONROE,TX,8531,10191,1660,0.5443328704198269
77385,SHENANDOAH,TX,128,169,41,0.569023569023569
77385,THE WOODLANDS,TX,364,514,150,0.5854214123006833
77386,SPRING,TX,19986,24668,4682,0.5524253146414655
77387,SPRING,TX,792,1646,854,0.6751435602953241
77387,THE WOODLANDS,TX,371,353,-18,0.48756906077348067
77388,SPRING,TX,18209,18416,207,0.5028259385665529
77389,SPRING,TX,12270,13852,1582,0.530280989204502
77389,THE WOODLANDS,TX,1583,2033,450,0.5622234513274337
77391,KLEIN,TX,27,43,16,0.6142857142857143
77391,SPRING,TX,185,526,341,0.739803094233474
77393,SPRING,TX,903,1244,341,0.5794131346064276
77393,THE WOODLANDS,TX,51,109,58,0.68125
77396,HUMBLE,TX,18797,18115,-682,0.4907618118768964
77399,LIVINGSTON,TX,1559,16479,14920,0.9135713493735448
77401,BELLAIRE,TX,4230,5054,824,0.5443774235243429
77402,BELLAIRE,TX,744,1054,310,0.5862068965517241
77404,BAY CITY,TX,385,386,1,0.5006485084306096
77404,SARGENT,TX,214,286,72,0.572
77406,RICHMOND,TX,16081,23527,7446,0.593996162391436
77407,RICHMOND,TX,18606,26223,7617,0.5849561667670481
77410,CYPRESS,TX,1195,2158,963,0.6436027438115121
77411,ALIEF,TX,171,469,298,0.7328125
77413,BARKER,TX,36,154,118,0.8105263157894737
77414,BAY CITY,TX,9351,7593,-1758,0.44812322946175637
77414,SARGENT,TX,170,144,-26,0.4585987261146497
77417,BEASLEY,TX,145,436,291,0.7504302925989673
77418,BELLVILLE,TX,3269,3225,-44,0.4966122574684324
77419,BLESSING,TX,75,112,37,0.5989304812834224
77420,BOLING,TX,229,349,120,0.6038062283737025
77422,BRAZORIA,TX,4587,4011,-576,0.46650383810188417
77423,BROOKSHIRE,TX,4687,7253,2566,0.6074539363484087
77426,CHAPPELL HILL,TX,432,719,287,0.6246741963509991
77429,CYPRESS,TX,26054,28460,2406,0.5220677257218329
77430,DAMON,TX,293,461,168,0.6114058355437666
77433,CYPRESS,TX,28985,39205,10220,0.5749376741457691
77434,EAGLE LAKE,TX,1235,1126,-109,0.4769165607793308
77435,EAST BERNARD,TX,1006,1249,243,0.553880266075388
77437,EL CAMPO,TX,6008,4758,-1250,0.4419468697752183
77441,FULSHEAR,TX,5483,10433,4950,0.6555038954511184
77441,WESTON LAKES,TX,323,540,217,0.6257242178447276
77442,GARWOOD,TX,37,66,29,0.6407766990291263
77444,GUY,TX,36,39,3,0.52
77445,HEMPSTEAD,TX,3927,4242,315,0.519280205655527
77445,PRAIRIE VIEW,TX,107,95,-12,0.47029702970297027
77446,PRAIRIE VIEW,TX,633,287,-346,0.3119565217391304
77447,HOCKLEY,TX,5146,9036,3890,0.6371456776195177
77448,HUNGERFORD,TX,62,0,-62,0
77449,KATY,TX,41035,45963,4928,0.5283224901721879
77450,KATY,TX,26193,24740,-1453,0.4857361631947853
77451,KENDLETON,TX,0,38,38,1
77455,LOUISE,TX,80,158,78,0.6638655462184874
77456,MARKHAM,TX,68,34,-34,0.3333333333333333
77457,MATAGORDA,TX,0,12,12,1
77459,MISSOURI CITY,TX,20052,28141,8089,0.5839229763658622
77459,SUGAR LAND,TX,330,488,158,0.5965770171149144
77461,NEEDVILLE,TX,2395,2816,421,0.5403953175973901
77465,PALACIOS,TX,2019,2036,17,0.5020961775585696
77466,PATTISON,TX,25,0,-25,0
77469,RICHMOND,TX,13936,20732,6796,0.5980154609438099
77469,ROSENBERG,TX,1326,2002,676,0.6015625
77471,ROSENBERG,TX,12891,12638,-253,0.49504485095381723
77474,SEALY,TX,4291,4410,119,0.5068382944489139
77475,SHERIDAN,TX,23,53,30,0.6973684210526315
77476,SIMONTON,TX,16,36,20,0.6923076923076923
77477,MEADOWS PLACE,TX,327,286,-41,0.466557911908646
77477,STAFFORD,TX,15470,13376,-2094,0.4637038064203009
77478,SUGAR LAND,TX,9049,8037,-1012,0.4703851106168793
77479,SUGAR LAND,TX,21700,24495,2795,0.5302521917956489
77480,SWEENY,TX,3064,2814,-250,0.4787342633548826
77482,MISSION,TX,11,16,5,0.5925925925925926
77482,VAN VLECK,TX,676,606,-70,0.47269890795631825
77484,WALLER,TX,3815,4274,459,0.5283718630238595
77485,WALLIS,TX,827,948,121,0.5340845070422535
77486,WEST COLUMBIA,TX,3107,3069,-38,0.49692357512953367
77487,SUGAR LAND,TX,491,906,415,0.6485325697924124
77488,WHARTON,TX,5051,4332,-719,0.4616860279228392
77489,MISSOURI CITY,TX,9585,9533,-52,0.49864002510722877
77491,KATY,TX,803,1279,476,0.6143131604226705
77491,PARK ROW,TX,40,32,-8,0.4444444444444444
77492,KATY,TX,349,912,563,0.7232355273592387
77493,KATY,TX,14803,29054,14251,0.662471213261281
77494,KATY,TX,43788,51543,7755,0.5406740724423325
77496,SUGAR LAND,TX,554,1133,579,0.6716064018968583
77497,STAFFORD,TX,277,760,483,0.7328833172613307
77498,SUGAR LAND,TX,13888,13327,-561,0.48969318390593425
77501,PASADENA,TX,145,439,294,0.7517123287671232
77502,PASADENA,TX,8340,7256,-1084,0.46524749935880994
77503,PASADENA,TX,6984,5664,-1320,0.4478178368121442
77504,PASADENA,TX,8802,7174,-1628,0.44904857285928895
77505,PASADENA,TX,7578,7720,142,0.5046411295594195
77506,PASADENA,TX,7908,6374,-1534,0.4462960369696121
77507,PASADENA,TX,785,701,-84,0.4717362045760431
77508,PASADENA,TX,243,535,292,0.6876606683804627
77510,SANTA FE,TX,4565,4696,131,0.5070726703379764
77511,ALVIN,TX,14303,15072,769,0.5130893617021277
77512,ALVIN,TX,733,1085,352,0.5968096809680968
77514,ANAHUAC,TX,1231,1217,-14,0.497140522875817
77515,ANGLETON,TX,10315,9629,-686,0.4828018451664661
77516,ANGLETON,TX,992,839,-153,0.4582195521572911
77517,SANTA FE,TX,1578,1713,135,0.5205104831358249
77518,BACLIFF,TX,5290,4108,-1182,0.43711427963396465
77519,BATSON,TX,51,65,14,0.5603448275862069
77520,BAYTOWN,TX,13148,10942,-2206,0.4542133665421337
77521,BAYTOWN,TX,22617,21413,-1204,0.4863275039745628
77522,BAYTOWN,TX,1206,2062,856,0.6309669522643819
77523,BAYTOWN,TX,5744,8164,2420,0.5870002876042565
77523,BEACH CITY,TX,824,1202,378,0.5932872655478776
77523,COVE,TX,338,371,33,0.5232722143864598
77523,MONT BELVIEU,TX,177,236,59,0.5714285714285714
77530,CHANNELVIEW,TX,7303,6833,-470,0.4833757781550651
77531,CLUTE,TX,7950,6378,-1572,0.445142378559464
77531,RICHWOOD,TX,1357,1086,-271,0.4445354072861236
77532,CROSBY,TX,9268,10025,757,0.5196185144871197
77533,DAISETTA,TX,125,70,-55,0.358974358974359
77534,DANBURY,TX,789,775,-14,0.4955242966751918
77535,DAYTON,TX,7939,9392,1453,0.5419191044948358
77535,OLD RIVER WINFREE,TX,539,579,40,0.5178890876565295
77536,DEER,TX,191,189,-2,0.49736842105263157
77536,DEER PARK,TX,9457,9061,-396,0.48930770061561724
77538,DEVERS,TX,11,0,-11,0
77539,DICKINSON,TX,16538,16724,186,0.5027959834044856
77539,SAN LEON,TX,374,405,31,0.5198973042362003
77541,FREEPORT,TX,7045,5775,-1270,0.4504680187207488
77541,JONES CREEK,TX,328,314,-14,0.48909657320872274
77542,FREEPORT,TX,273,530,257,0.660024906600249
77545,FRESNO,TX,7011,7088,77,0.5027306901198667
77546,FRIENDSWOOD,TX,14291,15249,958,0.5162153012863914
77547,GALENA PARK,TX,1793,1423,-370,0.44247512437810943
77549,FRIENDSWOOD,TX,877,537,-340,0.3797736916548798
77550,GALVESTON,TX,13157,10629,-2528,0.446859497183217
77551,GALVESTON,TX,9906,8579,-1327,0.46410603191777117
77552,GALVESTON,TX,705,1078,373,0.6045989904655076
77553,GALVESTON,TX,240,485,245,0.6689655172413793
77554,GALVESTON,TX,4675,4722,47,0.5025007981270618
77560,HANKAMER,TX,12,0,-12,0
77561,HARDIN,TX,52,86,34,0.6231884057971014
77562,HIGHLANDS,TX,3818,3655,-163,0.4890940719925064
77563,HITCHCOCK,TX,4344,4198,-146,0.49145399203933504
77564,HULL,TX,277,498,221,0.6425806451612903
77565,CLEAR LAKE SHORES,TX,169,175,6,0.5087209302325582
77565,CLEAR LK SHRS,TX,105,121,16,0.5353982300884956
77565,KEMAH,TX,4149,3972,-177,0.48910232729959363
77566,LAKE JACKSON,TX,16292,12908,-3384,0.44205479452054797
77568,LA MARQUE,TX,8074,10224,2150,0.5587495901191387
77568,TEXAS CITY,TX,326,466,140,0.5883838383838383
77571,LA PORTE,TX,11373,11693,320,0.5069366166652215
77572,LA PORTE,TX,223,419,196,0.6526479750778816
77573,LEAGUE CITY,TX,29974,32370,2396,0.5192159630437572
77574,LEAGUE CITY,TX,912,942,30,0.5080906148867314
77575,LIBERTY,TX,4796,4221,-575,0.4681157813019851
77577,LIVERPOOL,TX,300,419,119,0.5827538247566064
77578,MANVEL,TX,7072,10583,3511,0.5994335882186349
77580,MONT BELVIEU,TX,1119,491,-628,0.30496894409937886
77581,PEARLAND,TX,13765,14063,298,0.5053543193905419
77582,RAYWOOD,TX,14,31,17,0.6888888888888889
77583,IOWA COLONY,TX,119,255,136,0.6818181818181818
77583,ROSHARON,TX,8263,16065,7802,0.6603502137454784
77584,PEARLAND,TX,29274,30825,1551,0.5129037088803474
77585,SARATOGA,TX,65,48,-17,0.4247787610619469
77586,EL LAGO,TX,2777,2555,-222,0.47918229557389347
77586,SEABROOK,TX,8524,7876,-648,0.4802439024390244
77587,SOUTH HOUSTON,TX,4167,3170,-997,0.43205669892326565
77588,PEARLAND,TX,665,1068,403,0.6162723600692441
77590,TEXAS CITY,TX,11713,10617,-1096,0.4754590237348858
77591,TEXAS CITY,TX,7635,7189,-446,0.4849568267674042
77592,TEXAS CITY,TX,1489,1375,-114,0.4800977653631285
77597,WALLISVILLE,TX,28,81,53,0.7431192660550459
77598,WEBSTER,TX,17750,15304,-2446,0.46299993949295093
77611,BRIDGE CITY,TX,3972,3760,-212,0.48629073978272114
77612,BUNA,TX,2403,2210,-193,0.47908085844352916
77613,CHINA,TX,111,66,-45,0.3728813559322034
77614,DEWEYVILLE,TX,0,22,22,1
77615,EVADALE,TX,75,34,-41,0.3119266055045872
77616,FRED,TX,28,89,61,0.7606837606837606
77617,GILCHRIST,TX,11,0,-11,0
77619,GROVES,TX,5673,5277,-396,0.48191780821917807
77622,HAMSHIRE,TX,263,223,-40,0.4588477366255144
77623,HIGH ISLAND,TX,34,0,-34,0
77624,HILLISTER,TX,34,62,28,0.6458333333333334
77625,KOUNTZE,TX,2558,2775,217,0.5203450215638478
77626,MAURICEVILLE,TX,67,135,68,0.6683168316831684
77627,NEDERLAND,TX,9115,7892,-1223,0.46404421708708177
77629,NOME,TX,0,24,24,1
77630,ORANGE,TX,8220,7631,-589,0.4814207305532774
77630,WEST ORANGE,TX,2254,2058,-196,0.4772727272727273
77631,ORANGE,TX,180,368,188,0.6715328467153284
77632,ORANGE,TX,5722,5830,108,0.504674515235457
77639,ORANGEFIELD,TX,25,13,-12,0.34210526315789475
77640,PORT ARTHUR,TX,5474,5142,-332,0.48436322532027126
77641,PORT ARTHUR,TX,239,774,535,0.7640671273445212
77642,PORT ARTHUR,TX,11210,10049,-1161,0.47269391787007853
77650,CRYSTAL BEACH,TX,1195,817,-378,0.40606361829025844
77650,PORT BOLIVAR,TX,805,592,-213,0.42376521116678595
77651,PORT NECHES,TX,5027,4115,-912,0.4501203237803544
77655,SABINE PASS,TX,0,15,15,1
77656,SILSBEE,TX,5551,5290,-261,0.4879623650954709
77657,LUMBERTON,TX,7381,7624,243,0.5080973008997001
77659,SOUR LAKE,TX,1546,1715,169,0.5259122968414597
77660,SPURGER,TX,103,213,110,0.6740506329113924
77662,VIDOR,TX,9371,8100,-1271,0.463625436437525
77663,VILLAGE MILLS,TX,162,244,82,0.6009852216748769
77664,WARREN,TX,878,956,78,0.5212649945474372
77665,WINNIE,TX,1698,1734,36,0.5052447552447552
77670,VIDOR,TX,591,609,18,0.5075
77701,BEAUMONT,TX,5078,3837,-1241,0.43039820527201345
77702,BEAUMONT,TX,1440,1110,-330,0.43529411764705883
77703,BEAUMONT,TX,5049,4350,-699,0.46281519310564956
77704,BEAUMONT,TX,668,137,-531,0.1701863354037267
77705,BEAUMONT,TX,9896,8743,-1153,0.46907022908954343
77706,BEAUMONT,TX,13038,11523,-1515,0.4691584218883596
77707,BEAUMONT,TX,5761,5472,-289,0.48713611679871804
77708,BEAUMONT,TX,4658,4142,-516,0.4706818181818182
77713,BEAUMONT,TX,5892,5881,-11,0.4995328293553045
77720,BEAUMONT,TX,245,526,281,0.682230869001297
77725,BEAUMONT,TX,203,586,383,0.7427122940430925
77726,BEAUMONT,TX,840,1251,411,0.5982783357245337
77801,BRYAN,TX,8797,6421,-2376,0.421934551189381
77802,BRYAN,TX,13903,12097,-1806,0.46526923076923077
77803,BRYAN,TX,8875,8412,-463,0.4866084340834153
77805,BRYAN,TX,1275,1663,388,0.5660313138189245
77806,BRYAN,TX,427,599,172,0.5838206627680312
77807,BRYAN,TX,5316,5996,680,0.5300565770862801
77808,BRYAN,TX,3441,4589,1148,0.5714819427148194
77830,ANDERSON,TX,769,1059,290,0.5793216630196937
77831,BEDIAS,TX,1048,1167,119,0.52686230248307
77833,BRENHAM,TX,8301,8790,489,0.5143057749692821
77834,BRENHAM,TX,1312,766,-546,0.368623676612127
77835,BURTON,TX,517,756,239,0.593872741555381
77836,CALDWELL,TX,3916,4032,116,0.5072974333165576
77837,CALVERT,TX,214,314,100,0.5946969696969697
77840,COLLEGE STATION,TX,32485,21101,-11384,0.39377822565595494
77841,COLLEGE STA,TX,71,18,-53,0.20224719101123595
77841,COLLEGE STATION,TX,707,52,-655,0.06851119894598155
77842,COLLEGE STATION,TX,2503,1717,-786,0.40687203791469195
77845,COLLEGE STA,TX,806,788,-18,0.49435382685069007
77845,COLLEGE STATION,TX,27621,27650,29,0.5002623437245571
77853,DIME BOX,TX,332,114,-218,0.2556053811659193
77856,FRANKLIN,TX,1632,1952,320,0.5446428571428571
77857,GAUSE,TX,67,54,-13,0.4462809917355372
77859,HEARNE,TX,2380,2210,-170,0.48148148148148145
77861,IOLA,TX,716,968,252,0.5748218527315915
77863,LYONS,TX,0,11,11,1
77864,MADISONVILLE,TX,2252,2102,-150,0.4827744602664217
77865,MARQUEZ,TX,225,525,300,0.7
77866,MILLICAN,TX,24,17,-7,0.4146341463414634
77868,NAVASOTA,TX,4698,4579,-119,0.49358628867090654
77871,HILLTOP LAKES,TX,27,33,6,0.55
77871,NORMANGEE,TX,1331,1256,-75,0.4855044453034403
77872,NORTH ZULCH,TX,523,718,195,0.5785656728444802
77873,RICHARDS,TX,118,279,161,0.7027707808564232
77878,SNOOK,TX,139,121,-18,0.4653846153846154
77879,SOMERVILLE,TX,1361,1825,464,0.5728185812931575
77880,WASHINGTON,TX,236,357,121,0.6020236087689713
77881,WELLBORN,TX,12,24,12,0.6666666666666666
77901,VICTORIA,TX,15999,13305,-2694,0.45403357903357905
77902,VICTORIA,TX,180,177,-3,0.4957983193277311
77903,VICTORIA,TX,1332,1235,-97,0.4811063498246981
77904,VICTORIA,TX,11247,10539,-708,0.4837510327733407
77905,VICTORIA,TX,3522,3824,302,0.5205554043016608
77951,BLOOMINGTON,TX,364,240,-124,0.3973509933774834
77954,CUERO,TX,3850,3765,-85,0.4944189100459619
77957,EDNA,TX,2868,2674,-194,0.482497293395886
77960,FANNIN,TX,11,0,-11,0
77962,GANADO,TX,457,596,139,0.5660018993352327
77963,GOLIAD,TX,1380,1615,235,0.5392320534223706
77964,HALLETTSVILLE,TX,2156,2366,210,0.5232198142414861
77968,INEZ,TX,476,767,291,0.6170555108608206
77970,LA WARD,TX,0,22,22,1
77971,LOLITA,TX,39,0,-39,0
77975,MOULTON,TX,339,297,-42,0.4669811320754717
77976,NURSERY,TX,0,15,15,1
77977,PELICEDO,TX,0,11,11,1
77977,PLACEDO,TX,15,11,-4,0.4230769230769231
77978,POINT COMFORT,TX,25,0,-25,0
77979,PORT LAVACA,TX,4184,3815,-369,0.47693461682710336
77982,PORT O CONNOR,TX,459,407,-52,0.46997690531177827
77983,SEADRIFT,TX,1248,526,-722,0.2965050732807215
77984,SHINER,TX,1032,1133,101,0.523325635103926
77988,TELFERNER,TX,12,0,-12,0
77990,TIVOLI,TX,47,13,-34,0.21666666666666667
77991,VANDERBILT,TX,11,0,-11,0
77995,YOAKUM,TX,3115,2829,-286,0.4759421265141319
78002,ATASCOSA,TX,1458,1698,240,0.5380228136882129
78003,BANDERA,TX,3585,4998,1413,0.5823138762670395
78004,BERGHEIM,TX,11,0,-11,0
78005,BIGFOOT,TX,13,41,28,0.7592592592592593
78006,BOERNE,TX,14478,18561,4083,0.5617906110959775
78006,SISTERDALE,TX,316,489,173,0.6074534161490683
78009,CASTROVILLE,TX,2642,3578,936,0.5752411575562701
78010,CAMP VERDE,TX,18,22,4,0.55
78010,CENTER POINT,TX,1083,1020,-63,0.48502139800285304
78011,CHARLOTTE,TX,145,375,230,0.7211538461538461
78013,COMFORT,TX,1560,1722,162,0.5246800731261426
78014,COTULLA,TX,1295,1194,-101,0.4797107271996786
78015,BOERNE,TX,4470,6983,2513,0.609709246485637
78015,FAIR OAKS,TX,122,227,105,0.6504297994269341
78015,FAIR OAKS RANCH,TX,1168,1678,510,0.5895994378074491
78016,DEVINE,TX,3045,3339,294,0.5230263157894737
78017,DILLEY,TX,967,992,25,0.5063808065339459
78022,GEORGE WEST,TX,1284,1298,14,0.5027110766847405
78023,HELOTES,TX,8620,9497,877,0.5242037864988685
78024,HUNT,TX,165,212,47,0.5623342175066313
78025,INGRAM,TX,2155,2119,-36,0.4957884885353299
78026,JOURDANTON,TX,2078,2195,117,0.5136906154926282
78028,KERRVILLE,TX,16396,16700,304,0.5045927000241721
78029,KERRVILLE,TX,1898,1295,-603,0.40557469464453494
78039,LA COSTE,TX,103,184,81,0.6411149825783972
78040,LAREDO,TX,6302,5202,-1100,0.4521905424200278
78041,LAREDO,TX,10709,10039,-670,0.4838538654328128
78042,LAREDO,TX,11,157,146,0.9345238095238095
78043,LAREDO,TX,6929,6803,-126,0.4954121759394116
78044,LAREDO,TX,480,1007,527,0.6772024209818427
78045,LAREDO,TX,13362,13761,399,0.5073553810419201
78046,EL CENIZO,TX,205,192,-13,0.4836272040302267
78046,LAREDO,TX,7446,8577,1131,0.5352930162890844
78050,LEMING,TX,64,11,-53,0.14666666666666667
78052,LYTLE,TX,2117,2532,415,0.5446332544633254
78055,MEDINA,TX,549,644,95,0.539815590947192
78056,MICO,TX,301,751,450,0.7138783269961977
78057,MOORE,TX,136,303,167,0.6902050113895216
78058,MOUNTAIN HOME,TX,206,427,221,0.674565560821485
78059,NATALIA,TX,1110,1399,289,0.5575926664009565
78061,PEARSALL,TX,2340,2229,-111,0.48785292186474066
78063,LAKEHILLS,TX,1383,1649,266,0.5438654353562006
78063,PIPE CREEK,TX,1614,1886,272,0.5388571428571428
78064,PLEASANTON,TX,5484,6017,533,0.5231718980958178
78065,POTEET,TX,2423,2781,358,0.5343966179861644
78065,SAN ANTONIO,TX,46,71,25,0.6068376068376068
78066,RIO MEDINA,TX,12,23,11,0.6571428571428571
78069,SOMERSET,TX,1145,1360,215,0.5429141716566867
78070,SPRING BRANCH,TX,6379,9197,2818,0.5904596815613765
78071,THREE RIVERS,TX,665,826,161,0.5539906103286385
78072,TILDEN,TX,12,0,-12,0
78073,VON ORMY,TX,2066,2700,634,0.5665127989928661
78076,ZAPATA,TX,1454,1624,170,0.5276153346328785
78101,ADKINS,TX,1923,2575,652,0.5724766562916852
78102,BEEVILLE,TX,6180,5603,-577,0.4755155732835441
78104,BEEVILLE,TX,358,427,69,0.5439490445859873
78108,CIBOLO,TX,11715,13608,1893,0.5373770880227461
78108,SCHERTZ,TX,5042,5617,575,0.5269725114926354
78109,CONVERSE,TX,23664,28972,5308,0.5504217645717759
78112,ELMENDORF,TX,2377,2697,320,0.5315333070555774
78113,FALLS CITY,TX,47,150,103,0.7614213197969543
78113,MCCOY,TX,22,42,20,0.65625
78114,FLORESVILLE,TX,6029,7205,1176,0.5444310110321898
78118,KARNES CITY,TX,1217,1181,-36,0.4924937447873228
78119,KENEDY,TX,1575,1537,-38,0.49389460154241643
78121,LA VERNIA,TX,4231,5304,1073,0.5562663869952805
78121,LAVERNIA,TX,176,211,35,0.5452196382428941
78123,MC QUEENEY,TX,1120,961,-159,0.46179721287842385
78123,MCQUEENEY,TX,42,19,-23,0.3114754098360656
78124,MARION,TX,1882,2288,406,0.5486810551558753
78130,NEW BRAUNFELS,TX,42355,46994,4639,0.5259599995523173
78131,NEW BRAUNFELS,TX,1367,1817,450,0.5706658291457286
78132,NEW BRAUNFELS,TX,11400,17584,6184,0.6066795473364615
78133,CANYON LAKE,TX,8387,10639,2252,0.5591821717649532
78140,NIXON,TX,1276,1174,-102,0.4791836734693877
78142,NORMANNA,TX,0,14,14,1
78146,PETTUS,TX,0,23,23,1
78147,POTH,TX,275,263,-12,0.4888475836431227
78148,UNIVERSAL CITY,TX,12794,10757,-2037,0.456753428729141
78150,JBSA RANDOLPH,TX,0,24,24,1
78151,RUNGE,TX,70,29,-41,0.29292929292929293
78152,SAINT HEDWIG,TX,940,3024,2084,0.7628657921291625
78154,CIBOLO,TX,291,307,16,0.5133779264214047
78154,SCHERTZ,TX,11826,13376,1550,0.5307515276565352
78154,SELMA,TX,4106,4749,643,0.5363071710897798
78155,SEGUIN,TX,17939,19357,1418,0.5190100815100815
78156,SEGUIN,TX,1988,1523,-465,0.433779549985759
78159,SMILEY,TX,13,42,29,0.7636363636363637
78160,STOCKDALE,TX,1191,1430,239,0.545593285005723
78161,SUTHERLAND SPRINGS,TX,12,74,62,0.8604651162790697
78163,BULVERDE,TX,3692,7303,3611,0.6642110050022738
78164,AUSTIN,TX,19,13,-6,0.40625
78164,YORKTOWN,TX,795,831,36,0.511070110701107
78201,SAN ANTONIO,TX,15743,14352,-1391,0.476889848812095
78202,SAN ANTONIO,TX,4822,4338,-484,0.47358078602620085
78203,SAN ANTONIO,TX,2239,1968,-271,0.46779177561207513
78204,SAN ANTONIO,TX,5372,5043,-329,0.4842054728756601
78205,SAN ANTONIO,TX,2908,2197,-711,0.43036238981390795
78207,SAN ANTONIO,TX,14009,11904,-2105,0.4593833211129549
78208,SAN ANTONIO,TX,1918,1651,-267,0.46259456430372653
78209,SAN ANTONIO,TX,24362,21851,-2511,0.47283231990998204
78210,SAN ANTONIO,TX,12281,10706,-1575,0.4657415060686475
78211,SAN ANTONIO,TX,6244,5504,-740,0.46850527749404153
78212,SAN ANTONIO,TX,11709,10716,-993,0.47785953177257523
78213,CASTLE HILLS,TX,334,227,-107,0.40463458110516937
78213,SAN ANTONIO,TX,18629,15255,-3374,0.45021248967064104
78214,SAN ANTONIO,TX,6882,5812,-1070,0.4578541043012447
78215,SAN ANTONIO,TX,5317,4894,-423,0.4792870433845853
78216,SAN ANTONIO,TX,26738,21515,-5223,0.4458790127038733
78217,SAN ANTONIO,TX,20609,18116,-2493,0.4678114912846998
78218,SAN ANTONIO,TX,17292,16798,-494,0.4927544734526254
78219,KIRBY,TX,432,345,-87,0.444015444015444
78219,SAN ANTONIO,TX,6238,5659,-579,0.4756661343195764
78220,SAN ANTONIO,TX,7219,8279,1060,0.5341979610272293
78221,SAN ANTONIO,TX,9650,9109,-541,0.485580254811024
78222,SAN ANTONIO,TX,8594,8234,-360,0.4893035417161873
78223,SAN ANTONIO,TX,20546,19795,-751,0.49069185196202375
78224,SA,TX,121,117,-4,0.49159663865546216
78224,SAN ANTONIO,TX,5880,6543,663,0.5266843757546487
78225,SAN ANTONIO,TX,2586,2174,-412,0.45672268907563024
78226,SAN ANTONIO,TX,2624,2402,-222,0.4779148428173498
78226,ZAPATA,TX,61,55,-6,0.47413793103448276
78227,SA,TX,254,245,-9,0.4909819639278557
78227,SAN ANTONIO,TX,15845,13637,-2208,0.46255342242724373
78228,SAN ANTONIO,TX,15459,14002,-1457,0.4752723940124232
78229,SAN ANTONIO,TX,38417,23666,-14751,0.3811993621442263
78230,SAN ANTONIO,TX,25512,22705,-2807,0.47089200904245393
78231,SAN ANTONIO,TX,2492,2641,149,0.51451392947594
78231,SHAVANO PARK,TX,1176,1140,-36,0.49222797927461137
78232,SAN ANTONIO,TX,17249,16181,-1068,0.484026323661382
78233,LIVE OAK,TX,7637,6820,-817,0.4717437919347029
78233,SAN ANTONIO,TX,17665,14393,-3272,0.4489674964127519
78234,FORT SAM HOUSTON,TX,849,842,-7,0.4979302188054406
78234,FT SM HOUSTON,TX,227,192,-35,0.45823389021479716
78234,JBSA FSH,TX,223,272,49,0.5494949494949495
78234,JBSA FT SAM HOUSTON,TX,1444,1583,139,0.5229600264288073
78234,SAN ANTONIO,TX,326,327,1,0.5007656967840735
78235,BROOKS CB,TX,28,12,-16,0.3
78235,BROOKS CITY BASE,TX,164,103,-61,0.3857677902621723
78235,SAN ANTONIO,TX,2068,1392,-676,0.4023121387283237
78236,JBSA LACKLAND,TX,1393,1156,-237,0.45351118085523734
78236,LACKLAND AFB,TX,64,37,-27,0.36633663366336633
78236,SAN ANTONIO,TX,269,178,-91,0.3982102908277405
78237,SAN ANTONIO,TX,9843,8578,-1265,0.4656641876119646
78238,SAN ANTONIO,TX,12611,10899,-1712,0.4635899617184177
78239,SAN ANTONIO,TX,11272,7777,-3495,0.40826290093968187
78239,WINDCREST,TX,4363,3078,-1285,0.4136540787528558
78240,SAN ANTONIO,TX,38335,32475,-5860,0.4586216636068352
78242,SAN ANTONIO,TX,8520,7907,-613,0.4813416935532964
78244,SAN ANTONIO,TX,14339,15203,864,0.5146232482567192
78245,SAN ANTONIO,TX,35691,41389,5698,0.5369615983393876
78246,SAN ANTONIO,TX,46,632,586,0.9321533923303835
78247,SAN ANTONIO,TX,19088,18070,-1018,0.4863017385219872
78248,SAN ANTONIO,TX,4919,5265,346,0.516987431264729
78249,SAN ANTONIO,TX,29027,25286,-3741,0.4655607313166277
78250,SAN ANTONIO,TX,16824,15522,-1302,0.47987386384715264
78251,SAN ANTONIO,TX,28513,24875,-3638,0.4659286731100622
78252,SAN ANTONIO,TX,5038,9159,4121,0.6451362964006481
78253,SAN ANTONIO,TX,25885,34106,8221,0.5685186111250021
78254,SAN ANTONIO,TX,23845,30733,6888,0.563102348931804
78255,SAN ANTONIO,TX,4889,5969,1080,0.5497329158224351
78256,SAN ANTONIO,TX,10218,10075,-143,0.4964766175528507
78257,SAN ANTONIO,TX,9988,9999,11,0.500275178866263
78258,SAN ANTONIO,TX,24970,25711,741,0.5073104319172865
78259,SAN ANTONIO,TX,12866,14707,1841,0.5333841076415334
78260,SAN ANTONIO,TX,10804,13775,2971,0.5604377720818585
78261,SAN ANTONIO,TX,9710,12182,2472,0.5564589804494793
78263,CHINA GROVE,TX,180,197,17,0.5225464190981433
78263,SAN ANTONIO,TX,780,1047,267,0.5730706075533661
78264,SAN ANTONIO,TX,2836,3250,414,0.5340124876766349
78265,SAN ANTONIO,TX,1619,2220,601,0.5782755926022402
78266,GARDEN RIDGE,TX,733,1098,365,0.5996723102129984
78266,SAN ANTONIO,TX,1061,1632,571,0.6060155959896026
78268,LEON VALLEY,TX,106,248,142,0.7005649717514124
78268,SAN ANTONIO,TX,614,1179,565,0.6575571667596207
78269,SAN ANTONIO,TX,996,1590,594,0.6148491879350348
78270,SAN ANTONIO,TX,645,1029,384,0.6146953405017921
78278,SAN ANTONIO,TX,870,1585,715,0.6456211812627292
78279,SAN ANTONIO,TX,99,358,259,0.7833698030634574
78283,SAN ANTONIO,TX,328,884,556,0.7293729372937293
78292,SAN ANTONIO,TX,13,0,-13,0
78295,SAN ANTONIO,TX,11,0,-11,0
78299,SAN ANTONIO,TX,168,14,-154,0.07692307692307693
78330,AGUA DULCE,TX,0,20,20,1
78332,ALICE,TX,7528,6077,-1451,0.4466740169055494
78333,ALICE,TX,513,1066,553,0.675110829639012
78335,ARANSAS PASS,TX,603,693,90,0.5347222222222222
78336,ARANSAS PASS,TX,4428,5571,1143,0.5571557155715572
78340,BAYSIDE,TX,12,12,0,0.5
78341,BENAVIDES,TX,23,49,26,0.6805555555555556
78342,BEN BOLT,TX,40,0,-40,0
78343,BISHOP,TX,1064,1097,33,0.5076353540027765
78355,FALFURRIAS,TX,1882,1841,-41,0.49449368788611336
78357,DONNA,TX,0,11,11,1
78357,FREER,TX,201,116,-85,0.3659305993690852
78358,FULTON,TX,1393,2169,776,0.6089275687815834
78359,GREGORY,TX,139,231,92,0.6243243243243243
78361,HEBBRONVILLE,TX,1257,1179,-78,0.4839901477832512
78362,INGLESIDE,TX,4774,4627,-147,0.49218168279970215
78363,KINGSVILLE,TX,11826,9070,-2756,0.43405436447166923
78364,KINGSVILLE,TX,331,810,479,0.7099035933391762
78368,LAKE CITY,TX,54,72,18,0.5714285714285714
78368,MATHIS,TX,2721,2787,66,0.5059912854030502
78370,ODEM,TX,1254,1245,-9,0.49819927971188477
78372,ORANGE GROVE,TX,1342,1672,330,0.5547445255474452
78373,PORT ARANSAS,TX,3325,5443,2118,0.620780109489051
78374,PORTLAND,TX,8909,8860,-49,0.49862119421464346
78375,PREMONT,TX,405,451,46,0.5268691588785047
78376,REALITOS,TX,0,31,31,1
78377,REFUGIO,TX,1087,1092,5,0.5011473152822395
78379,RIVIERA,TX,469,719,250,0.6052188552188552
78380,ROBSTOWN,TX,5284,5562,278,0.5128157846210585
78381,ROCKPORT,TX,1650,1494,-156,0.4751908396946565
78382,ROCKPORT,TX,7816,11738,3922,0.6002863864171014
78383,SANDIA,TX,1044,1406,362,0.5738775510204082
78384,SAN DIEGO,TX,920,1001,81,0.5210827693909422
78387,SINTON,TX,2871,2713,-158,0.48585243553008595
78389,SKIDMORE,TX,281,234,-47,0.45436893203883494
78390,TAFT,TX,1505,1425,-80,0.4863481228668942
78393,WOODSBORO,TX,320,335,15,0.5114503816793893
78401,CORP CHRISTI,TX,267,228,-39,0.46060606060606063
78401,CORPUS CHRISTI,TX,2735,2266,-469,0.45310937812437513
78402,CORPUS CHRISTI,TX,232,236,4,0.5042735042735043
78403,CORP CHRISTI,TX,0,61,61,1
78403,CORPUS CHRISTI,TX,136,420,284,0.7553956834532374
78404,CORPUS CHRISTI,TX,6912,5332,-1580,0.4354786017641294
78405,CORPUS CHRISTI,TX,4134,3592,-542,0.46492363448097335
78406,CORPUS CHRISTI,TX,165,212,47,0.5623342175066313
78407,CORP CHRISTI,TX,69,57,-12,0.4523809523809524
78407,CORPUS CHRISTI,TX,467,202,-265,0.30194319880418535
78408,CORP CHRISTI,TX,164,158,-6,0.4906832298136646
78408,CORPUS CHRISTI,TX,3740,3233,-507,0.46364548974616376
78409,CORP CHRISTI,TX,55,74,19,0.5736434108527132
78409,CORPUS CHRISTI,TX,806,716,-90,0.4704336399474376
78410,CORP CHRISTI,TX,218,211,-7,0.49184149184149184
78410,CORPUS CHRISTI,TX,9394,8908,-486,0.48672276253961316
78411,CORP CHRISTI,TX,823,810,-13,0.4960195958358849
78411,CORPUS CHRISTI,TX,8891,8063,-828,0.47558098383862213
78412,CORP CHRISTI,TX,1978,1740,-238,0.4679935449166218
78412,CORPUS CHRISTI,TX,17063,14261,-2802,0.4552739113778572
78413,CORPUS CHRISTI,TX,16228,14189,-2039,0.4664825590952428
78414,CORPUS CHRISTI,TX,19599,20595,996,0.512389908941633
78415,CORP CHRISTI,TX,261,245,-16,0.4841897233201581
78415,CORPUS CHRISTI,TX,11486,11010,-476,0.4894203413940256
78416,CORP CHRISTI,TX,137,121,-16,0.4689922480620155
78416,CORPUS CHRISTI,TX,2783,2475,-308,0.4707112970711297
78417,CORP CHRISTI,TX,57,46,-11,0.44660194174757284
78417,CORPUS CHRISTI,TX,1131,1241,110,0.5231871838111298
78418,CORPUS CHRISTI,TX,15757,16116,359,0.5056317259122141
78426,CORPUS CHRISTI,TX,108,12,-96,0.1
78427,CORP CHRISTI,TX,11,141,130,0.9276315789473685
78427,CORPUS CHRISTI,TX,519,747,228,0.590047393364929
78460,CORP CHRISTI,TX,11,16,5,0.5925925925925926
78460,CORPUS CHRISTI,TX,85,410,325,0.8282828282828283
78463,CORP CHRISTI,TX,13,35,22,0.7291666666666666
78463,CORPUS CHRISTI,TX,76,187,111,0.7110266159695817
78465,CORPUS CHRISTI,TX,213,24,-189,0.10126582278481013
78466,CORP CHRISTI,TX,45,59,14,0.5673076923076923
78466,CORPUS CHRISTI,TX,458,847,389,0.6490421455938697
78467,CORP CHRISTI,TX,12,13,1,0.52
78467,CORPUS CHRISTI,TX,430,928,498,0.6833578792341679
78468,CORP CHRISTI,TX,23,53,30,0.6973684210526315
78468,CORPUS CHRISTI,TX,190,453,263,0.7045101088646968
78469,CORP CHRISTI,TX,15,15,0,0.5
78469,CORPUS CHRISTI,TX,147,422,275,0.7416520210896309
78480,CORPUS CHRISTI,TX,732,928,196,0.5590361445783133
78501,MCALLEN,TX,15616,13947,-1669,0.47177214761695363
78502,MCALLEN,TX,841,1726,885,0.6723802103622906
78503,MCALLEN,TX,4313,3862,-451,0.4724159021406728
78504,MCALLEN,TX,14011,14123,112,0.5019904741593801
78505,MCALLEN,TX,86,224,138,0.7225806451612903
78516,ALAMO,TX,6554,10213,3659,0.6091131389037991
78520,BROWNSVILLE,TX,10728,11076,348,0.5079801871216291
78521,BROWNSVILLE,TX,13899,13675,-224,0.4959382026546747
78522,BROWNSVILLE,TX,40,411,371,0.9113082039911308
78523,BROWNSVILLE,TX,256,632,376,0.7117117117117117
78526,BROWNSVILLE,TX,8227,8936,709,0.5206548971625007
78535,COMBES,TX,11,82,71,0.8817204301075269
78537,DONNA,TX,7777,11270,3493,0.591694230062477
78538,EDCOUCH,TX,1290,1384,94,0.5175766641735228
78539,EDINBURG,TX,11274,9823,-1451,0.46561122434469354
78540,EDINBURG,TX,1099,1651,552,0.6003636363636363
78541,EDINBURG,TX,9497,9190,-307,0.4917857333975491
78542,EDINBURG,TX,8325,9772,1447,0.5399790020445377
78543,ELSA,TX,409,467,58,0.5331050228310502
78547,GARCIASVILLE,TX,52,11,-41,0.1746031746031746
78548,GRULLA,TX,327,160,-167,0.32854209445585214
78548,LA GRULLA,TX,14,0,-14,0
78549,HARGILL,TX,11,0,-11,0
78550,HARLINGEN,TX,13918,13967,49,0.5008786085709163
78551,HARLINGEN,TX,31,26,-5,0.45614035087719296
78552,HARLINGEN,TX,8690,11604,2914,0.5717946190992411
78553,HARLINGEN,TX,336,917,581,0.7318435754189944
78557,HIDALGO,TX,1145,1635,490,0.5881294964028777
78558,LA BLANCA,TX,29,27,-2,0.48214285714285715
78559,LA FERIA,TX,2915,3561,646,0.5498764669549104
78560,LA JOYA,TX,344,367,23,0.5161744022503516
78561,LASARA,TX,14,0,-14,0
78562,LA VILLA,TX,168,11,-157,0.061452513966480445
78563,LINN,TX,0,11,11,1
78566,BAYVIEW,TX,101,77,-24,0.43258426966292135
78566,LOS FRESNOS,TX,3452,4086,634,0.5420535951180685
78569,LYFORD,TX,149,262,113,0.6374695863746959
78570,MERCEDES,TX,4796,5984,1188,0.5551020408163265
78572,MISSION,TX,20487,25044,4557,0.5500428279633656
78572,PALMVIEW,TX,1560,2436,876,0.6096096096096096
78573,ALTON,TX,1306,1514,208,0.5368794326241135
78573,MISSION,TX,4163,5253,1090,0.5578802039082413
78573,PALMHURST,TX,131,170,39,0.5647840531561462
78574,MISSION,TX,5517,6756,1239,0.5504766560743095
78574,PALMVIEW,TX,130,146,16,0.5289855072463768
78575,OLMITO,TX,592,734,142,0.5535444947209653
78575,RANCHO VIEJO,TX,730,982,252,0.5735981308411215
78576,PENITAS,TX,908,1041,133,0.5341200615700359
78577,PHARR,TX,14853,15516,663,0.5109157364417662
78578,LAGUNA VISTA,TX,1900,3881,1981,0.6713371389033039
78578,PORT ISABEL,TX,2102,2053,-49,0.4941034897713598
78579,PROGRESO,TX,33,55,22,0.625
78580,RAYMONDVILLE,TX,2235,2366,131,0.5142360356444251
78582,RIO GRANDE CITY,TX,5580,3399,-2181,0.37854994988306045
78583,RIO HONDO,TX,910,1626,716,0.6411671924290221
78584,ROMA,TX,1052,1206,154,0.5341009743135519
78586,BROWNSVILLE,TX,174,181,7,0.5098591549295775
78586,SAN BENITO,TX,7284,8487,1203,0.5381396233593304
78589,SAN JUAN,TX,5397,5472,75,0.5034501794093292
78592,SANTA MARIA,TX,11,0,-11,0
78593,SANTA ROSA,TX,323,539,216,0.6252900232018561
78594,SEBASTIAN,TX,11,16,5,0.5925925925925926
78595,SULLIVAN CITY,TX,342,476,134,0.5819070904645477
78596,WESLACO,TX,8651,10725,2074,0.5535198183319571
78597,S PADRE ISLE,TX,62,776,714,0.9260143198090692
78597,SOUTH PADRE ISLAND,TX,2285,6697,4412,0.7456023157425963
78598,PORT MANSFIELD,TX,22,76,54,0.7755102040816326
78599,WESLACO,TX,4534,5371,837,0.542251388187784
78602,BASTROP,TX,13193,15423,2230,0.5389642158233157
78605,BERTRAM,TX,2016,2908,892,0.5905767668562144
78606,BLANCO,TX,2145,3128,983,0.5932106959984829
78608,BRIGGS,TX,49,78,29,0.6141732283464567
78609,BUCHANAN DAM,TX,1203,1162,-41,0.4913319238900634
78610,BUDA,TX,14818,18779,3961,0.5589487156591363
78610,CREEDMOOR,TX,371,441,70,0.5431034482758621
78611,BURNET,TX,7366,6920,-446,0.4843903121937561
78612,CEDAR CREEK,TX,4206,5393,1187,0.561829357224711
78613,CEDAR PARK,TX,38810,39080,270,0.5017332135062267
78615,COUPLAND,TX,165,557,392,0.7714681440443213
78616,DALE,TX,2169,2408,239,0.5261088048940354
78617,DEL VALLE,TX,5846,7145,1299,0.5499961511815873
78618,DOSS,TX,0,13,13,1
78619,DRIFTWOOD,TX,1542,2194,652,0.5872591006423983
78620,DRIPPING SPGS,TX,622,993,371,0.61486068111455106
78620,DRIPPING SPRINGS,TX,6268,9541,3273,0.6035169839964577
78621,ELGIN,TX,7410,9327,1917,0.5572683276572863
78623,FISCHER,TX,462,1069,607,0.6982364467668191
78624,FREDERICKSBURG,TX,9335,10219,884,0.5226040707783574
78626,GEORGETOWN,TX,18508,25015,6507,0.5747535785676539
78627,GEORGETOWN,TX,1255,1892,637,0.6012074992055926
78628,GEORGETOWN,TX,16594,24429,7835,0.5954952100041441
78629,GONZALES,TX,3605,3723,118,0.5080513100436681
78630,CEDAR PARK,TX,1317,1754,437,0.5711494627157278
78631,HARPER,TX,820,1024,204,0.5553145336225597
78632,HARWOOD,TX,22,40,18,0.6451612903225806
78633,GEORGETOWN,TX,10325,14137,3812,0.5779167688659962
78634,HUTTO,TX,15756,21020,5264,0.571568414183163
78636,JOHNSON CITY,TX,1320,1637,317,0.5536016232668245
78638,KINGSBURY,TX,703,668,-35,0.48723559445660103
78639,KINGSLAND,TX,4252,4671,419,0.5234786506780231
78640,KYLE,TX,24279,29594,5315,0.5493289774098342
78641,LEANDER,TX,31656,47082,15426,0.5979577840432828
78642,LIBERTY HILL,TX,7667,13781,6114,0.6425307720999627
78643,LLANO,TX,2527,2794,267,0.5250892689344109
78643,SUNRISE BEACH,TX,208,268,60,0.5630252100840336
78644,LOCKHART,TX,7649,7334,-315,0.4894880864980311
78645,JONESTOWN,TX,1213,1650,437,0.5763185469786937
78645,LAGO VISTA,TX,4304,6207,1903,0.5905242127295215
78645,LEANDER,TX,515,723,208,0.5840064620355412
78645,POINT VENTURE,TX,167,240,73,0.5896805896805897
78646,LEANDER,TX,966,1261,295,0.566232599910193
78648,LULING,TX,2635,2564,-71,0.4931717638007309
78650,MC DADE,TX,210,395,185,0.6528925619834711
78650,MCDADE,TX,68,140,72,0.6730769230769231
78651,MC NEIL,TX,0,11,11,1
78652,MANCHACA,TX,2047,2958,911,0.591008991008991
78653,MANOR,TX,10132,15395,5263,0.60308692756689
78654,GRANITE SHOALS,TX,585,586,1,0.5004269854824936
78654,MARBLE FALLS,TX,7274,7710,436,0.5145488521089162
78654,MEADOWLAKES,TX,372,374,2,0.5013404825737265
78655,MARTINDALE,TX,841,805,-36,0.4890643985419198
78656,MAXWELL,TX,722,1022,300,0.5860091743119266
78657,COTTONWOOD SHORES,TX,2282,2685,403,0.540567747131065
78657,HORSESHOE BAY,TX,1316,1608,292,0.5499316005471956
78659,PAIGE,TX,1040,1442,402,0.580983078162772
78660,PFLUGERVILLE,TX,47303,54044,6741,0.5332570278350617
78661,PRAIRIE LEA,TX,0,12,12,1
78662,RED ROCK,TX,651,803,152,0.5522696011004127
78663,CYPRESS MILL,TX,11,0,-11,0
78663,ROUND MOUNTAIN,TX,65,152,87,0.7004608294930875
78664,ROUND ROCK,TX,31463,27565,-3898,0.4669817713627431
78665,ROUND ROCK,TX,28439,31882,3443,0.528538983107044
78666,SAN MARCOS,TX,37080,34616,-2464,0.4828163356393662
78667,SAN MARCOS,TX,1919,1197,-722,0.38414634146341464
78669,SPICEWOOD,TX,5091,5945,854,0.5386915549111997
78671,STONEWALL,TX,34,142,108,0.8068181818181818
78672,TOW,TX,157,193,36,0.5514285714285714
78674,WEIR,TX,25,24,-1,0.4897959183673469
78676,WIMBERLEY,TX,5905,6740,835,0.5330170027678924
78680,ROUND ROCK,TX,887,1491,604,0.6269974768713205
78681,ROUND ROCK,TX,20150,20177,27,0.5003347633099412
78683,ROUND ROCK,TX,1372,2108,736,0.6057471264367816
78691,PFLUGERVILLE,TX,1339,2225,886,0.6242985409652076
78701,AUSTIN,TX,16583,15463,-1120,0.48252512013979904
78702,AUSTIN,TX,22017,20826,-1191,0.486100413136335
78703,AUSTIN,TX,17263,14930,-2333,0.4637654148417358
78704,AUSTIN,TX,48550,40288,-8262,0.4534996285373376
78705,AUSTIN,TX,17486,9930,-7556,0.3621972570761599
78708,AUSTIN,TX,882,1425,543,0.6176853055916776
78709,AUSTIN,TX,860,1068,208,0.553941908713693
78711,AUSTIN,TX,66,334,268,0.835
78713,AUSTIN,TX,0,56,56,1
78714,AUSTIN,TX,718,1466,748,0.6712454212454212
78715,AUSTIN,TX,894,1309,415,0.5941897412619156
78716,AUSTIN,TX,478,875,397,0.6467110125646711
78716,DEVALLE,TX,0,14,14,1
78717,AUSTIN,TX,19782,21040,1258,0.5154083582382049
78718,AUSTIN,TX,0,35,35,1
78719,AUSTIN,TX,188,145,-43,0.43543543543543545
78720,AUSTIN,TX,1068,1416,348,0.5700483091787439
78721,AUSTIN,TX,6714,6407,-307,0.4883011965551406
78722,AUSTIN,TX,5522,4520,-1002,0.4501095399322844
78723,AUSTIN,TX,20615,18899,-1716,0.4782861770511717
78724,AUSTIN,TX,8969,10718,1749,0.5444201757504953
78725,AUSTIN,TX,3704,4248,544,0.53420523138833
78726,AUSTIN,TX,9528,8884,-644,0.4825114056050402
78727,AUSTIN,TX,21699,18865,-2834,0.4650675475791342
78727,SA,TX,319,306,-13,0.4896
78728,AUSTIN,TX,19838,18057,-1781,0.4765008576329331
78729,AUSTIN,TX,22595,19236,-3359,0.4598503502187373
78730,AUSTIN,TX,5243,4919,-324,0.4840582562487699
78731,AUSTIN,TX,16445,15469,-976,0.48470890518267845
78732,AUSTIN,TX,6402,6568,166,0.5063993831919815
78733,AUSTIN,TX,2320,2598,278,0.5282635217568117
78733,BEE CAVE,TX,57,65,8,0.5327868852459017
78734,AUSTIN,TX,5805,6508,703,0.5285470640786161
78734,LAKEWAY,TX,4293,4888,595,0.5324038775732491
78735,AUSTIN,TX,15410,14686,-724,0.4879718234981393
78736,AUSTIN,TX,5107,5231,124,0.5059972915457536
78737,AUSTIN,TX,4987,7804,2817,0.6101164881557345
78737,SA,TX,676,962,286,0.5873015873015873
78737,SF,TX,169,198,29,0.5395095367847411
78738,AUSTIN,TX,7779,10414,2635,0.572417962952784
78738,BEE CAVE,TX,1277,1616,339,0.55858969927411
78738,LAKEWAY,TX,612,775,163,0.558759913482336
78738,THE HILLS,TX,2833,3389,556,0.5446801671488267
78739,AUSTIN,TX,4600,5741,1141,0.555168745769268
78741,AUSTIN,TX,40966,32353,-8613,0.44126351968793903
78742,AUSTIN,TX,25,25,0,0.5
78744,AUSTIN,TX,23964,23018,-946,0.48993231450342684
78745,AUSTIN,TX,41440,35382,-6058,0.4605711905443753
78746,AUSTIN,TX,13828,12674,-1154,0.478228058259754
78746,WEST LAKE HILLS,TX,2099,1887,-212,0.4734069242348219
78747,AUSTIN,TX,9477,11107,1630,0.5395938593082006
78748,AUSTIN,TX,32546,29966,-2580,0.4793639621192731
78749,AUSTIN,TX,18944,17800,-1144,0.48443283257130415
78750,AUSTIN,TX,14334,13228,-1106,0.47993614396633044
78751,AUSTIN,TX,17354,12906,-4448,0.42650363516192996
78752,AUSTIN,TX,14097,11827,-2270,0.4562181762073754
78753,AUSTIN,TX,27732,22382,-5350,0.4466217025182584
78754,AUSTIN,TX,15078,15471,393,0.5064322891092998
78755,AUSTIN,TX,645,682,37,0.5139412207987942
78756,AUSTIN,TX,6464,5611,-853,0.4646790890269151
78757,AUSTIN,TX,14677,12499,-2178,0.459927877539005
78758,AUSTIN,TX,37198,29937,-7261,0.4459223951739033
78759,AUSTIN,TX,29731,25953,-3778,0.4660764312908555
78760,AUSTIN,TX,912,1749,837,0.657271702367531
78761,AUSTIN,TX,720,1625,905,0.6929637526652452
78762,AUSTIN,TX,136,488,352,0.782051282051282
78763,AUSTIN,TX,176,223,47,0.5588972431077694
78765,AUSTIN,TX,637,349,-288,0.3539553752535497
78766,AUSTIN,TX,370,611,241,0.6228338430173292
78767,AUSTIN,TX,563,778,215,0.5801640566741237
78768,AUSTIN,TX,78,60,-18,0.43478260869565216
78801,UVALDE,TX,6855,5589,-1266,0.4491321118611379
78802,UVALDE,TX,786,767,-19,0.49388280746941404
78832,BRACKETTVILLE,TX,919,642,-277,0.41127482383087766
78833,CAMP WOOD,TX,148,205,57,0.5807365439093485
78834,CARRIZO SPGS,TX,133,138,5,0.5092250922509225
78834,CARRIZO SPRINGS,TX,1774,1678,-96,0.4860950173812283
78838,CONCAN,TX,0,75,75,1
78839,CRYSTAL CITY,TX,1870,1859,-11,0.49852507374631266
78840,DEL RIO,TX,13321,11826,-1495,0.4702747842685012
78841,DEL RIO,TX,205,143,-62,0.4109195402298851
78842,DEL RIO,TX,381,588,207,0.6068111455108359
78850,D HANIS,TX,0,54,54,1
78852,EAGLE PASS,TX,7237,6797,-440,0.4843237850933447
78853,EAGLE PASS,TX,818,1451,633,0.6394887615689732
78861,HONDO,TX,3525,3811,286,0.5194929116684842
78870,KNIPPA,TX,13,12,-1,0.48
78872,LA PRYOR,TX,61,11,-50,0.1527777777777778
78873,LEAKEY,TX,463,536,73,0.5365365365365365
78880,ROCKSPRINGS,TX,383,168,-215,0.30490018148820325
78881,SABINAL,TX,139,204,65,0.5947521865889213
78884,UTOPIA,TX,63,158,95,0.7149321266968326
78932,CARMINE,TX,46,33,-13,0.4177215189873418
78933,CAT SPRING,TX,50,116,66,0.6987951807228916
78934,COLUMBUS,TX,2415,2223,-192,0.4793014230271669
78935,ALLEYTON,TX,24,52,28,0.6842105263157895
78938,ELLINGER,TX,11,0,-11,0
78940,FAYETTEVILLE,TX,225,469,244,0.6757925072046109
78941,FLATONIA,TX,514,712,198,0.5807504078303426
78942,GIDDINGS,TX,3064,2818,-246,0.47908874532471946
78945,LA GRANGE,TX,3524,3540,16,0.5011325028312571
78946,LEDBETTER,TX,25,91,66,0.7844827586206896
78947,LEXINGTON,TX,1474,1406,-68,0.48819444444444443
78948,LINCOLN,TX,37,65,28,0.6372549019607843
78950,NEW ULM,TX,268,452,184,0.6277777777777778
78953,ROSANKY,TX,101,190,89,0.6529209621993127
78954,ROUND TOP,TX,259,273,14,0.5131578947368421
78956,SCHULENBURG,TX,1468,1615,147,0.5238404151800194
78957,SMITHVILLE,TX,4680,4264,-416,0.47674418604651164
78959,WAELDER,TX,159,265,106,0.625
78962,WEIMAR,TX,1129,1253,124,0.5260285474391267
78963,WEST POINT,TX,23,23,0,0.5
79005,BOOKER,TX,180,33,-147,0.15492957746478872
79007,BORGER,TX,5118,4335,-783,0.4585845763249762
79008,BORGER,TX,123,117,-6,0.4875
79009,BOVINA,TX,154,46,-108,0.23
79010,BOYS RANCH,TX,120,0,-120,0
79012,BUSHLAND,TX,0,11,11,1
79013,CACTUS,TX,2086,445,-1641,0.1758198340576847
79014,CANADIAN,TX,943,868,-75,0.4792932081722805
79015,CANYON,TX,9263,8983,-280,0.49232708538857833
79019,CLAUDE,TX,206,338,132,0.6213235294117647
79022,DALHART,TX,3863,2996,-867,0.436798367108908
79027,DIMMITT,TX,1555,1064,-491,0.4062619320351279
79029,DUMAS,TX,4801,4286,-515,0.4716628150104545
79031,EARTH,TX,78,39,-39,0.3333333333333333
79034,FOLLETT,TX,32,0,-32,0
79035,FRIONA,TX,1101,708,-393,0.3913764510779436
79036,FRITCH,TX,1967,1563,-404,0.44277620396600564
79039,GROOM,TX,13,12,-1,0.48
79040,GRUVER,TX,189,11,-178,0.055
79041,HALE CENTER,TX,354,261,-93,0.424390243902439
79042,HAPPY,TX,0,102,102,1
79045,HEREFORD,TX,4998,4145,-853,0.45335229137044736
79046,HIGGINS,TX,11,0,-11,0
79052,KRESS,TX,63,43,-20,0.4056603773584906
79054,LEFORS,TX,11,13,2,0.5416666666666666
79057,MCLEAN,TX,23,0,-23,0
79059,MIAMI,TX,40,56,16,0.5833333333333334
79063,NAZARETH,TX,0,11,11,1
79064,OLTON,TX,245,74,-171,0.23197492163009403
79065,PAMPA,TX,6548,6141,-407,0.4839624871936323
79066,PAMPA,TX,312,110,-202,0.26066350710900477
79068,PANHANDLE,TX,647,599,-48,0.48073836276083465
79070,PERRYTON,TX,2666,2067,-599,0.43672089583773505
79072,PLAINVIEW,TX,7445,6308,-1137,0.45866356431324073
79073,PLAINVIEW,TX,115,204,89,0.6394984326018809
79079,SHAMROCK,TX,1152,804,-348,0.4110429447852761
79080,SKELLYTOWN,TX,36,0,-36,0
79081,SPEARMAN,TX,848,612,-236,0.4191780821917808
79083,STINNETT,TX,578,424,-154,0.4231536926147705
79084,STRATFORD,TX,520,164,-356,0.23976608187134502
79086,SUNRAY,TX,532,217,-315,0.2897196261682243
79087,TEXLINE,TX,11,0,-11,0
79088,TULIA,TX,1812,1539,-273,0.459265890778872
79092,VEGA,TX,178,77,-101,0.30196078431372547
79095,WELLINGTON,TX,492,575,83,0.5388940955951266
79096,WHEELER,TX,404,252,-152,0.38414634146341464
79097,WHITE DEER,TX,97,58,-39,0.3741935483870968
79098,WILDORADO,TX,0,12,12,1
79101,AMARILLO,TX,1937,1968,31,0.5039692701664533
79102,AMARILLO,TX,4525,3465,-1060,0.4336670838548185
79103,AMARILLO,TX,2788,2383,-405,0.4608392960742603
79104,AMARILLO,TX,1865,1519,-346,0.44887706855791965
79105,AMARILLO,TX,360,522,162,0.5918367346938775
79106,AMARILLO,TX,14670,11232,-3438,0.43363446838082004
79107,AMARILLO,TX,9732,8262,-1470,0.45915305101700565
79108,AMARILLO,TX,3442,3414,-28,0.49795799299883314
79109,AMARILLO,TX,20382,17700,-2682,0.4647865133133764
79110,AMARILLO,TX,8453,6301,-2152,0.4270706249152772
79111,AMARILLO,TX,635,642,7,0.5027407987470635
79114,AMARILLO,TX,988,1283,295,0.5649493615147512
79116,AMARILLO,TX,51,117,66,0.6964285714285714
79117,AMARILLO,TX,34,179,145,0.8403755868544601
79118,AMARILLO,TX,8620,9870,1250,0.533802055164954
79119,AMARILLO,TX,9395,10969,1574,0.5386466313101552
79120,AMARILLO,TX,551,786,235,0.5878833208676141
79121,AMARILLO,TX,2319,2217,-102,0.4887566137566138
79124,AMARILLO,TX,3166,3985,819,0.5572647182212278
79159,AMARILLO,TX,727,916,189,0.5575167376749848
79201,CHILDRESS,TX,1969,1978,9,0.5011401064099316
79225,CHILLICOTHE,TX,12,11,-1,0.4782608695652174
79226,CLARENDON,TX,461,528,67,0.5338725985844287
79226,HOWARDWICK,TX,189,177,-12,0.48360655737704916
79227,CROWELL,TX,197,145,-52,0.4239766081871345
79235,FLOYDADA,TX,964,953,-11,0.49713093375065204
79241,DALLAS,TX,15,19,4,0.5588235294117647
79241,LOCKNEY,TX,93,70,-23,0.4294478527607362
79245,MEMPHIS,TX,721,712,-9,0.49685973482205165
79248,PADUCAH,TX,744,486,-258,0.3951219512195122
79250,PETERSBURG,TX,13,0,-13,0
79252,QUANAH,TX,1082,1108,26,0.5059360730593607
79257,SILVERTON,TX,63,37,-26,0.37
79311,ABERNATHY,TX,798,799,1,0.5003130870381967
79312,AMHERST,TX,0,24,24,1
79313,ANTON,TX,98,93,-5,0.4869109947643979
79316,BROWNFIELD,TX,3396,2787,-609,0.4507520621057739
79322,CROSBYTON,TX,402,419,17,0.510353227771011
79323,DENVER CITY,TX,1297,1082,-215,0.4548129466162253
79325,FARWELL,TX,218,190,-28,0.46568627450980393
79329,IDALOU,TX,634,878,244,0.5806878306878307
79330,JUSTICEBURG,TX,11,0,-11,0
79331,LAMESA,TX,3328,2717,-611,0.44946236559139785
79336,LEVELLAND,TX,6422,4754,-1668,0.42537580529706515
79339,LITTLEFIELD,TX,1910,1983,73,0.5093758027228359
79342,LOOP,TX,0,11,11,1
79343,LORENZO,TX,143,127,-16,0.4703703703703704
79345,MEADOW,TX,12,14,2,0.5384615384615384
79346,MORTON,TX,133,150,17,0.5300353356890459
79347,MULESHOE,TX,1492,1397,-95,0.48355832467982
79350,NEW DEAL,TX,0,68,68,1
79351,ODONNELL,TX,49,0,-49,0
79355,PLAINS,TX,0,61,61,1
79356,POST,TX,1753,1317,-436,0.42899022801302933
79357,RALLS,TX,329,340,11,0.5082212257100149
79358,ROPESVILLE,TX,23,165,142,0.8776595744680851
79359,SEAGRAVES,TX,303,160,-143,0.34557235421166305
79360,SEMINOLE,TX,2929,2973,44,0.5037275499830566
79363,SHALLOWATER,TX,2217,2185,-32,0.4963652885052249
79364,SLATON,TX,2436,2467,31,0.5031613297980828
79366,RANSOM CANYON,TX,13,72,59,0.8470588235294118
79370,SPUR,TX,259,371,112,0.5888888888888889
79371,SUDAN,TX,80,105,25,0.5675675675675675
79372,SUNDOWN,TX,106,25,-81,0.19083969465648856
79373,TAHOKA,TX,652,768,116,0.5408450704225352
79379,WHITEFACE,TX,0,11,11,1
79381,NEW HOME,TX,49,104,55,0.6797385620915033
79381,WILSON,TX,112,223,111,0.6656716417910448
79382,WOLFFORTH,TX,3091,3809,718,0.5520289855072463
79401,LUBBOCK,TX,3549,2622,-927,0.42489061740398637
79403,LUBBOCK,TX,5051,4955,-96,0.49520287827303616
79404,LUBBOCK,TX,3293,3108,-185,0.48554913294797686
79407,LUBBOCK,TX,12521,11821,-700,0.4856215594445814
79408,LUBBOCK,TX,499,1061,562,0.6801282051282052
79410,LUBBOCK,TX,4687,3267,-1420,0.4107367362333417
79411,LUBBOCK,TX,3619,2962,-657,0.4500835739249354
79412,LUBBOCK,TX,6450,5431,-1019,0.45711640434306877
79413,LUBBOCK,TX,11021,7933,-3088,0.41853962224332597
79414,LUBBOCK,TX,11732,7912,-3820,0.4027692934229281
79415,LUBBOCK,TX,6250,5482,-768,0.4672690078418002
79416,LUBBOCK,TX,16255,13980,-2275,0.4623780386968745
79423,LUBBOCK,TX,17027,18592,1565,0.521968612257503
79424,LUBBOCK,TX,20659,22189,1530,0.5178538088125467
79452,LUBBOCK,TX,223,505,282,0.6936813186813187
79453,LUBBOCK,TX,68,36,-32,0.34615384615384615
79464,LUBBOCK,TX,444,939,495,0.6789587852494577
79490,LUBBOCK,TX,216,424,208,0.6625
79493,LUBBOCK,TX,1618,475,-1143,0.22694696607740086
79501,ANSON,TX,1415,1249,-166,0.46884384384384387
79502,ASPERMONT,TX,177,127,-50,0.41776315789473684
79504,BAIRD,TX,1131,1026,-105,0.4756606397774687
79506,BLACKWELL,TX,0,25,25,1
79508,BUFFALO GAP,TX,330,508,178,0.6062052505966588
79510,CLYDE,TX,3271,3294,23,0.5017517136329017
79511,COAHOMA,TX,202,213,11,0.5132530120481927
79511,COHOAMA,TX,14,0,-14,0
79511,SAFB,TX,18,0,-18,0
79512,COLORADO CITY,TX,2395,2342,-53,0.4944057420308212
79520,HAMLIN,TX,1152,817,-335,0.414931437277806
79521,HASKELL,TX,1196,1176,-20,0.4957841483979764
79521,RULE,TX,20,20,0,0.5
79525,HAWLEY,TX,964,1185,221,0.5514192647743137
79526,HERMLEIGH,TX,25,26,1,0.5098039215686274
79528,JAYTON,TX,11,0,-11,0
79529,KNOX CITY,TX,246,302,56,0.551094890510949
79530,LAWN,TX,13,14,1,0.5185185185185185
79532,LORAINE,TX,73,51,-22,0.4112903225806452
79533,LUEDERS,TX,0,13,13,1
79536,MERKEL,TX,1516,1641,125,0.5197972758948368
79541,OVALO,TX,23,150,127,0.8670520231213873
79543,ROBY,TX,98,189,91,0.6585365853658537
79544,ROCHESTER,TX,0,25,25,1
79545,ROSCOE,TX,204,201,-3,0.4962962962962963
79546,ROTAN,TX,855,611,-244,0.41678035470668484
79547,RULE,TX,42,26,-16,0.38235294117647056
79549,SNYDER,TX,5433,4333,-1100,0.44368216260495597
79550,SNYDER,TX,131,255,124,0.6606217616580311
79553,STAMFORD,TX,1450,1267,-183,0.46632315053367684
79556,SWEETWATER,TX,5643,5265,-378,0.48267326732673266
79562,TUSCOLA,TX,1457,2095,638,0.5898085585585585
79563,TYE,TX,424,408,-16,0.49038461538461536
79567,WINTERS,TX,1644,1232,-412,0.4283727399165508
79601,ABILENE,TX,10079,7982,-2097,0.44194673606112617
79602,ABILENE,TX,10346,10478,132,0.5031694199001152
79603,ABILENE,TX,9275,7754,-1521,0.45534088907158377
79604,ABILENE,TX,924,1289,365,0.5824672390420244
79605,ABILENE,TX,18754,13514,-5240,0.4188050080575183
79606,ABILENE,TX,15179,14505,-674,0.4886470826034227
79607,ABILENE,TX,102,113,11,0.5255813953488372
79607,DYESS AFB,TX,2116,2478,362,0.5393992163691772
79608,ABILENE,TX,1030,1186,156,0.5351985559566786
79701,MIDLAND,TX,9667,7280,-2387,0.429574555968608
79702,MIDLAND,TX,1280,1296,16,0.5031055900621118
79703,MIDLAND,TX,10488,6678,-3810,0.3890248164977281
79704,MIDLAND,TX,467,501,34,0.5175619834710744
79705,MIDLAND,TX,21744,18670,-3074,0.4619686247340031
79706,MIDLAND,TX,8572,8472,-100,0.49706641633419385
79707,MIDLAND,TX,19782,16594,-3188,0.4561798988343963
79708,MIDLAND,TX,1078,1166,88,0.5196078431372549
79710,MIDLAND,TX,769,1088,319,0.5858912224017232
79711,MIDLAND,TX,418,527,109,0.5576719576719577
79712,MIDLAND,TX,74,90,16,0.5487804878048781
79714,ANDREWS,TX,6435,4831,-1604,0.4288123557606959
79718,BALMORHEA,TX,0,13,13,1
79719,BARSTOW,TX,11,0,-11,0
79720,BIG SPRING,TX,10885,9402,-1483,0.46344949967959775
79721,BIG SPRING,TX,1683,1166,-517,0.4092664092664093
79731,CRANE,TX,1128,905,-223,0.4451549434333497
79734,FORT DAVIS,TX,493,413,-80,0.45584988962472406
79734,MCDONALD OBS,TX,50,0,-50,0
79735,FORT STOCKTON,TX,4121,3250,-871,0.4409171075837742
79739,GARDEN CITY,TX,13,0,-13,0
79741,GOLDSMITH,TX,19,26,7,0.5777777777777777
79742,GRANDFALLS,TX,11,14,3,0.56
79743,IMPERIAL,TX,11,0,-11,0
79744,IRAAN,TX,38,11,-27,0.22448979591836735
79745,KERMIT,TX,2123,1687,-436,0.4427821522309711
79752,MC CAMEY,TX,327,160,-167,0.32854209445585214
79752,MCCAMEY,TX,80,63,-17,0.4405594405594406
79756,MONAHANS,TX,5373,3292,-2081,0.3799192152336988
79758,GARDENDALE,TX,1230,1141,-89,0.48123154787009703
79760,ODESSA,TX,1265,1755,490,0.5811258278145696
79761,ODESSA,TX,12297,8233,-4064,0.40102289332683877
79762,ODESSA,TX,20062,14736,-5326,0.4234726133685844
79763,ODESSA,TX,11880,7577,-4303,0.3894228298298813
79764,ODESSA,TX,7142,5950,-1192,0.4544760158875649
79765,ODESSA,TX,9426,11047,1621,0.5395887266155425
79766,ODESSA,TX,2122,2001,-121,0.4853262187727383
79768,ODESSA,TX,1180,1249,69,0.5142033758748457
79769,ODESSA,TX,789,770,-19,0.4939063502245029
79770,ORLA,TX,0,11,11,1
79772,PECOS,TX,2618,2517,-101,0.4901655306718598
79778,RANKIN,TX,26,22,-4,0.4583333333333333
79782,STANTON,TX,1374,999,-375,0.42098609355246525
79788,WICKETT,TX,34,0,-34,0
79789,WINK,TX,198,104,-94,0.3443708609271523
79821,ANTHONY,TX,660,669,9,0.5033860045146726
79821,VINTON,TX,73,72,-1,0.496551724137931
79830,ALPINE,TX,2981,2574,-407,0.4633663366336634
79831,ALPINE,TX,548,566,18,0.5080789946140036
79834,BIG BEND NATIONAL PARK,TX,41,35,-6,0.4605263157894737
79835,CANUTILLO,TX,1956,2065,109,0.5135538423277791
79836,CLINT,TX,1087,1196,109,0.5238720981165134
79837,DELL CITY,TX,0,11,11,1
79838,FABENS,TX,731,824,93,0.5299035369774919
79839,FORT HANCOCK,TX,12,12,0,0.5
79842,MARATHON,TX,0,12,12,1
79843,MARFA,TX,724,521,-203,0.41847389558232934
79845,PRESIDIO,TX,141,194,53,0.5791044776119403
79849,EL PASO,TX,32,21,-11,0.39622641509433965
79849,SAN ELIZARIO,TX,1581,1649,68,0.5105263157894737
79851,SIERRA BLANCA,TX,45,14,-31,0.23728813559322035
79852,LAJITAS,TX,26,16,-10,0.38095238095238093
79852,TERLINGUA,TX,140,289,149,0.6736596736596736
79853,TORNILLO,TX,0,36,36,1
79855,VAN HORN,TX,396,355,-41,0.47270306258322237
79901,EL PASO,TX,4201,4252,51,0.5030166804684727
79902,EL PASO,TX,8100,6703,-1397,0.45281361886104166
79903,EL PASO,TX,4741,4359,-382,0.479010989010989
79904,EL PASO,TX,14611,11366,-3245,0.4375409015667706
79905,EL PASO,TX,5609,4906,-703,0.4665715644317642
79906,EL PASO,TX,4865,3173,-1692,0.3947499377954715
79906,FORT BLISS,TX,664,583,-81,0.46752205292702487
79907,EL PASO,TX,12467,10393,-2074,0.4546369203849519
79908,EL PASO,TX,2789,2342,-447,0.4564412395244592
79908,FORT BLISS,TX,178,165,-13,0.48104956268221577
79910,EL PASO,TX,0,12,12,1
79911,EL PASO,TX,3396,4421,1025,0.5655622361519764
79912,EL PASO,TX,30998,27142,-3856,0.4668386652906777
79913,EL PASO,TX,835,1292,457,0.60742830277386
79914,EL PASO,TX,179,234,55,0.5665859564164649
79915,EL PASO,TX,9458,8266,-1192,0.4663732791694877
79917,EL PASO,TX,576,915,339,0.613682092555332
79922,EL PASO,TX,1706,1862,156,0.5218609865470852
79923,EL PASO,TX,16,71,55,0.8160919540229885
79924,EL PASO,TX,19824,16891,-2933,0.46005719733079126
79925,EL PASO,TX,15233,12192,-3041,0.44455788514129446
79926,EL PASO,TX,57,152,95,0.7272727272727273
79927,EL PASO,TX,2775,3343,568,0.5464203988231449
79927,SOCORRO,TX,3123,3630,507,0.5375388716126166
79928,EL PASO,TX,8248,11230,2982,0.576547900195092
79928,HORIZON CITY,TX,5913,8651,2738,0.5939989014007141
79929,EL PASO,TX,25,262,237,0.9128919860627178
79929,LUBBOCK,TX,12,0,-12,0
79930,EL PASO,TX,8792,7352,-1440,0.4554013875123885
79931,EL PASO,TX,23,104,81,0.8188976377952756
79932,EL PASO,TX,7064,8098,1034,0.5340984039044981
79934,EL PASO,TX,13178,11124,-2054,0.4577401036951691
79935,EL PASO,TX,5823,5200,-623,0.47174090537966074
79936,EL PASO,TX,26714,24166,-2548,0.4749606918238994
79937,EL PASO,TX,22,116,94,0.8405797101449275
79938,EL PASO,TX,25485,26808,1323,0.5126498766565315
79995,EL PASO,TX,23,106,83,0.8217054263565892
79996,EL PASO,TX,1563,1068,-495,0.40592930444697833
79997,EL PASO,TX,341,410,69,0.5459387483355526
79998,EL PASO,TX,760,129,-631,0.14510686164229472
80001,ARVADA,CO,887,962,75,0.5202812330989725
80002,ARVADA,CO,13443,12733,-710,0.4864379584352078
80002,COMMERCE CITY,CO,269,285,16,0.5144404332129964
80003,ARVADA,CO,20729,15392,-5337,0.4261233077711027
80003,WESTMINSTER,CO,379,303,-76,0.4442815249266862
80004,ARVADA,CO,15945,15545,-400,0.4936487773896475
80005,ARVADA,CO,9758,9721,-37,0.4990502592535551
80005,WESTMINSTER,CO,145,129,-16,0.4708029197080292
80006,ARVADA,CO,1213,919,-294,0.43105065666041276
80007,ARVADA,CO,5375,7359,1984,0.5779016805402859
80010,AURORA,CO,21309,16516,-4793,0.4366424322538004
80011,AURORA,CO,25939,22722,-3217,0.46694478124165145
80012,AURORA,CO,29627,24766,-4861,0.45531594138951703
80013,AURORA,CO,33112,30586,-2526,0.48017206191717166
80014,AURORA,CO,28451,25018,-3433,0.46789728627803023
80014,DENVER,CO,702,655,-47,0.48268238761974946
80015,AURORA,CO,7661,7972,311,0.5099469071835221
80015,CENTENNIAL,CO,18575,19333,758,0.5099978896275192
80016,AURORA,CO,25253,31001,5748,0.5510897002879795
80016,CENTENNIAL,CO,443,568,125,0.5618199802176064
80016,FOXFIELD,CO,448,502,54,0.5284210526315789
80017,AURORA,CO,20635,18478,-2157,0.47242604760565543
80018,AURORA,CO,6501,9484,2983,0.5933062245855489
80019,AURORA,CO,2027,4205,2178,0.6747432605905006
80020,BROOMFIELD,CO,17611,17189,-422,0.4939367816091954
80020,WESTMINSTER,CO,9874,9244,-630,0.4835233811068103
80021,BROOMFIELD,CO,23024,22484,-540,0.4940669772347719
80021,WESTMINSTER,CO,3645,3599,-46,0.49682495858641634
80021,WR,CO,1072,967,-105,0.47425208435507604
80022,COMMERCE CITY,CO,20475,22806,2331,0.5269286754002911
80022,WR,CO,346,388,42,0.5286103542234333
80023,ARVADA,CO,305,418,113,0.5781466113416321
80023,BROOMFIELD,CO,8926,11504,2578,0.5630934899657367
80023,THORNTON,CO,1251,1431,180,0.5335570469798657
80023,WESTMINSTER,CO,684,870,186,0.5598455598455598
80024,DUPONT,CO,87,27,-60,0.23684210526315788
80026,LAFAYETTE,CO,16341,17081,740,0.5110705523308001
80027,LOUISVILLE,CO,15135,13108,-2027,0.4641150019473852
80027,SUPERIOR,CO,6669,6208,-461,0.48209986798167276
80030,WESTMINSTER,CO,7849,6823,-1026,0.46503544165757904
80031,WESTMINSTER,CO,19368,17829,-1539,0.4793128478103073
80033,WHEAT RIDGE,CO,15254,13994,-1260,0.47846006564551424
80033,WR,CO,790,757,-33,0.48933419521654814
80034,BROOMFIELD,CO,15,14,-1,0.4827586206896552
80034,WHEAT RIDGE,CO,534,796,262,0.5984962406015037
80035,WESTMINSTER,CO,835,1101,266,0.568698347107438
80036,WESTMINSTER,CO,130,311,181,0.7052154195011338
80037,COMMERCE CITY,CO,146,433,287,0.7478411053540587
80038,BROOMFIELD,CO,697,818,121,0.5399339933993399
80040,AURORA,CO,14,188,174,0.9306930693069307
80040,USAF ACADEMY,CO,0,14,14,1
80041,AURORA,CO,414,980,566,0.703012912482066
80042,AURORA,CO,280,603,323,0.6828992072480181
80044,AURORA,CO,874,1411,537,0.6175054704595186
80045,AURORA,CO,1498,1441,-57,0.49030282408982645
80046,AURORA,CO,1147,1268,121,0.5250517598343686
80047,AURORA,CO,1478,2214,736,0.5996749729144095
80101,AGATE,CO,0,11,11,1
80102,BENNETT,CO,3109,3208,99,0.5078359981003641
80103,BYERS,CO,1008,951,-57,0.48545176110260335
80104,CASTLE ROCK,CO,16802,20505,3703,0.549628755997534
80105,DEER TRAIL,CO,586,922,336,0.6114058355437666
80106,ELBERT,CO,1494,1772,278,0.5425597060624617
80107,ELIZABETH,CO,5140,6315,1175,0.5512876473155827
80108,CASTLE PINES,CO,4575,5787,1212,0.5584829183555298
80108,CASTLE ROCK,CO,8436,11393,2957,0.5745625094558475
80109,CASTLE ROCK,CO,10804,12649,1845,0.5393339871231826
80110,ENGLEWOOD,CO,15509,13797,-1712,0.47079096430765033
80111,CENTENNIAL,CO,4871,4372,-499,0.4730065995888781
80111,ENGLEWOOD,CO,6445,6155,-290,0.4884920634920635
80111,GREENWOOD VILLAGE,CO,10323,10163,-160,0.49609489407400176
80112,CENTENNIAL,CO,11855,11809,-46,0.49902805949966195
80112,ENGLEWOOD,CO,13367,13217,-150,0.49717875413782725
80112,GREENWOOD VILLAGE,CO,618,571,-47,0.4802354920100925
80113,ENGLEWOOD,CO,15271,14414,-857,0.4855651002189658
80116,FRANKTOWN,CO,1883,2011,128,0.5164355418592707
80117,KIOWA,CO,1273,1243,-30,0.4940381558028617
80118,LARKSPUR,CO,2258,2558,300,0.5311461794019934
80120,LITTLETON,CO,16103,14975,-1128,0.48185211403565226
80121,CENTENNIAL,CO,3632,3850,218,0.5145682972467255
80121,CHERRY HILLS VILLAGE,CO,114,160,46,0.583941605839416
80121,GREENWOOD VILLAGE,CO,1754,1988,234,0.5312667022982362
80121,LITTLETON,CO,709,826,117,0.5381107491856677
80122,CENTENNIAL,CO,10063,10803,740,0.5177321959168024
80122,LITTLETON,CO,2020,2178,158,0.5188184849928538
80123,LITTLETON,CO,24232,22042,-2190,0.47633660370834596
80124,LITTLETON,CO,1113,1116,3,0.5006729475100942
80124,LONE TREE,CO,14572,14004,-568,0.4900615901455767
80125,LITTLETON,CO,4017,7073,3056,0.6377817853922453
80125,ROXBOROUGH,CO,100,169,69,0.6282527881040892
80126,HIGHLANDS RANCH,CO,13156,14069,913,0.5167676767676768
80126,LITTLETON,CO,1829,1825,-4,0.49945265462506844
80127,DENVER,CO,279,306,27,0.5230769230769231
80127,LITTLETON,CO,17336,17378,42,0.5006049432505617
80128,LITTLETON,CO,14739,13808,-931,0.48369355799208325
80129,HIGHLANDS RANCH,CO,13209,14238,1029,0.5187452180566182
80129,LITTLETON,CO,994,1126,132,0.5311320754716982
80130,HIGHLANDS RANCH,CO,12038,10546,-1492,0.4669677647892313
80130,LITTLETON,CO,192,149,-43,0.436950146627566
80132,MONUMENT,CO,11395,13434,2039,0.5410608562567965
80133,PALMER LAKE,CO,1106,1141,35,0.5077881619937694
80134,PARKER,CO,34456,39255,4799,0.5325528075863847
80135,SEDALIA,CO,1659,1638,-21,0.4968152866242038
80136,STRASBURG,CO,2214,2587,373,0.5388460737346387
80137,WATKINS,CO,413,277,-136,0.40144927536231884
80138,PARKER,CO,14592,14247,-345,0.4940185165921148
80150,ENGLEWOOD,CO,261,457,196,0.6364902506963789
80151,ENGLEWOOD,CO,415,278,-137,0.40115440115440115
80155,ENGLEWOOD,CO,754,1002,248,0.570615034168565
80155,GREENWOOD VILLAGE,CO,458,621,163,0.5755329008341057
80160,LITTLETON,CO,561,511,-50,0.4766791044776119
80161,CENTENNIAL,CO,160,200,40,0.5555555555555556
80161,LITTLETON,CO,369,373,4,0.5026954177897575
80162,LITTLETON,CO,723,676,-47,0.4832022873481058
80163,HGHLNDS RANCH,CO,104,119,15,0.5336322869955157
80163,HIGHLANDS RANCH,CO,206,258,52,0.5560344827586207
80163,LITTLETON,CO,613,714,101,0.5380557648831952
80201,DENVER,CO,1390,1880,490,0.5749235474006116
80202,DENVER,CO,33391,29882,-3509,0.47227095285508824
80203,DENVER,CO,32649,27180,-5469,0.4542947400090257
80204,DENVER,CO,30528,29266,-1262,0.48944710171589123
80205,DENVER,CO,30722,28769,-1953,0.48358575246675967
80206,DENVER,CO,26509,23608,-2901,0.4710577249236786
80207,DENVER,CO,11100,9690,-1410,0.4660894660894661
80209,DENVER,CO,25355,24244,-1111,0.4888001774229319
80210,DENVER,CO,26625,22881,-3744,0.46218640164828506
80211,DENVER,CO,36125,32965,-3160,0.47713127804313216
80212,DENVER,CO,12262,11794,-468,0.49027269704023946
80212,WHEAT RIDGE,CO,1964,1840,-124,0.48370136698212407
80214,DENVER,CO,1237,1259,22,0.5044070512820513
80214,EDGEWATER,CO,3060,2781,-279,0.4761171032357473
80214,LAKEWOOD,CO,14896,14074,-822,0.48581290990680015
80214,WHEAT RIDGE,CO,617,608,-9,0.4963265306122449
80215,DENVER,CO,1692,1605,-87,0.48680618744313015
80215,LAKEWOOD,CO,10070,10390,320,0.5078201368523949
80216,COMMERCE CITY,CO,447,466,19,0.5104052573932092
80216,DENVER,CO,11994,11957,-37,0.499227589662227
80217,DENVER,CO,1409,1027,-382,0.4215927750410509
80218,DENVER,CO,22588,19118,-3470,0.45839927108809286
80219,DENVER,CO,23877,19920,-3957,0.4548256729913008
80220,DENVER,CO,24916,23079,-1837,0.4808625898531097
80221,DENVER,CO,18360,16627,-1733,0.47523365821590874
80221,FEDERAL HEIGHTS,CO,456,431,-25,0.4859075535512965
80222,DENVER,CO,18298,16201,-2097,0.4696078147192672
80223,DENVER,CO,13187,11962,-1225,0.4756451548769335
80224,DENVER,CO,12351,10643,-1708,0.462859876489519
80226,DENVER,CO,511,407,-104,0.4433551198257081
80226,LAKEWOOD,CO,20304,18150,-2154,0.47199251053206426
80227,DENVER,CO,10738,9860,-878,0.4786872511894359
80227,LAKEWOOD,CO,10085,9334,-751,0.4806632679334672
80228,DENVER,CO,1302,1198,-104,0.4792
80228,LAKEWOOD,CO,19335,17733,-1602,0.47839106506960183
80229,DENVER,CO,10924,9464,-1460,0.4641946242887973
80229,THORNTON,CO,14379,12875,-1504,0.47240771996771114
80230,DENVER,CO,6777,6932,155,0.5056532205120724
80230,LOWRY,CO,151,142,-9,0.48464163822525597
80231,DENVER,CO,29436,24839,-4597,0.4576508521418701
80232,DENVER,CO,939,925,-14,0.49624463519313305
80232,LAKEWOOD,CO,8815,8308,-507,0.48519535128190155
80233,NORTHGLENN,CO,10146,8916,-1230,0.46773685867170284
80233,THORNTON,CO,15073,13750,-1323,0.4770495784616452
80233,W R,CO,459,420,-39,0.4778156996587031
80234,DENVER,CO,8473,7757,-716,0.4779420825631546
80234,NORTHGLENN,CO,7581,6968,-613,0.4789332600178706
80234,WESTMINSTER,CO,1463,1351,-112,0.48009950248756217
80235,DENVER,CO,5142,4656,-486,0.47519902020820576
80235,LAKEWOOD,CO,1045,963,-82,0.4795816733067729
80236,DENVER,CO,6444,5868,-576,0.4766081871345029
80236,LAKEWOOD,CO,113,118,5,0.5108225108225108
80237,DENVER,CO,21366,20775,-591,0.49298782658218837
80238,DENVER,CO,13071,15563,2492,0.5435147028008661
80239,DENVER,CO,18794,16290,-2504,0.46431421730703454
80241,NORTHGLENN,CO,2879,823,-2056,0.222312263641275
80241,THORNTON,CO,14860,13534,-1326,0.47664999647812917
80246,DENVER,CO,15724,13522,-2202,0.4623538261642618
80246,GLENDALE,CO,958,841,-117,0.46748193440800445
80247,AURORA,CO,16035,13952,-2083,0.4652682829225998
80247,DENVER,CO,7702,6634,-1068,0.46275111607142855
80249,DENVER,CO,16309,17341,1032,0.515334323922734
80250,DENVER,CO,823,1211,388,0.595378564405113
80260,DENVER,CO,1763,1485,-278,0.4572044334975369
80260,FEDERAL HEIGHTS,CO,658,561,-97,0.4602132895816243
80260,FEDERAL HGTS,CO,269,262,-7,0.4934086629001883
80260,NORTHGLENN,CO,896,735,-161,0.45064377682403434
80260,THORNTON,CO,12086,10093,-1993,0.4550701113666081
80264,DENVER,CO,0,13,13,1
80265,DENVER,CO,24,0,-24,0
80301,BOULDER,CO,20066,18060,-2006,0.47369249331165086
80302,BOULDER,CO,28651,14240,-14411,0.33200438320393555
80303,BOULDER,CO,18357,13627,-4730,0.4260567783891946
80304,BOULDER,CO,17929,14633,-3296,0.4493888581782446
80305,BOULDER,CO,11356,9178,-2178,0.44696600759715593
80306,BOULDER,CO,1616,1370,-246,0.45880776959142666
80307,BOULDER,CO,476,116,-360,0.19594594594594594
80308,BOULDER,CO,1958,1589,-369,0.44798421201014943
80310,BOULDER,CO,0,14,14,1
80401,GOLDEN,CO,22267,20361,-1906,0.4776438021957399
80401,LAKEWOOD,CO,1245,1207,-38,0.49225122349102773
80402,FORT CARSON,CO,33,27,-6,0.45
80402,GOLDEN,CO,1277,1341,64,0.5122230710466005
80403,ARVADA,CO,675,677,2,0.5007396449704142
80403,GOLDEN,CO,7651,7954,303,0.5097084267862865
80420,ALMA,CO,532,125,-407,0.1902587519025875
80421,BAILEY,CO,3729,3522,-207,0.4857261067438974
80422,BLACK HAWK,CO,1820,1802,-18,0.49751518498067365
80424,BRECKENRIDGE,CO,5820,5648,-172,0.4925008719916289
80427,CENTRAL CITY,CO,603,477,-126,0.44166666666666665
80428,CLARK,CO,320,405,85,0.5586206896551724
80432,COMO,CO,314,179,-135,0.3630831643002028
80433,CONIFER,CO,3641,3802,161,0.5108155313717587
80435,DILLON,CO,5290,3949,-1341,0.4274272107370928
80435,KEYSTONE,CO,362,226,-136,0.3843537414965986
80436,DUMONT,CO,134,35,-99,0.20710059171597633
80437,EVERGREEN,CO,1469,1077,-392,0.4230164964650432
80438,EMPIRE,CO,112,75,-37,0.40106951871657753
80439,EVERGREEN,CO,9929,10202,273,0.5067805871541404
80439,GOLDEN,CO,225,250,25,0.5263157894736842
80440,FAIRPLAY,CO,2332,1502,-830,0.3917579551382368
80442,FRASER,CO,2408,1520,-888,0.3869653767820774
80443,FRISCO,CO,3166,3228,62,0.5048482952768221
80444,GEORGETOWN,CO,976,707,-269,0.42008318478906714
80446,GRANBY,CO,2190,1983,-207,0.47519769949676494
80447,GRAND LAKE,CO,3124,2095,-1029,0.4014178961486875
80449,HARTSEL,CO,1131,790,-341,0.4112441436751692
80451,HOT SULPHUR SPRINGS,CO,107,33,-74,0.2357142857142857
80452,IDAHO SPRINGS,CO,2359,1659,-700,0.41289198606271776
80453,IDLEDALE,CO,34,0,-34,0
80454,INDIAN HILLS,CO,395,426,31,0.5188794153471377
80455,JAMESTOWN,CO,88,69,-19,0.4394904458598726
80456,JEFFERSON,CO,557,341,-216,0.37973273942093544
80457,KITTREDGE,CO,200,267,67,0.5717344753747323
80459,KREMMLING,CO,753,722,-31,0.4894915254237288
80461,LEADVILLE,CO,4305,3504,-801,0.44871302343449865
80465,MORRISON,CO,6172,6539,367,0.5144363150027536
80466,NEDERLAND,CO,2385,1955,-430,0.4504608294930876
80467,OAK CREEK,CO,1358,1147,-211,0.45788423153692615
80468,PARSHALL,CO,65,38,-27,0.36893203883495146
80470,PINE,CO,1591,1627,36,0.5055935363579863
80474,ROLLINSVILLE,CO,48,59,11,0.5514018691588785
80475,SHAWNEE,CO,11,0,-11,0
80476,SILVER PLUME,CO,26,0,-26,0
80477,STEAMBOAT SPR,CO,45,37,-8,0.45121951219512196
80477,STEAMBOAT SPRINGS,CO,4788,2427,-2361,0.3363825363825364
80478,TABERNASH,CO,447,662,215,0.5969341749323716
80480,WALDEN,CO,427,380,-47,0.4708798017348203
80481,WARD,CO,141,120,-21,0.45977011494252873
80482,WINTER PARK,CO,1914,1103,-811,0.3655949618826649
80483,YAMPA,CO,61,75,14,0.5514705882352942
80487,STEAMBOAT SPR,CO,446,448,2,0.5011185682326622
80487,STEAMBOAT SPRINGS,CO,5916,6996,1080,0.54182156133829
80488,STEAMBOAT SPR,CO,26,37,11,0.5873015873015873
80488,STEAMBOAT SPRINGS,CO,2065,1347,-718,0.3947831184056272
80497,SILVERTHORNE,CO,939,924,-15,0.49597423510466987
80498,HEENEY,CO,45,93,48,0.6739130434782609
80498,SILVERTHORNE,CO,2856,3072,216,0.5182186234817814
80501,LONGMONT,CO,24404,23005,-1399,0.4852454175367546
80502,LONGMONT,CO,1283,1431,148,0.5272660280029476
80503,LONGMONT,CO,14229,14678,449,0.5077662849828761
80503,NIWOT,CO,2058,1987,-71,0.4912237330037083
80504,FIRESTONE,CO,2171,2537,366,0.5388700084961767
80504,FREDERICK,CO,657,669,12,0.504524886877828
80504,LONGMONT,CO,20579,22695,2116,0.5244488607477932
80510,ALLENSPARK,CO,242,252,10,0.5101214574898786
80510,ELIZABETH,CO,11,29,18,0.725
80511,ESTES PARK,CO,0,65,65,1
80512,BELLVUE,CO,905,827,-78,0.47748267898383373
80513,BERTHOUD,CO,6268,9367,3099,0.5991045730732332
80514,DACONO,CO,2521,2531,10,0.5009897070467142
80514,ERIE,CO,51,68,17,0.5714285714285714
80515,DRAKE,CO,339,283,-56,0.454983922829582
80516,ERIE,CO,11126,15404,4278,0.5806257067470788
80516,FREDERICK,CO,395,629,234,0.6142578125
80517,ESTES PARK,CO,8149,6843,-1306,0.4564434364994664
80520,FIRESTONE,CO,1914,782,-1132,0.2900593471810089
80521,FORT COLLINS,CO,27629,18979,-8650,0.4072047717130106
80522,FORT COLLINS,CO,1538,1570,32,0.5051480051480052
80524,FORT COLLINS,CO,23762,20629,-3133,0.46471131535671645
80525,FORT COLLINS,CO,35187,32166,-3021,0.47757338203198074
80526,FORT COLLINS,CO,29360,24687,-4673,0.4567691083686421
80527,FORT COLLINS,CO,1544,1985,441,0.5624822896004534
80528,FORT COLLINS,CO,11228,11604,376,0.5082340574632095
80530,FREDERICK,CO,2248,2878,630,0.5614514241123684
80532,GLEN HAVEN,CO,11,39,28,0.78
80533,HYGIENE,CO,93,96,3,0.5079365079365079
80534,JOHNSTOWN,CO,7627,8835,1208,0.5366905600777548
80534,LOVELAND,CO,276,347,71,0.5569823434991974
80535,LAPORTE,CO,1244,1153,-91,0.4810179390905298
80535,LOVELAND,CO,27,24,-3,0.47058823529411764
80536,LIVERMORE,CO,1005,992,-13,0.49674511767651475
80537,LOVELAND,CO,23599,22935,-664,0.49286543172733915
80538,LOVELAND,CO,24445,25974,1529,0.5151629346079851
80539,LOVELAND,CO,1384,1398,14,0.5025161754133717
80540,LYONS,CO,2380,2131,-249,0.47240079804921303
80541,MASONVILLE,CO,82,13,-69,0.1368421052631579
80542,MEAD,CO,1460,2383,923,0.6200884725474889
80543,MILLIKEN,CO,3096,3714,618,0.5453744493392071
80544,NIWOT,CO,526,203,-323,0.2784636488340192
80545,RED FE LKS,CO,162,106,-56,0.39552238805970147
80545,RED FEATHER LAKES,CO,608,485,-123,0.44373284537968893
80546,SEVERANCE,CO,30,11,-19,0.2682926829268293
80547,TIMNATH,CO,2457,5056,2599,0.6729668574470917
80549,WELLINGTON,CO,5419,6301,882,0.5376279863481229
80550,SEVERANCE,CO,3793,5951,2158,0.6107348111658456
80550,WINDSOR,CO,13056,18009,4953,0.5797199420569773
80601,BRIGHTON,CO,21799,19052,-2747,0.4663778120486647
80602,BRIGHTON,CO,6671,8835,2164,0.5697794402166904
80602,THORNTON,CO,6657,8171,1514,0.5510520636633396
80603,BRIGHTON,CO,3712,3710,-2,0.4998652654271086
80603,COMMERCE CITY,CO,106,95,-11,0.472636815920398
80603,LOCHBUIE,CO,1578,1809,231,0.5341009743135519
80610,AULT,CO,1244,1692,448,0.5762942779291553
80610,SEVERANCE,CO,220,265,45,0.5463917525773195
80611,BRIGGSDALE,CO,25,63,38,0.7159090909090909
80612,CARR,CO,37,25,-12,0.4032258064516129
80614,EASTLAKE,CO,546,343,-203,0.3858267716535433
80615,EATON,CO,3009,3221,212,0.5170144462279294
80620,EVANS,CO,12145,9726,-2419,0.44469845914681544
80621,EVANS,CO,114,120,6,0.5128205128205128
80621,FORT LUPTON,CO,4222,4908,686,0.5375684556407448
80623,GILCREST,CO,228,71,-157,0.23745819397993312
80624,GILL,CO,143,59,-84,0.29207920792079206
80631,GREELEY,CO,25465,20201,-5264,0.4423641221039723
80632,GREELEY,CO,1247,842,-405,0.4030636668262326
80633,GREELEY,CO,642,794,152,0.552924791086351
80634,EVANS,CO,748,785,37,0.5120678408349641
80634,GREELEY,CO,30737,30006,-731,0.4939828457600053
80640,COMMERCE CITY,CO,2765,2895,130,0.5114840989399293
80640,HENDERSON,CO,2321,2640,319,0.532150776053215
80642,HUDSON,CO,1448,1542,94,0.5157190635451505
80643,KEENESBURG,CO,1647,2036,389,0.552810209068694
80644,KERSEY,CO,1291,1043,-248,0.44687232219365897
80645,LA SALLE,CO,2343,1717,-626,0.4229064039408867
80648,NUNN,CO,453,475,22,0.5118534482758621
80650,PIERCE,CO,829,763,-66,0.4792713567839196
80651,PLATTEVILLE,CO,1829,1674,-155,0.4778761061946903
80652,ROGGEN,CO,12,0,-12,0
80653,WELDONA,CO,92,106,14,0.5353535353535354
80654,WIGGINS,CO,1254,1688,434,0.5737593473827328
80701,FORT MORGAN,CO,5658,5111,-547,0.4746030272077259
80705,DENVER,CO,0,22,22,1
80705,LOG LANE VILLAGE,CO,78,142,64,0.6454545454545455
80720,AKRON,CO,1391,1093,-298,0.44001610305958133
80723,BRUSH,CO,2814,2637,-177,0.4837644468904788
80727,ECKLEY,CO,12,11,-1,0.4782608695652174
80728,FLEMING,CO,33,23,-10,0.4107142857142857
80729,GROVER,CO,11,24,13,0.6857142857142857
80731,HAXTUN,CO,508,477,-31,0.4842639593908629
80733,HILLROSE,CO,34,22,-12,0.39285714285714285
80734,HOLYOKE,CO,1338,1157,-181,0.46372745490981965
80736,ILIFF,CO,36,26,-10,0.41935483870967744
80737,JULESBURG,CO,727,744,17,0.5057783820530252
80740,LINDON,CO,15,12,-3,0.4444444444444444
80741,MERINO,CO,69,95,26,0.5792682926829268
80743,OTIS,CO,81,98,17,0.547486033519553
80744,OVID,CO,30,35,5,0.5384615384615384
80751,STERLING,CO,7946,6840,-1106,0.4625997565264439
80755,VERNON,CO,21,0,-21,0
80758,WRAY,CO,1526,1179,-347,0.43585951940850276
80759,YUMA,CO,1640,1395,-245,0.4596375617792422
80804,ARRIBA,CO,14,13,-1,0.48148148148148145
80807,BURLINGTON,CO,1997,1827,-170,0.47777196652719667
80808,CALHAN,CO,2737,3002,265,0.5230876459313469
80809,CASCADE,CO,880,721,-159,0.45034353529044346
80810,CHEYENNE WELLS,CO,209,56,-153,0.21132075471698114
80813,CRIPPLE CREEK,CO,1754,1307,-447,0.426984645540673
80814,DIVIDE,CO,2801,2398,-403,0.4612425466435853
80815,FLAGLER,CO,129,173,44,0.5728476821192053
80816,FLORISSANT,CO,3562,3239,-323,0.47625349213350976
80817,FOUNTAIN,CO,17954,16426,-1528,0.4777777777777778
80818,GENOA,CO,25,0,-25,0
80819,GREEN MOUNTAIN FALLS,CO,185,248,63,0.5727482678983834
80819,GREEN MTN FLS,CO,0,14,14,1
80820,GUFFEY,CO,351,353,2,0.5014204545454546
80821,HUGO,CO,231,217,-14,0.484375
80827,LAKE GEORGE,CO,529,423,-106,0.44432773109243695
80828,LIMON,CO,1181,1098,-83,0.4817902588854761
80829,MANITOU SPRINGS,CO,3884,3560,-324,0.4782375067168189
80830,MATHESON,CO,0,16,16,1
80831,PEYTON,CO,13055,16242,3187,0.554391234597399
80832,RAMAH,CO,53,50,-3,0.4854368932038835
80833,RUSH,CO,28,63,35,0.6923076923076923
80833,W R,CO,12,0,-12,0
80835,SIMLA,CO,274,167,-107,0.3786848072562358
80836,STRATTON,CO,161,174,13,0.5194029850746269
80840,UNITED STATES AIR FORCE ACAD,CO,146,111,-35,0.43190661478599224
80840,USAF ACADEMY,CO,2832,1491,-1341,0.34489937543372656
80841,USAF ACADEMY,CO,6378,292,-6086,0.043778110944527736
80860,VICTOR,CO,242,143,-99,0.37142857142857144
80863,WOODLAND PARK,CO,7039,7270,231,0.5080718428960794
80864,YODER,CO,592,669,77,0.5305313243457573
80866,WOODLAND PARK,CO,1182,512,-670,0.3022432113341204
80901,COLO SPGS,CO,103,129,26,0.5560344827586207
80901,COLORADO SPGS,CO,17,29,12,0.6304347826086957
80901,COLORADO SPRINGS,CO,1088,1352,264,0.5540983606557377
80901,GOLDEN,CO,29,29,0,0.5
80902,COLO SPGS,CO,1709,1311,-398,0.43410596026490067
80902,COLORADO SPGS,CO,213,107,-106,0.334375
80902,COLORADO SPRINGS,CO,6327,4790,-1537,0.43087163803184314
80902,FORT CARSON,CO,595,480,-115,0.44651162790697674
80903,COLO SPGS,CO,625,635,10,0.503968253968254
80903,COLORADO SPGS,CO,280,308,28,0.5238095238095238
80903,COLORADO SPRINGS,CO,11049,10556,-493,0.4885906040268456
80904,COLORADO SPRINGS,CO,15176,13346,-1830,0.46791950073627375
80905,COLO SPGS,CO,761,749,-12,0.4960264900662252
80905,COLORADO SPRINGS,CO,12094,10442,-1652,0.4633475328363507
80906,COLO SPGS,CO,438,359,-79,0.4504391468005019
80906,COLORADO SPGS,CO,854,765,-89,0.47251389746757255
80906,COLORADO SPRINGS,CO,22160,20006,-2154,0.4744580941991178
80907,COLO SPGS,CO,752,717,-35,0.48808713410483323
80907,COLORADO SPGS,CO,358,294,-64,0.450920245398773
80907,COLORADO SPRINGS,CO,17507,15221,-2286,0.4650757760938646
80908,COLO SPGS,CO,1101,1717,616,0.6092973740241305
80908,COLORADO SPGS,CO,313,384,71,0.5509325681492109
80908,COLORADO SPRINGS,CO,6982,9477,2495,0.5757943982015918
80909,COLORADO SPRINGS,CO,25532,19576,-5956,0.43398066861754014
80910,COLO SPGS,CO,396,310,-86,0.43909348441926344
80910,COLORADO SPRINGS,CO,21720,18159,-3561,0.45535244113443163
80911,COLORADO SPGS,CO,286,285,-1,0.4991243432574431
80911,COLORADO SPRINGS,CO,15373,13996,-1377,0.4765569137525963
80913,COLORAD SPRINGS,CO,0,16,16,1
80913,COLORADO SPRINGS,CO,11,126,115,0.9197080291970803
80913,FORT CARSON,CO,0,75,75,1
80913,FT CARSON,CO,0,13,13,1
80914,COLORADO SPRINGS,CO,0,41,41,1
80915,COLORADO SPRINGS,CO,13292,11966,-1326,0.47375089080687305
80916,COLORADO SPRINGS,CO,27741,19481,-8260,0.4125407648977172
80917,COLO SPGS,CO,1322,1199,-123,0.47560491868306226
80917,COLORADO SPGS,CO,406,362,-44,0.4713541666666667
80917,COLORADO SPRINGS,CO,17463,15216,-2247,0.4656201230147801
80918,COLORADO SPRINGS,CO,30659,27215,-3444,0.47024570618930783
80919,COLO SPGS,CO,1212,1276,64,0.5128617363344051
80919,COLORADO SPGS,CO,592,558,-34,0.4852173913043478
80919,COLORADO SPRINGS,CO,12240,12102,-138,0.497165393147646
80920,COLO SPGS,CO,412,370,-42,0.4731457800511509
80920,COLO SPRINGS,CO,510,503,-7,0.49654491609081935
80920,COLORADO SPGS,CO,450,408,-42,0.4755244755244755
80920,COLORADO SPRINGS,CO,20012,19174,-838,0.4893074057061195
80921,COLO SPGS,CO,1972,2504,532,0.5594280607685433
80921,COLORADO SPGS,CO,509,716,207,0.5844897959183674
80921,COLORADO SPRINGS,CO,11517,12368,851,0.5178145279464099
80922,COLO SPGS,CO,473,481,8,0.5041928721174004
80922,COLORADO SPRINGS,CO,14587,15121,534,0.5089874781203716
80923,COLORADO SPRINGS,CO,19894,16986,-2908,0.4605748373101952
80924,COLO SPGS,CO,833,1335,502,0.6157749077490775
80924,COLORADO SPGS,CO,521,853,332,0.6208151382823872
80924,COLORADO SPRINGS,CO,6457,9396,2939,0.5926953888853844
80925,COLO SPGS,CO,110,166,56,0.6014492753623188
80925,COLORADO SPRINGS,CO,7693,10133,2440,0.5684393582407719
80926,COLO SPGS,CO,130,105,-25,0.44680851063829785
80926,COLORADO SPGS,CO,52,27,-25,0.34177215189873417
80926,COLORADO SPRINGS,CO,521,630,109,0.5473501303214596
80927,COLO SPGS,CO,573,898,325,0.610469068660775
80927,COLORADO SPGS,CO,289,497,208,0.6323155216284987
80927,COLORADO SPRINGS,CO,2702,4345,1643,0.6165744288349653
80928,COLO SPGS,CO,0,15,15,1
80928,COLORADO SPRINGS,CO,325,384,59,0.5416078984485191
80930,COLO SPGS,CO,91,128,37,0.5844748858447488
80930,COLORADO SPGS,CO,48,46,-2,0.48936170212765956
80930,COLORADO SPRINGS,CO,630,558,-72,0.4696969696969697
80931,COLO SPGS,CO,27,46,19,0.6301369863013698
80931,COLORADO SPGS,CO,11,11,0,0.5
80931,COLORADO SPRINGS,CO,318,447,129,0.5843137254901961
80932,COLO SPGS,CO,49,66,17,0.5739130434782609
80932,COLORADO SPRINGS,CO,283,448,165,0.612859097127223
80933,COLO SPGS,CO,32,12,-20,0.2727272727272727
80933,COLORADO SPGS,CO,19,17,-2,0.4722222222222222
80933,COLORADO SPRINGS,CO,452,540,88,0.5443548387096774
80934,COLO SPGS,CO,38,27,-11,0.4153846153846154
80934,COLORADO SPGS,CO,18,18,0,0.5
80934,COLORADO SPRINGS,CO,456,507,51,0.5264797507788161
80935,COLO SPGS,CO,90,108,18,0.5454545454545454
80935,COLORADO SPGS,CO,18,24,6,0.5714285714285714
80935,COLORADO SPRINGS,CO,762,1136,374,0.5985247629083246
80936,COLO SPGS,CO,62,108,46,0.6352941176470588
80936,COLORADO SPRINGS,CO,1013,1262,249,0.5547252747252748
80937,COLO SPGS,CO,26,93,67,0.7815126050420168
80937,COLORADO SPRINGS,CO,271,496,225,0.6466753585397653
80938,COLO SPGS,CO,0,180,180,1
80938,COLORADO SPGS,CO,22,51,29,0.6986301369863014
80938,COLORADO SPRINGS,CO,137,606,469,0.8156123822341858
80939,COLO SPGS,CO,0,53,53,1
80939,COLORADO SPRINGS,CO,16,244,228,0.9384615384615385
80949,COLO SPGS,CO,74,52,-22,0.4126984126984127
80949,COLORADO SPGS,CO,73,50,-23,0.4065040650406504
80949,COLORADO SPRINGS,CO,538,549,11,0.5050597976080957
80951,COLO SPGS,CO,548,462,-86,0.45742574257425744
80951,COLORADO SPGS,CO,106,97,-9,0.47783251231527096
80951,COLORADO SPRINGS,CO,1702,1555,-147,0.47743322075529626
80960,COLO SPGS,CO,0,37,37,1
80960,COLORADO SPRINGS,CO,72,38,-34,0.34545454545454546
80962,COLO SPGS,CO,152,163,11,0.5174603174603175
80962,COLORADO SPGS,CO,19,34,15,0.6415094339622641
80962,COLORADO SPRINGS,CO,1116,1325,209,0.5428103236378533
80970,COLO SPGS,CO,116,194,78,0.6258064516129033
80970,COLORADO SPRINGS,CO,631,730,99,0.5363703159441587
81001,PUEBLO,CO,14363,12511,-1852,0.4655429039220064
81002,PUEBLO,CO,119,244,125,0.6721763085399449
81003,PUEBLO,CO,7528,6783,-745,0.473971071203969
81004,PUEBLO,CO,13696,11684,-2012,0.4603624901497242
81005,PUEBLO,CO,11997,11443,-554,0.4881825938566553
81006,PUEBLO,CO,3183,3270,87,0.506741050674105
81007,PUEBLO,CO,8541,9897,1356,0.5367718841522942
81007,PUEBLO WEST,CO,3461,3964,503,0.5338720538720538
81008,PUEBLO,CO,7916,7788,-128,0.49592460519612835
81019,COLO CITY,CO,46,131,85,0.7401129943502824
81019,COLORADO CITY,CO,728,764,36,0.5120643431635389
81020,AGUILAR,CO,239,277,38,0.5368217054263565
81022,AVONDALE,CO,418,462,44,0.525
81023,BEULAH,CO,349,448,99,0.562107904642409
81025,BOONE,CO,104,111,7,0.5162790697674419
81036,CHIVINGTON,CO,11,0,-11,0
81036,EADS,CO,168,195,27,0.5371900826446281
81039,FOWLER,CO,971,821,-150,0.45814732142857145
81040,GARDNER,CO,119,137,18,0.53515625
81044,HASTY,CO,0,15,15,1
81047,HOLLY,CO,160,177,17,0.5252225519287834
81050,LA JUNTA,CO,4962,3864,-1098,0.43779741672331746
81052,LAMAR,CO,4682,3893,-789,0.45399416909620993
81054,LAS ANIMAS,CO,2361,1901,-460,0.4460347254809948
81055,LA VETA,CO,1223,1211,-12,0.49753492193919474
81058,MANZANOLA,CO,72,55,-17,0.4330708661417323
81062,OLNEY SPRINGS,CO,90,115,25,0.5609756097560976
81063,ORDWAY,CO,1008,842,-166,0.45513513513513515
81064,PRITCHETT,CO,22,0,-22,0
81067,ROCKY FORD,CO,2441,2109,-332,0.4635164835164835
81069,RYE,CO,1075,1138,63,0.5142340713962946
81073,SPRINGFIELD,CO,1354,921,-433,0.40483516483516485
81076,SUGAR CITY,CO,11,0,-11,0
81077,SWINK,CO,169,81,-88,0.324
81082,COKEDALE,CO,99,122,23,0.5520361990950227
81082,TRINIDAD,CO,4985,5083,98,0.5048669050456893
81089,WALSENBURG,CO,2595,2762,167,0.5155870823221953
81090,WALSH,CO,51,29,-22,0.3625
81091,WESTON,CO,205,245,40,0.5444444444444444
81092,WILEY,CO,11,23,12,0.6764705882352942
81101,ALAMOSA,CO,7434,6792,-642,0.47743568114719526
81120,ANTONITO,CO,529,786,257,0.5977186311787073
81121,ARBOLES,CO,11,0,-11,0
81122,BAYFIELD,CO,4283,4994,711,0.5383205777729869
81123,BLANCA,CO,85,59,-26,0.4097222222222222
81125,CENTER,CO,947,756,-191,0.44392248972401643
81128,CHROMO,CO,0,16,16,1
81130,CREEDE,CO,804,1040,236,0.5639913232104121
81131,CRESTONE,CO,893,957,64,0.5172972972972973
81132,DEL NORTE,CO,1399,1456,57,0.5099824868651489
81133,FORT GARLAND,CO,487,476,-11,0.49428868120456904
81137,IGNACIO,CO,1427,1560,133,0.5222631402745229
81140,LA JARA,CO,500,410,-90,0.45054945054945056
81141,MANASSA,CO,78,49,-29,0.3858267716535433
81143,MOFFAT,CO,252,262,10,0.5097276264591439
81144,MONTE VISTA,CO,2648,2588,-60,0.494270435446906
81146,MOSCA,CO,41,11,-30,0.21153846153846154
81147,PAGOSA SPRINGS,CO,9247,8854,-393,0.4891442461742445
81149,SAGUACHE,CO,130,161,31,0.5532646048109966
81151,SAN ACACIO,CO,13,0,-13,0
81151,SANFORD,CO,87,87,0,0.5
81152,SAN LUIS,CO,138,234,96,0.6290322580645161
81152,SAN PABLO,CO,0,12,12,1
81154,SOUTH FORK,CO,1561,1991,430,0.5605292792792793
81155,VILLA GROVE,CO,11,31,20,0.7380952380952381
81201,PONCHA SPRINGS,CO,161,135,-26,0.4560810810810811
81201,SALIDA,CO,6368,6299,-69,0.4972763874634878
81210,ALMONT,CO,331,407,76,0.551490514905149
81211,BUENA VISTA,CO,4775,4839,64,0.5033284793010193
81212,CANON CITY,CO,12953,12197,-756,0.48497017892644134
81215,CANON CITY,CO,1402,934,-468,0.3998287671232877
81220,CIMARRON,CO,155,180,25,0.5373134328358209
81222,COALDALE,CO,0,13,13,1
81223,COTOPAXI,CO,1246,1405,159,0.5299886835156544
81224,CRESTED BUTTE,CO,4251,3199,-1052,0.4293959731543624
81226,FLORENCE,CO,3070,3005,-65,0.49465020576131685
81230,GUNNISON,CO,8254,6622,-1632,0.44514654477009946
81233,HOWARD,CO,287,364,77,0.5591397849462365
81235,LAKE CITY,CO,1051,731,-320,0.4102132435465769
81236,NATHROP,CO,719,777,58,0.5193850267379679
81240,PENROSE,CO,1995,2001,6,0.5007507507507507
81241,PITKIN,CO,106,154,48,0.5923076923076923
81242,PONCHA SPGS,CO,11,37,26,0.7708333333333334
81242,PONCHA SPRINGS,CO,417,556,139,0.5714285714285714
81243,POWDERHORN,CO,0,31,31,1
81244,ROCKVALE,CO,0,12,12,1
81251,TWIN LAKES,CO,27,23,-4,0.46
81252,SILVER CLIFF,CO,118,124,6,0.512396694214876
81252,WESTCLIFFE,CO,2860,3249,389,0.5318382714028482
81253,WETMORE,CO,11,11,0,0.5
81301,DURANGO,CO,18378,18493,115,0.5015594911990453
81302,DURANGO,CO,2174,1541,-633,0.41480484522207267
81303,DURANGO,CO,3827,4169,342,0.5213856928464232
81320,CAHONE,CO,0,12,12,1
81321,CORTEZ,CO,7400,7103,-297,0.4897607391574157
81321,DENVER,CO,168,185,17,0.5240793201133145
81323,DOLORES,CO,2744,2553,-191,0.4819709269397772
81324,DOVE CREEK,CO,488,355,-133,0.4211150652431791
81326,HESPERUS,CO,894,1076,182,0.5461928934010152
81327,LEWIS,CO,65,40,-25,0.38095238095238093
81328,MANCOS,CO,2249,2489,240,0.5253271422541157
81332,RICO,CO,43,86,43,0.6666666666666666
81334,TOWAOC,CO,0,22,22,1
81401,MONTROSE,CO,12295,11414,-881,0.4814205575941626
81402,MONTROSE,CO,1724,1090,-634,0.38734896943852165
81403,MONTROSE,CO,4450,5070,620,0.532563025210084
81410,AUSTIN,CO,509,774,265,0.603273577552611
81413,CEDAREDGE,CO,2637,2912,275,0.5247792395026131
81414,CORY,CO,64,0,-64,0
81415,CRAWFORD,CO,970,844,-126,0.4652701212789416
81416,DELTA,CO,7125,6654,-471,0.48290877422164163
81418,ECKERT,CO,841,770,-71,0.47796399751707014
81419,HOTCHKISS,CO,1591,1749,158,0.5236526946107785
81422,NATURITA,CO,67,23,-44,0.25555555555555554
81423,NORWOOD,CO,976,660,-316,0.4034229828850856
81424,NUCLA,CO,184,198,14,0.518324607329843
81425,OLATHE,CO,1649,1523,-126,0.4801387137452711
81427,OURAY,CO,1461,1012,-449,0.40921957137080467
81428,PAONIA,CO,1797,1898,101,0.5136671177266576
81430,PLACERVILLE,CO,198,136,-62,0.40718562874251496
81431,REDVALE,CO,13,0,-13,0
81432,MONTROSE,CO,55,82,27,0.5985401459854015
81432,RIDGWAY,CO,2318,2286,-32,0.4965247610773241
81433,SILVERTON,CO,818,458,-360,0.35893416927899685
81435,MOUNTAIN VILLAGE,CO,440,320,-120,0.42105263157894735
81435,TELLURIDE,CO,3494,3103,-391,0.4703653175685918
81501,GRAND JUNCTION,CO,18060,13869,-4191,0.43437000845626234
81502,GRAND JCT,CO,110,62,-48,0.36046511627906974
81502,GRAND JUNCTION,CO,3841,2709,-1132,0.413587786259542
81503,GRAND JCT,CO,208,209,1,0.5011990407673861
81503,GRAND JUNCTION,CO,7454,7248,-206,0.4929941504557203
81504,GRAND JCT,CO,354,342,-12,0.49137931034482757
81504,GRAND JUNCTION,CO,15562,15142,-420,0.49316050026055236
81505,GRAND JUNCTION,CO,6569,7370,801,0.5287323337398666
81506,GRAND JUNCTION,CO,5816,6003,187,0.5079109907775615
81507,GRAND JUNCTION,CO,6309,6931,622,0.5234894259818731
81520,CLIFTON,CO,9280,7314,-1966,0.4407617211040135
81521,FRUITA,CO,7145,7503,358,0.5122200983069362
81522,GATEWAY,CO,12,0,-12,0
81523,GLADE PARK,CO,198,140,-58,0.41420118343195267
81524,LOMA,CO,826,981,155,0.5428887659103486
81525,MACK,CO,318,423,105,0.5708502024291497
81526,PALISADE,CO,2747,2461,-286,0.472542242703533
81527,WHITEWATER,CO,715,751,36,0.5122783083219645
81601,GLENWOOD SPGS,CO,452,438,-14,0.49213483146067416
81601,GLENWOOD SPRINGS,CO,6358,6404,46,0.5018022253565272
81602,GLENWOOD SPGS,CO,97,120,23,0.5529953917050692
81602,GLENWOOD SPRINGS,CO,1039,846,-193,0.4488063660477454
81610,DINOSAUR,CO,0,11,11,1
81611,ASPEN,CO,4794,4870,76,0.503932119205298
81612,ASPEN,CO,2555,1844,-711,0.41918617867697205
81615,SNOWMASS VILLAGE,CO,1375,1453,78,0.5137906647807637
81615,SNOWMASS VLG,CO,37,35,-2,0.4861111111111111
81620,AVON,CO,6663,4267,-2396,0.3903934126258006
81621,BASALT,CO,4085,3740,-345,0.4779552715654952
81623,CARBONDALE,CO,6806,7018,212,0.5076678240740741
81623,REDSTONE,CO,129,122,-7,0.4860557768924303
81624,COLLBRAN,CO,486,274,-212,0.3605263157894737
81625,CRAIG,CO,6205,5050,-1155,0.4486894713460684
81626,CRAIG,CO,898,742,-156,0.4524390243902439
81630,DE BEQUE,CO,151,185,34,0.5505952380952381
81631,EAGLE,CO,2710,2743,33,0.5030258573262424
81632,CORDILLERA,CO,137,173,36,0.5580645161290323
81632,EDWARDS,CO,3548,3851,303,0.5204757399648601
81635,BATTLEMENT MESA,CO,86,82,-4,0.4880952380952381
81635,PARACHUTE,CO,4137,3541,-596,0.46118780932534514
81637,GYPSUM,CO,1744,1762,18,0.5025670279520822
81639,HAYDEN,CO,984,1023,39,0.5097159940209267
81641,MEEKER,CO,1763,1625,-138,0.47963400236127507
81643,MESA,CO,103,171,68,0.6240875912408759
81645,MINTURN,CO,662,239,-423,0.26526082130965595
81647,NEW CASTLE,CO,4028,2954,-1074,0.4230879404182183
81648,RANGELY,CO,1606,1354,-252,0.4574324324324324
81650,RIFLE,CO,6529,5464,-1065,0.45559909947469357
81652,SILT,CO,2400,2267,-133,0.48575101778444396
81654,SNOWMASS,CO,575,532,-43,0.48057813911472447
81655,WOLCOTT,CO,77,59,-18,0.4338235294117647
81656,WOODY CREEK,CO,24,38,14,0.6129032258064516
81657,VAIL,CO,4377,3825,-552,0.4663496708119971
81658,VAIL,CO,2155,1397,-758,0.39329954954954954
82001,CHEYENNE,WY,21250,18993,-2257,0.47195785602465024
82003,CHEYENNE,WY,3934,2995,-939,0.43224130466156735
82007,CHEYENNE,WY,11335,10629,-706,0.48392824622108904
82009,CHEYENNE,WY,14180,15605,1425,0.5239214369649152
82050,ALBIN,WY,23,0,-23,0
82053,BURNS,WY,329,362,33,0.5238784370477568
82054,CARPENTER,WY,80,96,16,0.5454545454545454
82055,CENTENNIAL,WY,75,70,-5,0.4827586206896552
82059,GRANITE CANYON,WY,0,11,11,1
82060,HILLSDALE,WY,11,0,-11,0
82070,LARAMIE,WY,11137,9287,-1850,0.45471014492753625
82072,LARAMIE,WY,9769,7507,-2262,0.43453345681870803
82073,LARAMIE,WY,1994,1046,-948,0.34407894736842104
82082,PINE BLUFFS,WY,547,337,-210,0.38122171945701355
82083,ROCK RIVER,WY,23,0,-23,0
82190,YELLOWSTONE NATIONAL PARK,WY,1573,1353,-220,0.462406015037594
82201,WHEATLAND,WY,3894,3424,-470,0.46788740092921566
82210,CHUGWATER,WY,38,13,-25,0.2549019607843137
82212,FORT LARAMIE,WY,23,29,6,0.5576923076923077
82213,GLENDO,WY,213,41,-172,0.16141732283464566
82214,GUERNSEY,WY,388,270,-118,0.41033434650455924
82223,LINGLE,WY,160,117,-43,0.4223826714801444
82225,LUSK,WY,886,555,-331,0.3851492019430951
82240,TORRINGTON,WY,4405,3994,-411,0.47553280152399097
82243,VETERAN,WY,0,11,11,1
82301,RAWLINS,WY,4264,3641,-623,0.46059456040480706
82321,BAGGS,WY,62,11,-51,0.1506849315068493
82325,ENCAMPMENT,WY,277,244,-33,0.46833013435700577
82325,RIVERSIDE,WY,42,0,-42,0
82327,HANNA,WY,108,52,-56,0.325
82331,SARATOGA,WY,1353,1111,-242,0.45089285714285715
82332,SAVERY,WY,13,0,-13,0
82334,SINCLAIR,WY,34,0,-34,0
82336,WAMSUTTER,WY,24,0,-24,0
82401,WORLAND,WY,3137,3192,55,0.5043450782114078
82410,BASIN,WY,654,517,-137,0.44150298889837747
82411,BURLINGTON,WY,0,24,24,1
82414,CODY,WY,9662,9083,-579,0.4845558815684182
82420,COWLEY,WY,29,68,39,0.7010309278350515
82421,DEAVER,WY,11,0,-11,0
82426,GREYBULL,WY,1222,1133,-89,0.481104033970276
82431,LOVELL,WY,1437,1458,21,0.5036269430051813
82433,MEETEETSE,WY,211,181,-30,0.461734693877551
82435,POWELL,WY,5217,5273,56,0.5026692087702573
82441,SHELL,WY,11,50,39,0.819672131147541
82442,TEN SLEEP,WY,46,61,15,0.5700934579439252
82443,THERMOPOLIS,WY,2749,2369,-380,0.4628761234857366
82450,WAPITI,WY,98,95,-3,0.49222797927461137
82501,RIVERTON,WY,6654,6497,-157,0.49403087217702074
82513,DUBOIS,WY,1386,1275,-111,0.4791431792559188
82514,FORT WASHAKIE,WY,429,336,-93,0.4392156862745098
82515,HUDSON,WY,26,12,-14,0.3157894736842105
82516,KINNEAR,WY,0,33,33,1
82520,LANDER,WY,4965,4522,-443,0.47665226098872143
82523,PAVILLION,WY,88,93,5,0.5138121546961326
82601,BAR NUNN,WY,270,216,-54,0.4444444444444444
82601,CASPER,WY,11997,11466,-531,0.4886843114691216
82602,CASPER,WY,1001,886,-115,0.46952835188129305
82604,CASPER,WY,4099,4224,125,0.5075093115463174
82604,MILLS,WY,5263,5516,253,0.5117357825401243
82605,CASPER,WY,1105,976,-129,0.46900528592023066
82609,CASPER,WY,9952,9829,-123,0.49689095596784794
82620,ALCOVA,WY,11,41,30,0.7884615384615384
82633,DOUGLAS,WY,4842,4499,-343,0.4816400813617386
82636,EVANSVILLE,WY,1733,1784,51,0.5072504975831674
82637,GLENROCK,WY,1757,1326,-431,0.43010055141096337
82639,KAYCEE,WY,17,63,46,0.7875
82642,LYSITE,WY,11,0,-11,0
82644,MILLS,WY,1532,1521,-11,0.49819849328529314
82649,SHOSHONI,WY,180,222,42,0.5522388059701493
82701,NEWCASTLE,WY,2394,2216,-178,0.4806941431670282
82712,BEULAH,WY,12,0,-12,0
82714,DEVILS TOWER,WY,11,11,0,0.5
82716,GILLETTE,WY,8520,8176,-344,0.48969813128893147
82717,GILLETTE,WY,1817,1624,-193,0.47195582679453646
82718,GILLETTE,WY,11170,10981,-189,0.4957338269152634
82720,HULETT,WY,173,186,13,0.5181058495821727
82721,MOORCROFT,WY,1089,952,-137,0.466438020578148
82721,OSHOTO,WY,44,46,2,0.5111111111111111
82721,PINE HAVEN,WY,109,81,-28,0.4263157894736842
82727,ROZET,WY,288,440,152,0.6043956043956044
82729,SUNDANCE,WY,860,880,20,0.5057471264367817
82730,UPTON,WY,309,279,-30,0.4744897959183674
82732,WRIGHT,WY,862,707,-155,0.4506054811982154
82801,SHERIDAN,WY,13864,13170,-694,0.48716431160760526
82832,BANNER,WY,33,0,-33,0
82833,BIG HORN,WY,134,221,87,0.6225352112676056
82834,BUFFALO,WY,3629,3691,62,0.5042349726775956
82836,DAYTON,WY,133,271,138,0.6707920792079208
82839,RANCHESTER,WY,421,459,38,0.5215909090909091
82842,STORY,WY,267,263,-4,0.4962264150943396
82901,ROCK SPRINGS,WY,13050,11758,-1292,0.4739600128990648
82902,ROCK SPRINGS,WY,626,485,-141,0.4365436543654365
82922,BONDURANT,WY,119,113,-6,0.4870689655172414
82923,BOULDER,WY,149,129,-20,0.46402877697841727
82925,CORA,WY,100,74,-26,0.42528735632183906
82930,EVANSTON,WY,6903,5405,-1498,0.4391452713682158
82931,EVANSTON,WY,784,333,-451,0.2981199641897941
82932,FARSON,WY,31,0,-31,0
82933,FORT BRIDGER,WY,48,63,15,0.5675675675675675
82935,GREEN RIVER,WY,5493,4928,-565,0.47289127722867286
82937,LYMAN,WY,790,695,-95,0.468013468013468
82939,MOUNTAIN VIEW,WY,394,316,-78,0.4450704225352113
82941,PINEDALE,WY,1735,1969,234,0.5315874730021598
83001,JACKSON,WY,4242,4078,-164,0.49014423076923075
83002,JACKSON,WY,3610,2694,-916,0.42734771573604063
83002,JACKSON HOLE,WY,319,290,-29,0.47619047619047616
83012,MOOSE,WY,322,207,-115,0.391304347826087
83013,MORAN,WY,437,463,26,0.5144444444444445
83014,WILSON,WY,2314,2095,-219,0.47516443638013156
83025,TETON VILLAGE,WY,443,558,115,0.5574425574425574
83101,KEMMERER,WY,1399,1140,-259,0.44899566758566367
83110,AFTON,WY,1621,1627,6,0.5009236453201971
83111,AUBURN,WY,15,0,-15,0
83112,BEDFORD,WY,61,69,8,0.5307692307692308
83113,BIG PINEY,WY,719,587,-132,0.44946401225114857
83114,COKEVILLE,WY,25,0,-25,0
83115,DANIEL,WY,89,37,-52,0.29365079365079366
83116,DIAMONDVILLE,WY,0,12,12,1
83118,ETNA,WY,195,333,138,0.6306818181818182
83120,FREEDOM,WY,109,101,-8,0.48095238095238096
83122,GROVER,WY,28,0,-28,0
83123,LA BARGE,WY,34,23,-11,0.40350877192982454
83126,SMOOT,WY,33,22,-11,0.4
83127,STAR VALLEY RANCH,WY,1059,1465,406,0.5804278922345484
83127,STAR VLY RNCH,WY,226,189,-37,0.45542168674698796
83127,THAYNE,WY,1272,1539,267,0.5474919957310566
83128,ALPINE,WY,1152,1144,-8,0.49825783972125437
83201,POCATELLO,ID,21291,16258,-5033,0.4329809049508642
83202,CHUBBUCK,ID,1533,1597,64,0.5102236421725239
83202,POCATELLO,ID,7011,7146,135,0.5047679593134139
83203,FORT HALL,ID,469,22,-447,0.04480651731160896
83204,POCATELLO,ID,8874,7651,-1223,0.46299546142208775
83205,POCATELLO,ID,749,623,-126,0.45408163265306123
83206,POCATELLO,ID,348,106,-242,0.23348017621145375
83209,POCATELLO,ID,0,27,27,1
83210,ABERDEEN,ID,747,599,-148,0.4450222882615156
83210,STERLING,ID,15,21,6,0.5833333333333334
83211,AMERICAN FALLS,ID,2262,1740,-522,0.43478260869565216
83211,AMERICAN FLS,ID,264,163,-101,0.38173302107728335
83213,ARCO,ID,815,809,-6,0.4981527093596059
83214,ARIMO,ID,0,12,12,1
83217,BANCROFT,ID,49,51,2,0.51
83221,BLACKFOOT,ID,9592,8898,-694,0.4812330989724175
83226,CHALLIS,ID,1158,1160,2,0.5004314063848145
83227,CLAYTON,ID,11,13,2,0.5416666666666666
83232,DAYTON,ID,0,26,26,1
83234,DOWNEY,ID,130,186,56,0.5886075949367089
83236,FIRTH,ID,609,583,-26,0.4890939597315436
83237,FRANKLIN,ID,150,436,286,0.7440273037542662
83239,GEORGETOWN,ID,26,11,-15,0.2972972972972973
83241,GRACE,ID,527,540,13,0.5060918462980318
83245,INKOM,ID,563,608,45,0.5192143467122118
83246,LAVA HOT SPGS,ID,39,0,-39,0
83246,LAVA HOT SPRINGS,ID,338,361,23,0.5164520743919886
83250,MCCAMMON,ID,385,425,40,0.5246913580246914
83251,MACKAY,ID,488,532,44,0.5215686274509804
83252,MALAD CITY,ID,1585,1564,-21,0.49666560812956495
83252,STONE,ID,35,18,-17,0.33962264150943394
83254,MONTPELIER,ID,1441,1421,-20,0.4965059399021663
83254,OVID,ID,66,57,-9,0.4634146341463415
83255,DARLINGTON,ID,0,13,13,1
83255,MOORE,ID,135,183,48,0.5754716981132075
83261,PARIS,ID,39,22,-17,0.36065573770491804
83262,PINGREE,ID,186,104,-82,0.3586206896551724
83263,PRESTON,ID,2928,3164,236,0.5193696651346028
83272,SAINT CHARLES,ID,22,13,-9,0.37142857142857144
83274,SHELLEY,ID,3237,3672,435,0.531480677377334
83276,SODA SPRINGS,ID,2296,1769,-527,0.4351783517835178
83278,STANLEY,ID,263,231,-32,0.4676113360323887
83286,WESTON,ID,22,157,135,0.8770949720670391
83287,FISH HAVEN,ID,231,224,-7,0.49230769230769234
83301,TWIN FALLS,ID,28209,27413,-796,0.49284455790874115
83303,TWIN FALLS,ID,1566,1984,418,0.5588732394366197
83311,ALBION,ID,14,0,-14,0
83313,BELLEVUE,ID,997,1193,196,0.5447488584474885
83313,GANNETT,ID,23,21,-2,0.4772727272727273
83314,BLISS,ID,26,81,55,0.7570093457943925
83316,BUHL,ID,4087,3798,-289,0.4816740646797717
83318,BURLEY,ID,6397,6404,7,0.5002734161393642
83320,CAREY,ID,50,109,59,0.6855345911949685
83321,CASTLEFORD,ID,126,11,-115,0.08029197080291971
83323,DECLO,ID,156,264,108,0.6285714285714286
83325,EDEN,ID,42,58,16,0.58
83327,FAIRFIELD,ID,96,176,80,0.6470588235294118
83328,FILER,ID,2165,2443,278,0.5301649305555556
83330,GOODING,ID,3062,2650,-412,0.4639355742296919
83332,HAGERMAN,ID,995,1133,138,0.5324248120300752
83333,HAILEY,ID,3836,4150,314,0.5196594039569247
83334,HANSEN,ID,636,570,-66,0.472636815920398
83335,HAZELTON,ID,345,283,-62,0.45063694267515925
83336,HEYBURN,ID,2468,2131,-337,0.4633616003479017
83338,JEROME,ID,8898,6615,-2283,0.42641655385805455
83340,KETCHUM,ID,3790,4043,253,0.5161496233882293
83341,KIMBERLY,ID,2585,3171,586,0.5509034051424601
83342,ELBA,ID,37,24,-13,0.39344262295081966
83342,MALTA,ID,206,137,-69,0.39941690962099125
83344,MURTAUGH,ID,84,127,43,0.6018957345971564
83346,OAKLEY,ID,112,132,20,0.5409836065573771
83347,PAUL,ID,1054,928,-126,0.4682139253279516
83349,RICHFIELD,ID,87,117,30,0.5735294117647058
83350,JACKSON,ID,287,294,7,0.5060240963855421
83350,RUPERT,ID,3385,3711,326,0.5229706877113867
83352,SHOSHONE,ID,1386,1173,-213,0.45838218053927315
83353,SUN VALLEY,ID,2187,1974,-213,0.47440519105984136
83354,SUN VALLEY,ID,22,80,58,0.7843137254901961
83355,WENDELL,ID,2415,1666,-749,0.40823327615780447
83401,IDAHO FALLS,ID,18157,17529,-628,0.49120103121672365
83402,IDAHO FALLS,ID,13730,12534,-1196,0.47723119098385625
83403,IDAHO FALLS,ID,994,1077,83,0.5200386286817963
83404,IDAHO FALLS,ID,9749,10143,394,0.5099034787854414
83405,IDAHO FALLS,ID,711,938,227,0.5688295936931473
83406,AMMON,ID,6589,6664,75,0.5028295480268619
83406,IDAHO FALLS,ID,294,278,-16,0.486013986013986
83414,ALTA,WY,38,61,23,0.6161616161616161
83420,ASHTON,ID,1321,1082,-239,0.45027049521431545
83421,CHESTER,ID,32,0,-32,0
83422,DRIGGS,ID,2592,2683,91,0.5086255924170616
83423,DUBOIS,ID,37,0,-37,0
83427,IONA,ID,668,756,88,0.5308988764044944
83428,IRWIN,ID,148,95,-53,0.39094650205761317
83429,ISLAND PARK,ID,1975,1592,-383,0.4463134286515279
83431,LEWISVILLE,ID,71,120,49,0.6282722513089005
83433,MACKS INN,ID,48,117,69,0.7090909090909091
83434,MENAN,ID,544,511,-33,0.4843601895734597
83435,MONTEVIEW,ID,23,11,-12,0.3235294117647059
83436,NEWDALE,ID,0,11,11,1
83440,REXBURG,ID,23577,16583,-6994,0.4129233067729084
83442,RIGBY,ID,6862,7795,933,0.5318277955925497
83443,RIRIE,ID,298,268,-30,0.4734982332155477
83444,ROBERTS,ID,93,197,104,0.6793103448275862
83445,SAINT ANTHONY,ID,2367,2356,-11,0.4988354859199661
83448,SUGAR CITY,ID,1190,926,-264,0.43761814744801514
83449,SWAN VALLEY,ID,102,70,-32,0.4069767441860465
83450,TERRETON,ID,76,43,-33,0.36134453781512604
83451,TETON,ID,41,56,15,0.5773195876288659
83452,TETONIA,ID,665,883,218,0.5704134366925064
83454,UCON,ID,0,24,24,1
83455,VICTOR,ID,3032,2879,-153,0.4870580274065302
83462,CARMEN,ID,11,76,65,0.8735632183908046
83464,LEADORE,ID,12,22,10,0.6470588235294118
83466,NORTH FORK,ID,124,61,-63,0.32972972972972975
83467,SALMON,ID,3430,3423,-7,0.49948927477017363
83501,LEWISTON,ID,18250,15737,-2513,0.46302998205196105
83522,COTTONWOOD,ID,642,594,-48,0.48058252427184467
83522,KEUTERVILLE,ID,18,17,-1,0.4857142857142857
83523,CRAIGMONT,ID,93,85,-8,0.47752808988764045
83524,CULDESAC,ID,153,116,-37,0.4312267657992565
83525,DIXIE,ID,13,0,-13,0
83525,ELK CITY,ID,68,114,46,0.6263736263736264
83526,FERDINAND,ID,18,0,-18,0
83530,GRANGEVILLE,ID,2925,2827,-98,0.4914812239221141
83535,JULIAETTA,ID,280,247,-33,0.4686907020872865
83536,KAMIAH,ID,1870,2012,142,0.5182895414734673
83537,KENDRICK,ID,219,295,76,0.5739299610894941
83539,KOOSKIA,ID,877,984,107,0.5287479849543256
83540,LAPWAI,ID,401,426,25,0.5151148730350665
83541,LENORE,ID,363,445,82,0.5507425742574258
83543,NEZPERCE,ID,0,11,11,1
83544,OROFINO,ID,2730,2620,-110,0.4897196261682243
83545,PECK,ID,35,24,-11,0.4067796610169492
83546,PIERCE,ID,62,0,-62,0
83547,POLLOCK,ID,0,20,20,1
83549,RIGGINS,ID,250,325,75,0.5652173913043478
83552,CLEARWATER,ID,161,125,-36,0.4370629370629371
83552,HARPSTER,ID,101,134,33,0.5702127659574469
83552,STITES,ID,231,264,33,0.5333333333333333
83553,WEIPPE,ID,112,134,22,0.5447154471544715
83554,WHITE BIRD,ID,119,128,9,0.5182186234817814
83555,WINCHESTER,ID,22,37,15,0.6271186440677966
83604,BRUNEAU,ID,25,11,-14,0.3055555555555556
83605,CALDWELL,ID,16410,14473,-1937,0.4686397046919017
83606,CALDWELL,ID,726,1088,362,0.5997794928335171
83607,CALDWELL,ID,11425,13721,2296,0.5456533842360614
83610,CAMBRIDGE,ID,176,385,209,0.6862745098039216
83611,CASCADE,ID,1797,1687,-110,0.48421354764638347
83612,COUNCIL,ID,798,871,73,0.5218693828639904
83612,FRUITVALE,ID,14,23,9,0.6216216216216216
83615,DONNELLY,ID,1607,1579,-28,0.4956057752667922
83616,EAGLE,ID,15422,18568,3146,0.5462783171521035
83617,EMMETT,ID,7690,7735,45,0.5014586709886548
83619,FRUITLAND,ID,3366,3959,593,0.5404778156996587
83622,GARDEN VALLEY,ID,1650,1286,-364,0.4380108991825613
83623,GLENNS FERRY,ID,573,383,-190,0.4006276150627615
83624,GRAND VIEW,ID,307,239,-68,0.43772893772893773
83626,GREENLEAF,ID,232,281,49,0.5477582846003899
83626,HOMEDALE,ID,0,11,11,1
83627,HAMMETT,ID,78,48,-30,0.38095238095238093
83628,HOMEDALE,ID,1898,1995,97,0.5124582584125353
83629,GARDEN,ID,20,24,4,0.5454545454545454
83629,HORSESHOE BEND,ID,1037,1033,-4,0.4990338164251208
83629,HORSESHOE BND,ID,42,44,2,0.5116279069767442
83630,HUSTON,ID,0,24,24,1
83631,IDAHO CITY,ID,556,775,219,0.5822689706987227
83632,INDIAN VALLEY,ID,13,11,-2,0.4583333333333333
83634,KUNA,ID,11070,13722,2652,0.5534849951597289
83636,LETHA,ID,69,61,-8,0.46923076923076923
83637,LOWMAN,ID,84,48,-36,0.36363636363636365
83638,MCCALL,ID,4810,4604,-206,0.4890588485234757
83639,MARSING,ID,2007,1234,-773,0.38074668312249305
83641,MELBA,ID,900,1045,145,0.5372750642673522
83642,MERIDIAN,ID,26545,31931,5386,0.546053081606129
83644,MIDDLETON,ID,5655,6577,922,0.5376880313930673
83645,MIDVALE,ID,24,38,14,0.6129032258064516
83646,MERIDIAN,ID,25257,29979,4722,0.5427438626982403
83647,MOUNTAIN HOME,ID,11407,10359,-1048,0.47592575576587337
83647,MTN HOME,ID,1154,1053,-101,0.47711826008155866
83648,MOUNTAIN HOME AFB,ID,2247,1765,-482,0.4399302093718844
83648,MTN HOME AFB,ID,401,314,-87,0.43916083916083914
83650,MURPHY,ID,22,24,2,0.5217391304347826
83651,NAMPA,ID,14866,14285,-581,0.49003464718191486
83652,NAMPA,ID,25,0,-25,0
83653,NAMPA,ID,1184,1717,533,0.5918648741813168
83654,NEW MEADOWS,ID,1053,882,-171,0.4558139534883721
83655,NEW PLYMOUTH,ID,1855,1711,-144,0.4798093101514302
83657,OLA,ID,0,13,13,1
83660,PARMA,ID,2203,2330,127,0.5140083829693359
83661,PAYETTE,ID,5618,4969,-649,0.4693492018513271
83669,STAR,ID,5707,7761,2054,0.5762548262548263
83670,SWEET,ID,0,13,13,1
83672,WEISER,ID,3753,3907,154,0.5100522193211489
83676,WILDER,ID,1377,1642,265,0.543888704869162
83680,MERIDIAN,ID,1781,1171,-610,0.39668021680216803
83686,NAMPA,ID,20756,21561,805,0.5095115438239951
83687,NAMPA,ID,15309,18012,2703,0.540560007202665
83701,BOISE,ID,1124,619,-505,0.35513482501434307
83702,BOISE,ID,19445,15593,-3852,0.44503110908156857
83703,BOISE,ID,10060,8754,-1306,0.46529180397576275
83704,BOISE,ID,24175,19432,-4743,0.44561652945627994
83705,BOISE,ID,18528,15017,-3511,0.4476673125652109
83706,BOISE,ID,21399,16043,-5356,0.42847604294642383
83707,BOISE,ID,2529,2429,-100,0.4899152884227511
83709,BOISE,ID,23725,22746,-979,0.48946654903057824
83711,BOISE,ID,621,856,235,0.5795531482735274
83712,BOISE,ID,4812,4631,-181,0.4904161812983162
83713,BOISE,ID,14421,12801,-1620,0.4702446550584086
83714,BOISE,ID,6172,6473,301,0.5119019375247134
83714,EAGLE,ID,542,522,-20,0.4906015037593985
83714,GARDEN CITY,ID,7959,8688,729,0.5218958370877635
83715,BOISE,ID,200,43,-157,0.17695473251028807
83716,BOISE,ID,9191,9867,676,0.5177353342428377
83717,BOISE,ID,141,138,-3,0.4946236559139785
83719,BOISE,ID,800,911,111,0.532437171244886
83801,ATHOL,ID,3260,3508,248,0.5183215130023641
83803,BAYVIEW,ID,565,473,-92,0.4556840077071291
83804,BLANCHARD,ID,1000,1122,122,0.528746465598492
83805,BONNERS FERRY,ID,3782,3921,139,0.5090224587822926
83809,CAREYWOOD,ID,40,0,-40,0
83810,CATALDO,ID,97,159,62,0.62109375
83811,CLARK FORK,ID,1132,1034,-98,0.4773776546629732
83813,COCOLALLA,ID,572,581,9,0.5039028620988725
83814,COEUR D ALENE,ID,16970,15798,-1172,0.48211669921875
83815,COEUR D ALENE,ID,15922,16609,687,0.5105591589560726
83815,DALTON GARDENS,ID,1656,1889,233,0.5328631875881523
83815,DALTON GDNS,ID,448,462,14,0.5076923076923077
83816,COEUR D ALENE,ID,1965,1956,-9,0.49885233358837033
83821,COOLIN,ID,313,446,133,0.5876152832674572
83822,OLDTOWN,ID,716,872,156,0.5491183879093199
83823,DEARY,ID,366,432,66,0.5413533834586466
83825,DOVER,ID,169,245,76,0.5917874396135265
83830,FERNWOOD,ID,0,74,74,1
83832,GENESEE,ID,305,377,72,0.5527859237536656
83833,HARRISON,ID,916,1006,90,0.5234131113423517
83835,HAYDEN,ID,12031,13570,1539,0.5300574196320457
83836,HOPE,ID,849,892,43,0.5123492245835727
83837,KELLOGG,ID,1780,1575,-205,0.46944858420268254
83839,KINGSTON,ID,307,454,147,0.5965834428383706
83840,KOOTENAI,ID,0,133,133,1
83841,LACLEDE,ID,62,130,68,0.6770833333333334
83843,MOSCOW,ID,18148,13965,-4183,0.4348706131473235
83845,MOYIE SPRINGS,ID,744,813,69,0.5221579961464354
83846,MULLAN,ID,24,16,-8,0.4
83847,NAPLES,ID,660,775,115,0.5400696864111498
83848,NORDMAN,ID,211,119,-92,0.3606060606060606
83849,OSBURN,ID,718,816,98,0.5319426336375489
83850,PINEHURST,ID,839,1014,175,0.5472207231516459
83851,PLUMMER,ID,589,785,196,0.5713245997088792
83852,PONDERAY,ID,1286,1480,194,0.5350686912509038
83854,HAUSER,ID,472,659,187,0.5826702033598585
83854,POST FALLS,ID,21482,25567,4085,0.5434121872940977
83855,POTLATCH,ID,533,628,95,0.540913006029285
83856,PRIEST LAKE,ID,201,136,-65,0.4035608308605341
83856,PRIEST RIVER,ID,2972,3245,273,0.5219559272961235
83857,POST FALLS,ID,0,11,11,1
83857,PRINCETON,ID,14,95,81,0.8715596330275229
83858,RATHDRUM,ID,7709,8684,975,0.5297383029341792
83860,SAGLE,ID,4056,4281,225,0.5134940626124506
83861,SAINT MARIES,ID,2880,2939,59,0.505069599587558
83861,ST MARIES,ID,166,137,-29,0.4521452145214521
83864,SANDPOINT,ID,10894,11179,285,0.5064558510397318
83866,SANTA,ID,12,0,-12,0
83867,SILVERTON,ID,13,11,-2,0.4583333333333333
83868,SMELTERVILLE,ID,110,217,107,0.6636085626911316
83869,SPIRIT LAKE,ID,2884,2770,-114,0.4899186416696144
83871,TROY,ID,443,599,156,0.5748560460652591
83872,VIOLA,ID,94,148,54,0.6115702479338843
83873,WALLACE,ID,1094,873,-221,0.443823080833757
83876,WORLEY,ID,856,932,76,0.5212527964205816
83877,POST FALLS,ID,2034,1825,-209,0.4729204457113242
84001,ALTAMONT,UT,12,33,21,0.7333333333333333
84003,AMERICAN FORK,UT,10489,12427,1938,0.5422848664688428
84003,HIGHLAND,UT,4987,5626,639,0.530104588711957
84004,ALPINE,UT,2318,2556,238,0.5244152646696758
84005,EAGLE MOUNTAIN,UT,10784,15609,4825,0.591406812412382
84005,EAGLE MTN,UT,243,330,87,0.5759162303664922
84006,BINGHAM CANYON,UT,48,12,-36,0.2
84006,COPPERTON,UT,12,25,13,0.6756756756756757
84007,BLUEBELL,UT,11,0,-11,0
84009,SOUTH JORDAN,UT,12641,16757,4116,0.5700047622287231
84010,BOUNTIFUL,UT,15989,14386,-1603,0.47361316872427983
84010,WOODS CROSS,UT,319,260,-59,0.44905008635578586
84011,BOUNTIFUL,UT,462,686,224,0.5975609756097561
84013,CEDAR VALLEY,UT,64,53,-11,0.452991452991453
84013,FAIRFIELD,UT,25,0,-25,0
84014,CENTERVILLE,UT,5636,5277,-359,0.48355172729771834
84015,CLEARFIELD,UT,22543,21730,-813,0.49081833171458905
84015,CLINTON,UT,550,518,-32,0.4850187265917603
84015,SUNSET,UT,977,843,-134,0.4631868131868132
84016,CLEARFIELD,UT,98,119,21,0.5483870967741935
84017,COALVILLE,UT,1140,1281,141,0.5291201982651796
84017,WANSHIP,UT,137,173,36,0.5580645161290323
84020,DRAPER,UT,21515,21103,-412,0.4951663616312356
84021,DUCHESNE,UT,1044,1163,119,0.5269596737652923
84022,DUGWAY,UT,256,125,-131,0.32808398950131235
84022,TERRA,UT,11,0,-11,0
84023,DUTCH JOHN,UT,37,12,-25,0.24489795918367346
84025,FARMINGTON,UT,6957,7270,313,0.511000210866662
84026,FORT DUCHESNE,UT,272,176,-96,0.39285714285714285
84028,GARDEN CITY,UT,466,496,30,0.5155925155925156
84028,WVC,UT,36,0,-36,0
84029,GRANTSVILLE,UT,3985,4990,1005,0.5559888579387187
84031,HANNA,UT,12,0,-12,0
84032,HEBER CITY,UT,8443,8852,409,0.5118242266551026
84033,HENEFER,UT,12,0,-12,0
84035,JENSEN,UT,15,33,18,0.6875
84035,KAMAS,UT,0,12,12,1
84036,HIDEOUT,UT,569,751,182,0.568939393939394
84036,KAMAS,UT,3166,3365,199,0.5152350329199203
84037,FRUIT HEIGHTS,UT,971,1174,203,0.5473193473193473
84037,KAYSVILLE,UT,7751,8350,599,0.5186013291099931
84038,LAKETOWN,UT,0,14,14,1
84039,LAPOINT,UT,13,42,29,0.7636363636363637
84040,LAYTON,UT,8108,8294,186,0.5056700402389952
84041,LAYTON,UT,23220,20343,-2877,0.4669788582053578
84042,LINDON,UT,2862,3384,522,0.5417867435158501
84043,LEHI,UT,23136,27047,3911,0.5389673793914274
84044,MAGNA,UT,10047,10204,157,0.503876351785097
84045,SARATOGA SPGS,UT,1425,2047,622,0.589573732718894
84045,SARATOGA SPRINGS,UT,8290,12290,4000,0.597181729834791
84046,MANILA,UT,304,84,-220,0.21649484536082475
84047,MIDVALE,UT,25386,21104,-4282,0.4539470853947085
84049,MIDWAY,UT,3122,3336,214,0.516568597088882
84050,MORGAN,UT,2626,2913,287,0.5259072034663297
84050,MOUNTAIN GREEN,UT,148,201,53,0.5759312320916905
84052,MYTON,UT,205,220,15,0.5176470588235295
84052,OREM,UT,14,15,1,0.5172413793103449
84053,NEOLA,UT,0,23,23,1
84054,N SALT LAKE,UT,537,407,-130,0.4311440677966102
84054,NORTH SALT LAKE,UT,10973,8804,-2169,0.44516357384840977
84055,OAKLEY,UT,394,461,67,0.5391812865497077
84056,HILL AFB,UT,2328,1590,-738,0.4058192955589586
84056,HILL AIR FORCE BASE,UT,1551,1007,-544,0.3936669272869429
84057,OREM,UT,13652,11230,-2422,0.4513302789164858
84058,OREM,UT,14674,11208,-3466,0.43304226875821034
84059,OREM,UT,2972,3016,44,0.5036740146960588
84059,VINEYARD,UT,5338,5554,216,0.5099155343371282
84060,PARK CITY,UT,4916,5771,855,0.5400018714325816
84062,CEDAR HILLS,UT,1656,1536,-120,0.48120300751879697
84062,PLEASANT GROVE,UT,11861,11535,-326,0.4930329970935203
84062,PLEASANT GRV,UT,1389,1316,-73,0.4865064695009242
84065,BLUFFDALE,UT,2485,2788,303,0.5287312725203869
84065,RIVERTON,UT,11525,12629,1104,0.522853357621926
84066,BALLARD,UT,679,662,-17,0.4936614466815809
84066,ROOSEVELT,UT,3813,3827,14,0.5009162303664921
84067,ROY,UT,15668,13174,-2494,0.4567644407461341
84068,PARK CITY,UT,2326,2345,19,0.5020338257332477
84069,RUSH VALLEY,UT,0,11,11,1
84070,SANDY,UT,16696,14321,-2375,0.46171454363736014
84071,OPHIR,UT,0,12,12,1
84071,SOUTH RIM,UT,13,30,17,0.6976744186046512
84071,STOCKTON,UT,230,386,156,0.6266233766233766
84072,TABIONA,UT,11,0,-11,0
84074,LAKE POINT,UT,348,358,10,0.5070821529745042
84074,TOOELE,UT,17381,19851,2470,0.5331703910614525
84075,SYRACUSE,UT,8086,9065,979,0.5285406098769752
84078,VERNAL,UT,12333,12293,-40,0.4991878502395842
84081,WEST JORDAN,UT,14729,15391,662,0.5109893758300132
84082,WALLSBURG,UT,0,16,16,1
84083,WENDOVER,UT,215,63,-152,0.22661870503597123
84084,WEST JORDAN,UT,11912,10404,-1508,0.4662125829001613
84087,MURRAY,UT,70,84,14,0.5454545454545454
84087,WEST BOUNTIFUL,UT,1477,1716,239,0.5374256185405575
84087,WOODS CROSS,UT,2046,2280,234,0.5270457697642164
84088,WEST JORDAN,UT,13425,11923,-1502,0.47037241596970175
84089,CLEARFIELD,UT,657,339,-318,0.34036144578313254
84090,SANDY,UT,244,349,105,0.5885328836424958
84091,SANDY,UT,458,767,309,0.6261224489795918
84092,OREM,UT,134,180,46,0.5732484076433121
84092,SANDY,UT,7956,8047,91,0.5028432168968319
84093,COTTONWD HTS,UT,121,124,3,0.5061224489795918
84093,COTTONWOOD HEIGHTS,UT,707,689,-18,0.49355300859598855
84093,SANDY,UT,4773,5264,491,0.524459499850553
84094,SANDY,UT,10333,9139,-1194,0.4693405916187346
84095,SOUTH JORDAN,UT,15506,14860,-646,0.48936310347098727
84096,HERRIMAN,UT,15712,18862,3150,0.5455544628911899
84096,RIVERTON,UT,5914,7643,1729,0.563767795234934
84097,OREM,UT,11340,7256,-4084,0.3901914390191439
84098,PARK CITY,UT,10967,11477,510,0.5113616111210123
84098,SNYDERVILLE,UT,328,379,51,0.536067892503536
84101,SALT LAKE CITY,UT,8868,8509,-359,0.48967025378373713
84101,SLC,UT,426,440,14,0.5080831408775982
84102,BLG,UT,222,186,-36,0.45588235294117646
84102,SALT LAKE CITY,UT,15342,9768,-5574,0.38900836320191157
84102,SLC,UT,1411,879,-532,0.3838427947598253
84103,SALT LAKE CITY,UT,16345,13777,-2568,0.4573733483832415
84104,SALT LAKE CITY,UT,8846,6924,-1922,0.4390615091946734
84104,SLC,UT,195,158,-37,0.4475920679886686
84105,SALT LAKE CITY,UT,10938,8962,-1976,0.4503517587939698
84105,SLC,UT,1597,1228,-369,0.4346902654867257
84106,SALT LAKE CITY,UT,18267,15201,-3066,0.4541950519899606
84106,SLC,UT,2957,2483,-474,0.45643382352941175
84107,MILLCREEK,UT,850,798,-52,0.4842233009708738
84107,MURRAY,UT,7375,6351,-1024,0.46269852834037595
84107,SALT LAKE CITY,UT,15764,13006,-2758,0.4520681265206813
84108,SALT LAKE CITY,UT,8463,7378,-1085,0.4657534246575342
84108,SLC,UT,152,93,-59,0.3795918367346939
84109,MILLCREEK,UT,130,125,-5,0.49019607843137253
84109,SALT LAKE CITY,UT,8742,7968,-774,0.4768402154398564
84109,SLC,UT,193,173,-20,0.4726775956284153
84110,SALT LAKE CITY,UT,919,1154,235,0.5566811384466956
84110,SLC,UT,433,192,-241,0.3072
84111,SALT LAKE CITY,UT,11025,8775,-2250,0.4431818181818182
84111,SLC,UT,1483,1201,-282,0.4474664679582712
84112,SALT LAKE CITY,UT,114,41,-73,0.2645161290322581
84112,SALT LAKE CTY,UT,11,0,-11,0
84113,SALT LAKE CITY,UT,36,0,-36,0
84115,SALT LAKE CITY,UT,13086,8343,-4743,0.38933221335573287
84115,SOUTH SALT LAKE,UT,12699,8331,-4368,0.39614835948644794
84116,SALT LAKE CITY,UT,16452,13473,-2979,0.4502255639097744
84116,SLC,UT,327,305,-22,0.4825949367088608
84117,HOLLADAY,UT,1830,1680,-150,0.47863247863247865
84117,MILLCREEK,UT,561,494,-67,0.46824644549763034
84117,SALT LAKE CITY,UT,9139,8330,-809,0.476844696319194
84118,KEARNS,UT,2569,1877,-692,0.42217723796671164
84118,SALT LAKE CITY,UT,11093,9379,-1714,0.45813794450957407
84119,SALT LAKE CITY,UT,900,758,-142,0.4571773220747889
84119,SOUTH SALT LAKE,UT,2052,1386,-666,0.4031413612565445
84119,W VALLEY CITY,UT,403,273,-130,0.40384615384615385
84119,WEST VALLEY CITY,UT,20394,15105,-5289,0.4255049438012338
84120,W VALLEY CITY,UT,1819,1527,-292,0.45636580992229525
84120,WEST VALLEY CITY,UT,17147,12158,-4989,0.41487800716601264
84121,COTTONWOOD,UT,315,314,-1,0.49920508744038156
84121,COTTONWOOD HEIGHTS,UT,781,665,-116,0.4598893499308437
84121,COTTONWOOD HEIGHTS CITY,UT,775,681,-94,0.4677197802197802
84121,HOLLADAY,UT,2890,2643,-247,0.47767937827579976
84121,SALT LAKE CITY,UT,12485,11581,-904,0.4812183162968503
84123,MURRAY,UT,3612,2899,-713,0.4452465059130702
84123,SALT LAKE CITY,UT,13509,11401,-2108,0.4576876756322762
84123,SLC,UT,2015,1776,-239,0.468477974149301
84123,TAYLORSVILLE,UT,515,426,-89,0.4527098831030818
84124,HOLLADAY,UT,493,438,-55,0.47046186895810954
84124,MILLCREEK,UT,274,245,-29,0.4720616570327553
84124,SALT LAKE CITY,UT,7051,6377,-674,0.4749031873696753
84124,SLC,UT,308,246,-62,0.44404332129963897
84125,SALT LAKE CITY,UT,74,68,-6,0.4788732394366197
84126,SALT LAKE CITY,UT,43,75,32,0.635593220338983
84127,SALT LAKE CITY,UT,843,383,-460,0.31239804241435565
84128,W VALLEY CITY,UT,200,130,-70,0.3939393939393939
84128,WEST VALLEY,UT,258,178,-80,0.40825688073394495
84128,WEST VALLEY CITY,UT,10255,6990,-3265,0.4053348796752682
84129,TAYLORSVILLE,UT,13879,11473,-2406,0.4525481224360997
84130,SALT LAKE CITY,UT,37,51,14,0.5795454545454546
84147,SLC,UT,13,0,-13,0
84152,SALT LAKE CITY,UT,867,1007,140,0.5373532550693704
84152,SLC,UT,59,65,6,0.5241935483870968
84157,MURRAY,UT,568,575,7,0.5030621172353456
84157,SALT LAKE CITY,UT,846,772,-74,0.47713226205191595
84157,SLC,UT,17,35,18,0.6730769230769231
84158,SALT LAKE CITY,UT,326,328,2,0.5015290519877675
84165,S SALT LAKE,UT,36,53,17,0.5955056179775281
84165,SALT LAKE CITY,UT,526,703,177,0.5720097640358015
84165,SALT LAKE CTY,UT,12,16,4,0.5714285714285714
84165,SLC,UT,0,17,17,1
84165,SOUTH SALT LAKE,UT,31,51,20,0.6219512195121951
84170,SALT LAKE CITY,UT,572,860,288,0.6005586592178771
84170,W VALLEY CITY,UT,62,113,51,0.6457142857142857
84170,WEST VALLEY,UT,422,493,71,0.5387978142076503
84170,WEST VALLEY CITY,UT,22,62,40,0.7380952380952381
84171,COTTONWD HTS,UT,30,17,-13,0.3617021276595745
84171,COTTONWOOD,UT,15,12,-3,0.4444444444444444
84171,COTTONWOOD HEIGHTS,UT,92,132,40,0.5892857142857143
84171,COTTONWOOD HEIGHTS CITY,UT,66,59,-7,0.472
84171,SALT LAKE CITY,UT,336,350,14,0.5102040816326531
84171,SALT LAKE CTY,UT,13,0,-13,0
84301,BEAR RIVER CITY,UT,77,37,-40,0.32456140350877194
84302,BRIGHAM CITY,UT,8802,7893,-909,0.47277628032345015
84302,PERRY,UT,151,133,-18,0.46830985915492956
84305,CLARKSTON,UT,14,0,-14,0
84307,CORINNE,UT,155,238,83,0.6055979643765903
84310,EDEN,UT,2320,2494,174,0.5180722891566265
84310,LIBERTY,UT,83,105,22,0.5585106382978723
84311,FIELDING,UT,37,157,120,0.8092783505154639
84312,GARLAND,UT,1154,1307,153,0.531084924827306
84314,HONEYVILLE,UT,66,81,15,0.5510204081632653
84315,HOOPER,UT,1960,2340,380,0.5441860465116279
84317,HUNTSVILLE,UT,934,1188,254,0.5598491988689915
84318,HYDE PARK,UT,1089,1433,344,0.5681998413957177
84319,HYRUM,UT,2630,3348,718,0.5600535296085647
84320,COVE,UT,24,27,3,0.5294117647058824
84320,LEWISTON,UT,361,317,-44,0.46755162241887904
84321,LOGAN,UT,23925,18193,-5732,0.43195308419203193
84321,NIBLEY,UT,1589,1115,-474,0.41235207100591714
84323,LOGAN,UT,884,591,-293,0.4006779661016949
84324,MANTUA,UT,12,152,140,0.926829268292683
84325,MENDON,UT,424,484,60,0.5330396475770925
84326,MILLVILLE,UT,718,273,-445,0.27547931382441976
84327,NEWTON,UT,14,0,-14,0
84328,PARADISE,UT,243,248,5,0.505091649694501
84332,PROVIDENCE,UT,2510,2962,452,0.5413011695906432
84333,RICHMOND,UT,853,767,-86,0.4734567901234568
84335,SMITHFIELD,UT,4579,4819,240,0.512768674185997
84337,TREMONTON,UT,4014,4879,865,0.5486337568874395
84339,WELLSVILLE,UT,1287,1518,231,0.5411764705882353
84340,WILLARD,UT,1202,1309,107,0.5213062524890482
84341,LOGAN,UT,24336,12537,-11799,0.3400048816206981
84401,OGDEN,UT,19067,20481,1414,0.5178770102154344
84401,WEST HAVEN,UT,1245,1435,190,0.5354477611940298
84402,OGDEN,UT,386,484,98,0.5563218390804597
84403,OGDEN,UT,21584,13573,-8011,0.3860682083226669
84403,SOUTH OGDEN,UT,349,275,-74,0.4407051282051282
84404,FARR WEST,UT,502,467,-35,0.48194014447884415
84404,HARRISVILLE,UT,490,537,47,0.5228821811100293
84404,MARRIOTT SLATERVILLE CITY,UT,418,471,53,0.5298087739032621
84404,OGDEN,UT,19742,20106,364,0.5045673559526199
84405,OGDEN,UT,12203,11380,-823,0.4825509901200017
84408,OGDEN,UT,261,0,-261,0
84409,OGDEN,UT,105,421,316,0.8003802281368821
84412,OGDEN,UT,674,894,220,0.5701530612244898
84414,HARRISVILLE,UT,535,680,145,0.5596707818930041
84414,NORTH OGDEN,UT,3705,4266,561,0.5351900639819345
84414,OGDEN,UT,3801,4220,419,0.5261189377883057
84414,PLEASANT VIEW,UT,357,437,80,0.5503778337531486
84415,OGDEN,UT,271,108,-163,0.2849604221635884
84501,PRICE,UT,4779,4731,-48,0.4974763406940063
84511,BLANDING,UT,1187,1155,-32,0.4931682322801025
84511,WHITE MESA,UT,95,89,-6,0.483695652173913
84512,BLUFF,UT,150,97,-53,0.39271255060728744
84513,CASTLE DALE,UT,105,203,98,0.6590909090909091
84518,CLEVELAND,UT,11,26,15,0.7027027027027027
84520,EAST CARBON,UT,265,294,29,0.5259391771019678
84523,FERRON,UT,244,208,-36,0.46017699115044247
84525,GREEN RIVER,UT,50,108,58,0.6835443037974683
84526,HELPER,UT,1347,1364,17,0.5031353744005902
84526,SCOFIELD,UT,36,26,-10,0.41935483870967744
84528,HUNTINGTON,UT,749,648,-101,0.4638511095204009
84530,LA SAL,UT,27,12,-15,0.3076923076923077
84532,MOAB,UT,6360,5485,-875,0.463064584212748
84533,BULLFROG,UT,24,11,-13,0.3142857142857143
84533,LAKE POWELL,UT,0,11,11,1
84534,MONTEZUMA CREEK,UT,22,12,-10,0.35294117647058826
84535,MONTICELLO,UT,749,468,-281,0.38455217748562037
84537,ORANGEVILLE,UT,60,74,14,0.5522388059701493
84539,SUNNYSIDE,UT,25,0,-25,0
84542,WELLINGTON,UT,543,543,0,0.5
84601,PROVO,UT,13598,10396,-3202,0.4332749854130199
84602,PROVO,UT,39,22,-17,0.36065573770491804
84603,PROVO,UT,299,370,71,0.5530642750373692
84604,PROVO,UT,16112,11782,-4330,0.4223847422384742
84605,PROVO,UT,26,43,17,0.6231884057971014
84606,PROVO,UT,14982,9194,-5788,0.3802945069490404
84620,AURORA,UT,13,36,23,0.7346938775510204
84622,CENTERFIELD,UT,22,53,31,0.7066666666666667
84624,DELTA,UT,1145,1267,122,0.525290215588723
84624,DESERET,UT,44,38,-6,0.4634146341463415
84624,OASIS,UT,65,72,7,0.5255474452554745
84627,EPHRAIM,UT,2334,1754,-580,0.42906066536203524
84628,EUREKA,UT,34,0,-34,0
84629,FAIRVIEW,UT,752,1116,364,0.5974304068522484
84631,FILLMORE,UT,1148,1078,-70,0.48427672955974843
84632,FOUNTAIN GREEN,UT,66,86,20,0.5657894736842105
84633,GOSHEN,UT,0,12,12,1
84634,GUNNISON,UT,181,190,9,0.5121293800539084
84635,HINCKLEY,UT,0,15,15,1
84637,KANOSH,UT,11,11,0,0.5
84639,LEVAN,UT,40,27,-13,0.40298507462686567
84642,MANTI,UT,1041,1181,140,0.5315031503150315
84645,MONA,UT,281,373,92,0.5703363914373089
84646,MORONI,UT,162,153,-9,0.4857142857142857
84647,MOUNT PLEASANT,UT,1163,1300,137,0.5278116118554608
84647,MT PLEASANT,UT,191,227,36,0.5430622009569378
84648,NEPHI,UT,1809,2048,239,0.5309826289862587
84649,OAK CITY,UT,14,0,-14,0
84651,ELK RIDGE,UT,439,537,98,0.5502049180327869
84651,PAYSON,UT,6944,7782,838,0.5284530761917696
84652,REDMOND,UT,38,36,-2,0.4864864864864865
84653,SALEM,UT,1638,2124,486,0.5645933014354066
84653,SPRINGVILLE,UT,38,52,14,0.5777777777777777
84653,WOODLAND HILLS,UT,613,904,291,0.5959129861568886
84654,SALINA,UT,908,982,74,0.5195767195767196
84655,GENOLA,UT,256,397,141,0.6079632465543645
84655,SANTAQUIN,UT,3038,4415,1377,0.5923789078223534
84660,SPANISH FORK,UT,11903,12484,581,0.5119120843072129
84662,SPRING CITY,UT,44,165,121,0.7894736842105263
84663,SPRINGVILLE,UT,12781,11161,-1620,0.4661682399131234
84664,MAPLETON,UT,2267,3519,1252,0.6081921880400968
84701,RICHFIELD,UT,3153,3209,56,0.504401131719585
84701,SIGURD,UT,58,49,-9,0.45794392523364486
84711,ANNABELLA,UT,25,64,39,0.7191011235955056
84713,BEAVER,UT,1172,997,-175,0.45965882895343474
84714,BERYL,UT,22,26,4,0.5416666666666666
84715,BICKNELL,UT,14,11,-3,0.44
84716,BOULDER,UT,35,36,1,0.5070422535211268
84719,BRIAN HEAD,UT,0,12,12,1
84720,CEDAR CITY,UT,9217,9139,-78,0.4978753541076487
84721,CEDAR CITY,UT,11752,11990,238,0.5050122146407211
84722,CENTRAL,UT,22,49,27,0.6901408450704225
84724,ELSINORE,UT,185,189,4,0.5053475935828877
84725,ENTERPRISE,UT,180,433,253,0.7063621533442088
84726,ESCALANTE,UT,107,94,-13,0.46766169154228854
84735,HATCH,UT,54,15,-39,0.21739130434782608
84737,APPLE VALLEY,UT,192,253,61,0.5685393258426966
84737,HURRICANE,UT,9070,11058,1988,0.5493839427662957
84738,IVINS,UT,4015,4946,931,0.5519473273072202
84741,BIG WATER,UT,70,77,7,0.5238095238095238
84741,KANAB,UT,2548,3061,513,0.5457300766625067
84742,KANARRAVILLE,UT,22,12,-10,0.35294117647058826
84745,LA VERKIN,UT,1704,1681,-23,0.496602658788774
84746,LEEDS,UT,271,462,191,0.6302864938608458
84747,FREMONT,UT,12,12,0,0.5
84747,LOA,UT,103,86,-17,0.455026455026455
84750,MARYSVALE,UT,0,40,40,1
84751,MILFORD,UT,304,165,-139,0.35181236673773986
84752,MINERSVILLE,UT,11,0,-11,0
84754,CENTRAL VALLEY,UT,175,223,48,0.5603015075376885
84754,MONROE,UT,925,1086,161,0.5400298359025361
84757,NEW HARMONY,UT,319,566,247,0.63954802259887
84759,PANGUITCH,UT,653,705,52,0.5191458026509573
84761,CEDAR CITY,UT,21,16,-5,0.43243243243243246
84761,PAROWAN,UT,888,1207,319,0.5761336515513127
84762,DUCK CREEK VILLAGE,UT,110,206,96,0.6518987341772152
84764,BRYCE,UT,80,57,-23,0.41605839416058393
84765,SANTA CLARA,UT,2615,2683,68,0.5064175160437902
84767,SPRINGDALE,UT,743,324,-419,0.3036551077788191
84770,SAINT GEORGE,UT,22036,21969,-67,0.49923872287240084
84770,ST GEORGE,UT,1489,1157,-332,0.43726379440665153
84771,SAINT GEORGE,UT,1227,1183,-44,0.4908713692946058
84771,ST GEORGE,UT,90,112,22,0.5544554455445545
84773,TEASDALE,UT,0,38,38,1
84774,TOQUERVILLE,UT,592,647,55,0.5221953188054883
84775,TORREY,UT,35,11,-24,0.2391304347826087
84779,VIRGIN,UT,63,78,15,0.5531914893617021
84780,WASHINGTON,UT,13175,16019,2844,0.5487086387613893
84782,BROOKSIDE,UT,23,46,23,0.6666666666666666
84782,VEYO,UT,50,23,-27,0.3150684931506849
84783,DAMMERON VALLEY,UT,128,168,40,0.5675675675675675
84783,DAMMERON VLY,UT,11,0,-11,0
84784,HILDALE,UT,28,22,-6,0.44
84790,SAINT GEORGE,UT,17562,20318,2756,0.5363780359028512
84790,ST GEORGE,UT,5099,6220,1121,0.5495185087021822
84791,SAINT GEORGE,UT,1142,1176,34,0.5073339085418465
84791,ST GEORGE,UT,136,115,-21,0.4581673306772908
85001,PHOENIX,AZ,735,1025,290,0.5823863636363636
85002,PHOENIX,AZ,13,0,-13,0
85003,PHOENIX,AZ,6420,6355,-65,0.4974559686888454
85004,PHOENIX,AZ,10716,11038,322,0.5074009377585731
85005,PHOENIX,AZ,392,1076,684,0.7329700272479565
85006,PHOENIX,AZ,11318,9710,-1608,0.46176526536047174
85007,PHOENIX,AZ,6924,7241,317,0.5111895517119661
85008,PHOENIX,AZ,32183,28150,-4033,0.4665771634097426
85009,PHOENIX,AZ,13015,10643,-2372,0.44986896610026206
85010,PHOENIX,AZ,20,59,39,0.7468354430379747
85011,PHOENIX,AZ,110,61,-49,0.3567251461988304
85012,PHOENIX,AZ,8309,8130,-179,0.4945556299044954
85013,PHOENIX,AZ,17077,16099,-978,0.4852604292259465
85014,PHOENIX,AZ,21052,18095,-2957,0.4622320995223133
85014,PHX,AZ,504,399,-105,0.4418604651162791
85015,PHOENIX,AZ,24559,20185,-4374,0.4511219381369569
85016,PHOENIX,AZ,32876,30597,-2279,0.48204748475729836
85017,PHOENIX,AZ,16138,12693,-3445,0.4402552807741667
85018,PHOENIX,AZ,25475,24520,-955,0.49044904490449043
85019,PHOENIX,AZ,8658,7650,-1008,0.46909492273730685
85020,PHOENIX,AZ,21154,20598,-556,0.4933416363287986
85021,PHOENIX,AZ,24553,22715,-1838,0.48055767115173054
85022,PHOENIX,AZ,30599,28904,-1695,0.4857570206544208
85023,PHOENIX,AZ,19868,18344,-1524,0.48005862032869256
85024,PHOENIX,AZ,14288,14416,128,0.5022296544035675
85027,PHOENIX,AZ,25260,22518,-2742,0.4713047846289087
85028,PHOENIX,AZ,8654,9973,1319,0.5354055940301713
85029,PHOENIX,AZ,24646,22521,-2125,0.4774736574299828
85031,PHOENIX,AZ,8520,7250,-1270,0.45973367152821815
85032,FLORENCE,AZ,807,700,-107,0.46449900464499005
85032,PHOENIX,AZ,31828,29892,-1936,0.4843162670123137
85032,SCOTTSDALE,AZ,652,635,-17,0.4933954933954934
85033,PHOENIX,AZ,17377,14220,-3157,0.45004272557521285
85034,PHOENIX,AZ,4672,4518,-154,0.4916213275299238
85035,PHOENIX,AZ,19555,15569,-3986,0.44325817105113313
85036,PHOENIX,AZ,394,861,467,0.6860557768924302
85037,PHOENIX,AZ,19728,17298,-2430,0.4671852211959164
85038,PHOENIX,AZ,227,45,-182,0.16544117647058823
85040,PHOENIX,AZ,13530,12802,-728,0.4861765152665958
85041,PHOENIX,AZ,19465,19734,269,0.5034312099798465
85041,PHX,AZ,413,369,-44,0.4718670076726343
85042,PHOENIX,AZ,18147,18460,313,0.5042751386346873
85043,PHOENIX,AZ,10726,12620,1894,0.5405636939946886
85044,PHOENIX,AZ,25851,24079,-1772,0.48225515722010814
85045,PHOENIX,AZ,2846,3180,334,0.5277132426153336
85046,PHOENIX,AZ,476,769,293,0.6176706827309237
85046,SAFFORD,AZ,0,14,14,1
85048,PHOENIX,AZ,15888,16248,360,0.5056011949215833
85050,PHOENIX,AZ,14735,16935,2200,0.5347331859804231
85051,PHOENIX,AZ,21736,18725,-3011,0.46279132992264155
85053,PHOENIX,AZ,15092,13759,-1333,0.47689854771065127
85054,PHOENIX,AZ,11665,10910,-755,0.4832779623477298
85060,PHOENIX,AZ,767,1438,671,0.6521541950113379
85061,PHOENIX,AZ,226,546,320,0.7072538860103627
85061,PHX,AZ,0,21,21,1
85063,PHOENIX,AZ,966,1851,885,0.6570820021299254
85064,PHOENIX,AZ,1363,1887,524,0.5806153846153846
85066,PHOENIX,AZ,831,1535,704,0.6487743026204564
85067,PHOENIX,AZ,698,1592,894,0.6951965065502184
85068,PHOENIX,AZ,766,1025,259,0.5723059743160246
85069,PHOENIX,AZ,1090,1682,592,0.6067821067821068
85070,PHOENIX,AZ,85,170,85,0.6666666666666666
85071,PHOENIX,AZ,809,1100,291,0.5762179151388162
85072,PHOENIX,AZ,11,93,82,0.8942307692307693
85074,PHOENIX,AZ,48,190,142,0.7983193277310925
85076,PHOENIX,AZ,762,1039,277,0.5769017212659634
85078,PHOENIX,AZ,129,196,67,0.6030769230769231
85079,PHOENIX,AZ,71,238,167,0.7702265372168284
85080,PHOENIX,AZ,1476,2121,645,0.5896580483736447
85082,PHOENIX,AZ,2426,2060,-366,0.4592064199732501
85083,PHOENIX,AZ,5875,6591,716,0.5287181132680892
85085,PHOENIX,AZ,15415,17789,2374,0.5357487049753041
85086,ANTHEM,AZ,10154,12352,2198,0.548831422731716
85086,DESERT HILLS,AZ,367,427,60,0.5377833753148614
85086,PHOENIX,AZ,7480,8466,986,0.5309168443496801
85087,NEW RIVER,AZ,2978,4004,1026,0.5734746490976798
85087,PHOENIX,AZ,710,774,64,0.5215633423180593
85117,APACHE JCT,AZ,35,38,3,0.5205479452054794
85117,APACHE JUNCTION,AZ,1689,1770,81,0.5117085862966175
85118,GOLD CANYON,AZ,13141,21110,7969,0.6163323698578144
85118,QUEEN VALLEY,AZ,944,214,-730,0.1848013816925734
85119,APACHE JCT,AZ,1204,1275,71,0.5143202904396934
85119,APACHE JUNCTION,AZ,17345,24815,7470,0.5885910815939279
85120,APACHE JCT,AZ,1999,3727,1728,0.650890674118058
85120,APACHE JUNCTION,AZ,22945,30637,7692,0.5717778358403942
85121,BAPCHULE,AZ,151,94,-57,0.3836734693877551
85122,CAS GRANDE,AZ,535,719,184,0.5733652312599681
85122,CASA GRANDE,AZ,30336,36113,5777,0.5434694276813797
85123,ARIZONA CITY,AZ,4825,6724,1899,0.5822149103818512
85127,CHANDLER HEIGHTS,AZ,66,87,21,0.5686274509803921
85127,CHANDLER HTS,AZ,0,15,15,1
85128,COOLIDGE,AZ,8907,9288,381,0.5104699093157461
85130,CASA GRANDE,AZ,1639,2290,651,0.5828455077627895
85131,ELOY,AZ,5043,6935,1892,0.5789781265653698
85131,TOLTEC,AZ,204,113,-91,0.35646687697160884
85132,FLORENCE,AZ,16921,20262,3341,0.5449264448807251
85137,KEARNY,AZ,617,612,-5,0.4979658258746949
85138,MARICOPA,AZ,22310,28539,6229,0.5612499754174123
85139,MARICOPA,AZ,8372,10105,1733,0.5468961411484549
85140,QUEEN CREEK,AZ,856,1593,737,0.6504695794201715
85140,SAN TAN VALLEY,AZ,15834,20513,4679,0.5643656973065178
85140,SAN TAN VLY,AZ,657,863,206,0.5677631578947369
85142,QUEEN CREEK,AZ,29263,41883,12620,0.5886908610462992
85143,QUEEN CREEK,AZ,943,785,-158,0.4542824074074074
85143,SAN TAN VALLEY,AZ,16877,19623,2746,0.53761643835616435
85143,SAN TAN VLY,AZ,1500,1780,280,0.5426829268292683
85145,RED ROCK,AZ,1237,1559,322,0.5575822603719599
85147,SACATON,AZ,569,644,75,0.5309150865622424
85172,STANFIELD,AZ,159,216,57,0.576
85173,SUPERIOR,AZ,1589,1418,-171,0.47156634519454604
85173,TUCSON,AZ,13,25,12,0.6578947368421053
85178,APACHE JCT,AZ,0,13,13,1
85178,APACHE JUNCTION,AZ,739,818,79,0.525369299935774
85191,VALLEY FARMS,AZ,60,0,-60,0
85192,WINKELMAN,AZ,146,137,-9,0.4840989399293286
85193,CASA GRANDE,AZ,1180,1708,528,0.5914127423822715
85194,CASA GRANDE,AZ,4089,6496,2407,0.6136986301369863
85201,MESA,AZ,29699,27018,-2681,0.47636511098965034
85202,MESA,AZ,27808,22483,-5325,0.44705812173152254
85203,MESA,AZ,16374,14911,-1463,0.4766181876298546
85204,MESA,AZ,28022,25265,-2757,0.4741306510030589
85205,MESA,AZ,28562,35848,7286,0.5565595404440304
85206,MESA,AZ,28222,31377,3155,0.5264685649088072
85207,MESA,AZ,23096,28000,4904,0.5479881008298105
85208,MESA,AZ,24549,29747,5198,0.547867246205982
85209,MESA,AZ,28564,38322,9758,0.5729450109140927
85210,MESA,AZ,25973,19659,-6314,0.43081609396914444
85211,MESA,AZ,1427,2131,704,0.5989319842608207
85212,MESA,AZ,17311,25218,7907,0.5929600978156082
85213,MESA,AZ,16849,22174,5325,0.5682289931578812
85214,MESA,AZ,494,806,312,0.62
85215,MESA,AZ,11311,14700,3389,0.5651455153588866
85216,MESA,AZ,1310,1615,305,0.5521367521367522
85224,CHANDLER,AZ,26847,25536,-1311,0.48748639825897716
85225,CHANDLER,AZ,37997,34921,-3076,0.4789078142571107
85226,CHANDLER,AZ,22232,21942,-290,0.4967175261466021
85233,GILBERT,AZ,18131,17448,-683,0.4904016414176902
85234,GILBERT,AZ,20569,19829,-740,0.490841130749047
85236,HIGLEY,AZ,1935,1312,-623,0.40406529103788114
85244,CHANDLER,AZ,1318,1844,526,0.5831752055660974
85246,CHANDLER,AZ,1216,1773,557,0.593174974907996
85248,CHANDLER,AZ,16417,20531,4114,0.5556728375013532
85248,SUN LAKES,AZ,10124,9156,-968,0.47489626556016595
85249,CHANDLER,AZ,16769,20686,3917,0.5522894139634228
85250,SCOTTSDALE,AZ,11515,12158,643,0.5135808727242006
85251,SCOTTSDALE,AZ,40568,34977,-5591,0.4629955655569528
85252,SCOTTSDALE,AZ,1851,2449,598,0.5695348837209302
85253,PARADISE VALLEY,AZ,8528,9120,592,0.5167724388032638
85253,PARADISE VLY,AZ,222,205,-17,0.48009367681498827
85253,SCOTTSDALE,AZ,931,1210,279,0.5651564689397478
85254,SCOTTSDALE,AZ,26317,26904,587,0.5055147404220138
85255,SCOTTSDALE,AZ,30596,34074,3478,0.5268903664759549
85256,SCOTTSDALE,AZ,811,412,-399,0.33687653311529026
85257,SCOTTSDALE,AZ,20142,17827,-2315,0.4695146040190682
85258,SCOTTSDALE,AZ,20126,21502,1376,0.5165273373690785
85259,SCOTTSDALE,AZ,12135,12630,495,0.5099939430648092
85260,SCOTTSDALE,AZ,26896,27709,813,0.5074443732258951
85261,SCOTTSDALE,AZ,1355,1659,304,0.5504313205043132
85262,SCOTTSDALE,AZ,10653,13386,2733,0.5568451266691626
85263,RIO VERDE,AZ,4545,5866,1321,0.5634425127269235
85263,SCOTTSDALE,AZ,50,214,164,0.8106060606060606
85264,FORT MCDOWELL,AZ,28,23,-5,0.45098039215686275
85266,SCOTTSDALE,AZ,7527,9197,1670,0.5499282468309017
85267,SCOTTSDALE,AZ,1429,2084,655,0.5932251636777683
85268,FOUNTAIN HILLS,AZ,17283,20539,3256,0.5430437311617577
85269,FOUNTAIN HILLS,AZ,1075,1241,166,0.5358376511226253
85271,SCOTTSDALE,AZ,24,127,103,0.8410596026490066
85274,MESA,AZ,887,1342,455,0.6020637056976222
85275,MESA,AZ,575,674,99,0.5396317053642914
85277,MESA,AZ,882,1208,326,0.5779904306220096
85280,TEMPE,AZ,474,404,-70,0.4601366742596811
85281,TEMPE,AZ,52132,40033,-12099,0.4343622850322791
85282,TEMPE,AZ,38234,32656,-5578,0.46065735646776695
85283,TEMPE,AZ,28818,24722,-4096,0.4617482256257004
85284,TEMPE,AZ,9186,9408,222,0.5059696676347208
85285,SCOTTSDALE,AZ,35,40,5,0.5333333333333333
85285,TEMPE,AZ,1331,1759,428,0.5692556634304207
85286,CHANDLER,AZ,22055,24311,2256,0.5243281715049821
85288,TEMPE,AZ,2756,2053,-703,0.4269078810563527
85295,GILBERT,AZ,24934,26747,1813,0.5175402952729243
85296,GILBERT,AZ,22005,22296,291,0.5032843502404009
85297,GILBERT,AZ,13571,15139,1568,0.5273075583420411
85298,GILBERT,AZ,14126,16804,2678,0.5432913029421274
85299,GILBERT,AZ,1472,1936,464,0.568075117370892
85301,GLENDALE,AZ,32541,28048,-4493,0.46292231263100564
85302,GLENDALE,AZ,21339,19823,-1516,0.481584956999174
85303,GLENDALE,AZ,13460,11046,-2414,0.45074675589651514
85304,GLENDALE,AZ,10557,10310,-247,0.4940815641922653
85305,GLENDALE,AZ,8460,9682,1222,0.533678756476684
85306,GLENDALE,AZ,12341,11279,-1062,0.4775190516511431
85307,GLENDALE,AZ,5835,6705,870,0.534688995215311
85308,GLENDALE,AZ,32968,31408,-1560,0.4878836833602585
85309,GLENDALE,AZ,35,101,66,0.7426470588235294
85309,LUKE AFB,AZ,14,149,135,0.9141104294478528
85309,LUKE AIR FORCE BASE,AZ,62,321,259,0.8381201044386423
85310,GLENDALE,AZ,6045,6704,659,0.5258451643266139
85311,GLENDALE,AZ,715,1332,617,0.6507083536883244
85312,GLENDALE,AZ,1078,1434,356,0.570859872611465
85318,GLENDALE,AZ,1162,1422,260,0.5503095975232198
85320,AGUILA,AZ,283,362,79,0.5612403100775194
85321,AJO,AZ,3167,3295,128,0.5099040544722996
85322,ARLINGTON,AZ,11,33,22,0.75
85323,AVONDALE,AZ,18685,19025,340,0.5045080880403076
85324,BLACK CANYON CITY,AZ,2028,2174,146,0.5173726796763446
85324,BLACK CYN CTY,AZ,83,109,26,0.5677083333333334
85325,BOUSE,AZ,2024,2343,319,0.5365239294710328
85326,BUCKEYE,AZ,28417,32833,4416,0.5360489795918367
85327,CAVE CREEK,AZ,1732,1562,-170,0.4741955069823922
85329,CASHION,AZ,876,774,-102,0.4690909090909091
85331,CAVE CREEK,AZ,12268,14631,2363,0.543923565931819
85332,CONGRESS,AZ,2020,1980,-40,0.495
85333,DATELAND,AZ,0,12,12,1
85334,EHRENBERG,AZ,1163,748,-415,0.39141810570381996
85335,EL MIRAGE,AZ,13523,15386,1863,0.5322217994396209
85336,GADSDEN,AZ,188,161,-27,0.46131805157593125
85336,SAN LUIS,AZ,47,34,-13,0.41975308641975306
85337,GILA BEND,AZ,557,414,-143,0.42636457260556127
85337,SURPRISE,AZ,0,24,24,1
85338,GOODYEAR,AZ,28217,37003,8786,0.5673566390677707
85339,LAVEEN,AZ,20601,18942,-1659,0.4790228359001593
85340,LITCHFIELD PARK,AZ,14162,18671,4509,0.568665671732708
85340,PEORIA,AZ,241,312,71,0.5641952983725136
85341,LUKEVILLE,AZ,326,757,431,0.6989843028624192
85342,MORRISTOWN,AZ,1217,1536,319,0.557936796222303
85344,PARKER,AZ,4397,6159,1762,0.5834596438044714
85345,PEORIA,AZ,27452,26617,-835,0.49227838502654014
85346,QUARTZSITE,AZ,4254,5214,960,0.5506970849176173
85348,SALOME,AZ,3103,5281,2178,0.6298902671755725
85349,SAN LUIS,AZ,1503,2003,500,0.5713063320022818
85350,SOMERTON,AZ,2022,1839,-183,0.4763014763014763
85351,SUN CITY,AZ,25918,30606,4688,0.5414691104663506
85352,TACNA,AZ,105,239,134,0.6947674418604651
85353,TOLLESON,AZ,16410,16120,-290,0.4955425760836151
85354,TONOPAH,AZ,3044,4000,956,0.5678591709256104
85355,WADDELL,AZ,5053,6539,1486,0.564095928226363
85356,WELLTON,AZ,2547,4686,2139,0.6478639568643716
85357,WENDEN,AZ,147,230,83,0.610079575596817
85358,WICKENBURG,AZ,1291,1538,247,0.543655001767409
85359,QUARTZSITE,AZ,2055,2799,744,0.57663782447466
85360,WIKIEUP,AZ,24,12,-12,0.3333333333333333
85361,WITTMANN,AZ,3304,4412,1108,0.5717988595127009
85362,YARNELL,AZ,326,334,8,0.5060606060606061
85363,YOUNGTOWN,AZ,3478,3359,-119,0.4912973526400468
85364,YUMA,AZ,26317,26197,-120,0.4988574475377994
85365,YUMA,AZ,24203,33906,9703,0.5834896487635306
85366,YUMA,AZ,1610,2208,598,0.5783132530120482
85367,YUMA,AZ,24929,30090,5161,0.5469019793162362
85369,YUMA,AZ,2402,1996,-406,0.45384265575261484
85372,SUN CITY,AZ,961,1094,133,0.532360097323601
85373,SUN CITY,AZ,12077,14827,2750,0.5511076419863218
85374,SURPRISE,AZ,33950,39055,5105,0.5349633586740634
85375,SUN CITY,AZ,319,1031,712,0.7637037037037037
85375,SUN CITY WEST,AZ,29692,31267,1575,0.5129185190045769
85376,SUN CITY WEST,AZ,504,754,250,0.5993640699523053
85377,CAREFREE,AZ,3870,4026,156,0.5098784194528876
85378,SURPRISE,AZ,5510,7947,2437,0.5905476703574348
85379,SURPRISE,AZ,20497,23070,2573,0.5295292308398558
85380,PEORIA,AZ,825,1247,422,0.6018339768339769
85381,PEORIA,AZ,12676,13017,341,0.5066360487292259
85382,PEORIA,AZ,22771,24493,1722,0.5182168246445498
85383,PEORIA,AZ,24590,34636,10046,0.5848107250194171
85385,PEORIA,AZ,663,1120,457,0.628154795288839
85387,SURPRISE,AZ,8953,16428,7475,0.6472558212836373
85388,SURPRISE,AZ,12235,14615,2380,0.5443202979515829
85390,WICKENBURG,AZ,6757,8916,2159,0.5688764116633701
85392,AVONDALE,AZ,19209,17641,-1568,0.4787245590230665
85395,GOODYEAR,AZ,19626,23638,4012,0.5463664940828402
85396,BUCKEYE,AZ,17072,26104,9032,0.6045951454511765
85501,GLOBE,AZ,3201,3090,-111,0.4911778731521221
85502,GLOBE,AZ,566,274,-292,0.3261904761904762
85530,BYLAS,AZ,82,0,-82,0
85531,CENTRAL,AZ,0,11,11,1
85532,CLAYPOOL,AZ,569,394,-175,0.4091381100726895
85533,CLIFTON,AZ,829,562,-267,0.40402588066139467
85534,DUNCAN,AZ,1154,848,-306,0.42357642357642356
85536,FORT THOMAS,AZ,13,0,-13,0
85539,MIAMI,AZ,1174,1233,59,0.5122559202326548
85540,MORENCI,AZ,1674,1073,-601,0.39060793593010557
85541,PAYSON,AZ,13008,13267,259,0.5049286393910561
85542,PERIDOT,AZ,452,82,-370,0.15355805243445692
85543,FORT THOMAS,AZ,44,31,-13,0.41333333333333333
85543,PIMA,AZ,1260,1216,-44,0.4911147011308562
85544,PINE,AZ,2571,1916,-655,0.4270113661689325
85545,ROOSEVELT,AZ,316,396,80,0.5561797752808989
85546,SAFFORD,AZ,8095,6515,-1580,0.445927446954141
85547,PAYSON,AZ,1314,976,-338,0.4262008733624454
85548,SAFFORD,AZ,764,452,-312,0.3717105263157895
85550,SAN CARLOS,AZ,906,131,-775,0.12632594021215043
85552,THATCHER,AZ,2908,2184,-724,0.4289080911233307
85553,TONTO BASIN,AZ,1588,1620,32,0.5049875311720698
85554,YOUNG,AZ,173,248,75,0.5890736342042755
85601,ARIVACA,AZ,25,114,89,0.8201438848920863
85602,BENSON,AZ,6461,7089,628,0.5231734317343173
85603,BISBEE,AZ,3089,3329,240,0.5186974135244624
85605,BOWIE,AZ,11,0,-11,0
85606,COCHISE,AZ,179,250,71,0.5827505827505828
85607,DOUGLAS,AZ,5801,4387,-1414,0.4306046329014527
85608,DOUGLAS,AZ,315,580,265,0.6480446927374302
85609,DRAGOON,AZ,24,11,-13,0.3142857142857143
85610,ELFRIDA,AZ,369,333,-36,0.47435897435897434
85611,ELGIN,AZ,80,111,31,0.581151832460733
85613,FORT HUACHUCA,AZ,2998,2466,-532,0.4513177159590044
85614,GREEN VALLEY,AZ,25446,28952,3506,0.5322254494650539
85615,HEREFORD,AZ,4425,4529,104,0.5058074603529149
85616,HUACHUCA CITY,AZ,3439,3209,-230,0.48270156438026474
85617,MC NEAL,AZ,319,568,249,0.6403607666290868
85618,MAMMOTH,AZ,116,58,-58,0.3333333333333333
85620,NACO,AZ,0,26,26,1
85621,NOGALES,AZ,5110,4660,-450,0.47697031729785055
85622,GREEN VALLEY,AZ,9335,11157,1822,0.5444563732188171
85623,ORACLE,AZ,3143,3944,801,0.5565119232397348
85624,PATAGONIA,AZ,754,753,-1,0.4996682149966821
85625,PEARCE,AZ,1546,1541,-5,0.49919015225137675
85626,PIRTLEVILLE,AZ,11,11,0,0.5
85628,NOGALES,AZ,351,673,322,0.6572265625
85629,SAHUARITA,AZ,12331,13151,820,0.5160897888705753
85630,SAINT DAVID,AZ,1136,1234,98,0.5206751054852321
85630,ST DAVID,AZ,34,31,-3,0.47692307692307695
85631,SAN MANUEL,AZ,1685,1536,-149,0.47687053710027943
85632,PORTAL,AZ,100,124,24,0.5535714285714286
85632,SAN SIMON,AZ,24,143,119,0.8562874251497006
85634,SELLS,AZ,326,430,104,0.5687830687830688
85635,SIERRA VISTA,AZ,24538,21636,-2902,0.46857538874691385
85636,SIERRA VISTA,AZ,1178,1018,-160,0.46357012750455373
85637,SONOITA,AZ,743,806,63,0.5203357004519045
85638,TOMBSTONE,AZ,1157,1256,99,0.5205138831330294
85640,TUMACACORI,AZ,349,544,195,0.6091825307950728
85641,VAIL,AZ,10795,13072,2277,0.5477018477395567
85643,WILLCOX,AZ,2507,2574,67,0.5065931903168668
85644,WILLCOX,AZ,225,283,58,0.5570866141732284
85645,AMADO,AZ,331,333,2,0.5015060240963856
85646,TUBAC,AZ,1203,1543,340,0.5619082301529498
85648,RIO RICO,AZ,4383,5006,623,0.5331771221642347
85650,SIERRA VISTA,AZ,6661,6536,-125,0.49526407516859894
85652,CORTARO,AZ,1640,838,-802,0.33817594834543985
85653,MARANA,AZ,7605,10265,2660,0.5744264129826525
85654,RILLITO,AZ,0,11,11,1
85658,MARANA,AZ,9261,11014,1753,0.5432305795314427
85670,FORT HUACHUCA,AZ,169,23,-146,0.11979166666666667
85701,TUCSON,AZ,4751,4743,-8,0.49957868127238253
85702,TUCSON,AZ,407,603,196,0.597029702970297
85703,TUCSON,AZ,104,236,132,0.6941176470588235
85704,TUCSON,AZ,21369,20455,-914,0.48907325937260904
85705,TUCSON,AZ,30801,27847,-2954,0.4748158504978857
85706,TUCSON,AZ,16370,14996,-1374,0.478097302811962
85707,DAVIS MONTHAN AFB,AZ,0,33,33,1
85707,TUCSON,AZ,163,97,-66,0.3730769230769231
85708,TUCSON,AZ,2940,2444,-496,0.4539375928677563
85710,TUCSON,AZ,34822,32581,-2241,0.4833761108555999
85711,TUCSON,AZ,25240,20631,-4609,0.44976128708770247
85712,TUCSON,AZ,21405,20546,-859,0.4897618650330147
85713,TUCSON,AZ,17796,18336,540,0.5074726004649618
85714,TUCSON,AZ,3986,4128,142,0.5087503081094404
85715,TUCSON,AZ,10738,10229,-509,0.4878618781895359
85716,TUCSON,AZ,24351,19996,-4355,0.45089859516991004
85717,TUCSON,AZ,683,850,167,0.5544683626875407
85718,TUCSON,AZ,19188,19748,560,0.5071912882679268
85719,TUCSON,AZ,29706,22170,-7536,0.4273652556095304
85726,TUCSON,AZ,1357,3261,1904,0.7061498484192291
85728,TUCSON,AZ,993,1077,84,0.5202898550724637
85730,TUCSON,AZ,18247,18475,228,0.5031044060781004
85731,TUCSON,AZ,1079,1309,230,0.5481574539363484
85732,TUCSON,AZ,1088,1252,164,0.535042735042735
85733,TUCSON,AZ,301,560,259,0.6504065040650406
85734,TUCSON,AZ,702,1114,412,0.6134361233480177
85735,TUCSON,AZ,2937,4223,1286,0.589804469273743
85736,TUCSON,AZ,1288,1719,431,0.5716661124043898
85737,ORO VALLEY,AZ,6339,7183,844,0.5312084011240941
85737,TUCSON,AZ,7576,8084,508,0.5162196679438059
85738,CATALINA,AZ,79,110,31,0.582010582010582
85738,TUCSON,AZ,106,114,8,0.5181818181818182
85739,SADDLEBROOKE,AZ,2845,2619,-226,0.47931918008784774
85739,TUCSON,AZ,8513,10475,1962,0.5516642089740889
85740,TUCSON,AZ,807,955,148,0.5419977298524404
85741,TUCSON,AZ,17070,16226,-844,0.4873258049014897
85742,TUCSON,AZ,13431,15540,2109,0.5363984674329502
85743,TUCSON,AZ,12087,13805,1718,0.533176270662753
85745,TUCSON,AZ,17659,16558,-1101,0.48391150597656135
85746,TUCSON,AZ,11939,13300,1361,0.5269622409762669
85747,TUCSON,AZ,10402,12623,2221,0.5482301845819761
85748,TUCSON,AZ,9016,8716,-300,0.491540717347169
85749,TUCSON,AZ,7513,8858,1345,0.5410787367906664
85750,TUCSON,AZ,17786,17449,-337,0.49521782318717184
85751,TUCSON,AZ,940,1150,210,0.5502392344497608
85752,TUCSON,AZ,939,1112,173,0.5421745490004876
85754,TUCSON,AZ,864,1231,367,0.5875894988066825
85755,ORO VALLEY,AZ,10447,12767,2320,0.5499698457827173
85755,TUCSON,AZ,1032,1575,543,0.6041426927502876
85756,TUCSON,AZ,10380,13779,3399,0.570346454737365
85757,TUCSON,AZ,5023,6055,1032,0.5465788048384185
85901,SHOW LOW,AZ,13078,16309,3231,0.5549732875080818
85902,SHOW LOW,AZ,1969,2010,41,0.5051520482533299
85911,CIBECUE,AZ,11,0,-11,0
85912,WHITE MOUNTAIN LAKE,AZ,0,29,29,1
85912,WHITE MTN LK,AZ,0,11,11,1
85920,ALPINE,AZ,617,715,98,0.5367867867867868
85923,CLAY SPRINGS,AZ,12,32,20,0.7272727272727273
85924,CONCHO,AZ,1097,1554,457,0.5861938890984534
85925,EAGAR,AZ,2132,1917,-215,0.4734502346258335
85926,FORT APACHE,AZ,12,93,81,0.8857142857142857
85927,GREER,AZ,217,231,14,0.515625
85928,HEBER,AZ,458,558,100,0.5492125984251969
85929,LAKESIDE,AZ,6922,7346,424,0.5148584244463135
85931,FOREST LAKES,AZ,217,242,25,0.5272331154684096
85932,NUTRIOSO,AZ,160,156,-4,0.4936708860759494
85933,ARIPINE,AZ,44,34,-10,0.4358974358974359
85933,OVERGAARD,AZ,2923,3276,353,0.5284723342474593
85934,PINEDALE,AZ,62,99,37,0.6149068322981367
85935,PINETOP,AZ,7189,7337,148,0.5050943136444995
85936,SAINT JOHNS,AZ,1683,1473,-210,0.4667300380228137
85937,SNOWFLAKE,AZ,3564,3759,195,0.5133142154854567
85938,PINETOP,AZ,29,12,-17,0.2926829268292683
85938,SPRINGERVILLE,AZ,1530,1253,-277,0.45023356090549765
85939,TAYLOR,AZ,972,1272,300,0.5668449197860963
85940,VERNON,AZ,399,538,139,0.5741728922091782
85941,WHITERIVER,AZ,294,120,-174,0.2898550724637681
86001,FLAGSTAFF,AZ,21346,15896,-5450,0.42682992320498364
86002,FLAGSTAFF,AZ,1496,757,-739,0.3359964491788726
86003,FLAGSTAFF,AZ,2136,1399,-737,0.39575671852899574
86004,FLAGSTAFF,AZ,17207,16602,-605,0.49105267828093113
86005,FLAGSTAFF,AZ,9975,8219,-1756,0.45174233263713315
86015,BELLEMONT,AZ,755,1057,302,0.5833333333333334
86015,FLAGSTAFF,AZ,22,32,10,0.5925925925925926
86017,FLAGSTAFF,AZ,19,22,3,0.5365853658536586
86017,MUNDS PARK,AZ,1891,2208,317,0.5386679677970236
86018,PARKS,AZ,249,440,191,0.6386066763425254
86018,PARKS COMM PO,AZ,22,14,-8,0.3888888888888889
86021,COLORADO CITY,AZ,207,403,196,0.660655737704918
86022,CANE BEDS,AZ,0,11,11,1
86022,FREDONIA,AZ,292,334,42,0.5335463258785943
86023,GRAND CANYON,AZ,2103,1206,-897,0.3644605621033545
86024,HAPPY JACK,AZ,425,548,123,0.5632065775950668
86025,HOLBROOK,AZ,1710,1729,19,0.5027624309392266
86032,JOSEPH CITY,AZ,22,179,157,0.8905472636815921
86033,KAYENTA,AZ,622,788,166,0.5588652482269504
86034,KEAMS CANYON,AZ,85,41,-44,0.3253968253968254
86035,LEUPP,AZ,0,14,14,1
86038,MORMON LAKE,AZ,22,44,22,0.6666666666666666
86039,KYKOTSMOVI,AZ,0,12,12,1
86040,GREENEHAVEN,AZ,48,55,7,0.5339805825242718
86040,PAGE,AZ,2286,1910,-376,0.4551954242135367
86042,POLACCA,AZ,23,24,1,0.5106382978723404
86043,SECOND MESA,AZ,0,29,29,1
86044,TONALEA,AZ,57,151,94,0.7259615384615384
86045,TUBA CITY,AZ,912,1023,111,0.5286821705426357
86046,WILLIAMS,AZ,3419,3712,293,0.5205441032113308
86047,WINSLOW,AZ,3851,3518,-333,0.4774053467227575
86053,KAIBETO,AZ,12,12,0,0.5
86301,PRESCOTT,AZ,14303,16058,1755,0.528902210072132
86302,PRESCOTT,AZ,985,725,-260,0.4239766081871345
86303,PRESCOTT,AZ,10205,10698,493,0.5117925656604315
86304,PRESCOTT,AZ,1790,1425,-365,0.4432348367029549
86305,PRESCOTT,AZ,9275,11091,1816,0.5445841107728567
86312,PRESCOTT VALLEY,AZ,1227,1399,172,0.5327494287890328
86312,PRESCOTT VLY,AZ,21,31,10,0.5961538461538461
86313,PRESCOTT,AZ,23,0,-23,0
86314,PRESCOTT VALLEY,AZ,17781,19516,1735,0.5232592433707804
86314,PRESCOTT VLY,AZ,308,325,17,0.5134281200631912
86315,PRESCOTT VALLEY,AZ,3349,4925,1576,0.5952380952380952
86315,PRESCOTT VLY,AZ,263,336,73,0.5609348914858097
86320,ASH FORK,AZ,1445,987,-458,0.4058388157894737
86321,BAGDAD,AZ,693,524,-169,0.4305669679539852
86322,CAMP VERDE,AZ,5328,5981,653,0.5288708108586082
86323,CHINO VALLEY,AZ,8096,9516,1420,0.5403134226663638
86324,CLARKDALE,AZ,2218,2612,394,0.5407867494824017
86325,CORNVILLE,AZ,3110,3352,242,0.5187248529866915
86326,COTTONWOOD,AZ,14356,13170,-1186,0.478456731817191
86327,DEWEY,AZ,6728,7201,473,0.5169789647498025
86329,HUMBOLDT,AZ,619,727,108,0.5401188707280832
86331,JEROME,AZ,12,11,-1,0.4782608695652174
86332,KIRKLAND,AZ,502,630,128,0.5565371024734982
86332,PEEPLES VALLEY,AZ,190,251,61,0.5691609977324263
86332,PEEPLES VLY,AZ,19,42,23,0.6885245901639344
86333,MAYER,AZ,2793,3139,346,0.5291638570465274
86334,PAULDEN,AZ,1633,2234,601,0.5777088182053272
86335,RIMROCK,AZ,2520,2753,233,0.5220936848094064
86336,SEDONA,AZ,8720,8510,-210,0.493905977945444
86337,SELIGMAN,AZ,719,813,94,0.5306788511749347
86338,SKULL VALLEY,AZ,0,16,16,1
86339,SEDONA,AZ,1127,769,-358,0.4055907172995781
86340,SEDONA,AZ,693,228,-465,0.247557003257329
86341,SEDONA,AZ,722,377,-345,0.34303912647861695
86342,LAKE MONTEZUMA,AZ,133,0,-133,0
86351,SEDONA,AZ,5076,5362,286,0.5136999425177237
86401,KINGMAN,AZ,12656,14988,2332,0.5421791347127767
86402,KINGMAN,AZ,2515,2375,-140,0.48568507157464214
86403,LAKE HAVASU CITY,AZ,13417,18423,5006,0.5786118090452261
86404,LAKE HAVASU CITY,AZ,11414,13974,2560,0.5504175200882306
86405,LAKE HAVASU CITY,AZ,2488,2843,355,0.5332958169199025
86405,LK HAVASU CTY,AZ,47,98,51,0.6758620689655173
86406,LAKE HAVASU CITY,AZ,14176,16394,2218,0.5362773961400066
86409,KINGMAN,AZ,13053,14571,1518,0.5274761077324066
86413,GOLDEN VALLEY,AZ,4285,5973,1688,0.5822772470267109
86426,BULLHEAD CITY,AZ,133,178,45,0.572347266881029
86426,FORT MOHAVE,AZ,6947,8833,1886,0.5597591888466413
86427,FORT MOHAVE,AZ,1688,1185,-503,0.4124608423250957
86429,BULLHEAD CITY,AZ,4587,5463,876,0.5435820895522389
86430,BULLHEAD CITY,AZ,844,892,48,0.5138248847926268
86431,CHLORIDE,AZ,59,115,56,0.6609195402298851
86432,LITTLEFIELD,AZ,2747,2771,24,0.5021747009786155
86433,OATMAN,AZ,0,12,12,1
86434,PEACH SPRINGS,AZ,12,11,-1,0.4782608695652174
86436,TOPOCK,AZ,1198,1317,119,0.5236580516898608
86438,YUCCA,AZ,941,870,-71,0.4803975704030922
86439,BULLHEAD CITY,AZ,1762,1529,-233,0.4646004254026132
86440,MOHAVE VALLEY,AZ,2916,3889,973,0.5714915503306393
86441,DOLAN SPRINGS,AZ,845,862,17,0.50497949619215
86442,BULLHEAD CITY,AZ,20054,22265,2211,0.5261230180297266
86444,MEADVIEW,AZ,482,803,321,0.6249027237354086
86446,MOHAVE VALLEY,AZ,433,118,-315,0.21415607985480944
86502,CHAMBERS,AZ,82,44,-38,0.3492063492063492
86503,CHINLE,AZ,835,1000,165,0.5449591280653951
86504,FORT DEFIANCE,AZ,291,332,41,0.5329052969502408
86505,GANADO,AZ,50,240,190,0.8275862068965517
86510,PINON,AZ,13,95,82,0.8796296296296297
86511,SAINT MICHAELS,AZ,959,100,-859,0.09442870632672333
86512,SANDERS,AZ,377,484,107,0.562137049941928
86514,TEEC NOS POS,AZ,39,154,115,0.7979274611398963
86515,WINDOW ROCK,AZ,160,339,179,0.6793587174348698
87001,ALGODONES,NM,12,24,12,0.6666666666666666
87002,BELEN,NM,5500,5721,221,0.5098476071651368
87002,RIO COMM,NM,125,120,-5,0.4897959183673469
87002,RIO COMMUNITIES,NM,842,941,99,0.5277621985417835
87004,BERNALILLO,NM,2883,2851,-32,0.49720962678758285
87005,BLUEWATER,NM,0,12,12,1
87006,BOSQUE,NM,20,17,-3,0.4594594594594595
87008,CEDAR CREST,NM,1116,1026,-90,0.4789915966386555
87010,CERRILLOS,NM,468,463,-5,0.49731471535982813
87010,MADRID,NM,34,98,64,0.7424242424242424
87013,CUBA,NM,427,435,8,0.5046403712296984
87013,EDGEWOOD,NM,0,16,16,1
87015,EDGEWOOD,NM,4006,4621,615,0.5356439086588617
87016,ESTANCIA,NM,375,514,139,0.578177727784027
87016,TAJIQUE,NM,25,17,-8,0.40476190476190477
87020,GRANTS,NM,3155,2773,-382,0.4677800269905533
87021,MILAN,NM,235,236,1,0.5010615711252654
87023,JARALES,NM,0,11,11,1
87024,JEMEZ PUEBLO,NM,13,69,56,0.8414634146341463
87025,JEMEZ SPRINGS,NM,339,356,17,0.5122302158273381
87026,CANONCITO,NM,11,12,1,0.5217391304347826
87026,LAGUNA,NM,147,193,46,0.5676470588235294
87026,OLD LAGUNA,NM,11,0,-11,0
87031,LOS LUNAS,NM,13199,12422,-777,0.4848366574294524
87032,MCINTOSH,NM,170,69,-101,0.28870292887029286
87034,ACOMA,NM,0,12,12,1
87034,PUEBLO OF ACOMA,NM,11,25,14,0.6944444444444444
87035,MORIARTY,NM,2803,1947,-856,0.40989473684210526
87036,MOUNTAINAIR,NM,439,464,25,0.5138427464008859
87041,PENA BLANCA,NM,31,0,-31,0
87042,PERALTA,NM,1103,999,-104,0.4752616555661275
87043,PLACITAS,NM,1993,2446,453,0.551025005631899
87045,PREWITT,NM,12,25,13,0.6756756756756757
87046,REGINA,NM,15,0,-15,0
87047,SANDIA PARK,NM,1671,1984,313,0.5428180574555403
87048,CORRALES,NM,2665,3412,747,0.5614612473259832
87049,SAN FIDEL,NM,0,12,12,1
87051,SAN RAFAEL,NM,0,11,11,1
87056,STANLEY,NM,29,74,45,0.7184466019417476
87059,TIJERAS,NM,3056,3411,355,0.5274470388124324
87062,VEGUITA,NM,312,384,72,0.5517241379310345
87064,YOUNGSVILLE,NM,0,11,11,1
87068,BOSQUE FARMS,NM,869,965,96,0.5261723009814613
87083,COCHITI LAKE,NM,11,13,2,0.5416666666666666
87101,ALBUQUERQUE,NM,0,278,278,1
87102,ALBUQUERQUE,NM,11656,10238,-1418,0.4676166986388965
87103,ALBUQUERQUE,NM,86,14,-72,0.14
87104,ALBUQUERQUE,NM,4867,4765,-102,0.4947051495016611
87105,ALBUQUERQUE,NM,13241,11624,-1617,0.46748441584556605
87106,ALBUQUERQUE,NM,15646,13115,-2531,0.4559994436911095
87107,ALBUQUERQUE,NM,11615,11571,-44,0.49905115155697405
87108,ALBUQUERQUE,NM,21334,19246,-2088,0.4742730409068507
87109,ALBUQUERQUE,NM,21334,20026,-1308,0.48418762088974854
87110,ALBUQUERQUE,NM,18068,16571,-1497,0.4783914085279598
87111,ALBUQUERQUE,NM,28411,25787,-2624,0.47579246466659286
87112,ALBUQUERQUE,NM,18554,17182,-1372,0.4808036713678084
87113,ALBUQUERQUE,NM,7210,7097,-113,0.496050884182568
87114,ALBUQUERQUE,NM,27456,26067,-1389,0.4870242699400258
87116,ALBUQUERQUE,NM,3170,2624,-546,0.45288229202623403
87117,ABQ,NM,0,13,13,1
87117,KIRTLAND AFB,NM,0,37,37,1
87119,ALBUQUERQUE,NM,13,88,75,0.8712871287128713
87120,ALBUQUERQUE,NM,22273,23232,959,0.5105373035930117
87121,ALBUQUERQUE,NM,20999,18119,-2880,0.46318830206043254
87122,ALBUQUERQUE,NM,5041,6066,1025,0.5461420725668498
87123,ALBUQUERQUE,NM,19046,18316,-730,0.4902307157004443
87124,ABQ,NM,370,361,-9,0.493844049247606
87124,ALBUQUERQUE,NM,350,379,29,0.5198902606310014
87124,RIO RANCHO,NM,18209,19413,1204,0.5160012758492372
87125,ALBUQUERQUE,NM,647,1108,461,0.6313390313390314
87144,RIO RANCHO,NM,15879,17921,2042,0.5302071005917159
87153,ALBUQUERQUE,NM,12,130,118,0.9154929577464789
87154,ALBUQUERQUE,NM,694,968,274,0.5824308062575211
87174,RIO RANCHO,NM,1204,1608,404,0.5718349928876245
87176,ALBUQUERQUE,NM,892,1175,283,0.5684567005321722
87181,ALBUQUERQUE,NM,534,849,315,0.613882863340564
87184,ALAMEDA,NM,0,13,13,1
87184,ALBUQUERQUE,NM,45,139,94,0.7554347826086957
87185,ALBUQUERQUE,NM,11,14,3,0.56
87187,ALBUQUERQUE,NM,0,12,12,1
87190,ALBUQUERQUE,NM,142,227,85,0.6151761517615176
87191,ALBUQUERQUE,NM,92,304,212,0.7676767676767676
87192,ALBUQUERQUE,NM,183,347,164,0.6547169811320754
87193,ALBUQUERQUE,NM,1210,1693,483,0.5831898036513951
87194,ALBUQUERQUE,NM,25,92,67,0.7863247863247863
87195,ALBUQUERQUE,NM,553,992,439,0.6420711974110033
87196,ALBUQUERQUE,NM,321,436,115,0.5759577278731837
87197,ALBUQUERQUE,NM,143,206,63,0.5902578796561605
87198,ALBUQUERQUE,NM,712,1124,412,0.6122004357298475
87199,ALBUQUERQUE,NM,2148,1556,-592,0.4200863930885529
87301,GALLUP,NM,5294,3949,-1345,0.42724223736881967
87305,GALLUP,NM,1024,968,-56,0.4859437751004016
87311,CHURCH ROCK,NM,146,60,-86,0.2912621359223301
87313,CROWNPOINT,NM,374,384,10,0.5065963060686016
87315,FENCE LAKE,NM,0,12,12,1
87317,GAMERCO,NM,97,0,-97,0
87319,MENTMORE,NM,145,0,-145,0
87321,RAMAH,NM,474,563,89,0.5429122468659595
87322,REHOBOTH,NM,0,13,13,1
87323,THOREAU,NM,169,261,92,0.6069767441860465
87325,TOHATCHI,NM,326,115,-211,0.26077097505668934
87326,VANDERWAGEN,NM,211,103,-108,0.32802547770700635
87327,ZUNI,NM,68,129,61,0.6548223350253807
87328,NAVAJO,NM,14,0,-14,0
87364,SHEEP SPRINGS,NM,0,11,11,1
87401,FARMINGTON,NM,15082,12737,-2345,0.45785254682051835
87402,FARMINGTON,NM,4041,3908,-133,0.49163416781985153
87410,AZTEC,NM,6678,5540,-1138,0.4534293665084302
87412,BLANCO,NM,0,13,13,1
87413,BLOOMFIELD,NM,4751,3886,-865,0.44992474238740304
87415,FLORA VISTA,NM,835,731,-104,0.466794380587484
87416,FRUITLAND,NM,156,248,92,0.6138613861386139
87417,KIRTLAND,NM,1192,1371,179,0.5349200156067109
87418,LA PLATA,NM,57,47,-10,0.4519230769230769
87419,NAVAJO DAM,NM,15,0,-15,0
87420,SHIPROCK,NM,609,784,175,0.5628140703517588
87421,WATERFLOW,NM,42,45,3,0.5172413793103449
87499,FARMINGTON,NM,1204,1344,140,0.5274725274725275
87501,SANTA FE,NM,9585,10197,612,0.5154686078252957
87502,SANTA FE,NM,1561,1466,-95,0.4843078956062108
87504,SANTA FE,NM,953,1181,228,0.5534208059981256
87505,SANTA FE,NM,15309,15831,522,0.5083815028901734
87505,SF,NM,347,366,19,0.5133239831697055
87506,SANTA FE,NM,3995,4828,833,0.5472061657032755
87507,SANTA FE,NM,14351,14927,576,0.5098367374820685
87508,SANTA FE,NM,5607,6892,1285,0.5514041123289863
87510,ABIQUIU,NM,262,213,-49,0.44842105263157894
87511,ALCALDE,NM,14,42,28,0.75
87513,ARROYO HONDO,NM,11,50,39,0.819672131147541
87514,ARROYO SECO,NM,481,444,-37,0.48
87517,CARSON,NM,11,0,-11,0
87520,CHAMA,NM,476,525,49,0.5244755244755245
87522,CHIMAYO,NM,12,64,52,0.8421052631578947
87525,TAOS SKI VALLEY,NM,41,12,-29,0.22641509433962265
87527,DIXON,NM,0,13,13,1
87528,DULCE,NM,514,49,-465,0.08703374777975133
87529,EL PRADO,NM,1440,1613,173,0.5283327874222077
87530,EL RITO,NM,0,11,11,1
87532,ESPANOLA,NM,2200,2273,73,0.5081600715403533
87535,GLORIETA,NM,139,196,57,0.5850746268656717
87540,GALISTEO,NM,26,56,30,0.6829268292682927
87540,LAMY,NM,235,412,177,0.6367851622874807
87544,LOS ALAMOS,NM,6266,5833,-433,0.48210595917017934
87547,LOS ALAMOS,NM,162,225,63,0.5813953488372093
87547,WHITE ROCK,NM,1407,1591,184,0.5306871247498333
87549,OJO CALIENTE,NM,0,23,23,1
87551,LOS OJOS,NM,11,0,-11,0
87552,PECOS,NM,325,449,124,0.5801033591731266
87556,QUESTA,NM,377,457,80,0.5479616306954437
87557,RANCHOS DE TAOS,NM,1297,1347,50,0.5094553706505295
87557,RNCH DE TAOS,NM,28,41,13,0.5942028985507246
87558,RED RIVER,NM,421,407,-14,0.4915458937198068
87560,RIBERA,NM,28,24,-4,0.46153846153846156
87564,SAN CRISTOBAL,NM,20,19,-1,0.48717948717948717
87565,SAN JOSE,NM,0,11,11,1
87566,OHKAY OWINGEH,NM,124,38,-86,0.2345679012345679
87567,SANTA CRUZ,NM,1173,464,-709,0.2834453268173488
87571,TAOS,NM,4680,4827,147,0.5077311454717577
87574,TESUQUE,NM,283,481,198,0.6295811518324608
87577,TRES PIEDRAS,NM,14,12,-2,0.46153846153846156
87579,VADITO,NM,11,0,-11,0
87592,SANTA FE,NM,432,477,45,0.5247524752475248
87594,SANTA FE,NM,545,298,-247,0.3534994068801898
87701,LAS VEGAS,NM,7326,5519,-1807,0.42966134682755935
87710,ANGEL FIRE,NM,1604,1475,-129,0.4790516401429035
87714,CIMARRON,NM,36,139,103,0.7942857142857143
87718,EAGLE NEST,NM,161,281,120,0.6357466063348416
87732,MORA,NM,11,50,39,0.819672131147541
87740,RATON,NM,2835,2909,74,0.5064415041782729
87742,ROCIADA,NM,114,106,-8,0.4818181818181818
87743,ROY,NM,11,0,-11,0
87745,SAPELLO,NM,14,13,-1,0.48148148148148145
87747,SPRINGER,NM,45,56,11,0.5544554455445545
87753,WATROUS,NM,11,0,-11,0
87801,SOCORRO,NM,4113,3239,-874,0.44056039173014144
87821,DATIL,NM,149,130,-19,0.4659498207885305
87823,LEMITAR,NM,0,11,11,1
87825,ALAMO,NM,12,13,1,0.52
87825,MAGDALENA,NM,383,322,-61,0.45673758865248226
87827,PIE TOWN,NM,22,74,52,0.7708333333333334
87829,QUEMADO,NM,632,489,-143,0.4362176628010705
87830,RESERVE,NM,13,114,101,0.8976377952755905
87901,T OR C,NM,581,629,48,0.5198347107438016
87901,TRUTH OR CONSEQUENCES,NM,3739,3673,-66,0.4955477603885591
87931,CABALLO,NM,61,114,53,0.6514285714285715
87935,ELEPHANT BTTE,NM,50,114,64,0.6951219512195121
87935,ELEPHANT BUTTE,NM,1097,1319,222,0.5459437086092715
87937,HATCH,NM,55,48,-7,0.46601941747572817
87942,WILLIAMSBURG,NM,206,289,83,0.5838383838383838
88001,LAS CRUCES,NM,15406,13188,-2218,0.4612156396446807
88002,LAS CRUCES,NM,17,20,3,0.5405405405405406
88002,WHITE SANDS,NM,26,24,-2,0.48
88002,WHITE SANDS MISSILE RANGE,NM,596,501,-95,0.4567000911577028
88003,LAS CRUCES,NM,20,0,-20,0
88004,LAS CRUCES,NM,1174,1331,157,0.5313373253493014
88005,LAS CRUCES,NM,10061,9278,-783,0.4797559336056673
88007,LAS CRUCES,NM,6063,7127,1064,0.5403335860500379
88008,SANTA TERESA,NM,2319,2526,207,0.5213622291021672
88011,LAS CRUCES,NM,15193,15004,-189,0.4968705500546412
88011,LSS CRUCES,NM,263,297,34,0.5303571428571429
88012,LAS CRUCES,NM,9658,11453,1795,0.5425133816493771
88013,LAS CRUCES,NM,690,995,305,0.5905044510385756
88021,ANTHONY,NM,1948,2149,201,0.5245301440078106
88022,ARENAS VALLEY,NM,12,0,-12,0
88022,SILVER CITY,NM,0,15,15,1
88023,BAYARD,NM,404,374,-30,0.480719794344473
88026,SANTA CLARA,NM,267,182,-85,0.4053452115812918
88029,COLUMBUS,NM,683,253,-430,0.2702991452991453
88030,DEMING,NM,8061,7855,-206,0.49352852475496356
88031,DEMING,NM,713,825,112,0.5364109232769831
88032,DONA ANA,NM,63,88,25,0.5827814569536424
88033,FAIRACRES,NM,216,317,101,0.5947467166979362
88039,GLENWOOD,NM,0,13,13,1
88041,HANOVER,NM,0,13,13,1
88041,SAN LORENZO,NM,11,12,1,0.5217391304347826
88042,HILLSBORO,NM,12,15,3,0.5555555555555556
88043,HURLEY,NM,347,82,-265,0.19114219114219114
88044,LA MESA,NM,392,524,132,0.5720524017467249
88045,LORDSBURG,NM,1022,940,-82,0.47910295616717635
88045,ROAD FORKS,NM,22,18,-4,0.45
88045,SEPAR,NM,14,19,5,0.5757575757575758
88045,VIRDEN,NM,71,76,5,0.5170068027210885
88046,MESILLA,NM,347,471,124,0.5757946210268948
88047,MESILLA PARK,NM,1237,1318,81,0.5158512720156556
88048,MESQUITE,NM,72,133,61,0.6487804878048781
88049,MIMBRES,NM,243,393,150,0.6179245283018868
88052,ORGAN,NM,27,13,-14,0.325
88053,PINOS ALTOS,NM,12,0,-12,0
88054,RADIUM SPRINGS,NM,0,11,11,1
88056,RODEO,NM,66,47,-19,0.415929203539823
88061,SILVER CITY,NM,6158,6232,74,0.5029862792574658
88062,SILVER CITY,NM,1776,982,-794,0.3560551124002901
88063,SUNLAND PARK,NM,1663,1724,61,0.5090050191910245
88065,TYRONE,NM,333,149,-184,0.3091286307053942
88081,CHAPARRAL,NM,2031,2659,628,0.5669509594882729
88101,CLOVIS,NM,21957,19496,-2461,0.47031577931633417
88102,CLOVIS,NM,595,865,270,0.5924657534246576
88103,CANNON AFB,NM,0,333,333,1
88116,ELIDA,NM,0,13,13,1
88119,FORT SUMNER,NM,184,225,41,0.5501222493887531
88124,MELROSE,NM,34,114,80,0.7702702702702703
88130,PORTALES,NM,7263,6559,-704,0.474533352626248
88135,TEXICO,NM,101,133,32,0.5683760683760684
88201,ROSWELL,NM,9820,8910,-910,0.47570742124933263
88202,ROSWELL,NM,1083,1346,263,0.5541375051461507
88203,ROSWELL,NM,9605,7680,-1925,0.44431588082152157
88210,ARTESIA,NM,5642,4865,-777,0.4630246502331779
88211,ARTESIA,NM,394,719,325,0.6460017969451932
88220,CARLSBAD,NM,12305,11240,-1065,0.4773837332767042
88221,CARLSBAD,NM,1339,1175,-164,0.4673826571201273
88230,DEXTER,NM,913,765,-148,0.45589988081048866
88231,EUNICE,NM,648,297,-351,0.3142857142857143
88232,HAGERMAN,NM,537,431,-106,0.4452479338842975
88240,HOBBS,NM,13321,10792,-2529,0.4475594077883299
88241,HOBBS,NM,1027,1512,485,0.5955100433241434
88242,HOBBS,NM,1759,1933,174,0.5235644637053087
88250,HOPE,NM,11,0,-11,0
88252,JAL,NM,237,133,-104,0.35945945945945945
88253,LAKE ARTHUR,NM,0,11,11,1
88256,LOVING,NM,140,115,-25,0.45098039215686275
88260,LOVINGTON,NM,3710,3182,-528,0.4616947185142194
88267,TATUM,NM,64,12,-52,0.15789473684210525
88301,ANCHO,NM,11,0,-11,0
88301,CARRIZOZO,NM,129,139,10,0.5186567164179104
88301,WHITE OAKS,NM,12,0,-12,0
88310,ALAMOGORDO,NM,17857,17089,-768,0.48901161792479825
88311,ALAMOGORDO,NM,849,866,17,0.5049562682215744
88312,ALTO,NM,2861,2345,-516,0.4504417979254706
88316,ALAMOGORDO,NM,22,19,-3,0.4634146341463415
88316,CAPITAN,NM,575,748,173,0.5653817082388511
88317,CLOUDCROFT,NM,1333,1330,-3,0.49943672549755913
88325,HI RLS MTN PK,NM,0,14,14,1
88325,HIGH ROLLS MOUNTAIN PARK,NM,70,43,-27,0.3805309734513274
88330,HOLLOMAN AFB,NM,598,635,37,0.5150040551500406
88330,HOLLOMAN AIR FORCE BASE,NM,2637,3110,473,0.5411519053419175
88337,LA LUZ,NM,865,864,-1,0.4997108155002892
88339,MAYHILL,NM,24,279,255,0.9207920792079208
88340,MESCALERO,NM,286,68,-218,0.192090395480226
88341,NOGAL,NM,39,61,22,0.61
88345,RUIDOSO,NM,3488,3641,153,0.5107308177865059
88346,RUIDOSO DOWNS,NM,1259,1146,-113,0.47650727650727653
88347,SACRAMENTO,NM,0,11,11,1
88350,TIMBERON,NM,432,408,-24,0.4857142857142857
88352,TULAROSA,NM,1971,1698,-273,0.4627964022894522
88355,RUIDOSO,NM,2531,1561,-970,0.38147605083088953
88401,TUCUMCARI,NM,2520,2594,74,0.5072350410637466
88415,BUEYEROS,NM,30,32,2,0.5161290322580645
88415,CLAYTON,NM,1139,1114,-25,0.4944518419884598
88418,DES MOINES,NM,11,0,-11,0
88426,LOGAN,NM,126,229,103,0.6450704225352113
88435,SANTA ROSA,NM,878,829,-49,0.4856473345049795
89001,ALAMO,NV,38,41,3,0.5189873417721519
89002,HENDERSON,NV,13828,14344,516,0.5091580292488996
89003,BEATTY,NV,108,52,-56,0.325
89005,BOULDER CITY,NV,7455,8122,667,0.5214097708159466
89006,BOULDER CITY,NV,763,755,-8,0.497364953886693
89007,BUNKERVILLE,NV,80,46,-34,0.36507936507936506
89008,CALIENTE,NV,158,230,72,0.5927835051546392
89009,HENDERSON,NV,1730,1923,193,0.5264166438543663
89011,HENDERSON,NV,19409,23070,3661,0.54309188069399
89012,HENDERSON,NV,19778,19977,199,0.5025028298327254
89013,GOLDFIELD,NV,11,25,14,0.6944444444444444
89014,HENDERSON,NV,26656,26673,17,0.5001593879502709
89015,HENDERSON,NV,20772,20361,-411,0.49500401137772593
89016,HENDERSON,NV,631,996,365,0.6121696373693916
89018,INDIAN SPGS,NV,0,11,11,1
89018,INDIAN SPRINGS,NV,232,733,501,0.7595854922279792
89019,GOODSPRINGS,NV,15,15,0,0.5
89019,HD,NV,56,64,8,0.5333333333333333
89019,JEAN,NV,539,494,-45,0.4782187802516941
89019,PRIMM,NV,95,108,13,0.5320197044334976
89019,SANDY VALLEY,NV,95,89,-6,0.483695652173913
89020,AMARGOSA VALLEY,NV,758,664,-94,0.4669479606188467
89021,LOGANDALE,NV,694,883,189,0.5599239061509195
89024,MESQUITE,NV,1611,1849,238,0.534393063583815
89025,MOAPA,NV,11,36,25,0.7659574468085106
89027,MESQUITE,NV,10841,11632,791,0.517598896453522
89028,LAUGHLIN,NV,1520,965,-555,0.38832997987927564
89029,LAUGHLIN,NV,6378,6736,358,0.5136495348482538
89030,LAS VEGAS,NV,644,556,-88,0.4633333333333333
89030,N LAS VEGAS,NV,1401,1251,-150,0.47171945701357465
89030,NORTH LAS VEGAS,NV,15890,14473,-1417,0.47666567862200704
89031,N LAS VEGAS,NV,3737,4001,264,0.5170586714913414
89031,NORTH LAS VEGAS,NV,25329,27685,2356,0.5222205455162787
89032,LAS VEGAS,NV,377,346,-31,0.4785615491009682
89032,N LAS VEGAS,NV,749,751,2,0.5006666666666667
89032,NORTH LAS VEGAS,NV,17885,17108,-777,0.4888977795559112
89033,N LAS VEGAS,NV,169,287,118,0.6293859649122807
89033,NORTH LAS VEGAS,NV,1039,1692,653,0.6195532771878433
89034,MESQUITE,NV,2185,2981,796,0.5770421989934185
89036,N LAS VEGAS,NV,109,269,160,0.7116402116402116
89036,NORTH LAS VEGAS,NV,952,1731,779,0.6451733134550875
89039,CAL NEV ARI,NV,0,12,12,1
89040,OVERTON,NV,1905,1756,-149,0.4796503687517072
89041,PAHRUMP,NV,2398,2297,-101,0.48924387646432377
89042,PANACA,NV,0,50,50,1
89043,PIOCHE,NV,39,98,59,0.7153284671532847
89044,HENDERSON,NV,11481,15700,4219,0.5776093594790479
89044,LAS VEGAS,NV,230,395,165,0.632
89045,ROUND MOUNTAIN,NV,1343,1195,-148,0.47084318360914107
89046,SEARCHLIGHT,NV,97,36,-61,0.2706766917293233
89048,PAHRUMP,NV,11197,12172,975,0.5208609696606615
89049,TONOPAH,NV,819,695,-124,0.45904887714663145
89052,HENDERSON,NV,34057,37297,3240,0.5227037026655829
89053,HENDERSON,NV,932,1394,462,0.5993121238177128
89060,CRYSTAL,NV,73,93,20,0.5602409638554217
89060,PAHRUMP,NV,4642,5965,1323,0.5623644762892429
89061,PAHRUMP,NV,3413,4836,1423,0.5862528791368651
89074,HENDERSON,NV,30792,29478,-1314,0.4890990542558487
89077,HENDERSON,NV,496,1040,544,0.6770833333333334
89081,N LAS VEGAS,NV,1179,1213,34,0.5071070234113713
89081,NORTH LAS VEGAS,NV,16883,17642,759,0.5109920347574222
89084,NORTH LAS VEGAS,NV,15329,20670,5341,0.5741826161837829
89085,N LAS VEGAS,NV,170,195,25,0.5342465753424658
89085,NORTH LAS VEGAS,NV,1353,1477,124,0.5219081272084806
89086,LAS VEGAS,NV,140,135,-5,0.4909090909090909
89086,NORTH LAS VEGAS,NV,3815,6152,2337,0.6172368817096419
89101,LAS VEGAS,NV,20145,17989,-2156,0.4717312634394504
89102,LAS VEGAS,NV,23930,20243,-3687,0.45826636180472236
89103,LAS VEGAS,NV,31103,28471,-2632,0.47790982643435054
89104,LAS VEGAS,NV,21484,20030,-1454,0.4824878354290119
89105,LAS VEGAS,NV,1229,1887,658,0.6055840821566111
89106,LAS VEGAS,NV,13458,13506,48,0.5008900756564308
89107,LAS VEGAS,NV,16171,19510,3339,0.5467896079145764
89108,LAS VEGAS,NV,35615,32159,-3456,0.47450349691622157
89109,LAS VEGAS,NV,6876,6024,-852,0.4669767441860465
89110,LAS VEGAS,NV,23683,21897,-1786,0.4804080737165423
89111,LAS VEGAS,NV,124,16,-108,0.11428571428571428
89112,LAS VEGAS,NV,1919,1275,-644,0.3991859737006888
89113,LAS VEGAS,NV,20242,22487,2245,0.5262702146083457
89114,LAS VEGAS,NV,107,448,341,0.8072072072072072
89115,LAS VEGAS,NV,27336,26427,-909,0.4915462306790916
89116,LAS VEGAS,NV,532,909,377,0.6308119361554476
89117,LAS VEGAS,NV,36363,34369,-1994,0.4859045410846576
89118,LAS VEGAS,NV,15528,14783,-745,0.4877107320774636
89119,LAS VEGAS,NV,34465,29645,-4820,0.4624083606301669
89120,LAS VEGAS,NV,13807,13155,-652,0.4879089088346562
89121,LAS VEGAS,NV,36987,33499,-3488,0.4752574979428539
89122,LAS VEGAS,NV,25812,24900,-912,0.4910080454330336
89123,LAS VEGAS,NV,30268,29811,-457,0.49619667437873466
89124,LAS VEGAS,NV,22,52,30,0.7027027027027027
89124,MOUNT CHARLESTON,NV,0,15,15,1
89125,LAS VEGAS,NV,362,390,28,0.5186170212765957
89126,LAS VEGAS,NV,473,998,525,0.6784500339904826
89127,LAS VEGAS,NV,630,889,259,0.5852534562211982
89128,LAS VEGAS,NV,22443,21440,-1003,0.48857188432878335
89129,LAS VEGAS,NV,26178,25931,-247,0.4976299679517934
89130,LAS VEGAS,NV,14456,16557,2101,0.5338728920130268
89131,LAS VEGAS,NV,18617,20092,1475,0.5190524167506265
89132,LAS VEGAS,NV,546,601,55,0.5239755884917175
89133,LAS VEGAS,NV,1121,1672,551,0.5986394557823129
89134,LAS VEGAS,NV,12738,13515,777,0.5147983087647126
89135,LAS VEGAS,NV,17058,19003,1945,0.5269681927844486
89136,LAS VEGAS,NV,1472,1811,339,0.5516296070667073
89137,LAS VEGAS,NV,1133,1628,495,0.5896414342629482
89138,LAS VEGAS,NV,8738,13027,4289,0.5985297495979784
89139,LAS VEGAS,NV,21029,21547,518,0.5060832393836904
89140,LAS VEGAS,NV,1300,1256,-44,0.49139280125195617
89141,LAS VEGAS,NV,17992,22429,4437,0.5548848370896317
89142,LAS VEGAS,NV,12386,11604,-782,0.4837015423092955
89143,LAS VEGAS,NV,5523,5265,-258,0.48804226918798665
89144,LAS VEGAS,NV,10385,9599,-786,0.48033426741393115
89145,LAS VEGAS,NV,12622,12801,179,0.5035204342524485
89146,LAS VEGAS,NV,12193,11052,-1141,0.47545708754570876
89147,LAS VEGAS,NV,31768,29916,-1852,0.48498800337202513
89148,LAS VEGAS,NV,35578,35915,337,0.5023568740995622
89149,LAS VEGAS,NV,20084,21375,1291,0.515569598880822
89156,LAS VEGAS,NV,10147,9741,-406,0.4897928399034594
89157,LAS VEGAS,NV,560,921,361,0.6218771100607697
89158,CITY CENTER,NV,25,17,-8,0.40476190476190477
89158,LAS VEGAS,NV,783,603,-180,0.43506493506493504
89160,LAS VEGAS,NV,148,551,403,0.7882689556509299
89161,LAS VEGAS,NV,0,12,12,1
89162,LAS VEGAS,NV,782,1291,509,0.6227689339122046
89165,LAS VEGAS,NV,395,1873,1478,0.8258377425044092
89166,LAS VEGAS,NV,12407,15635,3228,0.5575565223593182
89169,LAS VEGAS,NV,16622,14791,-1831,0.47085601502562635
89170,LAS VEGAS,NV,1922,1467,-455,0.43287105340808496
89173,LAS VEGAS,NV,1025,1802,777,0.6374248319773611
89178,LAS VEGAS,NV,18345,20882,2537,0.5323374206541412
89179,LAS VEGAS,NV,4426,4635,209,0.5115329433837325
89180,LAS VEGAS,NV,1104,1586,482,0.5895910780669145
89183,LAS VEGAS,NV,22493,22767,274,0.5030269553689792
89191,NELLIS AFB,NV,3801,1353,-2448,0.26251455180442373
89193,LAS VEGAS,NV,1332,1647,315,0.552870090634441
89301,ELY,NV,2375,2332,-43,0.49543233482048016
89310,AUSTIN,NV,0,23,23,1
89315,ELY,NV,439,364,-75,0.4533001245330012
89316,EUREKA,NV,315,233,-82,0.4251824817518248
89318,MC GILL,NV,98,93,-5,0.4869109947643979
89319,RUTH,NV,176,185,9,0.5124653739612188
89402,CRYSTAL BAY,NV,173,174,1,0.5014409221902018
89403,DAYTON,NV,7210,8022,812,0.5266544117647058
89406,FALLON,NV,10842,10361,-481,0.48865726548129984
89407,FALLON,NV,872,977,105,0.5283937263385614
89408,FERNLEY,NV,13075,11908,-1167,0.47664411800024015
89410,GARDNERVILLE,NV,4967,5235,268,0.5131346794746128
89411,GENOA,NV,543,932,389,0.631864406779661
89412,GERLACH,NV,13,0,-13,0
89413,GLENBROOK,NV,232,115,-117,0.3314121037463977
89414,GOLCONDA,NV,41,39,-2,0.4875
89415,HAWTHORNE,NV,1962,1068,-894,0.35247524752475246
89415,WALKER LAKE,NV,35,24,-11,0.4067796610169492
89418,IMLAY,NV,13,31,18,0.7045454545454546
89419,LOVELOCK,NV,1339,1150,-189,0.4620329449578144
89423,MINDEN,NV,4504,5010,506,0.5265923901618668
89427,SCHURZ,NV,0,11,11,1
89429,SILVER SPRINGS,NV,3996,4203,207,0.5126234906695939
89430,SMITH,NV,0,11,11,1
89431,SPARKS,NV,21774,17183,-4591,0.44107605821803525
89432,SPARKS,NV,1298,1530,232,0.541018387553041
89433,SUN VALLEY,NV,6460,6213,-247,0.49025487256371814
89434,SPARKS,NV,13942,13863,-79,0.4985793921956483
89435,SPARKS,NV,744,795,51,0.5165692007797271
89436,SPANISH SPGS,NV,393,457,64,0.5376470588235294
89436,SPANISH SPRINGS,NV,1316,1516,200,0.5353107344632768
89436,SPARKS,NV,18147,20661,2514,0.5323902288188003
89439,VERDI,NV,914,1682,768,0.6479198767334361
89440,VIRGINIA CITY,NV,239,351,112,0.5949152542372881
89441,SPANISH SPGS,NV,450,732,282,0.6192893401015228
89441,SPANISH SPRINGS,NV,277,439,162,0.6131284916201117
89441,SPARKS,NV,2965,4320,1355,0.5929993136582018
89442,WADSWORTH,NV,48,74,26,0.6065573770491803
89444,WELLINGTON,NV,1176,1429,253,0.5485604606525911
89445,WINNEMUCCA,NV,7316,6287,-1029,0.46217746085422334
89446,WINNEMUCCA,NV,1702,1081,-621,0.3884297520661157
89447,YERINGTON,NV,4034,3375,-659,0.4555270616817384
89448,ZEPHYR COVE,NV,2177,1571,-606,0.41915688367129134
89449,STATELINE,NV,2032,1530,-502,0.4295339696799551
89450,INCLINE VILLAGE,NV,3115,2206,-909,0.4145837248637474
89450,INCLINE VLG,NV,126,74,-52,0.37
89451,INCLINE VILLAGE,NV,3034,3475,441,0.5338761714549086
89460,GARDNERVILLE,NV,4644,5004,360,0.5186567164179104
89501,RENO,NV,4541,4446,-95,0.49471458773784355
89502,I V,NV,564,381,-183,0.4031746031746032
89502,RENO,NV,24659,19945,-4714,0.4471572056317819
89503,RENO,NV,16112,13131,-2981,0.4490305372225832
89504,RENO,NV,330,436,106,0.5691906005221932
89505,RENO,NV,133,147,14,0.525
89506,RENO,NV,17522,19318,1796,0.5243756786102063
89507,RENO,NV,939,225,-714,0.19329896907216496
89508,RENO,NV,3985,4678,693,0.5399976913309477
89509,RENO,NV,19043,17783,-1260,0.4828925215880085
89510,RENO,NV,1695,2883,1188,0.6297509829619922
89511,RENO,NV,15372,17346,1974,0.5301668806161746
89512,RENO,NV,14339,11254,-3085,0.4397296135662095
89513,RENO,NV,709,653,-56,0.47944199706314244
89515,RENO,NV,496,871,375,0.6371616678858815
89519,RENO,NV,4161,4488,327,0.5189039195282692
89520,RENO,NV,0,11,11,1
89521,RENO,NV,17348,21213,3865,0.550115401571536
89523,RENO,NV,20005,18437,-1568,0.4796056396649498
89533,RENO,NV,790,715,-75,0.4750830564784053
89701,CARSON CITY,NV,11590,11641,51,0.5010976712151866
89702,CARSON CITY,NV,3071,1792,-1279,0.36849681266707796
89703,CARSON CITY,NV,4516,4889,373,0.5198298777246145
89704,CARSON CITY,NV,156,238,82,0.6040609137055838
89704,WASHOE VALLEY,NV,1217,1490,273,0.5504248245289989
89705,CARSON CITY,NV,1728,1985,257,0.5346081335847024
89706,CARSON CITY,NV,9194,8369,-825,0.476513124181518
89706,MOUND HOUSE,NV,186,204,18,0.5230769230769231
89721,CARSON CITY,NV,1107,508,-599,0.31455108359133127
89801,ELKO,NV,13329,10997,-2332,0.45206774644413383
89803,ELKO,NV,1146,1172,26,0.5056082830025884
89815,SPRING CREEK,NV,6380,5725,-655,0.4729450640231309
89820,BATTLE MOUNTAIN,NV,2589,2330,-259,0.47367351087619436
89821,BEOWAWE,NV,13,0,-13,0
89821,CRESCENT VALLEY,NV,0,60,60,1
89822,CARLIN,NV,778,785,7,0.5022392834293026
89825,JACKPOT,NV,175,11,-164,0.05913978494623656
89828,LAMOILLE,NV,12,0,-12,0
89832,OWYHEE,NV,121,63,-58,0.3423913043478261
89835,OASIS,NV,0,25,25,1
89835,WELLS,NV,298,264,-34,0.4697508896797153
89883,WEST WENDOVER,NV,1334,447,-887,0.2509825940482875
90001,LOS ANGELES,CA,8611,6914,-1697,0.44534621578099837
90002,LOS ANGELES,CA,9112,7314,-1798,0.4452696943869475
90002,WATTS,CA,742,597,-145,0.4458551157580284
90003,LOS ANGELES,CA,14270,10616,-3654,0.4265852286426103
90004,LOS ANGELES,CA,24571,20327,-4244,0.45273731569334935
90005,LOS ANGELES,CA,18120,14872,-3248,0.45077594568380214
90006,LOS ANGELES,CA,16040,12568,-3472,0.4393176733780761
90007,DOCKWEILER,CA,199,99,-100,0.33221476510067116
90007,LOS ANGELES,CA,13614,7236,-6378,0.3470503597122302
90008,BALDWIN HILLS,CA,226,218,-8,0.49099099099099097
90008,LEIMERT PARK,CA,467,455,-12,0.49349240780911063
90008,LOS ANGELES,CA,9028,7932,-1096,0.467688679245283
90008,VIEW PARK,CA,1186,928,-258,0.4389782403027436
90009,LOS ANGELES,CA,1263,1321,58,0.5112229102167183
90010,LOS ANGELES,CA,6588,6219,-369,0.48559381588193956
90011,LOS ANGELES,CA,14629,10660,-3969,0.4215271461900431
90012,LOS ANGELES,CA,19524,16521,-3003,0.4583437369954224
90013,LOS ANGELES,CA,9971,9448,-523,0.48653380709614297
90014,LOS ANGELES,CA,9714,7886,-1828,0.4480681818181818
90015,LOS ANGELES,CA,20301,17877,-2424,0.46825396825396826
90016,LOS ANGELES,CA,14875,12961,-1914,0.46562006035349907
90017,LOS ANGELES,CA,18531,15315,-3216,0.4524906931395143
90018,LOS ANGELES,CA,12712,10569,-2143,0.4539753447016881
90019,LOS ANGELES,CA,23446,19259,-4187,0.45097763727900714
90020,LOS ANGELES,CA,18460,13844,-4616,0.4285537394749876
90021,LOS ANGELES,CA,3325,2796,-529,0.45678810651854274
90022,COMMERCE,CA,438,392,-46,0.472289156626506
90022,EAST LOS ANGELES,CA,1305,1161,-144,0.4708029197080292
90022,LOS ANGELES,CA,8587,6795,-1792,0.44175009751657784
90023,COMMERCE,CA,141,135,-6,0.4891304347826087
90023,LOS ANGELES,CA,7027,5641,-1386,0.4452952320808336
90024,LOS ANGELES,CA,22110,15868,-6242,0.41782084364632155
90025,LOS ANGELES,CA,33865,28267,-5598,0.45495075001609475
90026,LOS ANGELES,CA,29962,22985,-6977,0.4341133586416605
90027,ESCONDIDO,CA,538,488,-50,0.4756335282651072
90027,LOS ANGELES,CA,24901,20923,-3978,0.45659479748603354
90028,HOLLYWOOD,CA,5137,4360,-777,0.4590923449510372
90028,LOS ANGELES,CA,21668,17979,-3689,0.4534769339420385
90029,LOS ANGELES,CA,15247,12180,-3067,0.4440879425383746
90030,LOS ANGELES,CA,12,94,82,0.8867924528301887
90031,LOS ANGELES,CA,9164,7142,-2022,0.43799828284067216
90032,LOS ANGELES,CA,9716,8130,-1586,0.45556427210579403
90033,LOS ANGELES,CA,8761,6982,-1779,0.44349869783395796
90034,LOS ANGELES,CA,35962,27310,-8652,0.43162852446579847
90035,LOS ANGELES,CA,15761,13028,-2733,0.45253395394074125
90036,LOS ANGELES,CA,32418,26660,-5758,0.45126781543044786
90037,LOS ANGELES,CA,12086,8648,-3438,0.4170926979839876
90038,LOS ANGELES,CA,14068,11095,-2973,0.4409251679052577
90038,W HOLLYWOOD,CA,451,341,-110,0.4305555555555556
90038,WEST HOLLYWOOD,CA,1162,896,-266,0.43537414965986393
90039,LOS ANGELES,CA,13134,11473,-1661,0.46624944121591416
90040,COMMERCE,CA,2838,2217,-621,0.43857566765578637
90040,LOS ANGELES,CA,109,106,-3,0.4930232558139535
90041,EAGLE ROCK,CA,1660,1449,-211,0.4660662592473464
90041,LOS ANGELES,CA,6952,6456,-496,0.4815035799522673
90042,HIGHLAND PARK,CA,3015,2389,-626,0.442079940784604
90042,LOS ANGELES,CA,16319,13597,-2722,0.4545059499933146
90043,LOS ANGELES,CA,12100,10984,-1116,0.4758274129267025
90043,VIEW PARK,CA,598,520,-78,0.46511627906976744
90043,WINDSOR HILLS,CA,292,263,-29,0.47387387387387386
90044,LOS ANGELES,CA,20718,16117,-4601,0.43754581240667845
90045,LOS ANGELES,CA,18457,17049,-1408,0.48017236523404494
90045,WESTCHESTER,CA,1270,1096,-174,0.463229078613694
90046,LOS ANGELES,CA,25989,21103,-4886,0.44812282340949633
90046,WEST HOLLYWOOD,CA,11613,9371,-2242,0.44657834540602365
90047,LOS ANGELES,CA,13189,11539,-1650,0.4666370106761566
90048,LOS ANGELES,CA,15155,11997,-3158,0.44184590453741895
90048,W HOLLYWOOD,CA,415,279,-136,0.4020172910662824
90048,WEST HOLLYWOOD,CA,1853,1486,-367,0.44504342617550163
90049,LOS ANGELES,CA,20888,17816,-3072,0.4603141794129806
90050,LOS ANGELES,CA,51,0,-51,0
90051,LOS ANGELES,CA,104,314,210,0.7511961722488039
90053,LOS ANGELES,CA,12,0,-12,0
90054,LOS ANGELES,CA,0,41,41,1
90056,BALDWIN HILLS,CA,150,131,-19,0.46619217081850534
90056,LOS ANGELES,CA,2655,2765,110,0.5101476014760148
90056,WINDSOR HILLS,CA,256,278,22,0.5205992509363296
90057,LOS ANGELES,CA,12755,9152,-3603,0.41776601086410736
90058,LOS ANGELES,CA,919,790,-129,0.46225863077823287
90058,VERNON,CA,882,762,-120,0.4635036496350365
90059,LOS ANGELES,CA,8266,7255,-1011,0.46743122221506345
90060,LOS ANGELES,CA,0,87,87,1
90061,LOS ANGELES,CA,6029,4557,-1472,0.4304742112223692
90062,LOS ANGELES,CA,7343,5738,-1605,0.43865147924470604
90063,LOS ANGELES,CA,8823,6837,-1986,0.43659003831417625
90064,LOS ANGELES,CA,13955,13620,-335,0.4939256572982774
90064,RANCHO PARK,CA,588,685,97,0.5380989787902593
90065,GLASSELL,CA,640,556,-84,0.46488294314381273
90065,GLASSELL PARK,CA,717,674,-43,0.4845434938892883
90065,LOS ANGELES,CA,11147,10187,-960,0.47750070310302806
90066,LOS ANGELES,CA,29267,24033,-5234,0.45090056285178237
90067,CENTURY CITY,CA,875,907,32,0.5089786756453423
90067,LOS ANGELES,CA,3733,3502,-231,0.48403593642017967
90068,HOLLYWOOD,CA,610,515,-95,0.4577777777777778
90068,LOS ANGELES,CA,15709,13074,-2635,0.45422645311468574
90069,LOS ANGELES,CA,4393,3701,-692,0.4572522856436867
90069,W HOLLYWOOD,CA,764,587,-177,0.43449296817172467
90069,WEST HOLLYWOOD,CA,13327,10759,-2568,0.4466910238312713
90070,LOS ANGELES,CA,11,0,-11,0
90071,LOS ANGELES,CA,1277,1231,-46,0.490829346092504
90075,LOS ANGELES,CA,73,49,-24,0.4016393442622951
90076,LOS ANGELES,CA,14,0,-14,0
90077,LOS ANGELES,CA,2947,3278,331,0.5265863453815262
90078,HOLLYWOOD,CA,218,244,26,0.5281385281385281
90078,LOS ANGELES,CA,545,631,86,0.5365646258503401
90079,LOS ANGELES,CA,73,29,-44,0.28431372549019607
90081,LOS ANGELES,CA,100,175,75,0.6363636363636364
90082,LOS ANGELES,CA,0,83,83,1
90083,LOS ANGELES,CA,0,12,12,1
90086,LA,CA,0,32,32,1
90086,LOS ANGELES,CA,190,402,212,0.6790540540540541
90089,LOS ANGELES,CA,0,15,15,1
90093,LOS ANGELES,CA,209,350,141,0.6261180679785331
90094,LOS ANGELES,CA,1254,1085,-169,0.4638734501923899
90094,PLAYA VISTA,CA,8394,7142,-1252,0.45970648815653964
90201,BELL,CA,1776,1353,-423,0.4324065196548418
90201,BELL GARDENS,CA,9092,7203,-1889,0.4420374347959497
90201,CUDAHY,CA,5333,4193,-1140,0.44016376233466303
90202,BELL,CA,29,128,99,0.8152866242038217
90202,BELL GARDENS,CA,32,240,208,0.8823529411764706
90209,BEVERLY HILLS,CA,248,1065,817,0.8111195734958111
90210,BEVERLY HILLS,CA,10240,10074,-166,0.4959141478783105
90211,BEVERLY HILLS,CA,5534,6047,513,0.5221483464294966
90212,BEVERLY HILLS,CA,9198,8704,-494,0.48620265892079095
90213,BEVERLY HILLS,CA,331,477,146,0.5903465346534653
90220,COMPTON,CA,8868,7632,-1236,0.46254545454545454
90220,RANCHO DOMINGUEZ,CA,912,766,-146,0.4564958283671037
90221,COMPTON,CA,8581,6877,-1704,0.4448829085263294
90221,E RNCHO DMNGZ,CA,184,104,-80,0.3611111111111111
90221,EAST RANCHO DOMINGUEZ,CA,192,166,-26,0.46368715083798884
90222,COMPTON,CA,5525,4284,-1241,0.43674176776429807
90222,ROSEWOOD,CA,135,101,-34,0.4279661016949153
90223,COMPTON,CA,40,350,310,0.8974358974358975
90223,GLENDALE,CA,0,15,15,1
90224,COMPTON,CA,253,641,388,0.7170022371364653
90230,CULVER CITY,CA,12009,10785,-1224,0.4731508291655699
90231,CULVER CITY,CA,344,560,216,0.6194690265486725
90232,CULVER CITY,CA,9583,8919,-664,0.48205599394660037
90239,DOWNEY,CA,929,538,-391,0.3667348329925017
90240,DOWNEY,CA,6643,5536,-1107,0.45455291895886363
90241,DOWNEY,CA,12188,10291,-1897,0.45780506250278036
90242,DOWNEY,CA,10719,8806,-1913,0.45101152368758
90245,EL SEGUNDO,CA,9556,9158,-398,0.4893662498664102
90247,GARDENA,CA,12771,11665,-1106,0.47736945490260274
90248,GARDENA,CA,3433,3371,-62,0.49544385655496764
90249,GARDENA,CA,6716,6363,-353,0.48650508448658153
90250,HAWTHORNE,CA,27989,22595,-5394,0.44668274553218407
90251,HAWTHORNE,CA,724,1267,543,0.6363636363636364
90254,HERMOSA BEACH,CA,11905,10026,-1879,0.45716109616524553
90255,HUNTINGTON PARK,CA,12455,9999,-2456,0.44531041239868174
90255,WALNUT PARK,CA,250,194,-56,0.4369369369369369
90260,LAWNDALE,CA,9144,7607,-1537,0.45412214196167394
90262,LYNWOOD,CA,10309,8357,-1952,0.4477124183006536
90264,MALIBU,CA,131,352,221,0.7287784679089027
90265,MALIBU,CA,8190,7075,-1115,0.4634785456927612
90266,MANHATTAN BCH,CA,1034,1053,19,0.5045519885002395
90266,MANHATTAN BEACH,CA,13059,12259,-800,0.4842009637412118
90267,MANHATTAN BCH,CA,0,25,25,1
90267,MANHATTAN BEACH,CA,138,163,25,0.5415282392026578
90270,MAYWOOD,CA,3944,3022,-922,0.43382141831754234
90272,PACIFIC PALISADES,CA,7636,8502,866,0.5268310819184533
90272,PACIFIC PLSDS,CA,260,314,54,0.5470383275261324
90274,PALOS VERDES ESTATES,CA,3359,4299,940,0.5613737268216245
90274,PALOS VERDES PENINSULA,CA,610,752,142,0.5521292217327459
90274,ROLLING HILLS,CA,274,366,92,0.571875
90274,ROLLING HILLS ESTATES,CA,2671,3356,685,0.5568276090924175
90275,PALOS VERDES ESTATES,CA,760,803,43,0.5137555982085733
90275,PALOS VERDES PENINSULA,CA,249,362,113,0.5924713584288053
90275,RANCHO PALOS VERDES,CA,9342,10658,1316,0.5329
90275,RCH PALOS VRD,CA,293,280,-13,0.4886561954624782
90275,ROLLING HILLS ESTATES,CA,239,276,37,0.5359223300970873
90277,REDONDO BEACH,CA,18238,17400,-838,0.4882428868062181
90278,REDONDO BEACH,CA,15421,15033,-388,0.4936297366519997
90280,SOUTH GATE,CA,14870,12746,-2124,0.46154403244495945
90290,TOPANGA,CA,3655,3154,-501,0.4632104567484212
90291,PLAYA DEL REY,CA,948,705,-243,0.426497277676951
90291,VENICE,CA,19131,15046,-4085,0.4402375866811013
90292,MARINA DEL REY,CA,24323,23825,-498,0.49482844562598655
90293,PLAYA DEL REY,CA,8019,6920,-1099,0.4632170828034005
90294,VENICE,CA,263,334,71,0.559463986599665
90295,MARINA DEL REY,CA,436,458,22,0.5123042505592841
90295,MARINA DL REY,CA,15,11,-4,0.4230769230769231
90296,PLAYA DEL REY,CA,0,25,25,1
90301,INGLEWOOD,CA,9174,7692,-1482,0.456065457132693
90302,INGLEWOOD,CA,9465,7703,-1762,0.44868359739049396
90303,INGLEWOOD,CA,4807,4026,-781,0.45579078455790784
90304,INGLEWOOD,CA,4264,3558,-706,0.4548708770135515
90305,INGLEWOOD,CA,4342,3917,-425,0.47427049279573796
90306,INGLEWOOD,CA,0,11,11,1
90308,INGLEWOOD,CA,0,113,113,1
90309,INGLEWOOD,CA,25,112,87,0.8175182481751825
90401,SANTA MONICA,CA,10160,7935,-2225,0.43851892788063
90402,SANTA MONICA,CA,4357,4214,-143,0.4916579162291448
90403,SANTA MONICA,CA,16456,14027,-2429,0.46015812091985697
90404,SANTA MONICA,CA,13076,10245,-2831,0.439303631919729
90405,SANTA MONICA,CA,15724,13846,-1878,0.4682448427460264
90406,SANTA MONICA,CA,496,603,107,0.5486806187443131
90408,SANTA MONICA,CA,61,106,45,0.6347305389221557
90409,SANTA MONICA,CA,262,63,-199,0.19384615384615383
90501,TORRANCE,CA,13549,12318,-1231,0.4762052035411915
90502,TORRANCE,CA,5022,4997,-25,0.4987523704960575
90503,TORRANCE,CA,15672,15177,-495,0.49197704949917337
90504,TORRANCE,CA,8968,8288,-680,0.4802967083912842
90505,TORRANCE,CA,12982,12114,-868,0.4827064073956009
90507,TORRANCE,CA,0,30,30,1
90508,TORRANCE,CA,0,24,24,1
90510,TORRANCE,CA,351,685,334,0.6611969111969112
90601,CITY INDUSTRY,CA,163,158,-5,0.49221183800623053
90601,WHITTIER,CA,7718,7023,-695,0.4764262940099043
90602,WHITTIER,CA,7077,6495,-582,0.47855879752431474
90603,WHITTIER,CA,4217,4363,146,0.5085081585081586
90604,WHITTIER,CA,8623,7888,-735,0.47774211131972627
90605,WHITTIER,CA,7551,7130,-421,0.48566173966351067
90606,WHITTIER,CA,5991,5195,-796,0.46441981047738246
90607,WHITTIER,CA,81,334,253,0.8048192771084337
90608,WHITTIER,CA,133,467,334,0.7783333333333333
90609,WHITTIER,CA,23,39,16,0.6290322580645161
90610,WHITTIER,CA,36,12,-24,0.25
90620,BUENA PARK,CA,10767,10456,-311,0.4926730433963153
90621,BUENA PARK,CA,11812,10262,-1550,0.46489082178128116
90622,BUENA PARK,CA,389,688,299,0.6388115134633241
90623,LA PALMA,CA,3449,3477,28,0.5020213687554144
90630,CYPRESS,CA,15335,14477,-858,0.4856098215483698
90631,LA HABRA,CA,16697,15341,-1356,0.4788376303140021
90631,LA HABRA HEIGHTS,CA,1703,1595,-108,0.4836264402668284
90632,LA HABRA,CA,295,583,288,0.664009111617312
90633,LA HABRA,CA,131,243,112,0.6497326203208557
90637,LA MIRADA,CA,362,539,177,0.5982241953385128
90638,LA MIRADA,CA,9989,9783,-206,0.4947906129880639
90638,LAMIRADA,CA,214,195,-19,0.4767726161369193
90638,MIRADA,CA,440,410,-30,0.4823529411764706
90640,MONTEBELLO,CA,14822,12769,-2053,0.462795839222935
90650,NORWALK,CA,20678,18296,-2382,0.46944116590547547
90651,NORWALK,CA,266,707,441,0.7266187050359713
90652,NORWALK,CA,0,13,13,1
90660,PICO RIVERA,CA,11529,10372,-1157,0.47358568101913157
90662,PICO RIVERA,CA,0,17,17,1
90670,SANTA FE SPGS,CA,775,698,-77,0.47386286490156143
90670,SANTA FE SPRINGS,CA,4489,3983,-506,0.47013692162417375
90680,STANTON,CA,8619,7769,-850,0.47406639004149376
90680,STATON,CA,144,138,-6,0.48936170212765956
90701,ARTESIA,CA,4316,3685,-631,0.46056742907136605
90702,ARTESIA,CA,417,276,-141,0.39826839826839827
90703,CERRITOS,CA,11796,11998,202,0.5042447675884677
90704,AVALON,CA,752,579,-173,0.43501126972201354
90706,BELLFLOWER,CA,20746,17536,-3210,0.4580742907894049
90707,BELLFLOWER,CA,755,1360,605,0.6430260047281324
90710,HARBOR CITY,CA,6467,6154,-313,0.48760003169320976
90711,LAKEWOOD,CA,41,26,-15,0.3880597014925373
90712,LAKEWOOD,CA,7927,7724,-203,0.49351479138713183
90713,LAKEWOOD,CA,6181,6335,154,0.506152125279642
90714,LAKEWOOD,CA,317,829,512,0.7233856893542757
90715,LAKEWOOD,CA,5671,4971,-700,0.46711144521706444
90716,HAWAIIAN GARDENS,CA,2522,1830,-692,0.42049632352941174
90716,HAWAIIAN GDNS,CA,76,77,1,0.5032679738562091
90717,LOMITA,CA,7673,6848,-825,0.4715928655051305
90720,CYPRESS,CA,460,544,84,0.5418326693227091
90720,LOS ALAMITOS,CA,5945,6895,950,0.536993769470405
90720,ROSSMOOR,CA,570,618,48,0.5202020202020202
90723,PARAMOUNT,CA,11610,10096,-1514,0.46512485027181427
90731,SAN PEDRO,CA,18389,16775,-1614,0.4770503924468206
90732,SAN PEDRO,CA,6139,6696,557,0.52169848071679
90733,SAN PEDRO,CA,257,316,59,0.5514834205933682
90734,SAN PEDRO,CA,138,128,-10,0.48120300751879697
90740,SEAL BEACH,CA,10133,11026,893,0.5211021314806938
90742,SUNSET BEACH,CA,448,523,75,0.5386199794026777
90743,SURFSIDE,CA,11,0,-11,0
90744,WILMINGTON,CA,9907,8043,-1864,0.44807799442896934
90745,CARSON,CA,12135,11511,-624,0.48680537934534385
90746,CARSON,CA,5844,6095,251,0.5105117681547868
90748,WILMINGTON,CA,412,975,563,0.702956020187455
90749,CARSON,CA,272,664,392,0.7094017094017094
90755,SIGNAL HILL,CA,4737,4144,-593,0.46661412003152797
90801,LONG BEACH,CA,1589,2888,1299,0.6450748268930087
90802,LONG BEACH,CA,30630,26433,-4197,0.46322485673729036
90803,LONG BEACH,CA,18392,16851,-1541,0.47813750248276254
90804,LONG BEACH,CA,18016,14211,-3805,0.4409656499208738
90805,LAKEWOOD,CA,468,456,-12,0.4935064935064935
90805,LONG BEACH,CA,22360,18592,-3768,0.45399492088298493
90806,LONG BEACH,CA,12267,10052,-2215,0.45037860119180967
90807,LONG BEACH,CA,11481,10874,-607,0.4864236188772087
90808,LONG BEACH,CA,9341,9844,503,0.5131091998957519
90809,LONG BEACH,CA,495,861,366,0.6349557522123894
90810,CARSON,CA,273,243,-30,0.47093023255813954
90810,LONG BEACH,CA,7339,6321,-1018,0.46273792093704247
90813,LONG BEACH,CA,18858,14464,-4394,0.4340675829782126
90814,LONG BEACH,CA,9939,8844,-1095,0.4708513017089922
90815,LONG BEACH,CA,13069,12207,-862,0.48294825130558633
90832,LONG BEACH,CA,0,26,26,1
90853,LONG BEACH,CA,92,217,125,0.7022653721682848
91001,ALTADENA,CA,8868,8917,49,0.5013775653640709
91003,ALTADENA,CA,39,188,149,0.8281938325991189
91006,ARCADIA,CA,9153,9493,340,0.5091172369408988
91007,ARCADIA,CA,10132,10099,-33,0.49918441994958235
91008,BRADBURY,CA,63,69,6,0.5227272727272727
91009,DUARTE,CA,66,132,66,0.6666666666666666
91010,DUARTE,CA,5738,5970,232,0.5099077553809361
91011,LA CANADA,CA,622,717,95,0.5354742345033607
91011,LA CANADA FLINTRIDGE,CA,3832,4760,928,0.5540037243947858
91011,LA CANADA FLT,CA,75,85,10,0.53125
91012,LA CANADA,CA,62,154,92,0.7129629629629629
91012,LA CANADA FLINTRIDGE,CA,24,160,136,0.8695652173913043
91016,MONROVIA,CA,13720,12593,-1127,0.478584729981378
91017,MONROVIA,CA,1375,684,-691,0.3322000971345313
91020,MONTROSE,CA,2929,2973,44,0.5037275499830566
91021,MONTROSE,CA,22,73,51,0.7684210526315789
91024,SIERRA MADRE,CA,3371,3594,223,0.5160086145010768
91025,SIERRA MADRE,CA,55,171,116,0.7566371681415929
91030,S PASADENA,CA,1228,1199,-29,0.49402554594149156
91030,SOUTH PASADENA,CA,8310,7445,-865,0.47254839733417964
91031,S PASADENA,CA,16,87,71,0.8446601941747572
91031,SOUTH PASADENA,CA,459,462,3,0.501628664495114
91040,SHADOW HILLS,CA,756,776,20,0.5065274151436031
91040,SUNLAND,CA,4741,4517,-224,0.48790235472024196
91041,SUNLAND,CA,62,89,27,0.5894039735099338
91042,TUJUNGA,CA,7114,6640,-474,0.4827686491202559
91043,TUJUNGA,CA,37,38,1,0.5066666666666667
91046,VERDUGO CITY,CA,67,56,-11,0.45528455284552843
91066,ARCADIA,CA,342,576,234,0.6274509803921569
91077,ARCADIA,CA,18,63,45,0.7777777777777778
91101,PASADENA,CA,16799,14334,-2465,0.46041178171072494
91102,PASADENA,CA,151,456,305,0.7512355848434926
91103,PASADENA,CA,8446,7576,-870,0.47284983148171267
91104,PASADENA,CA,10337,9335,-1002,0.47453233021553476
91105,PASADENA,CA,7180,7490,310,0.5105657805044308
91106,PASADENA,CA,13150,11007,-2143,0.4556443266961957
91107,PASADENA,CA,12098,11545,-553,0.48830520661506577
91108,SAN MARINO,CA,3170,4004,834,0.5581265681628101
91109,PASADENA,CA,972,1856,884,0.6562942008486563
91114,PASADENA,CA,28,11,-17,0.28205128205128205
91116,PASADENA,CA,25,80,55,0.7619047619047619
91117,PASADENA,CA,137,346,209,0.7163561076604554
91118,SAN MARINO,CA,29,194,165,0.8699551569506726
91201,GLENDALE,CA,7174,5914,-1260,0.4518643031784841
91202,GLENDALE,CA,8624,7566,-1058,0.46732550957381097
91203,GLENDALE,CA,10982,9044,-1938,0.45161290322580644
91204,GLENDALE,CA,8188,6804,-1384,0.45384204909284953
91205,GLENDALE,CA,13588,10161,-3427,0.4278495936671018
91206,GLENDALE,CA,11924,9802,-2122,0.45116450336002945
91207,GLENDALE,CA,2711,2545,-166,0.4842085235920852
91208,GLENDALE,CA,4415,4574,159,0.5088441428412505
91209,CHINO,CA,15,0,-15,0
91209,GLENDALE,CA,295,338,43,0.5339652448657188
91210,GLENDALE,CA,336,214,-122,0.3890909090909091
91214,GLENDALE,CA,308,415,107,0.573997233748271
91214,LA CRESCENTA,CA,7344,7811,467,0.5154074562850545
91221,GLENDALE,CA,72,298,226,0.8054054054054054
91222,GLENDALE,CA,12,185,173,0.9390862944162437
91224,LA CRESCENTA,CA,16,14,-2,0.4666666666666667
91225,GLENDALE,CA,0,11,11,1
91226,GLENDALE,CA,145,440,295,0.7521367521367521
91301,AGOURA,CA,139,190,51,0.5775075987841946
91301,AGOURA HILLS,CA,7532,8064,532,0.5170556552962298
91301,CALABASAS,CA,746,798,52,0.5168393782383419
91301,CALABASAS HILLS,CA,441,420,-21,0.4878048780487805
91302,CALABASAS,CA,10705,10721,16,0.50037337813871
91302,HIDDEN HILLS,CA,333,349,16,0.5117302052785924
91303,CANOGA PARK,CA,8421,6999,-1422,0.4538910505836576
91303,WOODLAND HILLS,CA,4120,3650,-470,0.4697554697554698
91304,CANOGA PARK,CA,11640,10328,-1312,0.47013838310269485
91304,WEST HILLS,CA,4733,4304,-429,0.4762642469846188
91306,CANOGA PARK,CA,476,513,37,0.5187057633973711
91306,WINNETKA,CA,12427,11084,-1343,0.47143890093998553
91307,BELL CANYON,CA,1565,1649,84,0.5130678282514001
91307,WEST HILLS,CA,5272,5937,665,0.5296636631278437
91308,WEST HILLS,CA,305,440,135,0.5906040268456376
91309,CANOGA PARK,CA,247,442,195,0.6415094339622641
91310,CASTAIC,CA,14,12,-2,0.46153846153846156
91311,CHATSWORTH,CA,13398,13457,59,0.5010984919009496
91313,CHATSWORTH,CA,457,772,315,0.628152969894223
91316,ENCINO,CA,13442,12235,-1207,0.4764964754449507
91319,NEWBURY PARK,CA,374,323,-51,0.4634146341463415
91320,NEWBURY,CA,274,231,-43,0.45742574257425744
91320,NEWBURY PARK,CA,11588,11675,87,0.501869922194042
91320,THOUSAND OAKS,CA,1423,1516,93,0.5158217080639673
91321,NEWHALL,CA,8985,8179,-806,0.4765206245630389
91321,SANTA CLARITA,CA,1048,960,-88,0.47808764940239046
91322,NEWHALL,CA,258,397,139,0.6061068702290077
91324,NORTHRIDGE,CA,11772,11218,-554,0.4879512831665942
91325,NORTHRIDGE,CA,10348,9650,-698,0.4825482548254825
91325,SHERWOOD FOREST,CA,2095,1653,-442,0.4410352187833511
91326,NORTHRIDGE,CA,1665,2118,453,0.5598731165741475
91326,PORTER RANCH,CA,7939,9423,1484,0.5427370118649925
91327,NORTHRIDGE,CA,0,120,120,1
91327,PORTER RANCH,CA,26,74,48,0.74
91328,NORTHRIDGE,CA,327,524,197,0.6157461809635723
91331,ARLETA,CA,8615,6825,-1790,0.4420336787564767
91331,PACOIMA,CA,8633,6786,-1847,0.44010636228030353
91333,PACOIMA,CA,154,595,441,0.794392523364486
91334,ARLETA,CA,0,24,24,1
91335,RESEDA,CA,20915,17433,-3482,0.4545999791384166
91335,TARZANA,CA,2718,2276,-442,0.4557468962755306
91337,RESEDA,CA,172,492,320,0.7409638554216867
91340,SAN FERNANDO,CA,6147,5092,-1055,0.45306521932556276
91341,SAN FERNANDO,CA,11,82,71,0.8817204301075269
91342,KAGEL CANYON,CA,379,335,-44,0.469187675070028
91342,LAKE VIEW TER,CA,433,448,15,0.5085130533484676
91342,RANCHO CASCADES,CA,336,301,-35,0.4725274725274725
91342,SYLMAR,CA,19140,17067,-2073,0.4713729389344602
91343,NORTH HILLS,CA,11218,9506,-1712,0.4586952325805829
91343,NORTHRIDGE,CA,2554,2237,-317,0.466917136297224
91343,SEPULVEDA,CA,336,288,-48,0.46153846153846156
91344,GRANADA HILLS,CA,12840,12750,-90,0.49824150058616645
91345,MISSION HILLS,CA,4072,3850,-222,0.4859883867710174
91346,MISSION HILLS,CA,0,49,49,1
91350,SANTA CLARITA,CA,9563,11513,1950,0.5462611501233631
91350,SAUGUS,CA,1157,1430,273,0.5527638190954773
91351,CANYON CNTRY,CA,1003,949,-54,0.48616803278688525
91351,CANYON COUNTRY,CA,8159,7894,-265,0.4917460910733196
91351,SANTA CLARITA,CA,201,179,-22,0.4710526315789474
91352,SUN VALLEY,CA,9931,8418,-1513,0.45877159518229876
91353,SUN VALLEY,CA,90,263,173,0.7450424929178471
91354,SANTA CLARITA,CA,581,581,0,0.5
91354,VALENCIA,CA,9297,9663,366,0.5096518987341773
91355,SANTA CLARITA,CA,1929,1759,-170,0.47695227765726683
91355,VALENCIA,CA,12500,11552,-948,0.4802926991518377
91356,TARZANA,CA,12128,11350,-778,0.48343129738478574
91357,TARZANA,CA,710,1080,370,0.6033519553072626
91358,THOUSAND OAKS,CA,76,162,86,0.680672268907563
91359,THOUSAND OAKS,CA,541,678,137,0.5561936013125512
91359,WESTLAKE VILLAGE,CA,495,695,200,0.5840336134453782
91359,WESTLAKE VLG,CA,27,32,5,0.5423728813559322
91360,THOUSAND OAKS,CA,13102,13102,0,0.5
91361,THOUSAND OAKS,CA,429,371,-58,0.46375
91361,WESTLAKE VILLAGE,CA,8146,8459,313,0.509424872026498
91361,WESTLAKE VLG,CA,440,437,-3,0.4982896237172178
91362,THOUSAND OAKS,CA,9848,10186,338,0.5084356593790557
91362,WESTLAKE VILLAGE,CA,3477,3623,146,0.5102816901408451
91364,WOODLAND HILLS,CA,12073,12384,311,0.5063580978860858
91364,WOODLAND HLS,CA,599,583,-16,0.49323181049069376
91365,WOODLAND HILLS,CA,842,1404,562,0.6251113089937667
91367,WOODLAND HILLS,CA,24498,23534,-964,0.48996502331778813
91367,WOODLAND HLS,CA,1839,1666,-173,0.475320970042796
91372,CALABASAS,CA,250,594,344,0.7037914691943128
91376,AGOURA,CA,34,58,24,0.6304347826086957
91376,AGOURA HILLS,CA,557,778,221,0.5827715355805243
91377,AGOURA HILLS,CA,85,108,23,0.5595854922279793
91377,OAK PARK,CA,4627,4745,118,0.5062953478446436
91380,SANTA CLARITA,CA,1044,1426,382,0.5773279352226721
91380,VALENCIA,CA,75,91,16,0.5481927710843374
91381,SANTA CLARITA,CA,105,114,9,0.5205479452054794
91381,STEVENSON RANCH,CA,3951,4573,622,0.5364852182074143
91381,VALENCIA,CA,2486,2675,189,0.518310404960279
91384,CASTAIC,CA,5276,5518,242,0.5112099314433944
91386,CANYON CNTRY,CA,29,55,26,0.6547619047619048
91386,CANYON COUNTRY,CA,593,746,153,0.5571321882001493
91386,SANTA CLARITA,CA,55,37,-18,0.40217391304347827
91387,CANYON CNTRY,CA,1566,1634,68,0.510625
91387,CANYON COUNTRY,CA,11013,11037,24,0.5005442176870748
91387,SANTA CLARITA,CA,3139,3204,65,0.5051237584739082
91390,AGUA DULCE,CA,844,873,29,0.5084449621432732
91390,GREEN VALLEY,CA,322,317,-5,0.49608763693270735
91390,SANTA CLARITA,CA,3619,3806,187,0.5125925925925926
91392,SYLMAR,CA,512,1053,541,0.6728434504792332
91393,NORTH HILLS,CA,44,64,20,0.5925925925925926
91394,GRANADA HILLS,CA,105,307,202,0.7451456310679612
91395,MISSION HILLS,CA,14,22,8,0.6111111111111112
91396,CANOGA PARK,CA,16,0,-16,0
91396,WINNETKA,CA,76,313,237,0.8046272493573264
91401,SHERMAN OAKS,CA,4548,3848,-700,0.45831348261076704
91401,VALLEY GLEN,CA,898,808,-90,0.47362250879249707
91401,VAN NUYS,CA,8433,7395,-1038,0.46721000758150116
91402,PANORAMA CITY,CA,15683,11696,-3987,0.42718872128273494
91403,SHERMAN OAKS,CA,15139,14389,-750,0.4873001896505012
91405,VALLEY GLEN,CA,336,309,-27,0.4790697674418605
91405,VAN NUYS,CA,16555,13097,-3458,0.4416902738432483
91406,LAKE BALBOA,CA,4587,3566,-1021,0.4373850116521526
91406,VAN NUYS,CA,13658,11143,-2515,0.44929639933873633
91408,VAN NUYS,CA,22,210,188,0.9051724137931034
91409,VAN NUYS,CA,638,1324,686,0.6748216106014271
91411,SHERMAN OAKS,CA,5947,5048,-899,0.45911778080945886
91411,VAN NUYS,CA,4110,3127,-983,0.43208511814287687
91412,PANORAMA CITY,CA,462,398,-64,0.4627906976744186
91413,SHERMAN OAKS,CA,1000,1437,437,0.5896594173163726
91416,ENCINO,CA,282,446,164,0.6126373626373627
91423,SHERMAN OAKS,CA,17290,15493,-1797,0.47259250221151206
91426,ENCINO,CA,134,361,227,0.7292929292929293
91436,ENCINO,CA,7777,7500,-277,0.4909340839169994
91501,BURBANK,CA,7850,6463,-1387,0.45154754419059595
91502,BURBANK,CA,6456,5318,-1138,0.45167317818923053
91503,BURBANK,CA,210,399,189,0.6551724137931034
91504,BURBANK,CA,9027,7850,-1177,0.4651300586597144
91505,BURBANK,CA,14339,12732,-1607,0.4703187913265118
91506,BURBANK,CA,6578,6918,340,0.5125963248369887
91510,BURBANK,CA,1044,1361,317,0.5659043659043659
91601,N HOLLYWOOD,CA,7834,6614,-1220,0.4577796234772979
91601,NORTH HOLLYWOOD,CA,18251,15183,-3068,0.4541185619429323
91602,N HOLLYWOOD,CA,1577,1348,-229,0.46085470085470087
91602,NORTH HOLLYWOOD,CA,7796,6760,-1036,0.464413300357241
91602,STUDIO CITY,CA,728,587,-141,0.4463878326996198
91602,TOLUCA LAKE,CA,2542,2240,-302,0.46842325386867417
91603,N HOLLYWOOD,CA,50,117,67,0.7005988023952096
91603,NORTH HOLLYWOOD,CA,356,576,220,0.6180257510729614
91604,NORTH HOLLYWOOD,CA,565,418,-147,0.4252288911495422
91604,STUDIO CITY,CA,17634,16032,-1602,0.47620744965246836
91605,N HOLLYWOOD,CA,1584,1274,-310,0.4457662701189643
91605,NORTH HOLLYWOOD,CA,13140,10079,-3061,0.43408415521770966
91606,N HOLLYWOOD,CA,2506,1800,-706,0.41802136553646074
91606,NORTH HOLLYWOOD,CA,11643,8999,-2644,0.43595581823466717
91607,N HOLLYWOOD,CA,1287,1148,-139,0.47145790554414785
91607,NORTH HOLLYWOOD,CA,1435,1258,-177,0.4671370219086521
91607,SHERMAN VILLAGE,CA,304,269,-35,0.4694589877835951
91607,VALLEY VILLAGE,CA,11948,10225,-1723,0.46114643936318944
91607,VALLEY VLG,CA,518,416,-102,0.44539614561027835
91609,N HOLLYWOOD,CA,0,13,13,1
91609,NORTH HOLLYWOOD,CA,0,47,47,1
91610,TOLUCA LAKE,CA,289,119,-170,0.2916666666666667
91614,STUDIO CITY,CA,277,332,55,0.5451559934318555
91615,N HOLLYWOOD,CA,35,53,18,0.6022727272727273
91615,NORTH HOLLYWOOD,CA,133,177,44,0.5709677419354838
91616,NORTH HOLLYWOOD,CA,0,11,11,1
91617,VALLEY VILLAGE,CA,47,69,22,0.5948275862068966
91701,ALTA LOMA,CA,1940,1914,-26,0.49662688116242865
91701,CHINO HILLS,CA,168,169,1,0.5014836795252225
91701,RANCHO CUCAMONGA,CA,8272,8825,553,0.5161724279113294
91702,AZUSA,CA,14874,13490,-1384,0.4756028768861938
91706,BALDWIN PARK,CA,14387,12417,-1970,0.4632517534696314
91708,CHINO,CA,6442,9316,2874,0.5911917756060414
91709,CHINO HILLS,CA,26509,24919,-1590,0.48454149490549897
91710,CHINO,CA,19969,19220,-749,0.49044374696981297
91711,CLAREMONT,CA,10775,11510,735,0.5164909131702939
91715,CITY INDUSTRY,CA,12,49,37,0.8032786885245902
91715,CITY OF INDUSTRY,CA,78,362,284,0.8227272727272728
91722,COVINA,CA,8866,8579,-287,0.491774147320149
91723,COVINA,CA,6303,5953,-350,0.4857212793733681
91724,COVINA,CA,6200,6323,123,0.5049109638265591
91724,RC,CA,161,157,-4,0.4937106918238994
91729,RANCHO CUCAMONGA,CA,2752,2704,-48,0.49560117302052786
91730,RANCHO CUCAMONGA,CA,31822,28767,-3055,0.4747891531466108
91731,EL MONTE,CA,6490,5121,-1369,0.4410472827491172
91732,EL MONTE,CA,11579,9536,-2043,0.45162206961875445
91732,MIRA LOMA,CA,590,509,-81,0.46314831665150136
91733,EL MONTE,CA,4626,3894,-732,0.45704225352112676
91733,S EL MONTE,CA,120,111,-9,0.4805194805194805
91733,SOUTH EL MONTE,CA,3034,2654,-380,0.46659634317862164
91734,EL MONTE,CA,548,1193,645,0.6852383687535899
91737,ALTA LOMA,CA,1788,1692,-96,0.4862068965517241
91737,RANCHO CUCAMONGA,CA,5632,5580,-52,0.4976810560114163
91739,ETIWANDA,CA,509,443,-66,0.4653361344537815
91739,RANCHO CUCAMONGA,CA,11503,11795,292,0.5062666323289553
91739,RCH CUCAMONGA,CA,241,297,56,0.5520446096654275
91740,GLENDORA,CA,8144,7869,-275,0.491413226753263
91741,GLENDORA,CA,6631,6964,333,0.512247149687385
91743,GUASTI,CA,501,96,-405,0.16080402010050251
91744,LA PUENTE,CA,14589,12319,-2270,0.45781923591496954
91745,CITY INDUSTRY,CA,530,507,-23,0.4889103182256509
91745,HACIENDA HEIGHTS,CA,11777,11434,-343,0.4926112619016845
91745,HACIENDA HTS,CA,532,534,2,0.50093808630394
91746,CITY OF INDUSTRY,CA,403,386,-17,0.4892268694550063
91746,LA PUENTE,CA,4940,4439,-501,0.4732913956711803
91747,LA PUENTE,CA,550,1207,657,0.6869664200341491
91748,CITY INDUSTRY,CA,235,289,54,0.5515267175572519
91748,CITY OF INDUSTRY,CA,2536,2271,-265,0.47243603078843355
91748,ROWLAND HEIGHTS,CA,11512,10511,-1001,0.4772737592516914
91750,LA VERNE,CA,9605,10187,582,0.5147029102667745
91752,EASTVALE,CA,2246,2266,20,0.5022163120567376
91752,JURUPA VALLEY,CA,9059,8888,-171,0.49523597258594754
91752,MIRA LOMA,CA,638,644,6,0.5023400936037441
91754,MONTEREY PARK,CA,10187,9398,-789,0.4798570334439622
91755,MONTEREY PARK,CA,8379,6814,-1565,0.44849601790298166
91759,MT BALDY,CA,0,11,11,1
91761,ONTARIO,CA,17671,19305,1634,0.5220954132410212
91762,ONTARIO,CA,17411,18006,595,0.5083999209419205
91763,MONTCLAIR,CA,9908,8856,-1052,0.4719675975271797
91764,ONTARIO,CA,18008,15258,-2750,0.4586665063428125
91765,DIAMOND BAR,CA,13808,14409,601,0.510649608392104
91765,POMONA,CA,302,358,56,0.5424242424242425
91766,PHILLIPS RANCH,CA,274,286,12,0.5107142857142857
91766,POMONA,CA,15072,13502,-1570,0.4725274725274725
91767,POMONA,CA,13796,11317,-2479,0.4506430932186517
91768,POMONA,CA,7329,6348,-981,0.4641368721210792
91769,POMONA,CA,881,1710,829,0.6599768429177924
91770,ROSEMEAD,CA,13923,11526,-2397,0.4529058116232465
91773,SAN DIMAS,CA,10146,10718,572,0.5137078220858896
91775,SAN GABRIEL,CA,5923,5576,-347,0.4849117314549091
91776,SAN GABRIEL,CA,12720,10269,-2451,0.4466918961242333
91778,SAN GABRIEL,CA,341,534,193,0.6102857142857143
91780,TEMPLE CITY,CA,9619,9241,-378,0.4899787910922587
91784,UPLAND,CA,6351,7552,1201,0.5431921168093218
91785,UPLAND,CA,839,1426,587,0.6295805739514349
91786,UPLAND,CA,20827,18372,-2455,0.4686854256486135
91788,WALNUT,CA,487,1193,706,0.7101190476190476
91789,DIAMOND BAR,CA,201,284,83,0.5855670103092784
91789,WALNUT,CA,10066,14087,4021,0.58324017720366
91790,W COVINA,CA,239,193,-46,0.44675925925925924
91790,WEST COVINA,CA,10932,10041,-891,0.47875840366185096
91791,WEST COVINA,CA,9404,8949,-455,0.4876042063967744
91792,WEST COVINA,CA,8137,6835,-1302,0.4565188351589634
91793,WEST COVINA,CA,606,299,-307,0.33038674033149174
91801,ALHAMBRA,CA,19602,15987,-3615,0.4492118351175925
91802,ALHAMBRA,CA,678,989,311,0.5932813437312537
91803,ALHAMBRA,CA,8317,7643,-674,0.47888471177944864
91901,ALPINE,CA,7858,6556,-1302,0.454835576522825
91902,BONITA,CA,5364,5583,219,0.510002740476843
91903,ALPINE,CA,853,625,-228,0.42286874154262516
91905,BOULEVARD,CA,618,619,1,0.5004042037186742
91906,CAMPO,CA,1302,1251,-51,0.4900117508813161
91908,BONITA,CA,243,513,270,0.6785714285714286
91909,CHULA VISTA,CA,152,665,513,0.813953488372093
91910,CHULA VISTA,CA,30629,27051,-3578,0.46898404993065185
91911,CHULA VISTA,CA,28996,23859,-5137,0.4514047866805411
91912,CHULA VISTA,CA,1702,2451,749,0.5901757765470744
91913,CHULA VISTA,CA,19762,21170,1408,0.5171992573047982
91914,CHULA VISTA,CA,4184,4223,39,0.50231949565838
91915,CHULA VISTA,CA,11065,12599,1534,0.5324121027721433
91916,DESCANSO,CA,986,794,-192,0.4460674157303371
91917,DULZURA,CA,165,103,-62,0.3843283582089552
91921,CHULA VISTA,CA,988,1198,210,0.5480329368709973
91921,SV,CA,21,36,15,0.631578947368421
91931,GUATAY,CA,36,0,-36,0
91932,IMPERIAL BCH,CA,1344,1035,-309,0.43505674653215637
91932,IMPERIAL BEACH,CA,12834,10173,-2661,0.4421697744164819
91933,IMPERIAL BCH,CA,38,66,28,0.6346153846153846
91933,IMPERIAL BEACH,CA,418,749,331,0.6418166238217652
91934,JACUMBA,CA,0,60,60,1
91935,JAMUL,CA,2827,3042,215,0.518316578633498
91941,LA MESA,CA,13250,12708,-542,0.4895600585561291
91942,LA MESA,CA,22127,20978,-1149,0.486672079805127
91943,LA MESA,CA,29,164,135,0.8497409326424871
91944,LA MESA,CA,465,693,228,0.5984455958549223
91945,LEMON GROVE,CA,11312,9730,-1582,0.4624085163007319
91946,LEMON GROVE,CA,198,633,435,0.7617328519855595
91950,NATIONAL CITY,CA,20868,16094,-4774,0.4354201612466858
91951,NATIONAL CITY,CA,932,1624,692,0.6353677621283255
91962,PINE VALLEY,CA,577,447,-130,0.4365234375
91963,POTRERO,CA,114,74,-40,0.39361702127659576
91976,SPRING VALLEY,CA,14,14,0,0.5
91977,SPRING VALLEY,CA,21021,18597,-2424,0.46940784491897625
91977,SV,CA,519,435,-84,0.4559748427672956
91978,SPRING VALLEY,CA,3696,3643,-53,0.49638915383567245
91979,SPRING VALLEY,CA,415,724,309,0.6356453028972783
91980,TECATE,CA,196,545,349,0.7354925775978407
92003,BONSALL,CA,2210,2609,399,0.5413986304212492
92004,BORREGO SPGS,CA,95,73,-22,0.43452380952380953
92004,BORREGO SPRINGS,CA,3001,2688,-313,0.47249077166461595
92007,CARDIFF,CA,585,610,25,0.5104602510460251
92007,CARDIFF BY THE SEA,CA,4824,4694,-130,0.4931708342088674
92007,CARDIFF BY THE SEA NEW,CA,159,189,30,0.5431034482758621
92008,CARLSBAD,CA,16795,16259,-536,0.49189205542445696
92009,CARLSBAD,CA,15031,16201,1170,0.5187307889344263
92010,CARLSBAD,CA,7812,8339,527,0.5163147792706334
92011,CARLSBAD,CA,9835,10934,1099,0.5264577013818672
92013,CARLSBAD,CA,705,970,265,0.5791044776119403
92014,DEL MAR,CA,6823,7434,611,0.5214280704215473
92018,CARLSBAD,CA,1196,1293,97,0.519485737243873
92019,EL CAJON,CA,15976,15473,-503,0.49200292537123597
92020,EL CAJON,CA,27332,23648,-3684,0.4638681836014123
92021,EL CAJON,CA,29344,26684,-2660,0.47626186906546725
92022,EL CAJON,CA,643,858,215,0.5716189207195204
92023,ENCINITAS,CA,1229,1522,293,0.5532533624136677
92023,ESTACADA,CA,18,39,21,0.6842105263157895
92024,ENCINITAS,CA,21156,21610,454,0.5053079549174578
92025,ESCONDIDO,CA,18132,16626,-1506,0.4783359226652857
92026,ESCONDIDO,CA,18296,18634,338,0.5045762252910913
92027,ESCONDIDO,CA,19213,15928,-3285,0.45325972510742435
92028,FALLBROOK,CA,16358,17756,1398,0.5204901213578003
92029,ESCONDIDO,CA,8019,8349,330,0.5100806451612904
92030,ESCONDIDO,CA,419,739,320,0.6381692573402418
92033,ESCONDIDO,CA,577,922,345,0.6150767178118746
92036,JULIAN,CA,1455,1493,38,0.5064450474898237
92037,LA JOLLA,CA,21239,21253,14,0.5001647368916502
92038,LA JOLLA,CA,914,1082,168,0.5420841683366734
92039,LA JOLLA,CA,346,155,-191,0.3093812375249501
92040,LAKESIDE,CA,16651,16388,-263,0.49601985532249765
92046,ESCONDIDO,CA,690,883,193,0.561347743165925
92049,OCEANSIDE,CA,474,610,136,0.5627306273062731
92051,CAMP PENDLETON,CA,18,32,14,0.64
92051,OCEANSIDE,CA,664,1008,344,0.6028708133971292
92052,OCEANSIDE,CA,1069,1396,327,0.5663286004056796
92054,OCEANSIDE,CA,19615,18670,-945,0.4876583518349223
92055,CAMP PENDLETON,CA,1689,2404,715,0.5873442462741265
92056,OCEANSIDE,CA,24550,22554,-1996,0.478812839673913
92057,OCEANSIDE,CA,21988,20114,-1874,0.47774452520070304
92058,OCEANSIDE,CA,22479,18586,-3893,0.4525995373188847
92059,PALA,CA,49,65,16,0.5701754385964912
92061,PAUMA VALLEY,CA,891,811,-80,0.4764982373678026
92064,POWAY,CA,14304,15142,838,0.5142294369354072
92065,RAMONA,CA,13381,13915,534,0.509781652989449
92067,RANCHO SANTA FE,CA,2537,4304,1767,0.6291477854114895
92067,RCHO SANTA FE,CA,198,455,257,0.6967840735068913
92068,OCEANSIDE,CA,14,0,-14,0
92068,SAN LUIS REY,CA,143,305,162,0.6808035714285714
92069,SAN MARCOS,CA,17555,16385,-1170,0.48276370064820273
92070,SANTA YSABEL,CA,444,335,-109,0.4300385109114249
92071,SANTEE,CA,21157,20780,-377,0.49550516250566323
92072,SANTEE,CA,1123,1211,88,0.5188517566409597
92074,POWAY,CA,796,634,-162,0.4433566433566434
92075,SOLANA BEACH,CA,7721,7890,169,0.5054128499135225
92078,SAN MARCOS,CA,18383,18925,542,0.5072638576176691
92079,SAN MARCOS,CA,1077,1333,256,0.5531120331950208
92081,VISTA,CA,14581,14205,-376,0.4934690474536233
92082,VALLEY CENTER,CA,5671,6955,1284,0.5508474576271186
92083,VISTA,CA,14882,13284,-1598,0.4716324646737201
92084,VISTA,CA,16151,15259,-892,0.4858007004138809
92085,VISTA,CA,1135,1559,424,0.5786933927245731
92086,WARNER SPGS,CA,15,18,3,0.5454545454545454
92086,WARNER SPRINGS,CA,544,668,124,0.5511551155115512
92088,FALLBROOK,CA,741,1018,277,0.5787379192723138
92091,RANCHO SANTA FE,CA,923,947,24,0.5064171122994653
92092,LA JOLLA,CA,146,428,282,0.7456445993031359
92101,SAN DIEGO,CA,49020,46573,-2447,0.48720094567593863
92102,SAN DIEGO,CA,18761,15298,-3463,0.44916174873014475
92103,SAN DIEGO,CA,27092,25260,-1832,0.48250305623471884
92104,SAN DIEGO,CA,32641,27216,-5425,0.45468366272950533
92105,SAN DIEGO,CA,25651,20043,-5608,0.4386352694007966
92106,SAN DIEGO,CA,8815,9022,207,0.5058025452710657
92106,SD,CA,217,260,43,0.5450733752620545
92107,SAN DIEGO,CA,18002,15173,-2829,0.45736247174076866
92108,SAN DIEGO,CA,27458,25355,-2103,0.4800901293242194
92109,SAN DIEGO,CA,37765,30907,-6858,0.4500669850885368
92110,SAN DIEGO,CA,17633,15768,-1865,0.4720816742013712
92111,SAN DIEGO,CA,20182,17270,-2912,0.46112357150485955
92112,SAN DIEGO,CA,1277,1423,146,0.5270370370370371
92113,SAN DIEGO,CA,14877,11408,-3469,0.43401179379874455
92114,SAN DIEGO,CA,18503,16386,-2117,0.4696609246467368
92115,SAN DIEGO,CA,32583,25136,-7447,0.43548918033922973
92116,SAN DIEGO,CA,23349,19267,-4082,0.4521071897878731
92117,SAN DIEGO,CA,23397,21612,-1785,0.4801706325401586
92118,CORONADO,CA,9990,11334,1344,0.5315137872819359
92119,SAN DIEGO,CA,8655,8647,-8,0.4997688128540053
92120,SAN DIEGO,CA,14456,13643,-813,0.4855332929997509
92121,SAN DIEGO,CA,6494,5120,-1374,0.4408472533149647
92122,SAN DIEGO,CA,34824,28029,-6795,0.4459453009402892
92123,SAN DIEGO,CA,21471,19313,-2158,0.47354354648881913
92124,SAN DIEGO,CA,16509,14999,-1510,0.4760378316618002
92126,SAN DIEGO,CA,35638,30442,-5196,0.46068401937046005
92127,SAN DIEGO,CA,16420,16736,316,0.5047653516708891
92128,SAN DIEGO,CA,22064,22177,113,0.501277095906512
92129,SAN DIEGO,CA,15954,16921,967,0.5147072243346008
92130,SAN DIEGO,CA,25975,27884,1909,0.5177222005607234
92131,SAN DIEGO,CA,11055,12857,1802,0.5376798260287722
92137,SAN DIEGO,CA,253,577,324,0.6951807228915663
92138,SAN DIEGO,CA,984,865,-119,0.46782044348296375
92139,SAN DIEGO,CA,11437,9776,-1661,0.460849479093009
92140,SAN DIEGO,CA,13,0,-13,0
92142,SAN DIEGO,CA,304,191,-113,0.38585858585858585
92143,SAN DIEGO,CA,82,208,126,0.7172413793103448
92143,SAN YSIDRO,CA,705,1490,785,0.6788154897494305
92145,SAN DIEGO,CA,240,89,-151,0.270516717325228
92149,SAN DIEGO,CA,125,238,113,0.6556473829201102
92150,SAN DIEGO,CA,1522,1210,-312,0.4428989751098097
92153,SAN DIEGO,CA,657,1220,563,0.6499733617474693
92154,SAN DIEGO,CA,26554,26628,74,0.5006957241171826
92159,SAN DIEGO,CA,87,212,125,0.7090301003344481
92160,SAN DIEGO,CA,290,477,187,0.621903520208605
92163,SAN DIEGO,CA,1197,1388,191,0.5369439071566731
92165,SAN DIEGO,CA,367,834,467,0.694421315570358
92166,SAN DIEGO,CA,514,540,26,0.5123339658444023
92167,SAN DIEGO,CA,354,525,171,0.5972696245733788
92168,SAN DIEGO,CA,433,559,126,0.563508064516129
92169,SAN DIEGO,CA,1040,1339,299,0.5628415300546448
92170,SAN DIEGO,CA,640,778,138,0.5486600846262342
92171,SAN DIEGO,CA,380,644,264,0.62890625
92172,SAN DIEGO,CA,190,296,106,0.6090534979423868
92173,SAN YSIDRO,CA,8449,11610,3161,0.5787925619422704
92174,SAN DIEGO,CA,642,1301,659,0.669583118888317
92175,SAN DIEGO,CA,230,420,190,0.6461538461538462
92176,SAN DIEGO,CA,1124,584,-540,0.34192037470725994
92177,CLAREMONT,CA,16,17,1,0.5151515151515151
92177,SAN DIEGO,CA,672,647,-25,0.49052312357846856
92178,CORONADO,CA,1251,1254,3,0.5005988023952096
92178,SAN DIEGO,CA,31,18,-13,0.3673469387755102
92191,SAN DIEGO,CA,297,270,-27,0.47619047619047616
92192,SAN DIEGO,CA,851,868,17,0.5049447353112274
92193,SAN DIEGO,CA,560,803,243,0.5891415994130594
92195,SAN DIEGO,CA,384,891,507,0.6988235294117647
92196,SAN DIEGO,CA,733,923,190,0.5573671497584541
92198,SAN DIEGO,CA,725,851,126,0.5399746192893401
92201,CHIRIACO SUMMIT,CA,465,466,1,0.5005370569280344
92201,INDIO,CA,17883,19113,1230,0.5166234187479728
92202,INDIO,CA,906,1754,848,0.6593984962406015
92203,BERMUDA DUNES,CA,2824,3853,1029,0.5770555638759922
92203,INDIO,CA,10028,10904,876,0.5209248996751386
92210,INDIAN WELLS,CA,4840,5802,962,0.5451982710016914
92211,PALM DESERT,CA,20401,24564,4163,0.5462915601023018
92220,BANNING,CA,10598,11792,1194,0.5266636891469406
92222,BARD,CA,12,0,-12,0
92223,BEAUMONT,CA,14410,17294,2884,0.5454832197829926
92223,CHERRY VALLEY,CA,2058,2468,410,0.5452938577110031
92223,FT CAMPBELL,KS,356,369,13,0.5089655172413793
92225,BLYTHE,CA,4644,3878,-766,0.4550574982398498
92225,RIPLEY,CA,782,691,-91,0.46911065852002715
92226,BLYTHE,CA,1497,830,-667,0.35668242372152986
92227,BRAWLEY,CA,7244,6942,-302,0.489355702805583
92230,CABAZON,CA,1069,974,-95,0.4767498776309349
92231,CALEXICO,CA,9658,8038,-1620,0.4542269439421338
92232,CALEXICO,CA,385,3274,2889,0.8947799945340257
92233,CALIPATRIA,CA,509,407,-102,0.4443231441048035
92234,CATHEDRAL CITY,CA,16513,20109,3596,0.549096171700071
92234,CATHEDRAL CTY,CA,412,380,-32,0.4797979797979798
92234,PALM SPRINGS,CA,262,553,291,0.6785276073619632
92235,CATHEDRAL CITY,CA,852,1225,373,0.5897929706307173
92236,COACHELLA,CA,5895,5668,-227,0.49018420825045406
92239,DESERT CENTER,CA,200,172,-28,0.46236559139784944
92240,DESERT HOT SPRINGS,CA,15280,15282,2,0.5000327203717034
92240,DSRT HOT SPGS,CA,330,335,5,0.5037593984962406
92241,DESERT HOT SPRINGS,CA,4283,5944,1661,0.5812066099540433
92241,DSRT HOT SPGS,CA,69,127,58,0.6479591836734694
92242,BIG RIVER,CA,239,454,215,0.6551226551226551
92242,EARP,CA,808,841,33,0.5100060642813826
92243,EL CENTRO,CA,14935,12398,-2537,0.4535908974499689
92244,EL CENTRO,CA,999,1609,610,0.6169478527607362
92247,LA QUINTA,CA,793,850,57,0.5173463177115033
92248,LA QUINTA,CA,1000,1541,541,0.6064541519086973
92249,HEBER,CA,1130,976,-154,0.4634377967711301
92250,HOLTVILLE,CA,1836,1562,-274,0.45968216597998823
92251,IMPERIAL,CA,5592,6086,494,0.5211508820003425
92252,JOSHUA TREE,CA,4998,4143,-855,0.4532326878897276
92253,LA QUINTA,CA,21839,24642,2803,0.5301521051612487
92254,MECCA,CA,696,895,199,0.562539283469516
92255,PALM DESERT,CA,1063,1896,833,0.6407570125042245
92256,MORONGO VALLEY,CA,1694,1537,-157,0.47570411637264004
92256,MORONGO VLY,CA,150,145,-5,0.4915254237288136
92257,NILAND,CA,545,1387,842,0.7179089026915114
92258,N PALM SPGS,CA,0,20,20,1
92258,N PALM SPRINGS,CA,0,34,34,1
92258,NO PALM SPRINGS,CA,33,0,-33,0
92258,NORTH PALM SPRINGS,CA,102,396,294,0.7951807228915663
92259,OCOTILLO,CA,16,0,-16,0
92260,PALM DESERT,CA,22608,24613,2005,0.5212299612460558
92261,PALM DESERT,CA,843,965,122,0.5337389380530974
92262,PALM SPRINGS,CA,19629,21382,1753,0.5213723147448246
92263,PALM SPRINGS,CA,2433,3228,795,0.570217276099629
92264,PALM SPRINGS,CA,17385,20443,3058,0.5404197948609496
92267,PARKER DAM,CA,509,886,377,0.6351254480286739
92268,PIONEERTOWN,CA,79,145,66,0.6473214285714286
92270,RANCHO MIRAGE,CA,15665,19245,3580,0.5512747063878545
92273,SEELEY,CA,96,115,19,0.5450236966824644
92274,SALTON CITY,CA,23,51,28,0.6891891891891891
92274,THERMAL,CA,2294,2353,59,0.5063481816225521
92275,SALTON CITY,CA,29,280,251,0.9061488673139159
92276,THOUSAND PALMS,CA,3585,3876,291,0.5195014073180538
92277,29 PALMS,CA,1835,1447,-388,0.4408897014015844
92277,TWENTYNINE PALMS,CA,13460,11012,-2448,0.44998365478914676
92278,29 PALMS,CA,26,0,-26,0
92278,TWENTYNINE PALMS,CA,121,0,-121,0
92281,WESTMORLAND,CA,108,184,76,0.6301369863013698
92282,WHITEWATER,CA,274,348,74,0.5594855305466238
92283,FELICITY,CA,18,90,72,0.8333333333333334
92283,WINTERHAVEN,CA,908,1825,917,0.667764361507501
92284,YUCCA VALLEY,CA,11439,10949,-490,0.4890566374843666
92285,JOHNSON VALLEY,CA,85,99,14,0.5380434782608695
92285,LANDERS,CA,1102,1012,-90,0.47871333964049195
92286,YUCCA VALLEY,CA,963,1225,262,0.5598720292504571
92301,ADELANTO,CA,12516,11845,-671,0.48622798735684086
92305,ANGELUS OAKS,CA,51,65,14,0.5603448275862069
92307,APPLE VALLEY,CA,14512,15462,950,0.515847067458464
92308,APPLE VALLEY,CA,12863,14111,1248,0.5231333877066805
92310,FORT IRWIN,CA,5598,4144,-1454,0.4253746663929378
92311,BARSTOW,CA,14123,12499,-1624,0.46949891067538124
92311,PHELAN,CA,324,216,-108,0.4
92312,BARSTOW,CA,857,1597,740,0.6507742461287693
92313,GRAND TERRACE,CA,4104,4128,24,0.5014577259475219
92314,BIG BEAR CITY,CA,4044,3099,-945,0.4338513229735405
92315,BIG BEAR LAKE,CA,3297,2945,-352,0.47180390900352454
92316,BLOOMINGTON,CA,5966,5766,-200,0.4914763041254688
92317,BLUE JAY,CA,1367,1121,-246,0.45056270096463025
92320,CALIMESA,CA,3417,4964,1547,0.592292089249493
92321,CEDAR GLEN,CA,362,209,-153,0.3660245183887916
92321,PHELAN,CA,22,14,-8,0.3888888888888889
92322,CEDARPINES PARK,CA,35,23,-12,0.39655172413793105
92322,CEDARPINES PK,CA,0,12,12,1
92324,COLTON,CA,17911,16407,-1504,0.47808730112477416
92325,CRESTLINE,CA,4741,3367,-1374,0.41526887025160336
92327,DAGGETT,CA,32,34,2,0.5151515151515151
92328,DEATH VALLEY,CA,513,134,-379,0.2071097372488408
92329,PHELAN,CA,1585,1726,141,0.5212926608275446
92331,FONTANA,CA,437,928,491,0.6798534798534799
92333,FAWNSKIN,CA,200,67,-133,0.250936329588015
92334,FONTANA,CA,1204,2231,1027,0.649490538573508
92335,FONTANA,CA,22060,18647,-3413,0.45807846316358364
92336,FONTANA,CA,22087,25623,3536,0.5370572207084469
92337,FONTANA,CA,8276,7151,-1125,0.4635379529396513
92339,FOREST FALLS,CA,416,239,-177,0.3648854961832061
92340,HESPERIA,CA,1191,1865,674,0.6102748691099477
92341,GREEN VALLEY LAKE,CA,25,11,-14,0.3055555555555556
92342,HELENDALE,CA,2051,2527,476,0.5519877675840978
92344,HESPERIA,CA,3254,3700,446,0.5320678746045442
92344,OAK HILLS,CA,2738,3269,531,0.5441984351589811
92344,PALM DESERT,CA,176,236,60,0.5728155339805825
92345,HESPERIA,CA,25453,25657,204,0.5019956955585991
92346,HIGHLAND,CA,15528,15385,-143,0.49768705722511564
92347,HINKLEY,CA,23,61,38,0.7261904761904762
92352,LAKE ARROWHEAD,CA,1761,1682,-79,0.48852744699390066
92352,LK ARROWHEAD,CA,20,24,4,0.5454545454545454
92354,LOMA LINDA,CA,10568,9564,-1004,0.4750645738128353
92356,LUCERNE VALLEY,CA,2401,2574,173,0.5173869346733668
92356,LUCERNE VLY,CA,39,46,7,0.5411764705882353
92358,LYTLE CREEK,CA,86,55,-31,0.3900709219858156
92359,MENTONE,CA,2714,2732,18,0.501652589056188
92363,NEEDLES,CA,3435,3099,-336,0.47428833792470154
92365,NEWBERRY SPGS,CA,45,74,29,0.6218487394957983
92365,NEWBERRY SPRINGS,CA,745,736,-9,0.49696151249155973
92368,ORO GRANDE,CA,157,252,95,0.6161369193154034
92369,PATTON,CA,25,137,112,0.845679012345679
92371,PHELAN,CA,4054,3371,-683,0.454006734006734
92372,PINON HILLS,CA,1356,1777,421,0.5671879987232684
92373,REDLANDS,CA,15198,14111,-1087,0.4814562079907196
92374,REDLANDS,CA,13746,13647,-99,0.49819296900668053
92375,REDLANDS,CA,1168,1182,14,0.5029787234042553
92376,RIALTO,CA,20863,17998,-2865,0.46313785028692006
92377,PHELAN,CA,106,143,37,0.5742971887550201
92377,RIALTO,CA,5288,6753,1465,0.5608338177892201
92378,RIMFOREST,CA,91,0,-91,0
92382,ARROWBEAR LAKE,CA,56,40,-16,0.4166666666666667
92382,RUNNING SPGS,CA,575,497,-78,0.46361940298507465
92382,RUNNING SPRINGS,CA,1373,1301,-72,0.48653702318623787
92385,SKYFOREST,CA,35,47,12,0.573170731707317
92386,BIG BEAR CITY,CA,29,21,-8,0.42
92386,SUGARLOAF,CA,995,842,-153,0.4583560152422428
92389,TECOPA,CA,11,0,-11,0
92391,TWIN PEAKS,CA,688,686,-2,0.4992721979621543
92392,VICTORVILLE,CA,20177,21151,974,0.5117837785520712
92393,VICTORVILLE,CA,2139,3725,1586,0.6352319236016372
92394,VICTORVILLE,CA,11084,11273,189,0.504226864069419
92395,VICTORVILLE,CA,17449,17027,-422,0.4938798004408864
92397,WRIGHTWOOD,CA,1806,1759,-47,0.4934081346423562
92398,YERMO,CA,654,410,-244,0.38533834586466165
92399,YUCAIPA,CA,16836,17141,305,0.5044883303411131
92401,SAN BERNARDINO,CA,1037,881,-156,0.45933263816475495
92401,SN BERNRDNO,CA,21,13,-8,0.38235294117647056
92402,SAN BERNARDINO,CA,950,2443,1493,0.7200117889773062
92402,SN BERNRDNO,CA,31,60,29,0.6593406593406593
92404,SAN BERNARDINO,CA,21792,17324,-4468,0.44288782084057676
92405,SAN BERNARDINO,CA,9935,8282,-1653,0.45463029038809905
92405,SN BERNRDNO,CA,262,194,-68,0.42543859649122806
92406,SAN BERNARDINO,CA,269,1007,738,0.7891849529780565
92406,SN BERNRDNO,CA,15,22,7,0.5945945945945946
92407,SAN BERNARDINO,CA,19709,18487,-1222,0.4840035605822599
92408,SAN BERNARDINO,CA,4547,3806,-741,0.4556446785586017
92410,SAN BERNARDINO,CA,13543,11102,-2441,0.4504767701359302
92410,SN BERNRDNO,CA,317,222,-95,0.41187384044526903
92411,SAN BERNARDINO,CA,6894,6144,-750,0.4712379199263691
92411,SN BERNRDNO,CA,154,121,-33,0.44
92413,SAN BERNARDINO,CA,392,1094,702,0.7362045760430687
92415,SAN BERNARDINO,CA,0,44,44,1
92423,SAN BERNARDINO,CA,529,983,454,0.6501322751322751
92427,SAN BERNARDINO,CA,598,1093,495,0.6463630987581312
92501,RIVERSIDE,CA,8568,7232,-1336,0.45772151898734176
92502,RIVERSIDE,CA,702,1771,1069,0.7161342498989082
92503,RIVERSIDE,CA,23629,23235,-394,0.49579634687606694
92504,RIVERSIDE,CA,15169,15079,-90,0.49851229833377414
92505,RIVERSIDE,CA,16294,14310,-1984,0.46758593647889163
92506,RIVERSIDE,CA,13176,13273,97,0.5018337177208968
92507,RIVERSIDE,CA,26423,23488,-2935,0.4705976638416381
92508,RIVERSIDE,CA,9611,9830,219,0.5056324263155187
92509,JURUPA VALLEY,CA,17261,15711,-1550,0.47649520805531964
92509,RIVERSIDE,CA,407,402,-5,0.4969097651421508
92513,RIVERSIDE,CA,836,1541,705,0.6482961716449306
92514,RIVERSIDE,CA,104,334,230,0.7625570776255708
92516,RIVERSIDE,CA,338,665,327,0.6630109670987039
92517,RIVERSIDE,CA,1059,1880,821,0.6396733582851309
92518,MARCH AIR RESERVE BASE,CA,227,306,79,0.574108818011257
92518,MARCH ARB,CA,171,181,10,0.5142045454545454
92518,RIVERSIDE,CA,367,492,125,0.5727590221187427
92519,RIVERSIDE,CA,248,783,535,0.7594568380213385
92530,LAKE ELSINORE,CA,18300,19034,734,0.5098301816038999
92531,LAKE ELSINORE,CA,772,1238,466,0.6159203980099502
92532,LAKE ELSINORE,CA,8610,8997,387,0.5109899471800988
92536,AGUANGA,CA,1788,1723,-65,0.49074337795499856
92539,ANZA,CA,1666,1508,-158,0.4751102709514808
92543,HEMET,CA,15039,15367,328,0.5053936723015194
92544,HEMET,CA,15766,16042,276,0.5043385311871227
92545,HEMET,CA,16449,17185,736,0.5109413093893085
92546,HEMET,CA,1124,1819,695,0.618076792388719
92548,HOMELAND,CA,2114,2202,88,0.510194624652456
92549,IDYLLWILD,CA,2198,1898,-300,0.46337890625
92551,MORENO VALLEY,CA,8387,7913,-474,0.4854601226993865
92552,MORENO VALLEY,CA,1648,3045,1397,0.6488386959301087
92553,MORENO VALLEY,CA,22513,19286,-3227,0.461398598052585
92554,MORENO VALLEY,CA,11,23,12,0.6764705882352942
92555,MORENO VALLEY,CA,11859,11667,-192,0.49591940831420556
92556,MORENO VALLEY,CA,437,812,375,0.6501200960768615
92557,MORENO VALLEY,CA,16577,15399,-1178,0.48157993495121343
92561,MOUNTAIN CENTER,CA,527,722,195,0.578062449959968
92561,MOUNTAIN CTR,CA,29,26,-3,0.4727272727272727
92562,MURRIETA,CA,24988,26033,1045,0.510240881205778
92563,MURRIETA,CA,24883,27025,2142,0.5206326577791477
92564,MURRIETA,CA,728,1128,400,0.6077586206896551
92567,NUEVO,CA,2937,2692,-245,0.4782376976372357
92570,PERRIS,CA,12703,12939,236,0.504601825130645
92571,PERRIS,CA,13722,12220,-1502,0.4710508056433583
92572,PERRIS,CA,1478,1963,485,0.5704736995059576
92581,SAN JACINTO,CA,820,1385,565,0.6281179138321995
92582,SAN JACINTO,CA,5646,6124,478,0.5203058623619371
92583,SAN JACINTO,CA,11107,9669,-1438,0.4653927608779361
92584,MENIFEE,CA,18009,23964,5955,0.5709384604388535
92585,MENIFEE,CA,6421,8459,2038,0.5684811827956989
92585,ROMOLAND,CA,325,445,120,0.577922077922078
92585,SUN CITY,CA,673,767,94,0.5326388888888889
92586,MENIFEE,CA,4782,5202,420,0.5210336538461539
92586,SUN CITY,CA,5783,6628,845,0.5340423817581178
92587,CANYON LAKE,CA,4791,4947,156,0.5080098582871226
92587,MENIFEE,CA,1235,1326,91,0.5177664974619289
92587,QUAIL VALLEY,CA,312,304,-8,0.4935064935064935
92589,TEMECULA,CA,3253,2149,-1104,0.3978156238430211
92590,TEMECULA,CA,3753,3226,-527,0.4622438744805846
92591,TEMECULA,CA,18186,18751,565,0.5076481576738772
92592,TEMECULA,CA,25985,27366,1381,0.5129425877678019
92593,TEMECULA,CA,1918,832,-1086,0.30254545454545456
92595,WILDOMAR,CA,13053,12902,-151,0.49709111924484684
92596,WINCHESTER,CA,9162,12665,3503,0.5802446511201723
92602,IRVINE,CA,14214,15340,1126,0.5190498748054408
92603,IRVINE,CA,8372,8068,-304,0.49075425790754257
92604,COSTA MESA,CA,180,179,-1,0.4986072423398329
92604,IRVINE,CA,10012,10144,132,0.5032744592180989
92605,HUNTINGTN BCH,CA,12,14,2,0.5384615384615384
92605,HUNTINGTON BEACH,CA,110,349,239,0.7603485838779956
92606,IRVINE,CA,12972,11583,-1389,0.47171655467318263
92607,LAGUNA NIGUEL,CA,484,732,248,0.6019736842105263
92609,EL TORO,CA,162,212,50,0.5668449197860963
92609,JURUPA VALLEY,CA,33,43,10,0.5657894736842105
92609,LAKE FOREST,CA,419,732,313,0.635968722849696
92610,FOOTHILL RANCH,CA,4321,5148,827,0.5436688140247122
92610,LAKE FOREST,CA,85,124,39,0.5933014354066986
92612,IRVINE,CA,24732,21647,-3085,0.46674141313956746
92614,IRVINE,CA,19780,18421,-1359,0.482212507525981
92615,HUNTINGTN BCH,CA,88,115,27,0.5665024630541872
92615,HUNTINGTON BEACH,CA,641,695,54,0.5202095808383234
92616,IRVINE,CA,157,317,160,0.6687763713080169
92617,IRVINE,CA,7166,4718,-2448,0.39700437563110064
92618,IRVINE,CA,38279,44759,6480,0.5390182807871096
92619,IRVINE,CA,1056,2049,993,0.659903381642512
92620,IRVINE,CA,26578,26200,-378,0.49641896244647393
92623,IRVINE,CA,1068,1722,654,0.6172043010752688
92624,CAPISTRANO BEACH,CA,2918,2810,-108,0.49057262569832405
92624,CAPO BEACH,CA,113,132,19,0.5387755102040817
92624,DANA POINT,CA,75,90,15,0.5454545454545454
92625,CORONA DEL MAR,CA,6262,6386,124,0.5049019607843137
92625,CORONA DL MAR,CA,136,163,27,0.5451505016722408
92625,COSTA MESA,CA,163,123,-40,0.43006993006993005
92626,COSTA MESA,CA,29283,24880,-4403,0.45935417166700515
92627,COSTA MESA,CA,25952,22615,-3337,0.46564539708032204
92628,COSTA MESA,CA,783,771,-12,0.49613899613899615
92629,DANA POINT,CA,14253,14629,376,0.5065092445121528
92630,EL TORO,CA,1385,1433,48,0.5085166784953868
92630,LAKE FOREST,CA,22475,22380,-95,0.4989410322149147
92637,LAGUNA WOODS,CA,9321,10269,948,0.5241960183767228
92646,HUNTINGTN BCH,CA,1143,1152,9,0.5019607843137255
92646,HUNTINGTON BEACH,CA,16045,15877,-168,0.4973685859282
92647,HB,CA,505,430,-75,0.45989304812834225
92647,HUNTINGTN BCH,CA,553,546,-7,0.4968152866242038
92647,HUNTINGTON BEACH,CA,24794,22229,-2565,0.4727261127533335
92648,HUNTINGTN BCH,CA,1399,1311,-88,0.4837638376383764
92648,HUNTINGTON BEACH,CA,21351,20051,-1300,0.48430027534901693
92649,HUNTINGTN BCH,CA,263,257,-6,0.49423076923076925
92649,HUNTINGTON BEACH,CA,13158,13009,-149,0.497152902510796
92651,LAGUNA BEACH,CA,12083,13745,1662,0.5321743843890352
92652,LAGUNA BEACH,CA,739,853,114,0.5358040201005025
92653,LAGUNA HILLS,CA,11735,10852,-883,0.48045335812635587
92654,LAGUNA HILLS,CA,852,991,139,0.5377102550189907
92654,LAGUNA WOODS,CA,53,59,6,0.5267857142857143
92655,MIDWAY CITY,CA,2763,2504,-259,0.4754129485475603
92656,ALISO VIEJO,CA,19975,19644,-331,0.4958227113253742
92656,LAGUNA HILLS,CA,2788,2631,-157,0.48551393245986346
92657,NEWPORT BEACH,CA,184,182,-2,0.4972677595628415
92657,NEWPORT COAST,CA,4087,4456,369,0.5215966288189161
92658,NEWPORT BEACH,CA,1410,2043,633,0.5916594265855778
92659,NEWPORT BEACH,CA,497,919,422,0.6490112994350282
92660,NEWPORT BEACH,CA,23628,24159,531,0.5055559043254442
92661,NEWPORT BEACH,CA,2234,1758,-476,0.4403807615230461
92662,BALBOA,CA,42,41,-1,0.4939759036144578
92662,BALBOA ISLAND,CA,462,383,-79,0.4532544378698225
92662,NEWPORT BEACH,CA,1294,1260,-34,0.49334377447141736
92663,NEWPORT BEACH,CA,13328,11287,-2041,0.458541539711558
92672,SAN CLEMENTE,CA,17909,16475,-1434,0.4791472778036296
92673,SAN CLEMENTE,CA,9484,9974,490,0.5125912221194368
92674,SAN CLEMENTE,CA,1026,1168,142,0.5323609845031905
92675,SAN JUAN CAPISTRANO,CA,9456,10439,983,0.5247046996732847
92675,SAN JUAN CAPO,CA,206,308,102,0.5992217898832685
92676,SILVERADO,CA,528,581,53,0.5238954012623985
92677,LAGUNA NIGUEL,CA,26090,27368,1278,0.5119533091398856
92678,TRABUCO CANYON,CA,51,37,-14,0.42045454545454547
92678,TRABUCO CYN,CA,13,0,-13,0
92679,COTO DE CAZA,CA,2558,2873,315,0.5290001841281532
92679,DOVE CANYON,CA,630,750,120,0.5434782608695652
92679,PORTOLA HILLS,CA,143,213,70,0.598314606741573
92679,TRABUCO,CA,100,153,53,0.6047430830039525
92679,TRABUCO CANYON,CA,4840,5582,742,0.5355977739397428
92683,WESTMINSTER,CA,26149,23321,-2828,0.471417020416414
92684,WESTMINSTER,CA,369,539,170,0.5936123348017621
92685,WESTMINSTER,CA,415,758,343,0.6462063086104007
92688,RANCHO SANTA MARGARITA,CA,15930,15097,-833,0.48657620781899635
92688,RANCHO STA MARG,CA,300,281,-19,0.4836488812392427
92690,MISSION VIEJO,CA,728,972,244,0.571764705882353
92691,MISSION VIEJO,CA,15483,15800,317,0.5050666496180034
92691,SAN JUAN CAPISTRANO,CA,309,360,51,0.5381165919282511
92692,MISSION VIEJO,CA,15260,16070,810,0.5129269071177784
92693,SAN JUAN CAPISTRANO,CA,73,238,165,0.7652733118971061
92693,SAN JUAN CAPO,CA,14,0,-14,0
92694,LADERA RANCH,CA,6645,8051,1406,0.5478361458900382
92694,RANCHO MISSION VIEJO,CA,4701,5850,1149,0.554449815183395
92701,SANTA ANA,CA,11438,8719,-2719,0.4325544475864464
92702,SANTA ANA,CA,146,470,324,0.762987012987013
92703,SANTA ANA,CA,12926,10425,-2501,0.4464476896064408
92704,SANTA ANA,CA,18296,14584,-3712,0.4435523114355231
92705,NORTH TUSTIN,CA,338,375,37,0.5259467040673211
92705,SANTA ANA,CA,14903,15423,520,0.5085735012860252
92706,SANTA ANA,CA,8245,7144,-1101,0.46422769510689454
92707,SANTA ANA,CA,13994,11256,-2738,0.4457821782178218
92708,FOUNTAIN VALLEY,CA,15663,14889,-774,0.48733307148468186
92708,FOUNTAIN VLY,CA,1082,1019,-63,0.48500713945740126
92711,SANTA ANA,CA,593,1308,715,0.6880589163598106
92728,FOUNTAIN VALLEY,CA,648,862,214,0.5708609271523178
92728,FOUNTAIN VLY,CA,20,22,2,0.5238095238095238
92735,SANTA ANA,CA,38,22,-16,0.36666666666666664
92780,TUSTIN,CA,20371,17661,-2710,0.46437210769877996
92781,TUSTIN,CA,1051,1605,554,0.6042921686746988
92782,TUSTIN,CA,11972,11784,-188,0.4960431048998148
92799,SANTA ANA,CA,932,874,-58,0.4839424141749723
92801,ANAHEIM,CA,19495,16626,-2869,0.4602862600703192
92802,ANAHEIM,CA,11606,9524,-2082,0.4507335541883578
92803,ANAHEIM,CA,713,1433,720,0.6677539608574091
92804,ANAHEIM,CA,26502,21028,-5474,0.44241531664212075
92805,ANAHEIM,CA,21785,19633,-2152,0.4740209570718045
92806,ANAHEIM,CA,17319,14656,-2663,0.4583580922595778
92807,ANAHEIM,CA,10181,9987,-194,0.4951904006346688
92808,ANAHEIM,CA,6232,6202,-30,0.49879363036834484
92809,ANAHEIM,CA,13,150,137,0.9202453987730062
92811,ATWOOD,CA,41,21,-20,0.3387096774193548
92812,ANAHEIM,CA,130,439,309,0.7715289982425307
92814,ANAHEIM,CA,177,518,341,0.7453237410071942
92815,ANAHEIM,CA,270,675,405,0.7142857142857143
92815,FULLERTON,CA,0,11,11,1
92816,ANAHEIM,CA,88,284,196,0.7634408602150538
92817,ANAHEIM,CA,276,617,341,0.6909294512877939
92821,BREA,CA,14366,13983,-383,0.4932449116370948
92822,BREA,CA,1032,1210,178,0.5396966993755575
92823,BREA,CA,1760,1855,95,0.5131396957123098
92825,ANAHEIM,CA,11,25,14,0.6944444444444444
92831,FULLERTON,CA,16339,12802,-3537,0.4393123091177379
92832,FULLERTON,CA,10379,8856,-1523,0.46041070964387837
92833,FULLERTON,CA,14811,14227,-584,0.48994421103381774
92834,FULLERTON,CA,580,929,349,0.6156394963552021
92835,FULLERTON,CA,7337,7660,323,0.5107688204307528
92836,FULLERTON,CA,102,210,108,0.6730769230769231
92837,FULLERTON,CA,134,345,211,0.7202505219206681
92838,FULLERTON,CA,225,63,-162,0.21875
92840,GARDEN GROVE,CA,15446,13302,-2144,0.4627104494225685
92841,GARDEN GROVE,CA,9823,8751,-1072,0.4711424571982341
92842,GARDEN GROVE,CA,1310,2059,749,0.6111605817750074
92843,GARDEN GROVE,CA,11648,9599,-2049,0.4517814279663011
92844,GARDEN GROVE,CA,7061,5726,-1335,0.4477985453976695
92845,GARDEN GROVE,CA,3693,3831,138,0.509170653907496
92846,GARDEN GROVE,CA,53,39,-14,0.42391304347826086
92856,ORANGE,CA,161,222,61,0.5796344647519582
92857,ORANGE,CA,18,0,-18,0
92859,ORANGE,CA,101,85,-16,0.45698924731182794
92860,NORCO,CA,7135,7182,47,0.501641405322344
92861,VILLA PARK,CA,1185,1579,394,0.571273516642547
92863,ORANGE,CA,895,1283,388,0.5890725436179982
92865,ORANGE,CA,6198,5628,-570,0.4759005580923389
92866,ORANGE,CA,5622,4526,-1096,0.4459992116673236
92867,ORANGE,CA,10650,10313,-337,0.49196202833563896
92868,ORANGE,CA,12075,10804,-1271,0.4722234363390008
92869,ORANGE,CA,8246,8433,187,0.5056058516697644
92870,PLACENTIA,CA,15790,14126,-1664,0.47218879529348845
92871,PLACENTIA,CA,754,730,-24,0.4919137466307278
92877,CORONA,CA,700,1164,464,0.6244635193133047
92878,CORONA,CA,6798,6933,135,0.5049158837666594
92879,CORONA,CA,15200,13797,-1403,0.47580784219057143
92880,CORONA,CA,630,802,172,0.5600558659217877
92880,EASTVALE,CA,13094,14277,1183,0.5216104636293888
92881,CORONA,CA,8055,8423,368,0.5111664036897682
92882,CORONA,CA,18468,17382,-1086,0.48485355648535566
92883,CORONA,CA,9978,12713,2735,0.5602661848309902
92883,TEMESCAL VALLEY,CA,250,302,52,0.5471014492753623
92885,YORBA LINDA,CA,58,145,87,0.7142857142857143
92886,YORBA LINDA,CA,11529,13214,1685,0.5340500343531503
92887,YORBA LINDA,CA,5598,6141,543,0.5231280347559417
93001,VENTURA,CA,13614,12702,-912,0.482672138622891
93002,VENTURA,CA,1125,1425,300,0.5588235294117647
93003,VENTURA,CA,19448,19063,-385,0.4950014281633819
93004,VENTURA,CA,9685,9887,202,0.5051604332720212
93005,VENTURA,CA,67,165,98,0.7112068965517241
93006,VENTURA,CA,1121,1340,219,0.5444941080861438
93007,VENTURA,CA,0,12,12,1
93010,CAMARILLO,CA,16026,15959,-67,0.49895263404720963
93011,CAMARILLO,CA,1290,1744,454,0.5748187211601846
93012,CAMARILLO,CA,11946,13184,1238,0.5246319140469559
93012,SANTA ROSA VALLEY,CA,291,331,40,0.5321543408360129
93013,CARPINTERIA,CA,4892,4958,66,0.5033502538071066
93014,CARPINTERIA,CA,457,455,-2,0.49890350877192985
93015,FILLMORE,CA,3528,3746,218,0.5149848776464119
93016,FILLMORE,CA,95,299,204,0.7588832487309645
93020,MOORPARK,CA,179,278,99,0.6083150984682714
93021,MOORPARK,CA,9568,9825,257,0.5066261022018254
93022,OAK VIEW,CA,2053,2005,-48,0.4940857565303105
93023,OJAI,CA,7292,7809,517,0.5171180716508841
93024,OJAI,CA,655,593,-62,0.4751602564102564
93030,OXNARD,CA,12741,10607,-2134,0.4543001541887956
93031,OXNARD,CA,1291,2116,825,0.621074258878779
93032,OXNARD,CA,228,569,341,0.7139272271016311
93033,OXNARD,CA,12064,9403,-2661,0.4380211487399264
93034,OXNARD,CA,236,611,375,0.7213695395513577
93034,SANTA PAULA,CA,11,21,10,0.65625
93035,OXNARD,CA,10373,9888,-485,0.48803119293223435
93036,OXNARD,CA,13823,12561,-1262,0.47608399029714976
93040,PIRU,CA,43,145,102,0.7712765957446809
93041,POINT MUGU NAWC,CA,318,270,-48,0.45918367346938777
93041,PORT HUENEME,CA,7889,6772,-1117,0.4619057363072096
93044,PORT HUENEME,CA,752,751,-1,0.49966733200266134
93044,PORT HUENEME CBC BASE,CA,65,44,-21,0.4036697247706422
93060,SANTA PAULA,CA,6757,6820,63,0.5023201001694041
93061,SANTA PAULA,CA,524,324,-200,0.38207547169811323
93062,SIMI VALLEY,CA,663,771,108,0.5376569037656904
93063,SIMI VALLEY,CA,15952,16220,268,0.5041651125202039
93065,SIMI VALLEY,CA,23878,23999,121,0.5012636547820457
93066,SOMIS,CA,784,1024,240,0.5663716814159292
93067,SUMMERLAND,CA,630,386,-244,0.3799212598425197
93094,SIMI VALLEY,CA,389,517,128,0.5706401766004415
93101,SANTA BARBARA,CA,15268,12349,-2919,0.4471521164500127
93102,SANTA BARBARA,CA,639,744,105,0.5379609544468547
93103,SANTA BARBARA,CA,7333,6691,-642,0.47711066742726754
93105,SANTA BARBARA,CA,10209,10281,72,0.5017569546120059
93106,GOLETA,CA,0,44,44,1
93106,SANTA BARBARA,CA,0,118,118,1
93107,SANTA BARBARA,CA,58,24,-34,0.2926829268292683
93108,MONTECITO,CA,940,969,29,0.5075955997904662
93108,SANTA BARBARA,CA,3621,4138,517,0.5333161489882717
93109,SANTA BARBARA,CA,4666,4494,-172,0.4906113537117904
93110,SANTA BARBARA,CA,5260,5053,-207,0.48996412295161446
93111,GOLETA,CA,78,104,26,0.5714285714285714
93111,SANTA BARBARA,CA,5215,5508,293,0.5136622213932668
93116,GOLETA,CA,402,590,188,0.594758064516129
93116,SANTA BARBARA,CA,27,54,27,0.6666666666666666
93117,GOLETA,CA,17775,13614,-4161,0.4337188186944471
93118,GOLETA,CA,710,144,-566,0.1686182669789227
93120,SANTA BARBARA,CA,230,301,71,0.5668549905838042
93121,SANTA BARBARA,CA,33,12,-21,0.26666666666666666
93130,SANTA BARBARA,CA,763,801,38,0.5121483375959079
93140,SANTA BARBARA,CA,205,327,122,0.6146616541353384
93150,MONTECITO,CA,48,123,75,0.7192982456140351
93150,SANTA BARBARA,CA,217,352,135,0.6186291739894552
93160,SANTA BARBARA,CA,79,64,-15,0.44755244755244755
93190,SANTA BARBARA,CA,410,118,-292,0.22348484848484848
93201,ALPAUGH,CA,11,0,-11,0
93202,ARMONA,CA,1091,1018,-73,0.4826932195353248
93203,ARVIN,CA,3072,2806,-266,0.4773732562095951
93203,TEJON RANCH,CA,93,75,-18,0.44642857142857145
93204,AVENAL,CA,2265,1663,-602,0.4233706720977597
93205,BODFISH,CA,1030,1010,-20,0.4950980392156863
93206,BUTTONWILLOW,CA,354,82,-272,0.18807339449541285
93207,CALIFORNIA HOT SPRINGS,CA,0,12,12,1
93210,COALINGA,CA,4407,3850,-557,0.4662710427516047
93212,CORCORAN,CA,3959,3762,-197,0.487242585157363
93215,DELANO,CA,7331,6157,-1174,0.45647983392645314
93216,DELANO,CA,199,1003,804,0.8344425956738769
93218,DUCOR,CA,36,15,-21,0.29411764705882354
93219,EARLIMART,CA,739,568,-171,0.4345830145371079
93220,EDISON,CA,22,0,-22,0
93221,EXETER,CA,4435,4275,-160,0.4908151549942595
93222,FRAZIER PARK,CA,76,86,10,0.5308641975308642
93222,PINE MOUNTAIN CLUB,CA,770,695,-75,0.47440273037542663
93222,PINE MTN CLB,CA,16,13,-3,0.4482758620689655
93223,FARMERSVILLE,CA,2181,1940,-241,0.47075952438728463
93224,FELLOWS,CA,0,24,24,1
93225,FRAZIER PARK,CA,1686,1544,-142,0.4780185758513932
93227,GOSHEN,CA,73,82,9,0.5290322580645161
93230,HANFORD,CA,22507,20098,-2409,0.47172867034385635
93232,HANFORD,CA,920,1491,571,0.6184155951887184
93234,HURON,CA,85,29,-56,0.2543859649122807
93235,IVANHOE,CA,1251,813,-438,0.3938953488372093
93238,KERNVILLE,CA,562,625,63,0.5265374894692502
93240,LAKE ISABELLA,CA,2792,2851,59,0.5052277157540316
93241,LAMONT,CA,2914,2238,-676,0.4343944099378882
93242,LATON,CA,344,305,-39,0.4699537750385208
93243,GORMAN,CA,13,0,-13,0
93243,LEBEC,CA,381,319,-62,0.45571428571428574
93244,LEMON COVE,CA,0,29,29,1
93245,LEMOORE,CA,15814,12810,-3004,0.44752655114589157
93247,LINDSAY,CA,3404,3226,-178,0.4865761689291101
93249,LOST HILLS,CA,74,49,-25,0.3983739837398374
93250,MC FARLAND,CA,1867,1612,-255,0.46335153779821786
93252,MARICOPA,CA,402,449,47,0.5276145710928319
93254,NEW CUYAMA,CA,0,34,34,1
93255,ONYX,CA,24,56,32,0.7
93256,PIXLEY,CA,703,498,-205,0.414654454621149
93257,PORTERVILLE,CA,15755,14608,-1147,0.48111187959029084
93257,TULARE,CA,476,429,-47,0.4740331491712707
93258,PORTERVILLE,CA,985,1213,228,0.5518653321201092
93261,RICHGROVE,CA,11,11,0,0.5
93261,TEAL,CA,0,11,11,1
93262,SEQUOIA NATIONAL PARK,CA,72,42,-30,0.3684210526315789
93263,SHAFTER,CA,6277,5865,-412,0.48303409652446055
93265,SPRINGVILLE,CA,1229,1496,267,0.5489908256880734
93266,STRATFORD,CA,73,24,-49,0.24742268041237114
93267,STRATHMORE,CA,1130,1046,-84,0.4806985294117647
93268,TAFT,CA,8163,6242,-1921,0.43332176327664007
93270,NFD,CA,17,18,1,0.5142857142857142
93270,TERRA BELLA,CA,826,700,-126,0.45871559633027525
93271,THREE RIVERS,CA,1089,873,-216,0.44495412844036697
93272,TIPTON,CA,237,251,14,0.514344262295082
93274,TULARE,CA,21010,19453,-1557,0.48076020067716185
93275,TULARE,CA,1003,1679,676,0.6260253542132737
93276,TUPMAN,CA,12,0,-12,0
93277,VISALIA,CA,20315,17035,-3280,0.456091030789826
93278,VISALIA,CA,644,863,219,0.5726609157266092
93279,VISALIA,CA,506,964,458,0.6557823129251701
93280,WASCO,CA,4843,4484,-359,0.48075479789857406
93283,WELDON,CA,611,750,139,0.5510653930933137
93285,WOFFORD HEIGHTS,CA,1093,1056,-37,0.49139134481154023
93285,WOFFORD HTS,CA,51,31,-20,0.3780487804878049
93286,WOODLAKE,CA,2518,2152,-366,0.460813704496788
93290,VISALIA,CA,675,943,268,0.5828182941903585
93291,VISALIA,CA,17661,17816,155,0.5021845139104208
93292,VISALIA,CA,12734,13162,428,0.5082638245288847
93301,BAKERSFIELD,CA,7994,6556,-1438,0.45058419243986253
93302,BAKERSFIELD,CA,579,1287,708,0.6897106109324759
93303,BAKERSFIELD,CA,55,146,91,0.7263681592039801
93304,BAKERSFIELD,CA,16065,13570,-2495,0.4579045048085035
93305,BAKERSFIELD,CA,13064,9936,-3128,0.432
93306,BAKERSFIELD,CA,21125,19865,-1260,0.48463039765796534
93307,BAKERSFIELD,CA,21058,18859,-2199,0.47245534484054413
93308,BAKERSFIELD,CA,23605,21339,-2266,0.47479085083659667
93309,BAKERSFIELD,CA,25220,21161,-4059,0.4562428580668808
93311,BAKERSFIELD,CA,16340,17974,1634,0.5238095238095238
93312,BAKERSFIELD,CA,17604,17236,-368,0.4947187141216992
93313,BAKERSFIELD,CA,15214,15989,775,0.5124186776912476
93314,BAKERSFIELD,CA,8288,10511,2223,0.5591254853981594
93380,BAKERSFIELD,CA,491,891,400,0.6447178002894356
93383,BAKERSFIELD,CA,0,12,12,1
93383,PUMPKIN CENTER,CA,0,11,11,1
93384,BAKERSFIELD,CA,1011,1931,920,0.6563562202583276
93385,BAKERSFIELD,CA,85,488,403,0.8516579406631762
93386,BAKERSFIELD,CA,292,787,495,0.7293790546802595
93387,BAKERSFIELD,CA,600,1480,880,0.7115384615384616
93388,BAKERSFIELD,CA,81,262,181,0.7638483965014577
93389,BAKERSFIELD,CA,1279,2212,933,0.6336293325694643
93390,BAKERSFIELD,CA,977,1218,241,0.5548974943052392
93401,SAN LUIS OBISPO,CA,16193,15332,-861,0.4863441712926249
93402,LOS OSOS,CA,4661,4805,144,0.5076061694485527
93403,SAN LUIS OBISPO,CA,783,801,18,0.5056818181818182
93403,SN LUIS OBISP,CA,36,41,5,0.5324675324675324
93405,SAN LUIS OBISPO,CA,10528,7339,-3189,0.41075726199138074
93406,SAN LUIS OBISPO,CA,1079,1118,39,0.5088757396449705
93406,SN LUIS OBISP,CA,14,16,2,0.5333333333333333
93410,SAN LUIS OBISPO,CA,0,17,17,1
93412,LOS OSOS,CA,228,278,50,0.549407114624506
93420,ARROYO GRANDE,CA,9132,9963,831,0.5217596229379419
93421,ARROYO GRANDE,CA,970,863,-107,0.4708128750681942
93422,ATASCADERO,CA,11318,11271,-47,0.4989596706361503
93423,ATASCADERO,CA,1191,1191,0,0.5
93424,AVILA BEACH,CA,801,811,10,0.5031017369727047
93426,BRADLEY,CA,337,302,-35,0.4726134585289515
93427,BUELLTON,CA,1864,2044,180,0.5230296827021494
93428,CAMBRIA,CA,2608,2986,378,0.5337861994994637
93430,CAYUCOS,CA,1602,1647,45,0.5069252077562327
93432,CRESTON,CA,225,332,107,0.5960502692998204
93433,GROVER BEACH,CA,5396,4784,-612,0.46994106090373283
93434,GUADALUPE,CA,1420,1583,163,0.5271395271395272
93436,LOMPOC,CA,16733,15374,-1359,0.4788363908182016
93437,LOMPOC,CA,1377,1287,-90,0.4831081081081081
93437,VANDENBERG AFB,CA,975,841,-134,0.4631057268722467
93437,VANDENBRG AFB,CA,61,49,-12,0.44545454545454544
93438,LOMPOC,CA,778,1058,280,0.5762527233115469
93438,VANDENBERG AFB,CA,15,20,5,0.5714285714285714
93440,LOS ALAMOS,CA,221,341,120,0.6067615658362989
93441,LOS OLIVOS,CA,63,185,122,0.7459677419354839
93442,MORRO BAY,CA,4876,5371,495,0.5241534107543672
93443,MORRO BAY,CA,712,731,19,0.5065835065835066
93444,NIPOMO,CA,6976,7729,753,0.5256035362121727
93445,OCEANO,CA,2129,1847,-282,0.4645372233400402
93446,HERITAGE RANCH,CA,280,310,30,0.5254237288135594
93446,PASO ROBLES,CA,14759,14982,223,0.5037490333210046
93447,PASO ROBLES,CA,2230,1941,-289,0.46535602972908174
93448,PISMO BEACH,CA,743,901,158,0.5480535279805353
93448,SHELL BEACH,CA,93,123,30,0.5694444444444444
93449,PISMO BEACH,CA,3560,3840,280,0.518918918918919
93449,SHELL BEACH,CA,397,393,-4,0.49746835443037973
93451,PARKFIELD,CA,0,11,11,1
93451,SAN MIGUEL,CA,1184,1280,96,0.5194805194805194
93452,SAN SIMEON,CA,12,16,4,0.5714285714285714
93453,SANTA MARGARITA,CA,907,881,-26,0.49272930648769575
93454,SANTA MARIA,CA,9606,8436,-1170,0.46757565680079816
93455,ORCUTT,CA,500,510,10,0.504950495049505
93455,SANTA MARIA,CA,12093,12514,421,0.508554476368513
93456,SANTA MARIA,CA,1650,2672,1022,0.6182322998611753
93457,ORCUTT,CA,49,166,117,0.772093023255814
93457,SANTA MARIA,CA,48,146,98,0.7525773195876289
93458,SANTA MARIA,CA,9436,7457,-1979,0.4414254424909726
93460,SANTA YNEZ,CA,1941,2058,117,0.5146286571642911
93461,SHANDON,CA,123,35,-88,0.22151898734177214
93463,SOLVANG,CA,2652,2798,146,0.513394495412844
93464,SOLVANG,CA,66,191,125,0.7431906614785992
93465,TEMPLETON,CA,3759,3918,159,0.5103556076592419
93475,OCEANO,CA,12,61,49,0.8356164383561644
93483,GROVER BEACH,CA,629,817,188,0.5650069156293223
93501,MOJAVE,CA,2169,1800,-369,0.45351473922902497
93501,TEHACHAPI,CA,35,40,5,0.5333333333333333
93502,MOJAVE,CA,11,88,77,0.8888888888888888
93504,CALIF CITY,CA,24,31,7,0.5636363636363636
93504,CALIFORNIA CITY,CA,43,212,169,0.8313725490196079
93505,CALIF CITY,CA,228,142,-86,0.3837837837837838
93505,CALIFORNIA CITY,CA,5728,5147,-581,0.4732873563218391
93510,ACTON,CA,2682,2774,92,0.5084310850439883
93513,BIG PINE,CA,390,395,5,0.5031847133757962
93514,BISHOP,CA,5015,4761,-254,0.4870090016366612
93515,BISHOP,CA,906,648,-258,0.416988416988417
93516,BORON,CA,904,851,-53,0.4849002849002849
93517,BRIDGEPORT,CA,164,272,108,0.6238532110091743
93518,CALIENTE,CA,230,174,-56,0.4306930693069307
93518,HAVILAH,CA,0,15,15,1
93523,EDWARDS,CA,2670,2055,-615,0.43492063492063493
93526,INDEPENDENCE,CA,27,34,7,0.5573770491803278
93527,INYOKERN,CA,671,807,136,0.5460081190798376
93528,JOHANNESBURG,CA,0,50,50,1
93529,JUNE LAKE,CA,168,232,64,0.58
93531,KEENE,CA,46,46,0,0.5
93532,ELIZABETH LAKE,CA,75,57,-18,0.4318181818181818
93532,LAKE HUGHES,CA,1233,906,-327,0.423562412342216
93534,LANCASTER,CA,18677,15941,-2736,0.46048298572996704
93535,LANCASTER,CA,21809,21065,-744,0.49132341279096886
93536,DEL SUR,CA,579,498,-81,0.4623955431754875
93536,LANCASTER,CA,20808,21624,816,0.5096153846153846
93536,QUARTZ HILL,CA,872,954,82,0.5224534501642936
93539,LANCASTER,CA,1952,3191,1239,0.6204549873614622
93541,LEE VINING,CA,91,17,-74,0.1574074074074074
93543,LITTLEROCK,CA,3315,3359,44,0.5032963739886125
93544,LLANO,CA,131,238,107,0.6449864498644986
93545,LONE PINE,CA,233,234,1,0.5010706638115632
93546,MAMMOTH LAKES,CA,5133,2793,-2340,0.35238455715367145
93550,PALMDALE,CA,22869,19574,-3295,0.4611832339844026
93551,LEONA VALLEY,CA,384,378,-6,0.49606299212598426
93551,PALMDALE,CA,15705,16839,1134,0.5174225663716814
93552,PALMDALE,CA,8386,8557,171,0.50504633181845
93553,PEARBLOSSOM,CA,482,617,135,0.5614194722474978
93555,RIDGECREST,CA,14841,12933,-1908,0.465651328580687
93556,RIDGECREST,CA,907,1028,121,0.531266149870801
93560,ROSAMOND,CA,7740,8094,354,0.511178476695718
93561,BEAR VALLEY SPRINGS,CA,550,573,23,0.5102404274265361
93561,GOLDEN HILLS,CA,207,233,26,0.5295454545454545
93561,TEHACHAPI,CA,10626,11368,742,0.5168682367918523
93562,TRONA,CA,685,585,-100,0.46062992125984253
93581,TEHACHAPI,CA,1038,1422,384,0.5780487804878048
93584,LANCASTER,CA,227,649,422,0.7408675799086758
93586,LANCASTER,CA,0,17,17,1
93586,QUARTZ HILL,CA,18,76,58,0.8085106382978723
93590,PALMDALE,CA,910,1624,714,0.6408839779005525
93591,LAKE LA,CA,31,30,-1,0.4918032786885246
93591,LAKE LOS ANGELES,CA,265,204,-61,0.4349680170575693
93591,PALMDALE,CA,1252,1258,6,0.501195219123506
93592,TRONA,CA,16,0,-16,0
93601,AHWAHNEE,CA,532,507,-25,0.4879692011549567
93602,AUBERRY,CA,1358,1123,-235,0.45264006449012495
93604,BASS LAKE,CA,159,79,-80,0.3319327731092437
93605,BIG CREEK,CA,27,0,-27,0
93606,BIOLA,CA,17,23,6,0.575
93608,CANTUA CREEK,CA,0,11,11,1
93609,CARLSBAD,CA,19,21,2,0.525
93609,CARUTHERS,CA,829,743,-86,0.47264631043257
93610,CHOWCHILLA,CA,6122,5634,-488,0.4792446410343654
93610,SHARON,CA,136,119,-17,0.4666666666666667
93611,CLOVIS,CA,14150,14757,607,0.5104991870481198
93612,CLOVIS,CA,17188,13748,-3440,0.44440134471166276
93613,CLOVIS,CA,1448,2173,725,0.6001104667219
93614,COARSEGOLD,CA,3907,4170,263,0.5162807973257397
93615,CUTLER,CA,754,631,-123,0.4555956678700361
93616,DEL REY,CA,688,267,-421,0.27958115183246074
93618,DINUBA,CA,5872,5813,-59,0.49747539580658967
93619,CLOVIS,CA,12344,16138,3794,0.566603468857524
93620,DOS PALOS,CA,2685,2357,-328,0.4674732249107497
93621,DUNLAP,CA,36,76,40,0.6785714285714286
93622,FIREBAUGH,CA,1663,1577,-86,0.4867283950617284
93624,FIVE POINTS,CA,31,0,-31,0
93625,FOWLER,CA,1976,2294,318,0.5372365339578454
93626,FRIANT,CA,795,894,99,0.5293072824156305
93630,KERMAN,CA,4261,4017,-244,0.4852621406136748
93631,KINGSBURG,CA,4528,4879,351,0.5186563197618794
93634,LAKESHORE,CA,11,0,-11,0
93635,LOS BANOS,CA,13002,12562,-440,0.49139414802065406
93636,MADERA,CA,3050,5970,2920,0.6618625277161863
93637,MADERA,CA,9483,9558,75,0.5019694343784465
93638,MADERA,CA,8548,8057,-491,0.4852152965974104
93639,MADERA,CA,234,726,492,0.75625
93640,MENDOTA,CA,1281,974,-307,0.4319290465631929
93641,MIRAMONTE,CA,22,24,2,0.5217391304347826
93643,NORTH FORK,CA,1094,1082,-12,0.49724264705882354
93644,OAKHURST,CA,3971,3312,-659,0.45475765481257724
93646,ORANGE COVE,CA,2280,1887,-393,0.4528437724982001
93647,OROSI,CA,1594,1297,-297,0.4486336907644414
93648,PARLIER,CA,2442,2131,-311,0.46599606385305054
93650,FRESNO,CA,1455,1339,-116,0.47924123120973516
93650,PINEDALE,CA,261,239,-22,0.478
93651,PRATHER,CA,545,394,-151,0.41959531416400425
93652,RAISIN CITY,CA,0,12,12,1
93653,RAYMOND,CA,61,80,19,0.5673758865248227
93654,REEDLEY,CA,6013,5851,-162,0.4931726230613621
93656,RIVERDALE,CA,2131,1199,-932,0.3600600600600601
93657,SANGER,CA,9836,8416,-1420,0.4611001534078457
93660,SAN JACINTO,CA,0,11,11,1
93660,SAN JOAQUIN,CA,49,41,-8,0.45555555555555555
93662,SELMA,CA,8588,6554,-2034,0.43283582089552236
93664,SHAVER LAKE,CA,196,91,-105,0.3170731707317073
93666,SULTANA,CA,0,11,11,1
93667,TOLLHOUSE,CA,808,549,-259,0.40456890198968315
93668,TRANQUILLITY,CA,11,11,0,0.5
93675,SQUAW VALLEY,CA,1030,1133,103,0.5238095238095238
93701,FRESNO,CA,4116,3084,-1032,0.42833333333333334
93702,FRESNO,CA,10751,9502,-1249,0.46916506196612845
93703,FRESNO,CA,10080,9169,-911,0.47633643306145773
93704,FRESNO,CA,11312,9577,-1735,0.4584709655799703
93705,FRESNO,CA,12927,10738,-2189,0.45375026410310587
93706,FRESNO,CA,10078,8967,-1111,0.470832239432922
93707,FRESNO,CA,23,15,-8,0.39473684210526316
93709,FRESNO,CA,14,0,-14,0
93710,FRESNO,CA,13496,10576,-2920,0.4393486208042539
93711,FRESNO,CA,15769,14007,-1762,0.4704124126813541
93712,FRESNO,CA,26,0,-26,0
93720,FRESNO,CA,20571,19209,-1362,0.48288084464555053
93721,FRESNO,CA,2785,2171,-614,0.4380548829701372
93722,FRESNO,CA,28929,25255,-3674,0.4660970028052562
93723,FRESNO,CA,2729,3941,1212,0.5908545727136432
93725,FRESNO,CA,5486,5016,-470,0.4776233098457437
93726,FRESNO,CA,15964,12906,-3058,0.4470384482161413
93727,FRESNO,CA,23198,23748,550,0.5058577940612619
93728,FRESNO,CA,6159,5400,-759,0.46716844017648584
93729,FRESNO,CA,980,1562,582,0.6144767899291896
93730,FRESNO,CA,3930,4696,766,0.5444006492000928
93737,FRESNO,CA,1385,2223,838,0.616130820399113
93744,FRESNO,CA,94,297,203,0.7595907928388747
93745,FRESNO,CA,186,129,-57,0.4095238095238095
93747,FRESNO,CA,190,601,411,0.7597977243994943
93755,FRESNO,CA,464,889,425,0.6570583887657059
93771,FRESNO,CA,0,11,11,1
93773,FRESNO,CA,0,11,11,1
93779,FRESNO,CA,126,0,-126,0
93790,FRESNO,CA,46,61,15,0.5700934579439252
93791,FRESNO,CA,13,17,4,0.5666666666666667
93794,FRESNO,CA,111,119,8,0.5173913043478261
93901,SALINAS,CA,9184,7331,-1853,0.44389948531637907
93902,SALINAS,CA,596,886,290,0.5978407557354926
93905,SALINAS,CA,8537,5626,-2911,0.3972322248111276
93906,SALINAS,CA,14332,11730,-2602,0.4500805770854117
93907,PRUNEDALE,CA,684,681,-3,0.4989010989010989
93907,SALINAS,CA,4760,4563,-197,0.48943473130966425
93908,CORRAL DE TIERRA,CA,272,319,47,0.5397631133671743
93908,SALINAS,CA,2430,2912,482,0.5451141894421565
93912,SALINAS,CA,1113,1844,731,0.6236050050727088
93915,SALINAS,CA,53,448,395,0.8942115768463074
93920,BIG SUR,CA,500,187,-313,0.27219796215429404
93921,CARMEL,CA,704,703,-1,0.4996446339729922
93921,CARMEL BY THE,CA,130,136,6,0.5112781954887218
93921,CARMEL BY THE SEA,CA,1017,949,-68,0.482706002034588
93922,CARMEL,CA,1382,1021,-361,0.4248855597170204
93923,CARMEL,CA,4300,5295,995,0.5518499218342887
93924,CARMEL VALLEY,CA,2429,2500,71,0.5072022722661798
93925,CHUALAR,CA,34,25,-9,0.423728813559322
93926,GONZALES,CA,953,670,-283,0.41281577325939617
93927,GREENFIELD,CA,2168,1873,-295,0.46349913387775304
93928,JOLON,CA,49,48,-1,0.4948453608247423
93930,KING CITY,CA,2291,2165,-126,0.4858617594254937
93932,LOCKWOOD,CA,12,19,7,0.6129032258064516
93933,EAST GARRISON,CA,1295,1328,33,0.5062905070529927
93933,MARINA,CA,9922,9742,-180,0.49542310821806346
93940,MONTEREY,CA,18239,15955,-2284,0.46660232789378253
93942,MONTEREY,CA,1032,1132,100,0.5231053604436229
93943,MONTEREY,CA,40,12,-28,0.23076923076923078
93944,MONTEREY,CA,12,91,79,0.883495145631068
93950,PACIFIC GROVE,CA,8301,7826,-475,0.48527314441619646
93953,PEBBLE BEACH,CA,2365,2236,-129,0.48598130841121495
93955,SEASIDE,CA,13969,11283,-2686,0.4468160937747505
93960,SOLEDAD,CA,2678,2646,-32,0.49699474079639366
93962,SPRECKELS,CA,25,29,4,0.5370370370370371
94002,BELMONT,CA,11762,10898,-864,0.48093556928508385
94005,BRISBANE,CA,2547,2089,-458,0.4506039689387403
94010,BURLINGAME,CA,16081,14844,-1237,0.48
94010,HILLSBOROUGH,CA,1390,1342,-48,0.4912152269399707
94011,BURLINGAME,CA,524,563,39,0.5179392824287029
94014,DALY CITY,CA,13661,10314,-3347,0.4301981230448384
94015,DALY CITY,CA,23335,17386,-5949,0.4269541514206429
94017,DALY CITY,CA,236,485,249,0.6726768377253814
94018,EL GRANADA,CA,985,1062,77,0.5188080117244749
94019,HALF MOON BAY,CA,4383,4262,-121,0.49300173510699824
94020,LA HONDA,CA,368,227,-141,0.3815126050420168
94022,LOS ALTOS,CA,4655,4953,298,0.5155079100749376
94022,LOS ALTOS HILLS,CA,2120,2201,81,0.5093728303633418
94023,LOS ALTOS,CA,256,347,91,0.5754560530679934
94024,LOS ALTOS,CA,5095,5812,717,0.5328687998533053
94024,LOS ALTOS HILLS,CA,411,463,52,0.5297482837528604
94025,MENLO PARK,CA,21178,18339,-2839,0.4640787509173267
94026,MENLO PARK,CA,848,948,100,0.5278396436525612
94027,ATHERTON,CA,1811,1987,176,0.5231700895208005
94028,PORTOLA VALLEY,CA,1822,2186,364,0.5454091816367266
94028,PORTOLA VALLY,CA,26,28,2,0.5185185185185185
94030,MILLBRAE,CA,8125,7492,-633,0.47973362361529104
94037,MONTARA,CA,514,669,155,0.5655114116652579
94038,MOSS BEACH,CA,816,752,-64,0.47959183673469385
94039,MOUNTAIN VIEW,CA,319,376,57,0.5410071942446043
94040,MOUNTAIN VIEW,CA,23924,20383,-3541,0.4600401742388336
94041,MOUNTAIN VIEW,CA,10818,9277,-1541,0.4616571286389649
94042,MOUNTAIN VIEW,CA,321,515,194,0.6160287081339713
94043,MOUNTAIN VIEW,CA,21141,17608,-3533,0.4544117267542388
94044,PACIFICA,CA,13652,12146,-1506,0.4708116908287464
94060,PESCADERO,CA,78,73,-5,0.48344370860927155
94061,REDWOOD CITY,CA,14764,12700,-2064,0.46242353626565685
94062,EMERALD HILLS,CA,890,773,-117,0.46482260974143114
94062,PALOMAR PARK,CA,163,134,-29,0.4511784511784512
94062,REDWOOD CITY,CA,7038,6705,-333,0.48788474132285525
94062,WOODSIDE,CA,1565,1403,-162,0.4727088948787062
94063,REDWOOD CITY,CA,17955,14706,-3249,0.450261780104712
94064,REDWOOD CITY,CA,335,266,-69,0.4425956738768719
94065,REDWOOD CITY,CA,5829,5670,-159,0.49308635533524653
94066,SAN BRUNO,CA,17462,14455,-3007,0.45289344236613716
94070,SAN CARLOS,CA,11745,11628,-117,0.49749711205236813
94080,S SAN FRAN,CA,771,680,-91,0.4686423156443832
94080,SOUTH SAN FRANCISCO,CA,19550,16946,-2604,0.4643248575186322
94083,S SAN FRAN,CA,40,56,16,0.5833333333333334
94083,SOUTH SAN FRANCISCO,CA,288,510,222,0.6390977443609023
94085,SUNNYVALE,CA,17691,15241,-2450,0.46280213773837
94086,SUNNYVALE,CA,37242,30761,-6481,0.4523476905430643
94087,SUNNYVALE,CA,24569,22292,-2277,0.47570474381681993
94088,SUNNYVALE,CA,541,715,174,0.5692675159235668
94089,SUNNYVALE,CA,14833,12538,-2295,0.45807606590917394
94102,SAN FRANCISCO,CA,23879,16634,-7245,0.4105842569051909
94103,SAN FRANCISCO,CA,29494,23245,-6249,0.4407554181914712
94104,SAN FRANCISCO,CA,4572,5021,449,0.5234024809757114
94105,SAN FRANCISCO,CA,20427,16350,-4077,0.4445713353454605
94107,SAN FRANCISCO,CA,32162,24987,-7175,0.43722549825893714
94108,SAN FRANCISCO,CA,9214,5515,-3699,0.3744313938488696
94109,SAN FRANCISCO,CA,45525,29182,-16343,0.3906193529388143
94110,SAN FRANCISCO,CA,38059,27670,-10389,0.42097095650321775
94111,SAN FRANCISCO,CA,7654,5644,-2010,0.424424725522635
94112,SAN FRANCISCO,CA,21893,15657,-6236,0.4169640479360852
94114,SAN FRANCISCO,CA,24259,20028,-4231,0.4522320319732653
94115,SAN FRANCISCO,CA,26611,21343,-5268,0.4450723610126371
94116,SAN FRANCISCO,CA,13318,10973,-2345,0.45173109382075666
94117,SAN FRANCISCO,CA,30837,21590,-9247,0.41181070822286225
94118,SAN FRANCISCO,CA,20877,15274,-5603,0.4225056015047993
94119,SAN FRANCISCO,CA,732,522,-210,0.41626794258373206
94121,SAN FRANCISCO,CA,17038,13418,-3620,0.44057000262674023
94122,SAN FRANCISCO,CA,25410,18803,-6607,0.42528215683170106
94123,SAN FRANCISCO,CA,22445,15776,-6669,0.41275738468381257
94124,SAN FRANCISCO,CA,10962,8304,-2658,0.4310183743382124
94126,SAN FRANCISCO,CA,129,184,55,0.5878594249201278
94127,SAN FRANCISCO,CA,5849,5918,69,0.5029319282739866
94128,SAN FRANCISCO,CA,432,208,-224,0.325
94129,SAN FRANCISCO,CA,3618,2726,-892,0.4296973518284994
94130,SAN FRANCISCO,CA,994,591,-403,0.3728706624605678
94131,SAN FRANCISCO,CA,14575,12249,-2326,0.45664330450342977
94132,SAN FRANCISCO,CA,11000,7812,-3188,0.4152668509462045
94133,SAN FRANCISCO,CA,15708,10313,-5395,0.3963337304484839
94134,SAN FRANCISCO,CA,10284,7843,-2441,0.43266949853809233
94140,SAN FRANCISCO,CA,89,398,309,0.8172484599589322
94141,SAN FRANCISCO,CA,359,685,326,0.6561302681992337
94142,SAN FRANCISCO,CA,527,513,-14,0.4932692307692308
94146,SAN FRANCISCO,CA,25,25,0,0.5
94147,SAN FRANCISCO,CA,298,394,96,0.569364161849711
94158,SAN FRANCISCO,CA,10857,8827,-2030,0.4484352773826458
94159,SAN FRANCISCO,CA,179,152,-27,0.459214501510574
94164,SAN FRANCISCO,CA,169,285,116,0.6277533039647577
94172,SAN FRANCISCO,CA,0,17,17,1
94188,SAN FRANCISCO,CA,293,602,309,0.6726256983240223
94301,PALO ALTO,CA,9638,8105,-1533,0.4567998647353886
94302,PALO ALTO,CA,397,401,4,0.5025062656641605
94303,EAST PALO ALTO,CA,6184,4949,-1235,0.4445342674930387
94303,PALO ALTO,CA,9575,8031,-1544,0.4561513120527093
94304,PALO ALTO,CA,3394,2917,-477,0.46220884170495957
94305,PALO ALTO,CA,179,239,60,0.5717703349282297
94305,STANFORD,CA,6555,4548,-2007,0.40961902188597676
94306,PALO ALTO,CA,13769,11974,-1795,0.46513615351746107
94309,PALO ALTO,CA,264,23,-241,0.08013937282229965
94309,STANFORD,CA,1409,77,-1332,0.051816958277254375
94401,SAN MATEO,CA,16206,12823,-3383,0.44173068310999347
94402,SAN MATEO,CA,10966,11432,466,0.5104027145280828
94403,SAN MATEO,CA,21963,19325,-2638,0.468053671769037
94404,FOSTER CITY,CA,20350,18540,-1810,0.47672923630753405
94404,SAN MATEO,CA,853,920,67,0.5188945290468133
94501,ALAMEDA,CA,28306,25933,-2373,0.4781245966924169
94502,ALAMEDA,CA,3503,3735,232,0.5160265266648245
94503,AMERICAN CANYON,CA,4685,4699,14,0.5007459505541347
94503,AMERICAN CYN,CA,251,238,-13,0.4867075664621677
94505,BYRON,CA,233,243,10,0.5105042016806722
94505,DISCOVERY BAY,CA,5479,5744,265,0.5118061124476522
94506,BLACKHAWK,CA,683,927,244,0.575776397515528
94506,DANVILLE,CA,5557,6745,1188,0.5482848317346772
94507,ALAMO,CA,3836,4822,986,0.5569415569415569
94508,ANGWIN,CA,1808,1022,-786,0.36113074204947
94509,ANTIOCH,CA,26447,20629,-5818,0.43820630469878497
94510,BENICIA,CA,10445,9797,-648,0.48399367651417846
94511,BETHEL ISLAND,CA,752,960,208,0.5607476635514018
94513,BRENTWOOD,CA,19809,22097,2288,0.5272991934329213
94514,BYRON,CA,62,11,-51,0.1506849315068493
94515,CALISTOGA,CA,2778,2424,-354,0.4659746251441753
94517,CLAYTON,CA,3099,3556,457,0.5343350864012021
94518,CONCORD,CA,8884,8158,-726,0.4786996831357822
94519,BENICIA,CA,134,140,6,0.5109489051094891
94519,CONCORD,CA,5860,5400,-460,0.47957371225577267
94520,CONCORD,CA,16659,13789,-2870,0.4528704676826064
94521,CONCORD,CA,12841,12402,-439,0.4913045200649685
94522,CONCORD,CA,229,495,266,0.6837016574585635
94523,PLEASANT HILL,CA,14599,14036,-563,0.49016937314475295
94523,PLEASANTHILL,CA,246,222,-24,0.47435897435897434
94524,CONCORD,CA,522,819,297,0.610738255033557
94525,CROCKETT,CA,1790,1302,-488,0.42108667529107374
94526,DANVILLE,CA,9487,10375,888,0.5223542442855704
94528,DIABLO,CA,49,75,26,0.6048387096774194
94530,EL CERRITO,CA,10909,10388,-521,0.4877682302671738
94531,ANTIOCH,CA,15148,15657,509,0.5082616458367148
94533,FAIRFIELD,CA,27783,24908,-2875,0.47271830103812795
94534,FAIRFIELD,CA,12153,12665,512,0.5103150938834716
94535,FAIRFIELD,CA,128,131,3,0.5057915057915058
94535,TRAVIS AFB,CA,3055,3535,480,0.5364188163884673
94536,FREMONT,CA,30036,27314,-2722,0.47626852659110724
94537,FREMONT,CA,559,892,333,0.6147484493452792
94538,FREMONT,CA,36508,32850,-3658,0.473629574093832
94539,FREMONT,CA,13997,16497,2500,0.5409916704925559
94540,HAYWARD,CA,671,818,147,0.5493619879113499
94541,HAYWARD,CA,22690,18352,-4338,0.4471516982603187
94542,HAYWARD,CA,5060,4609,-451,0.47667804323094426
94543,HAYWARD,CA,124,78,-46,0.38613861386138615
94544,HAYWARD,CA,24554,20788,-3766,0.4584711746283799
94545,HAYWARD,CA,10242,8748,-1494,0.4606635071090047
94546,CASTRO VALLEY,CA,14449,13526,-923,0.483503127792672
94546,HAYWARD,CA,240,244,4,0.5041322314049587
94547,HERCULES,CA,6891,6913,22,0.5007968704723269
94548,KNIGHTSEN,CA,47,38,-9,0.4470588235294118
94549,LAFAYETTE,CA,9379,10156,777,0.5198873816227284
94550,LIVERMORE,CA,14628,14603,-25,0.49957237179706476
94551,LIVERMORE,CA,14037,14179,142,0.5025163028069181
94552,CASTRO VALLEY,CA,2940,3201,261,0.5212506106497313
94553,MARTINEZ,CA,11817,11597,-220,0.4953019560946442
94553,PACHECO,CA,4216,4359,143,0.508338192419825
94555,FREMONT,CA,11173,10712,-461,0.48946767192140733
94556,MORAGA,CA,4079,4538,459,0.5266333990948125
94557,HAYWARD,CA,18,76,58,0.8085106382978723
94557,MOUNT EDEN,CA,0,13,13,1
94558,NAPA,CA,21579,21031,-548,0.4935695846045529
94559,NAPA,CA,12253,11158,-1095,0.47661355772927255
94560,DUBLIN,CA,381,401,20,0.5127877237851662
94560,NEWARK,CA,15966,16782,816,0.5124587761084647
94561,OAKLEY,CA,12832,13360,528,0.5100794135613927
94563,ORINDA,CA,5114,6455,1341,0.5579566081770249
94564,PINOLE,CA,5820,5572,-248,0.48911516853932585
94565,BAY POINT,CA,2555,2397,-158,0.48404684975767365
94565,PITTSBURG,CA,27783,24836,-2947,0.4719968072369296
94566,PLEASANTON,CA,15951,16479,528,0.508140610545791
94567,POPE VALLEY,CA,36,11,-25,0.23404255319148937
94568,DUBLIN,CA,29196,29155,-41,0.49964867782900035
94569,PORT COSTA,CA,29,0,-29,0
94570,MORAGA,CA,13,26,13,0.6666666666666666
94571,RIO VISTA,CA,3979,4785,806,0.5459835691465085
94572,RODEO,CA,2444,2228,-216,0.4768835616438356
94572,SEBASTOPOL,CA,58,55,-3,0.48672566371681414
94573,RUTHERFORD,CA,63,22,-41,0.25882352941176473
94574,SAINT HELENA,CA,3795,3195,-600,0.4570815450643777
94576,DEER PARK,CA,23,0,-23,0
94577,SAN LEANDRO,CA,15550,13917,-1633,0.47229103743170325
94578,SAN LEANDRO,CA,14964,11987,-2977,0.4447701383993173
94579,SAN LEANDRO,CA,4816,4517,-299,0.4839815707703847
94580,SAN LORENZO,CA,7502,6770,-732,0.4743553811659193
94581,NAPA,CA,351,325,-26,0.4807692307692308
94582,SAN RAMON,CA,14147,14808,661,0.5114142635123468
94583,SAN RAMON,CA,14466,15135,669,0.5113002939089896
94585,SUISUN CITY,CA,9829,9191,-638,0.4832281808622503
94586,SUNOL,CA,57,143,86,0.715
94587,UNION CITY,CA,23422,20680,-2742,0.46891297446827807
94588,PLEASANTON,CA,16168,15095,-1073,0.48283913891821
94589,VALLEJO,CA,8968,7458,-1510,0.454036283940095
94590,VALLEJO,CA,17174,15146,-2028,0.4686262376237624
94591,VALLEJO,CA,17631,16561,-1070,0.48435306504445486
94592,VALLEJO,CA,349,224,-125,0.39092495636998253
94595,LAFAYETTE,CA,111,97,-14,0.46634615384615385
94595,WALNUT CREEK,CA,6727,7256,529,0.5189158263605808
94596,WALNUT CREEK,CA,15968,13980,-1988,0.4668091358354481
94597,WALNUT CREEK,CA,14527,12795,-1732,0.4683039308981773
94598,WALNUT CREEK,CA,8924,10104,1180,0.5310069371452596
94599,YOUNTVILLE,CA,1395,1330,-65,0.48807339449541287
94601,OAKLAND,CA,14167,10556,-3611,0.42697083687254783
94602,OAKLAND,CA,10407,9633,-774,0.48068862275449104
94603,OAKLAND,CA,9195,7012,-2183,0.43265255753686677
94604,OAKLAND,CA,885,1478,593,0.6254760897164621
94605,EMERYVILLE,CA,322,201,-121,0.384321223709369
94605,OAKLAND,CA,15307,12726,-2581,0.4539649698569543
94606,OAKLAND,CA,17524,12643,-4881,0.41910034143269137
94607,OAKLAND,CA,18229,14842,-3387,0.4487919929847903
94608,EMERYVILLE,CA,25613,18664,-6949,0.42152810714366373
94608,OAKLAND,CA,615,453,-162,0.4241573033707865
94609,OAKLAND,CA,15543,13267,-2276,0.4604998264491496
94610,OAKLAND,CA,17993,14274,-3719,0.44237146310472
94610,PIEDMONT,CA,309,257,-52,0.4540636042402827
94611,OAKLAND,CA,16314,15647,-667,0.489565407840806
94611,PIEDMONT,CA,2823,2877,54,0.5047368421052632
94612,OAKLAND,CA,19293,17559,-1734,0.47647346141322044
94614,OAKLAND,CA,24,62,38,0.7209302325581395
94617,OAKLAND,CA,0,12,12,1
94618,OAKLAND,CA,7767,6992,-775,0.47374483366081716
94619,OAKLAND,CA,8636,7703,-933,0.4714486810698329
94620,OAKLAND,CA,11,0,-11,0
94620,PIEDMONT,CA,11,0,-11,0
94621,OAKLAND,CA,9038,6563,-2475,0.42067816165630406
94623,OAKLAND,CA,211,612,401,0.7436208991494532
94662,EMERYVILLE,CA,489,1054,565,0.6830848995463383
94701,BERKELEY,CA,50,78,28,0.609375
94702,BERKELEY,CA,8574,7339,-1235,0.46119524916734744
94703,BERKELEY,CA,11216,8376,-2840,0.42752143732135567
94704,BERKELEY,CA,13537,7271,-6266,0.3494329104190696
94705,BERKELEY,CA,7581,6467,-1114,0.4603502277904328
94706,ALBANY,CA,9031,7812,-1219,0.4638128599418156
94706,BERKELEY,CA,152,131,-21,0.4628975265017668
94707,ALBANY,CA,267,300,33,0.5291005291005291
94707,BERKELEY,CA,3162,3484,322,0.5242250978031899
94707,KENSINGTON,CA,642,719,77,0.5282880235121235
94708,BERKELEY,CA,3107,3287,180,0.5140756959649672
94708,KENSINGTON,CA,922,947,25,0.5066880684858213
94709,BERKELEY,CA,7699,4838,-2861,0.38589774268166227
94710,ALBANY,CA,169,91,-78,0.35
94710,BERKELEY,CA,5160,4374,-786,0.45877910635619884
94720,BERKELEY,CA,19,47,28,0.7121212121212122
94801,NORTH RICHMOND,CA,169,129,-40,0.43288590604026844
94801,POINT RICHMOND,CA,1298,1095,-203,0.4575846218136231
94801,RICHMOND,CA,6724,5746,-978,0.46078588612670407
94802,RICHMOND,CA,115,321,206,0.7362385321100917
94803,EL SOBRANTE,CA,7244,6934,-310,0.4890675694738327
94803,RICHMOND,CA,355,253,-102,0.4161184210526316
94804,RICHMOMD,CA,304,211,-93,0.4097087378640777
94804,RICHMOND,CA,13337,11543,-1794,0.4639469453376206
94805,RICHMOND,CA,4371,3947,-424,0.4745131041115653
94806,RICHMOND,CA,380,284,-96,0.42771084337349397
94806,SAN PABLO,CA,18520,14168,-4352,0.4334312285854136
94807,RICHMOND,CA,0,55,55,1
94820,EL SOBRANTE,CA,225,437,212,0.66012084592145015
94820,RICHMOND,CA,0,20,20,1
94901,SAN RAFAEL,CA,13281,12224,-1057,0.4792785728288571
94903,SAN RAFAEL,CA,10802,10921,119,0.5027390323620126
94904,GREENBRAE,CA,2918,2958,40,0.5034036759700476
94904,KENTFIELD,CA,1336,1343,7,0.5013064576334453
94912,SAN RAFAEL,CA,484,640,156,0.5693950177935944
94913,SAN RAFAEL,CA,0,53,53,1
94914,KENTFIELD,CA,11,24,13,0.6857142857142857
94915,SAN RAFAEL,CA,484,361,-123,0.4272189349112426
94920,BEL TIBURON,CA,640,627,-13,0.494869771112865
94920,BELVEDERE TIBURON,CA,3542,3589,47,0.5032954704809984
94920,TIBURON,CA,1798,1931,133,0.5178331992491284
94922,BODEGA,CA,11,0,-11,0
94923,BODEGA BAY,CA,583,641,58,0.5236928104575164
94924,BOLINAS,CA,226,159,-67,0.412987012987013
94925,CORTE MADERA,CA,3979,4169,190,0.5116593028964163
94927,ROHNERT PARK,CA,589,698,109,0.5423465423465423
94928,ROHNERT PARK,CA,19231,18210,-1021,0.48636521460431076
94930,FAIRFAX,CA,3121,3107,-14,0.49887604367373156
94931,COTATI,CA,4048,3763,-285,0.4817564972474715
94933,FOREST KNOLLS,CA,46,28,-18,0.3783783783783784
94937,INVERNESS,CA,139,235,96,0.6283422459893048
94938,LAGUNITAS,CA,35,25,-10,0.4166666666666667
94939,LARKSPUR,CA,4246,3725,-521,0.46731903148914816
94941,MILL VALLEY,CA,12114,12528,414,0.508400292184076
94942,MILL VALLEY,CA,567,550,-17,0.4923903312444047
94945,NOVATO,CA,5324,5408,84,0.5039135296310101
94946,NICASIO,CA,45,29,-16,0.3918918918918919
94947,NOVATO,CA,7157,7042,-115,0.4959504190435946
94948,NOVATO,CA,770,879,109,0.533050333535476
94949,NOVATO,CA,6390,5976,-414,0.48326055312954874
94951,PENNGROVE,CA,1538,1577,39,0.5062600321027287
94952,PETALUMA,CA,11259,11244,-15,0.49966671110518596
94953,PETALUMA,CA,374,676,302,0.6438095238095238
94954,PETALUMA,CA,12703,12380,-323,0.49356137623091334
94955,PETALUMA,CA,48,33,-15,0.4074074074074074
94956,POINT REYES STATION,CA,152,227,75,0.5989445910290238
94957,ROSS,CA,462,433,-29,0.48379888268156424
94960,SAN ANSELMO,CA,4689,4940,251,0.5130335445009866
94963,SAN GERONIMO,CA,11,51,40,0.8225806451612904
94964,SAN QUENTIN,CA,11,0,-11,0
94965,MUIR BEACH,CA,163,146,-17,0.47249190938511326
94965,SAUSALITO,CA,6946,6533,-413,0.4846798723940945
94966,SAUSALITO,CA,452,362,-90,0.44471744471744473
94970,STINSON BEACH,CA,48,11,-37,0.1864406779661017
94971,TOMALES,CA,22,0,-22,0
94973,WOODACRE,CA,164,262,98,0.6150234741784038
94975,PETALUMA,CA,438,561,123,0.5615615615615616
94976,CORTE MADERA,CA,68,79,11,0.5374149659863946
94977,LARKSPUR,CA,25,41,16,0.6212121212121212
94978,FAIRFAX,CA,52,122,70,0.7011494252873564
94979,SAN ANSELMO,CA,42,44,2,0.5116279069767442
95001,APTOS,CA,959,983,24,0.5061791967044285
95002,ALVISO,CA,359,284,-75,0.4416796267496112
95003,APTOS,CA,8798,8130,-668,0.48026937618147447
95004,AROMAS,CA,1022,984,-38,0.4905284147557328
95005,BEN LOMOND,CA,2381,1938,-443,0.4487149803195184
95006,BOULDER CREEK,CA,4807,3276,-1531,0.40529506371396756
95007,BROOKDALE,CA,149,52,-97,0.25870646766169153
95008,CAMPBELL,CA,23882,20885,-2997,0.4665266826010231
95009,CAMPBELL,CA,247,198,-49,0.4449438202247191
95010,CAPITOLA,CA,5273,4798,-475,0.476417436202959
95011,CAMPBELL,CA,595,860,265,0.5910652920962199
95011,SAN JOSE,CA,13,21,8,0.6176470588235294
95012,CASTROVILLE,CA,1613,1410,-203,0.4664240820377109
95013,COYOTE,CA,0,11,11,1
95014,CUPERTINO,CA,25883,23930,-1953,0.4803966835966515
95015,CUPERTINO,CA,675,769,94,0.5325484764542936
95017,DAVENPORT,CA,237,36,-201,0.13186813186813187
95018,FELTON,CA,3380,2962,-418,0.467045096184169
95019,FREEDOM,CA,1505,1428,-77,0.48687350835322196
95020,GILROY,CA,17235,16330,-905,0.4865186950692686
95021,GILROY,CA,946,1508,562,0.6145069274653626
95023,HOLLISTER,CA,14480,14713,233,0.503990682697907
95024,HOLLISTER,CA,951,1003,52,0.5133060388945753
95030,LOS GATOS,CA,3685,3751,66,0.5044378698224852
95030,MONTE SERENO,CA,1205,1163,-42,0.49113175675675674
95031,LOS GATOS,CA,827,911,84,0.5241657077100115
95032,LOS GATOS,CA,10218,10412,194,0.5047018904507998
95033,LOS GATOS,CA,2935,2896,-39,0.49665580517921454
95035,MILPITAS,CA,34392,32690,-1702,0.48731403357085357
95036,MILPITAS,CA,746,1044,298,0.5832402234636872
95037,MORGAN HILL,CA,14288,15297,1009,0.5170525604191313
95038,MORGAN HILL,CA,980,1106,126,0.5302013422818792
95039,MOSS LANDING,CA,267,209,-58,0.43907563025210083
95041,MOUNT HERMON,CA,86,24,-62,0.21818181818181817
95043,PAICINES,CA,36,26,-10,0.41935483870967744
95045,SAN JUAN BAUTISTA,CA,1436,1412,-24,0.4957865168539326
95046,SAN MARTIN,CA,1819,1907,88,0.511808910359635
95050,SANTA CLARA,CA,20521,17483,-3038,0.46003052310283127
95051,SANTA CLARA,CA,38422,33660,-4762,0.4669681751338753
95052,SANTA CLARA,CA,252,361,109,0.5889070146818923
95052,VALLEY SPRINGS,CA,14,14,0,0.5
95054,SANTA CLARA,CA,19234,17658,-1576,0.4786403556326575
95055,SANTA CLARA,CA,629,903,274,0.589425587467363
95056,SANTA CLARA,CA,215,151,-64,0.412568306010929
95060,SANTA CRUZ,CA,20817,17360,-3457,0.4547240485108835
95061,SANTA CRUZ,CA,984,890,-94,0.47491995731056563
95062,SANTA CRUZ,CA,15082,12925,-2157,0.4614917699146642
95063,SANTA CRUZ,CA,1587,1316,-271,0.45332414743368926
95064,SANTA CRUZ,CA,355,413,58,0.5377604166666666
95065,SANTA CRUZ,CA,2598,2570,-28,0.49729102167182665
95066,SANTA CRUZ,CA,82,88,6,0.5176470588235295
95066,SCOTTS VALLEY,CA,4875,5007,132,0.5066788099574985
95067,SCOTTS VALLEY,CA,578,498,-80,0.4628252788104089
95070,SARATOGA,CA,7680,9315,1635,0.5481023830538394
95073,SOQUEL,CA,3937,3675,-262,0.482790331056227
95073,SOQURL DR,CA,93,68,-25,0.422360248447205
95075,TRES PINOS,CA,17,56,39,0.7671232876712328
95076,LA SELVA BEACH,CA,411,322,-89,0.4392905866302865
95076,MT MADONNA,CA,310,274,-36,0.4691780821917808
95076,ROYAL OAKS,CA,2346,2043,-303,0.4654818865345181
95076,WATSONVILLE,CA,11697,10526,-1171,0.47365342213022543
95077,WATSONVILLE,CA,604,1031,427,0.6305810397553517
95103,SAN JOSE,CA,25,114,89,0.8201438848920863
95106,SAN JOSE,CA,14,170,156,0.9239130434782609
95109,SAN JOSE,CA,163,211,48,0.5641711229946524
95110,SAN JOSE,CA,10567,8906,-1661,0.45735120423150005
95111,SAN JOSE,CA,15367,11798,-3569,0.4343088533038837
95112,SAN JOSE,CA,28444,22288,-6156,0.43932823464480014
95113,SAN JOSE,CA,3981,3334,-647,0.4557758031442242
95116,SAN JOSE,CA,13780,9947,-3833,0.41922704092384205
95117,SAN JOSE,CA,13223,10716,-2507,0.44763774593759137
95118,SAN JOSE,CA,10258,9389,-869,0.47788466432534227
95119,SAN JOSE,CA,3038,3818,780,0.5568844807467911
95120,SAN JOSE,CA,7520,8752,1232,0.5378564405113078
95121,SAN JOSE,CA,8783,7468,-1315,0.45954095132607226
95122,SAN JOSE,CA,15082,9971,-5111,0.3979962479543368
95123,SAN JOSE,CA,27596,23787,-3809,0.4629352120351089
95124,SAN JOSE,CA,13789,13482,-307,0.49437131018297825
95125,SAN JOSE,CA,19861,18885,-976,0.48740515149950964
95126,SAN JOSE,CA,24238,20314,-3924,0.4559615729933561
95127,SAN JOSE,CA,15236,12493,-2743,0.4505391467416784
95128,SAN JOSE,CA,17291,14499,-2792,0.4560868197546398
95129,SAN JOSE,CA,16282,14858,-1424,0.4771355170199101
95130,SAN JOSE,CA,4308,3840,-468,0.47128129602356406
95131,SAN JOSE,CA,14442,12138,-2304,0.4566591422121896
95132,SAN JOSE,CA,12514,10667,-1847,0.46016133902765194
95133,SAN JOSE,CA,10518,9513,-1005,0.47491388348060504
95134,SAN JOSE,CA,36303,30694,-5609,0.4581399167126886
95135,SAN JOSE,CA,4462,5124,662,0.534529522219904
95136,SAN JOSE,CA,19253,16851,-2402,0.4667349878129847
95138,SAN JOSE,CA,4662,4718,56,0.5029850746268657
95139,SAN JOSE,CA,1528,1661,133,0.5208529319535905
95148,SAN JOSE,CA,9568,8563,-1005,0.47228503667751365
95150,SAN JOSE,CA,778,957,179,0.5515850144092219
95151,SAN JOSE,CA,707,1299,592,0.6475573280159521
95152,SAN JOSE,CA,184,503,319,0.7321688500727802
95153,SAN JOSE,CA,625,845,220,0.5748299319727891
95154,SAN JOSE,CA,423,505,82,0.5441810344827587
95155,SAN JOSE,CA,26,38,12,0.59375
95156,SAN JOSE,CA,321,738,417,0.6968838526912181
95157,SAN JOSE,CA,518,559,41,0.5190343546889508
95158,SAN JOSE,CA,255,516,261,0.669260700389105
95159,SAN JOSE,CA,501,636,135,0.5593667546174143
95160,SAN JOSE,CA,775,159,-616,0.1702355460385439
95161,SAN JOSE,CA,811,1198,387,0.5963165754106521
95164,SAN JOSE,CA,263,89,-174,0.2528409090909091
95172,SAN JOSE,CA,15,57,42,0.7916666666666666
95173,SAN JOSE,CA,270,478,208,0.6390374331550802
95201,STOCKTON,CA,736,1144,408,0.6085106382978723
95202,STOCKTON,CA,3816,2893,-923,0.43121180503800866
95203,STOCKTON,CA,5601,5051,-550,0.4741832519714608
95204,STOCKTON,CA,10893,9667,-1226,0.47018482490272373
95205,STOCKTON,CA,9439,8433,-1006,0.4718554162936437
95206,STOCKTON,CA,15743,14442,-1301,0.47844956104025177
95207,STOCKTON,CA,19965,17212,-2753,0.46297441966807434
95208,STOCKTON,CA,692,1610,918,0.6993918331885317
95209,STOCKTON,CA,12022,11391,-631,0.4865245803613377
95210,STOCKTON,CA,11662,10081,-1581,0.46364347146207974
95212,STOCKTON,CA,6393,6331,-62,0.4975636592266583
95213,STOCKTON,CA,247,708,461,0.7413612565445026
95215,STOCKTON,CA,4470,4287,-183,0.4895512161699212
95219,STOCKTON,CA,11536,10940,-596,0.4867414130628226
95220,ACAMPO,CA,1724,1772,48,0.5068649885583524
95221,ALTAVILLE,CA,145,80,-65,0.35555555555555557
95221,ANGELS CAMP,CA,0,26,26,1
95222,ANGELS CAMP,CA,1541,1652,111,0.517381772627623
95223,ARNOLD,CA,2039,1221,-818,0.3745398773006135
95223,CAMP CONNELL,CA,296,267,-29,0.47424511545293074
95224,AVERY,CA,0,11,11,1
95225,BURSON,CA,78,77,-1,0.4967741935483871
95227,CLEMENTS,CA,117,120,3,0.5063291139240507
95228,COPPEROPOLIS,CA,1973,2268,295,0.534779533128979
95230,FARMINGTON,CA,12,25,13,0.6756756756756757
95231,FRENCH CAMP,CA,1185,1470,285,0.5536723163841808
95236,LINDEN,CA,1555,1178,-377,0.43102817416758143
95237,LOCKEFORD,CA,985,1283,298,0.5656966490299824
95240,LODI,CA,14953,13423,-1530,0.4730405976881872
95241,LODI,CA,777,1347,570,0.634180790960452
95242,LODI,CA,9041,9830,789,0.5209050924699274
95245,MOKELUMNE HILL,CA,602,747,145,0.5537435137138621
95245,MOKELUMNE HL,CA,16,11,-5,0.4074074074074074
95246,MOUNTAIN RANCH,CA,463,421,-42,0.4762443438914027
95246,MTN RANCH,CA,11,17,6,0.6071428571428571
95246,SHEEP RANCH,CA,22,25,3,0.5319148936170213
95247,MURPHYS,CA,1620,1744,124,0.5184304399524375
95248,RAIL ROAD FLAT,CA,27,0,-27,0
95249,SAN ANDREAS,CA,1598,1765,167,0.5248290217068095
95251,VALLECITO,CA,11,0,-11,0
95252,VALLEY SPGS,CA,164,170,6,0.5089820359281437
95252,VALLEY SPRINGS,CA,4782,4768,-14,0.49926701570680626
95253,VICTOR,CA,0,34,34,1
95254,WALLACE,CA,0,22,22,1
95255,WEST POINT,CA,578,699,121,0.5473766640563822
95257,WILSEYVILLE,CA,0,11,11,1
95258,WOODBRIDGE,CA,1518,1664,146,0.5229415461973601
95267,STOCKTON,CA,361,987,626,0.7321958456973294
95269,STOCKTON,CA,1247,2022,775,0.6185377791373509
95301,ATWATER,CA,10793,10378,-415,0.49019885692692833
95303,BALLICO,CA,26,13,-13,0.3333333333333333
95304,TRACY,CA,4734,4799,65,0.5034092101122417
95305,BIG OAK FLAT,CA,11,0,-11,0
95306,CATHEYS VALLEY,CA,65,88,23,0.5751633986928104
95307,CERES,CA,12222,10956,-1266,0.4726896194667357
95309,CHINESE CAMP,CA,11,0,-11,0
95310,COLUMBIA,CA,1080,1023,-57,0.4864479315263909
95311,COULTERVILLE,CA,810,796,-14,0.49564134495641343
95313,CROWS LANDING,CA,130,130,0,0.5
95315,DELHI,CA,2716,2092,-624,0.435108153078203
95316,DENAIR,CA,1895,1748,-147,0.47982432061487784
95317,EL NIDO,CA,36,12,-24,0.25
95318,EL PORTAL,CA,136,14,-122,0.09333333333333334
95319,EMPIRE,CA,1141,731,-410,0.390491452991453
95320,ESCALON,CA,3443,3365,-78,0.4942714453584019
95321,GROVELAND,CA,2009,1676,-333,0.45481682496607867
95322,GUSTINE,CA,2257,2124,-133,0.48482081716503084
95322,SANTA NELLA,CA,187,184,-3,0.49595687331536387
95323,HICKMAN,CA,44,126,82,0.7411764705882353
95324,HILMAR,CA,2034,1787,-247,0.4676786181627846
95326,HUGHSON,CA,2537,2586,49,0.5047823540894008
95327,JAMESTOWN,CA,2447,2327,-120,0.4874319229157939
95328,KEYES,CA,1002,952,-50,0.4872057318321392
95329,LA GRANGE,CA,877,949,72,0.5197152245345017
95330,LATHROP,CA,7085,10751,3666,0.6027696793002916
95333,LE GRAND,CA,349,280,-69,0.4451510333863275
95334,LIVINGSTON,CA,3667,3511,-156,0.4891334633602675
95336,MANTECA,CA,15070,15446,376,0.506160702582252
95337,MANTECA,CA,14086,16368,2282,0.5374663426807644
95338,MARIPOSA,CA,3755,3896,141,0.5092144817670893
95340,MERCED,CA,12976,13070,94,0.5018044997312447
95341,MERCED,CA,9092,8322,-770,0.47789135178591935
95344,MERCED,CA,530,834,304,0.6114369501466276
95345,MIDPINES,CA,55,88,33,0.6153846153846154
95346,MI WUK VILLAGE,CA,428,272,-156,0.38857142857142857
95346,MI WUK VLG,CA,19,0,-19,0
95348,MERCED,CA,14167,13793,-374,0.4933118741058655
95350,MODESTO,CA,19333,17174,-2159,0.4704303284301641
95351,MODESTO,CA,12209,9082,-3127,0.4265652153492086
95352,MODESTO,CA,220,475,255,0.6834532374100719
95353,MODESTO,CA,638,1476,838,0.6982024597918638
95354,MODESTO,CA,9316,8168,-1148,0.46716998398535803
95355,MODESTO,CA,21866,19610,-2256,0.4728035490404089
95356,MODESTO,CA,12219,10855,-1364,0.47044292277021754
95357,MODESTO,CA,4199,4063,-136,0.49176954732510286
95358,MODESTO,CA,6910,6468,-442,0.4834803408581253
95360,NEWMAN,CA,3157,3011,-146,0.4881647211413748
95361,OAKDALE,CA,12170,11532,-638,0.4865412201501983
95363,DIABLO GRANDE,CA,466,478,12,0.5063559322033898
95363,PATTERSON,CA,6875,6955,80,0.5028922631959508
95364,PINECREST,CA,12,0,-12,0
95365,PLANADA,CA,253,249,-4,0.4960159362549801
95366,RIPON,CA,5325,5393,68,0.5031722336256764
95367,RIVERBANK,CA,6230,6152,-78,0.4968502665159102
95368,SALIDA,CA,4030,3202,-828,0.44275442477876104
95369,SNELLING,CA,65,75,10,0.5357142857142857
95370,SONORA,CA,11203,10577,-626,0.4856290174471993
95372,SOULSBYVILLE,CA,870,938,68,0.5188053097345132
95374,STEVINSON,CA,313,246,-67,0.4400715563506261
95376,TRACY,CA,16472,14746,-1726,0.47235569222884233
95377,TRACY,CA,9363,12134,2771,0.5644508536074802
95378,TRACY,CA,485,930,445,0.657243816254417
95379,TUOLUMNE,CA,1304,1293,-11,0.4978821717366192
95380,TURLOCK,CA,14776,10879,-3897,0.4240498928084194
95381,TURLOCK,CA,1167,1523,356,0.5661710037174721
95382,TURLOCK,CA,14278,11034,-3244,0.4359197218710493
95383,TWAIN HARTE,CA,2177,1971,-206,0.475168756027001
95386,WATERFORD,CA,2863,2880,17,0.5014800626850079
95387,WESTLEY,CA,48,59,11,0.5514018691588785
95388,WINTON,CA,5935,3071,-2864,0.3409948922940262
95389,YOSEMITE NATIONAL PARK,CA,1345,369,-976,0.21528588098016335
95391,MOUNTAIN HOUSE,CA,3293,5204,1911,0.6124514534541603
95391,MTN HOUSE,CA,245,406,161,0.6236559139784946
95391,TRACY,CA,2787,3997,1210,0.5891804245283019
95401,SANTA ROSA,CA,14886,12543,-2343,0.4572897298479711
95402,SANTA ROSA,CA,1940,2322,382,0.5448146410136087
95403,SANTA ROSA,CA,18062,19230,1168,0.5156601952161322
95404,SANTA ROSA,CA,16641,15427,-1214,0.4810714731196208
95405,SANTA ROSA,CA,9190,9050,-140,0.4961622807017544
95406,SANTA ROSA,CA,674,938,264,0.5818858560794045
95407,SANTA ROSA,CA,12466,11035,-1431,0.46955448704310454
95409,SANTA ROSA,CA,11680,11368,-312,0.4932315168344325
95410,ALBION,CA,63,49,-14,0.4375
95415,BOONVILLE,CA,49,40,-9,0.449438202247191
95416,BOYES HOT SPRINGS,CA,76,20,-56,0.20833333333333334
95420,CASPAR,CA,20,0,-20,0
95421,CAZADERO,CA,356,368,12,0.5082872928176796
95422,CLEARLAKE,CA,5755,4985,-770,0.46415270018621974
95423,CLEARLAKE OAKS,CA,1578,1587,9,0.5014218009478673
95423,CLEARLAKE OKS,CA,71,83,12,0.538961038961039
95424,CLEARLAKE PARK,CA,130,0,-130,0
95425,CLOVERDALE,CA,3936,3588,-348,0.4768740031897927
95426,COBB,CA,724,538,-186,0.42630744849445323
95427,COMPTCHE,CA,0,12,12,1
95428,COVELO,CA,444,333,-111,0.42857142857142855
95431,ELDRIDGE,CA,12,0,-12,0
95432,ELK,CA,11,11,0,0.5
95433,EL VERANO,CA,54,0,-54,0
95436,FORESTVILLE,CA,2225,2121,-104,0.4880349746893695
95437,FORT BRAGG,CA,5376,5290,-86,0.49596849803112697
95439,FULTON,CA,73,83,10,0.532051282051282
95441,GEYSERVILLE,CA,295,262,-33,0.4703770197486535
95442,GLEN ELLEN,CA,1186,1170,-16,0.4966044142614601
95443,GLENHAVEN,CA,11,0,-11,0
95444,GRATON,CA,506,326,-180,0.3918269230769231
95445,GUALALA,CA,1034,1072,38,0.5090218423551757
95446,GUERNEVILLE,CA,2925,2357,-568,0.44623248769405527
95448,HEALDSBURG,CA,6210,6166,-44,0.4982223658694247
95449,HOPLAND,CA,279,200,-79,0.4175365344467641
95450,JENNER,CA,35,11,-24,0.2391304347826087
95451,KELSEYVILLE,CA,4302,4032,-270,0.4838012958963283
95452,KENWOOD,CA,371,491,120,0.5696055684454756
95453,LAKEPORT,CA,4503,4370,-133,0.4925053533190578
95454,LAYTONVILLE,CA,503,359,-144,0.41647331786542924
95456,LITTLE RIVER,CA,534,100,-434,0.15772870662460567
95457,LOWER LAKE,CA,1234,1239,5,0.5010109179134654
95458,LUCERNE,CA,1153,1127,-26,0.49429824561403507
95459,MANCHESTER,CA,37,31,-6,0.45588235294117646
95460,MENDOCINO,CA,1151,1219,68,0.5143459915611814
95461,MIDDLETOWN,CA,1583,1250,-333,0.44122837980938934
95462,MONTE RIO,CA,645,431,-214,0.40055762081784385
95462,SACRAMENTO,CA,0,11,11,1
95464,NICE,CA,838,866,28,0.5082159624413145
95465,OCCIDENTAL,CA,796,866,70,0.5210589651022864
95466,PHILO,CA,551,128,-423,0.18851251840942562
95467,HIDDEN VALLEY LAKE,CA,1866,1847,-19,0.49744142203070296
95467,HIDDEN VL LK,CA,139,130,-9,0.483271375464684
95468,POINT ARENA,CA,232,160,-72,0.40816326530612246
95469,POTTER VALLEY,CA,471,171,-300,0.26635514018691586
95470,REDWOOD VALLEY,CA,1635,1503,-132,0.4789674952198853
95471,RIO NIDO,CA,39,0,-39,0
95472,FREESTONE,CA,218,260,42,0.5439330543933054
95472,SEBASTOPOL,CA,9339,9519,180,0.504772510340439
95473,SEBASTOPOL,CA,843,865,22,0.5064402810304449
95476,SONOMA,CA,11003,11469,466,0.5103684585261659
95481,TALMAGE,CA,1024,25,-999,0.023832221163012392
95482,UKIAH,CA,11040,9460,-1580,0.46146341463414636
95485,UPPER LAKE,CA,1070,912,-158,0.4601412714429869
95487,VINEBURG,CA,60,12,-48,0.16666666666666666
95490,WILLITS,CA,5612,4660,-952,0.45366043613707163
95492,WINDSOR,CA,8138,7844,-294,0.4908021524214742
95497,THE SEA RANCH,CA,0,103,103,1
95501,EUREKA,CA,11555,9971,-1584,0.46320728421443835
95502,EUREKA,CA,2975,1813,-1162,0.3786549707602339
95503,EUREKA,CA,8095,7748,-347,0.48904879126428075
95518,ARCATA,CA,928,738,-190,0.4429771908763505
95519,MCKINLEYVILLE,CA,6876,6537,-339,0.48736300603891747
95521,ARCATA,CA,12226,9496,-2730,0.43716048246017863
95524,BAYSIDE,CA,705,658,-47,0.4827586206896552
95525,BLUE LAKE,CA,380,590,210,0.6082474226804123
95526,BRIDGEVILLE,CA,147,23,-124,0.13529411764705881
95528,CARLOTTA,CA,66,13,-53,0.16455696202531644
95531,CRESCENT CITY,CA,9000,8734,-266,0.4925002819442878
95534,CUTTEN,CA,0,39,39,1
95536,FERNDALE,CA,734,907,173,0.5527117611212675
95538,FORT DICK,CA,13,0,-13,0
95540,FORTUNA,CA,5295,4945,-350,0.48291015625
95542,GARBERVILLE,CA,1114,705,-409,0.3875755909840572
95543,GASQUET,CA,45,34,-11,0.43037974683544306
95546,HOOPA,CA,50,42,-8,0.45652173913043476
95547,HYDESVILLE,CA,101,178,77,0.6379928315412187
95548,KLAMATH,CA,141,254,113,0.6430379746835443
95549,KNEELAND,CA,26,11,-15,0.2972972972972973
95551,LOLETA,CA,353,301,-52,0.4602446483180428
95552,MAD RIVER,CA,46,80,34,0.6349206349206349
95553,MIRANDA,CA,0,47,47,1
95555,ORICK,CA,23,12,-11,0.34285714285714286
95556,ORLEANS,CA,13,0,-13,0
95558,PETROLIA,CA,36,0,-36,0
95560,REDDING,CA,14,13,-1,0.48148148148148145
95560,REDWAY,CA,596,275,-321,0.3157290470723307
95562,RIO DELL,CA,1230,1125,-105,0.47770700636942676
95564,SAMOA,CA,22,75,53,0.7731958762886598
95565,SCOTIA,CA,12,109,97,0.9008264462809917
95567,SMITH RIVER,CA,573,683,110,0.5437898089171974
95570,TRINIDAD,CA,1253,1221,-32,0.4935327405012126
95573,WILLOW CREEK,CA,757,479,-278,0.38754045307443363
95589,WHITETHORN,CA,503,348,-155,0.408930669800235
95602,AUBURN,CA,5748,6334,586,0.5242509518291674
95603,AUBURN,CA,10796,10633,-163,0.496196742731812
95604,AUBURN,CA,2763,1555,-1208,0.36012042612320516
95604,BOWMAN,CA,102,105,3,0.5072463768115942
95605,BRODERICK,CA,130,127,-3,0.49416342412451364
95605,W SACRAMENTO,CA,702,674,-28,0.4898255813953488
95605,WEST SACRAMENTO,CA,5306,4505,-801,0.4591784731423912
95608,CARMICHAEL,CA,28841,24535,-4306,0.45966351918465226
95609,CARMICHAEL,CA,1074,1337,263,0.5545416839485691
95610,CITRUS HEIGHTS,CA,22025,19476,-2549,0.4692898966289969
95611,CITRUS HEIGHTS,CA,938,1278,340,0.5767148014440433
95611,CITRUS HTS,CA,22,26,4,0.5416666666666666
95612,CLARKSBURG,CA,38,34,-4,0.4722222222222222
95614,COOL,CA,1387,1525,138,0.523695054945055
95615,COURTLAND,CA,13,0,-13,0
95616,DAVIS,CA,25140,18763,-6377,0.42737398355465456
95617,DAVIS,CA,1355,963,-392,0.4154443485763589
95618,DAVIS,CA,11343,9923,-1420,0.46661337345998305
95618,EL MACERO,CA,141,144,3,0.5052631578947369
95619,DIAMOND SPGS,CA,230,228,-2,0.4978165938864629
95619,DIAMOND SPRINGS,CA,1840,2029,189,0.5244249159989661
95620,DIXON,CA,6802,7166,364,0.5130297823596792
95621,CITRUS HEIGHTS,CA,17769,15671,-2098,0.4686303827751196
95621,CITRUS HTS,CA,1205,988,-217,0.45052439580483356
95623,EL DORADO,CA,1629,1720,91,0.5135861451179456
95624,ELK GROVE,CA,16321,17671,1350,0.5198576135561308
95625,ELMIRA,CA,122,50,-72,0.29069767441860467
95626,ELVERTA,CA,2204,1873,-331,0.45940642629384354
95627,ESPARTO,CA,1267,1057,-210,0.45481927710843373
95628,FAIR OAKS,CA,16893,17595,702,0.5101774530271399
95629,FIDDLETOWN,CA,113,111,-2,0.4955357142857143
95630,FOLSOM,CA,30080,33943,3863,0.5301688455711229
95631,FORESTHILL,CA,2261,2256,-5,0.49944653531104716
95632,GALT,CA,8828,9034,206,0.5057664315306236
95633,GARDEN VALLEY,CA,1007,1131,124,0.528999064546305
95634,GEORGETOWN,CA,1026,1081,55,0.5130517323208353
95635,GREENWOOD,CA,269,255,-14,0.4866412213740458
95636,GRIZZLY FLATS,CA,759,329,-430,0.3023897058823529
95638,HERALD,CA,532,580,48,0.5215827338129496
95640,IONE,CA,2949,3574,625,0.5479074045684501
95640,KIRKWOOD,CA,46,73,27,0.6134453781512605
95641,ISLETON,CA,943,901,-42,0.4886117136659436
95642,JACKSON,CA,3265,3241,-24,0.49815554872425455
95645,KNIGHTS LANDING,CA,110,111,1,0.502262443438914
95645,KNIGHTS LNDG,CA,16,0,-16,0
95648,LINCOLN,CA,17119,21078,3959,0.5518234416315417
95650,LOOMIS,CA,4246,4686,440,0.5246305418719212
95651,LOTUS,CA,66,47,-19,0.415929203539823
95652,MCCLELLAN,CA,193,35,-158,0.15350877192982457
95653,MADISON,CA,63,12,-51,0.16
95655,MATHER,CA,1528,1453,-75,0.487420328748742
95656,MOUNT AUKUM,CA,23,0,-23,0
95658,NEWCASTLE,CA,2419,2356,-63,0.49340314136125657
95659,EAST NICOLAUS,CA,11,12,1,0.5217391304347826
95659,NICOLAUS,CA,23,24,1,0.5106382978723404
95660,N HIGHLANDS,CA,3987,3487,-500,0.46655070912496655
95660,NORTH HIGHLANDS,CA,11122,9294,-1828,0.45523119122257055
95661,ROSEVILLE,CA,14590,14655,65,0.5011113010771072
95662,ORANGEVALE,CA,12276,11965,-311,0.4935852481333278
95663,PENRYN,CA,850,974,124,0.5339912280701754
95664,PILOT HILL,CA,148,327,179,0.6884210526315789
95665,PINE GROVE,CA,1789,1928,139,0.518697874630078
95666,PIONEER,CA,2534,2521,-13,0.49871414441147377
95667,PLACERVILLE,CA,12680,13224,544,0.5105003088326128
95668,PLEASANT GROVE,CA,36,29,-7,0.4461538461538462
95669,PLYMOUTH,CA,834,840,6,0.5017921146953405
95670,GOLD RIVER,CA,1663,1461,-202,0.46766965428937257
95670,RANCHO CORDOVA,CA,23531,21333,-2198,0.47550374465049927
95672,RESCUE,CA,1479,1573,94,0.515399737876802
95673,RIO LINDA,CA,5843,5373,-470,0.4790477888730385
95674,RIO OSO,CA,62,26,-36,0.29545454545454547
95677,ROCKLIN,CA,13288,13047,-241,0.4954243402316309
95678,ROSEVILLE,CA,22554,20472,-2082,0.4758053270115744
95681,SHERIDAN,CA,278,276,-2,0.4981949458483754
95682,CAMERON PARK,CA,2933,3238,305,0.5247123642845568
95682,EL DORADO HILLS,CA,207,222,15,0.5174825174825175
95682,SHINGLE SPGS,CA,1544,1432,-112,0.48118279569892475
95682,SHINGLE SPRINGS,CA,5706,6106,400,0.5169319336268202
95683,RANCHO MURIETA,CA,1571,2073,502,0.568880351262349
95683,SLOUGHHOUSE,CA,371,416,45,0.5285895806861499
95684,SOMERSET,CA,1225,1242,17,0.5034454803404945
95685,SUTTER CREEK,CA,1996,1761,-235,0.46872504657971786
95686,THORNTON,CA,24,0,-24,0
95687,VACAVILLE,CA,24582,24248,-334,0.496579971329101
95688,VACAVILLE,CA,13524,13015,-509,0.49041033950035795
95689,VOLCANO,CA,237,341,104,0.5899653979238755
95690,WALNUT GROVE,CA,570,630,60,0.525
95691,W SACRAMENTO,CA,1996,1928,-68,0.49133537206931704
95691,WEST SACRAMENTO,CA,11892,11988,96,0.5020100502512563
95692,WHEATLAND,CA,1789,1708,-81,0.4884186445524735
95693,WILTON,CA,1880,2334,454,0.5538680588514475
95694,WINTERS,CA,2652,2965,313,0.5278618479615453
95695,WOODLAND,CA,12042,10657,-1385,0.46949204810784617
95696,VACAVILLE,CA,1439,1826,387,0.5592649310872895
95697,YOLO,CA,12,0,-12,0
95698,ZAMORA,CA,0,11,11,1
95701,ALTA,CA,150,125,-25,0.45454545454545453
95703,APPLEGATE,CA,658,702,44,0.5161764705882353
95709,CAMINO,CA,1858,1788,-70,0.49040043883708173
95712,CHICAGO PARK,CA,63,0,-63,0
95713,COLFAX,CA,2929,2947,18,0.5015316541865215
95713,IOWA HILL,CA,86,71,-15,0.45222929936305734
95722,MEADOW VISTA,CA,1537,1868,331,0.5486049926578561
95726,POLLOCK PINES,CA,3872,3679,-193,0.4872202357303668
95728,SODA SPRINGS,CA,38,185,147,0.8295964125560538
95735,TWIN BRIDGES,CA,0,16,16,1
95736,WEIMAR,CA,263,246,-17,0.48330058939096265
95741,RANCHO CORDOVA,CA,1654,2064,410,0.5551371705217859
95741,RNCHO CORDOVA,CA,25,34,9,0.576271186440678
95742,RANCHO CORDOVA,CA,5673,8394,2721,0.5967157176370228
95742,RNCHO CORDOVA,CA,143,191,48,0.5718562874251497
95746,GRANITE BAY,CA,5954,7318,1364,0.5513863773357445
95747,ROSEVILLE,CA,23640,32384,8744,0.5780379837212624
95757,ELK GROVE,CA,13089,15354,2265,0.5398164750553739
95758,ELK GROVE,CA,21483,21810,327,0.5037765920587624
95759,ELK GROVE,CA,774,1227,453,0.6131934032983508
95762,EL DORADO HILLS,CA,14161,18408,4247,0.5652000368448524
95762,EL DORADO HLS,CA,209,283,74,0.5752032520325203
95763,FOLSOM,CA,1034,1194,160,0.5359066427289049
95763,ORLAND,CA,33,25,-8,0.43103448275862066
95765,ROCKLIN,CA,15457,16930,1473,0.5227406057986229
95776,WOODLAND,CA,8467,9664,1197,0.5330097622855883
95798,W SACRAMENTO,CA,24,92,68,0.7931034482758621
95798,WEST SACRAMENTO,CA,36,332,296,0.9021739130434783
95811,SACRAMENTO,CA,8334,7019,-1315,0.4571744935843158
95812,SACRAMENTO,CA,795,2057,1262,0.7212482468443198
95813,SACRAMENTO,CA,72,247,175,0.774294670846395
95814,SACRAMENTO,CA,10362,8103,-2259,0.4388302193338749
95815,SACRAMENTO,CA,14344,10833,-3511,0.43027366246971444
95816,SACRAMENTO,CA,15641,13367,-2274,0.46080391616105904
95817,SACRAMENTO,CA,8254,7444,-810,0.47420053510001275
95818,SACRAMENTO,CA,10851,10419,-432,0.4898448519040903
95819,SACRAMENTO,CA,7422,7644,222,0.5073675826363998
95820,SACRAMENTO,CA,13825,11985,-1840,0.46435490120108486
95821,SACRAMENTO,CA,18484,15418,-3066,0.45478142882425815
95822,SACRAMENTO,CA,15347,14745,-602,0.48999734148610924
95823,SACRAMENTO,CA,31796,25007,-6789,0.440240832350404
95824,SACRAMENTO,CA,10199,9327,-872,0.47767079791047834
95825,SACRAMENTO,CA,23372,18853,-4519,0.4464890467732386
95826,SACRAMENTO,CA,18187,15735,-2452,0.4638582630741112
95827,SACRAMENTO,CA,9165,8541,-624,0.48237885462555063
95828,SACRAMENTO,CA,17695,16586,-1109,0.4838248592514804
95829,SACRAMENTO,CA,8163,9828,1665,0.5462731365682841
95830,SACRAMENTO,CA,0,22,22,1
95831,SACRAMENTO,CA,16364,15233,-1131,0.4821027312719562
95832,SACRAMENTO,CA,3459,2847,-612,0.4514747859181732
95833,SACRAMENTO,CA,19402,17565,-1837,0.47515351529742744
95834,SACRAMENTO,CA,18831,18684,-147,0.4980407836865254
95835,SACRAMENTO,CA,15997,16557,560,0.5086010935676107
95838,SACRAMENTO,CA,13906,12499,-1407,0.4733573186896421
95841,SACRAMENTO,CA,11472,9494,-1978,0.45282838881999427
95842,SACRAMENTO,CA,14954,11693,-3261,0.43881112320336246
95843,ANTELOPE,CA,16908,15081,-1827,0.47144330863734407
95851,SACRAMENTO,CA,34,62,28,0.6458333333333334
95852,SACRAMENTO,CA,66,145,79,0.6872037914691943
95853,SACRAMENTO,CA,35,135,100,0.7941176470588235
95860,SACRAMENTO,CA,254,254,0,0.5
95864,SACRAMENTO,CA,7922,8386,464,0.5142261466764778
95865,SACRAMENTO,CA,317,469,152,0.5966921119592875
95866,SACRAMENTO,CA,241,543,302,0.6926020408163265
95901,MARYSILLE,CA,276,243,-33,0.4682080924855491
95901,MARYSVILLE,CA,14002,13436,-566,0.48968583716014286
95903,BEALE AFB,CA,2129,2025,-104,0.48748194511314397
95912,ARBUCKLE,CA,739,719,-20,0.49314128943758573
95914,BANGOR,CA,97,86,-11,0.46994535519125685
95916,BERRY CREEK,CA,1601,274,-1327,0.14613333333333334
95917,BIGGS,CA,839,773,-66,0.4795285359801489
95918,BROWNS VALLEY,CA,676,885,209,0.566944266495836
95919,BROWNSVILLE,CA,399,354,-45,0.4701195219123506
95922,CAMPTONVILLE,CA,42,12,-30,0.2222222222222222
95923,CANYON DAM,CA,46,0,-46,0
95924,CEDAR RIDGE,CA,278,240,-38,0.46332046332046334
95925,CHALLENGE,CA,0,11,11,1
95926,CHICO,CA,20267,16597,-3670,0.4502224392361111
95927,CHICO,CA,3405,2628,-777,0.43560417702635507
95928,CHICO,CA,19150,16401,-2749,0.46133723383308484
95930,CLIPPER MILLS,CA,29,11,-18,0.275
95930,LA PORTE,CA,0,11,11,1
95932,COLUSA,CA,2125,2065,-60,0.4928400954653938
95932,IMPERIAL BEACH,CA,45,45,0,0.5
95934,CRESCENT MILLS,CA,30,71,41,0.7029702970297029
95935,DOBBINS,CA,199,102,-97,0.3388704318936877
95937,DUNNIGAN,CA,39,206,167,0.8408163265306122
95938,DURHAM,CA,1789,1508,-281,0.45738550197148925
95941,FORBESTOWN,CA,26,0,-26,0
95942,BUTTE MEADOWS,CA,31,51,20,0.6219512195121951
95942,FOREST RANCH,CA,429,487,58,0.5316593886462883
95943,GLENN,CA,11,15,4,0.5769230769230769
95945,GRASS VALLEY,CA,10961,11569,608,0.5134931202840657
95946,PENN VALLEY,CA,4134,4571,437,0.525100516944285
95947,GREENVILLE,CA,1368,665,-703,0.32710280373831774
95948,GRIDLEY,CA,4228,3678,-550,0.46521629142423476
95949,GRASS VALLEY,CA,6396,7111,715,0.5264677574590952
95951,HAMILTON CITY,CA,417,42,-375,0.0915032679738562
95953,LIVE OAK,CA,2776,2780,4,0.5003599712023038
95954,MAGALIA,CA,7830,5574,-2256,0.41584601611459265
95955,MAXWELL,CA,67,39,-28,0.36792452830188677
95956,MEADOW VALLEY,CA,26,0,-26,0
95957,MERIDIAN,CA,34,23,-11,0.40350877192982454
95959,NEVADA CITY,CA,7482,7346,-136,0.49541408146749394
95960,N SAN JUAN,CA,75,26,-49,0.25742574257425743
95960,NORTH SAN JUAN,CA,491,364,-127,0.4257309941520468
95961,OLIVEHURST,CA,2385,2823,438,0.5420506912442397
95961,PLUMAS LAKE,CA,7080,8250,1170,0.538160469667319
95962,OREGON HOUSE,CA,562,260,-302,0.31630170316301703
95963,ORLAND,CA,4826,4291,-535,0.47065920807283096
95965,OROVILLE,CA,8902,8795,-107,0.4969768887382042
95965,YANKEE HILL,CA,184,184,0,0.5
95966,OROVILLE,CA,11375,10620,-755,0.4828370084110025
95967,PARADISE,CA,2107,2258,151,0.5172966781214204
95968,PALERMO,CA,664,709,45,0.5163874726875455
95969,OROVILLE,CA,100,142,42,0.5867768595041323
95969,PARADISE,CA,24378,6579,-17799,0.21252059308072488
95971,QUINCY,CA,3495,2397,-1098,0.40682281059063136
95973,CHICO,CA,16126,15510,-616,0.4902642559109875
95975,ROUGH AND READY,CA,561,365,-196,0.3941684665226782
95975,ROUGH READY,CA,24,26,2,0.52
95977,SMARTSVILLE,CA,571,489,-82,0.46132075471698114
95978,STIRLING CITY,CA,0,11,11,1
95979,STONYFORD,CA,11,14,3,0.56
95982,SUTTER,CA,1062,1088,26,0.5060465116279069
95983,TAYLORSVILLE,CA,69,140,71,0.6698564593301436
95987,WILLIAMS,CA,817,776,-41,0.48713119899560575
95988,WILLOWS,CA,3716,3272,-444,0.4682312535775615
95991,YUBA CITY,CA,15320,13449,-1871,0.467482359484167
95992,YUBA CITY,CA,1133,1597,464,0.584981684981685
95993,YUBA CITY,CA,10127,9718,-409,0.48969513731418496
96001,REDDING,CA,15122,14108,-1014,0.48265480670543964
96002,REDDING,CA,18341,13713,-4628,0.427809321769514
96003,REDDING,CA,22436,19559,-2877,0.46574592213358734
96007,ANDERSON,CA,10581,9492,-1089,0.4728740098639964
96008,BELLA VISTA,CA,372,495,123,0.5709342560553633
96009,BIEBER,CA,0,15,15,1
96013,BURNEY,CA,1591,1522,-69,0.4889174429810472
96019,CENTRAL VALLEY,CA,66,95,29,0.5900621118012422
96019,SHASTA LAKE,CA,3818,3949,131,0.508433114458607
96020,CHESTER,CA,1823,1173,-650,0.39152202937249664
96021,CORNING,CA,6689,5498,-1191,0.45113645688028225
96022,COTTONWOOD,CA,6099,6189,90,0.503662109375
96023,DORRIS,CA,219,61,-158,0.21785714285714286
96024,DOUGLAS CITY,CA,92,37,-55,0.2868217054263566
96025,DUNSMUIR,CA,1221,1116,-105,0.47753530166880614
96027,ETNA,CA,544,464,-80,0.4603174603174603
96027,SAWYERS BAR,CA,14,17,3,0.5483870967741935
96028,FALL RIVER MILLS,CA,272,395,123,0.5922038980509745
96032,FORT JONES,CA,833,740,-93,0.47043865225683407
96033,FRENCH GULCH,CA,12,0,-12,0
96035,GERBER,CA,858,799,-59,0.4821967410983706
96038,GRENADA,CA,80,88,8,0.5238095238095238
96039,HAPPY CAMP,CA,432,154,-278,0.2627986348122867
96041,HAYFORK,CA,757,599,-158,0.441740412979351
96044,HORNBROOK,CA,458,303,-155,0.39816031537450725
96047,IGO,CA,92,96,4,0.5106382978723404
96048,JUNCTION CITY,CA,14,0,-14,0
96049,REDDING,CA,2104,2811,707,0.5719226856561547
96050,KLAMATH RIVER,CA,51,0,-51,0
96051,LAKEHEAD,CA,568,429,-139,0.43029087261785354
96052,LEWISTON,CA,241,240,-1,0.498960498960499
96055,LOS MOLINOS,CA,1621,1521,-100,0.48408656906429026
96056,MCARTHUR,CA,638,383,-255,0.3751224289911851
96057,MCCLOUD,CA,288,450,162,0.6097560975609756
96059,MANTON,CA,38,13,-25,0.2549019607843137
96062,MILLVILLE,CA,164,204,40,0.5543478260869565
96064,MONTAGUE,CA,1659,1580,-79,0.4878048780487805
96065,MONTGOMERY CREEK,CA,11,13,2,0.5416666666666666
96067,MOUNT SHASTA,CA,4179,3877,-302,0.48125620655412116
96069,OAK RUN,CA,61,80,19,0.5673758865248227
96073,PALO CEDRO,CA,1538,1663,125,0.5195251483911277
96080,RED BLUFF,CA,13203,12428,-775,0.48488158870118214
96087,SHASTA,CA,175,25,-150,0.125
96088,SHINGLETOWN,CA,1885,1975,90,0.5116580310880829
96090,TEHAMA,CA,12,40,28,0.7692307692307693
96091,TRINITY CENTER,CA,169,35,-134,0.1715686274509804
96092,VINA,CA,28,0,-28,0
96093,WEAVERVILLE,CA,2053,1326,-727,0.3924237940219
96094,WEED,CA,3732,3379,-353,0.4751792996765574
96096,WHITMORE,CA,23,0,-23,0
96097,YREKA,CA,5040,5110,70,0.503448275862069
96099,REDDING,CA,1206,1254,48,0.5097560975609756
96101,ALTURAS,CA,2541,2564,23,0.5022526934378061
96103,BLAIRSDEN,CA,143,114,-29,0.44357976653696496
96103,BLAIRSDEN GRAEAGLE,CA,684,614,-70,0.47303543913713403
96103,CROMBERG,CA,34,0,-34,0
96103,GRAEAGLE,CA,101,205,104,0.6699346405228758
96104,CEDARVILLE,CA,22,34,12,0.6071428571428571
96105,CHILCOOT,CA,0,28,28,1
96106,CLIO,CA,75,156,81,0.6753246753246753
96107,COLEVILLE,CA,636,477,-159,0.42857142857142855
96109,DOYLE,CA,87,66,-21,0.43137254901960786
96113,HERLONG,CA,245,217,-28,0.4696969696969697
96114,JANESVILLE,CA,1043,1076,33,0.5077866918357716
96118,LOYALTON,CA,98,155,57,0.6126482213438735
96120,MARKLEEVILLE,CA,206,254,48,0.5521739130434783
96122,PORTOLA,CA,2536,2040,-496,0.4458041958041958
96124,CALPINE,CA,13,17,4,0.5666666666666667
96127,SUSANVILLE,CA,223,135,-88,0.3770949720670391
96128,STANDISH,CA,0,23,23,1
96130,SUSANVILLE,CA,7739,6896,-843,0.47119918004783057
96134,TULELAKE,CA,611,307,-304,0.3344226579520697
96137,LAKE ALMANOR,CA,139,77,-62,0.35648148148148145
96137,WESTWOOD,CA,2302,1639,-663,0.41588429332656685
96140,CARNELIAN BAY,CA,1254,732,-522,0.3685800604229607
96141,HOMEWOOD,CA,882,419,-463,0.3220599538816295
96142,TAHOMA,CA,624,451,-173,0.41953488372093023
96143,KINGS BEACH,CA,2185,913,-1272,0.2947062621045836
96145,TAHOE CITY,CA,3282,2058,-1224,0.3853932584269663
96146,ALPINE MDWS,CA,18,23,5,0.5609756097560976
96146,ALPINE MEADOWS,CA,85,102,17,0.5454545454545454
96146,OLYMPIC VALLEY,CA,624,588,-36,0.48514851485148514
96146,OLYMPIC VLY,CA,48,13,-35,0.21311475409836064
96148,TAHOE VISTA,CA,77,60,-17,0.43795620437956206
96150,S LAKE TAHOE,CA,1219,897,-322,0.42391304347826086
96150,SOUTH LAKE TAHOE,CA,9246,9623,377,0.5099899305739573
96151,S LAKE TAHOE,CA,378,279,-99,0.4246575342465753
96151,SOUTH LAKE TAHOE,CA,2309,1864,-445,0.4466810448118859
96155,S LAKE TAHOE,CA,73,35,-38,0.32407407407407407
96155,SOUTH LAKE TAHOE,CA,339,144,-195,0.2981366459627329
96158,S LAKE TAHOE,CA,263,239,-24,0.4760956175298805
96158,SOUTH LAKE TAHOE,CA,1309,1074,-235,0.4506924045321024
96160,TRUCKEE,CA,2072,1246,-826,0.3755274261603376
96161,TRUCKEE,CA,6410,8028,1618,0.5560326915085192
96162,TRUCKEE,CA,1188,1027,-161,0.4636568848758465
96701,AIEA,HI,13320,11870,-1450,0.47121873759428345
96703,ANAHOLA,HI,759,319,-440,0.29591836734693877
96704,CAPTAIN COOK,HI,1860,2189,329,0.5406273153865152
96705,ELEELE,HI,138,142,4,0.5071428571428571
96706,EWA BEACH,HI,29403,27401,-2002,0.4823780015491867
96707,KAPOLEI,HI,19868,16909,-2959,0.45977105256002393
96708,HAIKU,HI,4699,4426,-273,0.48504109589041094
96709,KAPOLEI,HI,506,672,166,0.5704584040747029
96710,HAKALAU,HI,0,15,15,1
96712,HALEIWA,HI,3638,3431,-207,0.4853586080067902
96713,HANA,HI,229,167,-62,0.4217171717171717
96714,HANALEI,HI,797,632,-165,0.44226731980405876
96715,HANAMAULU,HI,11,0,-11,0
96716,HANAPEPE,HI,109,114,5,0.5112107623318386
96717,HAUULA,HI,1887,1357,-530,0.4183107274969174
96718,HAWAII NATIONAL PARK,HI,13,25,12,0.6578947368421053
96719,HAWI,HI,155,440,285,0.7394957983193278
96720,HILO,HI,16454,14824,-1630,0.4739433467613019
96721,HILO,HI,2176,1962,-214,0.4741420976317061
96722,PRINCEVILLE,HI,2026,2102,76,0.5092054263565892
96725,HOLUALOA,HI,1363,1410,47,0.5084745762711864
96726,HONAUNAU,HI,72,298,226,0.8054054054054054
96727,HONOKAA,HI,1169,1233,64,0.5133222314737719
96728,HONOLULU,HI,23,0,-23,0
96728,HONOMU,HI,63,199,136,0.7595419847328244
96729,HOOLEHUA,HI,11,42,31,0.7924528301886793
96730,KAAAWA,HI,561,507,-54,0.4747191011235955
96731,KAHUKU,HI,881,641,-240,0.4211563731931669
96732,KAHULUI,HI,7730,6255,-1475,0.44726492670718626
96733,KAHULUI,HI,1257,1243,-14,0.4972
96734,KAILUA,HI,25142,21921,-3221,0.4657799120328071
96737,KAHULUI,HI,12,20,8,0.625
96737,KAILUA,HI,20,19,-1,0.48717948717948717
96737,OCEAN VIEW,HI,836,1086,250,0.5650364203954215
96738,WAIKOLOA,HI,4401,4160,-241,0.4859245415255227
96739,KEAUHOU,HI,288,0,-288,0
96740,KAILUA KONA,HI,16070,16994,924,0.5139729010404065
96741,KALAHEO,HI,1802,1894,92,0.5124458874458875
96743,KAMUELA,HI,4943,5175,232,0.5114647163471042
96744,KANEOHE,HI,17422,15613,-1809,0.4726199485394279
96745,KAILUA KONA,HI,3492,2942,-550,0.45725831520049737
96746,KAPAA,HI,8487,6829,-1658,0.44587359623922695
96748,KALANI WAY,HI,26,21,-5,0.44680851063829785
96748,KAUNAKAKAI,HI,1119,1169,50,0.5109265734265734
96749,KEAAU,HI,3619,4511,892,0.5548585485854859
96750,KEALAKEKUA,HI,1566,1748,182,0.5274592637296318
96752,KEKAHA,HI,629,473,-156,0.42921960072595283
96753,KIHEI,HI,19661,19661,0,0.5
96754,KILAUEA,HI,1862,1721,-141,0.48032375104660896
96755,KAPAAU,HI,667,656,-11,0.4958427815570673
96756,KOLOA,HI,2974,3174,200,0.5162654521795705
96759,KUNIA,HI,58,26,-32,0.30952380952380953
96760,KURTISTOWN,HI,841,1119,278,0.5709183673469388
96761,LAHAINA,HI,12552,12539,-13,0.49974094296759797
96762,LAIE,HI,1236,1021,-215,0.4523704031900753
96763,LANAI CITY,HI,979,692,-287,0.41412327947336924
96764,LAUPAHOEHOE,HI,49,99,50,0.668918918918919
96765,LAWAI,HI,258,168,-90,0.39436619718309857
96766,LIHUE,HI,5757,5246,-511,0.47677906025629374
96767,LAHAINA,HI,738,476,-262,0.39209225700164746
96768,MAKAWAO,HI,6225,6243,18,0.5007218479307026
96770,MAUNALOA,HI,53,180,127,0.7725321888412017
96771,MOUNTAIN VIEW,HI,1222,1505,283,0.5518885221855518
96772,NAALEHU,HI,926,1263,337,0.5769757880310644
96776,PAAUILO,HI,28,41,13,0.5942028985507246
96777,PAHALA,HI,12,0,-12,0
96778,PAHOA,HI,5813,7058,1245,0.5483645404397482
96779,PAIA,HI,2888,2155,-733,0.42732500495736664
96780,PAPAALOA,HI,14,12,-2,0.46153846153846156
96781,PAPAIKOU,HI,302,294,-8,0.49328859060402686
96782,PEARL CITY,HI,11312,9423,-1889,0.4544489992765855
96783,PEPEEKEO,HI,634,401,-233,0.38743961352657
96784,PUUNENE,HI,469,172,-297,0.26833073322932915
96785,VOLCANO,HI,874,1186,312,0.5757281553398058
96786,WAHIAWA,HI,21069,16211,-4858,0.4348444206008584
96788,PUKALANI,HI,756,446,-310,0.37104825291181365
96789,MILILANI,HI,21376,14308,-7068,0.4009640174868288
96790,KULA,HI,3511,3544,33,0.502338766832034
96791,WAIALUA,HI,2924,2730,-194,0.48284400424478247
96791,WAPAHU,HI,74,69,-5,0.4825174825174825
96792,WAIANAE,HI,17547,14645,-2902,0.454926689860835
96793,WAILUKU,HI,12009,10810,-1199,0.4737280336561637
96795,WAIMANALO,HI,2379,2063,-316,0.4644304367402071
96796,WAIMEA,HI,239,161,-78,0.4025
96797,WAIPAH,HI,418,325,-93,0.43741588156123823
96797,WAIPAHU,HI,20425,17643,-2782,0.4634601239886519
96801,HONOLULU,HI,12,0,-12,0
96802,HONOLULU,HI,12,13,1,0.52
96803,HONOLULU,HI,13,0,-13,0
96804,HONOLULU,HI,0,13,13,1
96805,HONOLULU,HI,11,0,-11,0
96806,HONOLULU,HI,0,18,18,1
96808,HONOLULU,HI,20,22,2,0.5238095238095238
96809,HONOLULU,HI,0,139,139,1
96812,HONOLULU,HI,91,12,-79,0.11650485436893204
96813,HONOLULU,HI,16201,13805,-2396,0.4600746517363194
96814,HONOLULU,HI,14724,14865,141,0.5023826421981141
96815,HONOLULU,HI,26578,21307,-5271,0.44496188785632246
96816,HONOLULU,HI,18170,17262,-908,0.4871867238654324
96817,HONOLULU,HI,22720,17427,-5293,0.4340797568934167
96818,HONOLULU,HI,25111,20362,-4749,0.4477822004266268
96819,HONOLULU,HI,17078,12559,-4519,0.42376083949117654
96820,HONOLULU,HI,1393,1357,-36,0.4934545454545455
96821,HONOLULU,HI,5021,5637,616,0.5288984800150122
96822,HONOLULU,HI,18818,15193,-3625,0.44670841786480847
96823,HONOLULU,HI,905,1167,262,0.5632239382239382
96824,HONOLULU,HI,446,153,-293,0.25542570951585974
96825,HONOLULU,HI,10969,10776,-193,0.49556219820648423
96826,HONOLULU,HI,17185,12047,-5138,0.4121168582375479
96828,HONOLULU,HI,1271,910,-361,0.41723979825768
96830,HONOLULU,HI,1412,1487,75,0.5129354949982753
96837,HONOLULU,HI,552,277,-275,0.3341375150784077
96839,HONOLULU,HI,759,152,-607,0.1668496158068057
96857,SCHOFIELD BARRACKS,HI,12,37,25,0.7551020408163265
96860,JB PEARL HARBOR HICKAM,HI,144,95,-49,0.39748953974895396
96860,JBPHH,HI,148,177,29,0.5446153846153846
96860,JOINT BASE PEARL HBR HICKAM,HI,0,20,20,1
97002,AURORA,OR,1888,1889,1,0.5001323801959227
97003,ALOHA,OR,1513,1396,-117,0.47988999656239256
97003,BEAVERTON,OR,13202,11792,-1410,0.4717932303752901
97004,BEAVERCREEK,OR,1996,1474,-522,0.42478386167146975
97005,BEAVERTON,OR,15712,13789,-1923,0.46740788447849224
97006,ALOHA,OR,651,598,-53,0.4787830264211369
97006,BEAVERTON,OR,25841,23869,-1972,0.48016495674914506
97006,HILLSBORO,OR,598,467,-131,0.4384976525821596
97007,ALOHA,OR,1349,1348,-1,0.4998146088246199
97007,BEAVERTON,OR,18614,18825,211,0.502817917145223
97008,BEAVERTON,OR,14133,17569,3436,0.5541921645322062
97009,BORING,OR,3349,3237,-112,0.49149711509262073
97011,BRIGHTWOOD,OR,59,176,117,0.7489361702127659
97013,CANBY,OR,8518,9243,725,0.5204098868306964
97014,CASCADE LOCKS,OR,446,564,118,0.5584158415841585
97015,CLACKAMAS,OR,11643,11691,48,0.5010285420416559
97015,HAPPY VALLEY,OR,285,287,2,0.5017482517482518
97016,CLATSKANIE,OR,2112,2316,204,0.5230352303523035
97016,WESTPORT,OR,120,145,25,0.5471698113207547
97017,COLTON,OR,870,897,27,0.5076400679117148
97018,COLUMBIA CITY,OR,734,614,-120,0.45548961424332346
97019,CORBETT,OR,1221,1113,-108,0.4768637532133676
97020,DONALD,OR,211,100,-111,0.3215434083601286
97021,DUFUR,OR,312,213,-99,0.4057142857142857
97022,EAGLE CREEK,OR,1263,1236,-27,0.49459783913565425
97023,ESTACADA,OR,4677,4999,322,0.5166391070690368
97024,FAIRVIEW,OR,7389,5957,-1432,0.44635096658174733
97026,GERVAIS,OR,865,890,25,0.5071225071225072
97027,GLADSTONE,OR,6160,5651,-509,0.4784522902379138
97028,GOVERNMENT CAMP,OR,12,0,-12,0
97030,GRESHAM,OR,24404,19733,-4671,0.44708521195368967
97031,HOOD RIVER,OR,8498,8175,-323,0.4903136808012955
97032,HUBBARD,OR,1610,1401,-209,0.46529392228495514
97034,LAKE OSWEGO,OR,9977,10334,357,0.5087883412928955
97035,LAKE GROVE,OR,643,695,52,0.5194319880418535
97035,LAKE OSWEGO,OR,13839,14091,252,0.5045112781954887
97035,LAKEOSWEGO,OR,336,323,-13,0.49013657056145676
97037,MAUPIN,OR,151,258,107,0.6308068459657702
97038,MOLALLA,OR,6584,6188,-396,0.4844973379267147
97040,MOSIER,OR,533,560,27,0.5123513266239708
97041,MOUNT HOOD PARKDALE,OR,808,841,33,0.5100060642813826
97042,MULINO,OR,931,950,19,0.5050505050505051
97044,ODELL,OR,11,0,-11,0
97045,OREGON CITY,OR,22277,21883,-394,0.4955389492753623
97048,RAINIER,OR,2860,2490,-370,0.4654205607476635
97049,RHODODENDRON,OR,955,672,-283,0.4130301167793485
97050,RUFUS,OR,75,0,-75,0
97051,SAINT HELENS,OR,7855,7905,50,0.5015862944162437
97053,WARREN,OR,731,930,199,0.5599036724864539
97054,DEER ISLAND,OR,327,257,-70,0.4400684931506849
97055,SANDY,OR,7673,8010,337,0.5107441178345979
97056,SCAPPOOSE,OR,5508,4921,-587,0.4718573209320165
97058,THE DALLES,OR,9866,8620,-1246,0.4662988207292005
97060,TROUTDALE,OR,6847,6851,4,0.5001460067163089
97060,WOOD VILLAGE,OR,1158,1206,48,0.5101522842639594
97062,TUALATIN,OR,14293,12815,-1478,0.47273867492991
97063,TYGH VALLEY,OR,529,490,-39,0.48086359175662413
97063,WAMIC,OR,14,14,0,0.5
97064,VERNONIA,OR,1502,1593,91,0.5147011308562197
97065,WASCO,OR,24,0,-24,0
97067,WELCHES,OR,1385,1241,-144,0.47258187357197257
97068,WEST LINN,OR,11232,11692,460,0.5100331530273948
97070,WILSONVILLE,OR,16997,16667,-330,0.4950986216730038
97071,WOODBURN,OR,9659,8413,-1246,0.46552678176184153
97075,BEAVERTON,OR,845,1426,581,0.6279172170849846
97078,ALOHA,OR,2047,1744,-303,0.4600369295700343
97078,BEAVERTON,OR,9442,7658,-1784,0.44783625730994153
97080,GRESHAM,OR,17067,15852,-1215,0.4815456119566208
97086,HAPPY VALLEY,OR,14075,14986,911,0.5156739272564606
97089,DAMASCUS,OR,4117,4190,73,0.5043938846755748
97101,AMITY,OR,1569,1571,2,0.5003184713375797
97103,ASTORIA,OR,10146,8755,-1391,0.4632030051320036
97106,BANKS,OR,1378,1482,104,0.5181818181818182
97107,BAY CITY,OR,603,586,-17,0.4928511354079058
97108,BEAVER,OR,49,0,-49,0
97110,CANNON BEACH,OR,743,843,100,0.5315258511979823
97111,CARLTON,OR,1483,1412,-71,0.4877374784110535
97112,CLOVERDALE,OR,1150,866,-284,0.42956349206349204
97113,CORNELIUS,OR,4093,4667,574,0.5327625570776255
97114,DAYTON,OR,1769,1616,-153,0.4774002954209749
97115,DUNDEE,OR,1568,1525,-43,0.49304881991593924
97116,FOREST GROVE,OR,10620,10197,-423,0.4898400345871163
97117,GALES CREEK,OR,12,0,-12,0
97118,GARIBALDI,OR,991,612,-379,0.3817841547099189
97119,GASTON,OR,1378,1440,62,0.511000709723208
97121,HAMMOND,OR,621,735,114,0.5420353982300885
97122,HEBO,OR,68,35,-33,0.33980582524271846
97123,HILLSBORO,OR,18087,19550,1463,0.5194356617158647
97124,HILLSBORO,OR,31326,28093,-3233,0.4727948972550868
97127,LAFAYETTE,OR,1598,1512,-86,0.48617363344051445
97128,MCMINNVILLE,OR,16760,16264,-496,0.49249031007751937
97130,MANZANITA,OR,902,899,-3,0.4991671293725708
97131,NEHALEM,OR,1023,1125,102,0.5237430167597765
97132,NEWBERG,OR,12643,11910,-733,0.48507310715594837
97133,NORTH PLAINS,OR,2120,2534,414,0.5444778685002148
97135,PACIFIC CITY,OR,837,848,11,0.5032640949554896
97136,ROCKAWAY BCH,OR,72,55,-17,0.4330708661417323
97136,ROCKAWAY BEACH,OR,1677,1399,-278,0.4548114434330299
97137,SAINT PAUL,OR,185,115,-70,0.38333333333333336
97138,GEARHART,OR,1518,1610,92,0.5147058823529411
97138,SEASIDE,OR,4757,4844,87,0.5045307780439537
97140,SHERWOOD,OR,9361,9028,-333,0.4909456740442656
97141,TILLAMOOK,OR,6839,6170,-669,0.47428703205473133
97143,NETARTS,OR,0,12,12,1
97144,TIMBER,OR,16,0,-16,0
97146,WARRENTON,OR,4748,4229,-519,0.4710927926924362
97147,WHEELER,OR,23,36,13,0.6101694915254238
97148,YAMHILL,OR,1170,1192,22,0.5046570702794242
97149,NESKOWIN,OR,496,498,2,0.5010060362173038
97201,PORTLAND,OR,18663,14961,-3702,0.4449500356887937
97202,PORTLAND,OR,30780,26279,-4501,0.46055836940710493
97203,PORTLAND,OR,17201,14984,-2217,0.46555848997980426
97204,PORTLAND,OR,2406,2276,-130,0.4861170439982913
97205,PORTLAND,OR,10241,7976,-2265,0.4378327935444914
97206,PORTLAND,OR,26816,24896,-1920,0.4814356435643564
97207,PORTLAND,OR,583,490,-93,0.45666356011183595
97208,PORTLAND,OR,2302,1741,-561,0.4306208261192184
97209,PORTLAND,OR,29173,26225,-2948,0.47339254124697644
97210,PORTLAND,OR,13186,12176,-1010,0.4800883211103225
97211,PORTLAND,OR,21445,19520,-1925,0.4765043329671671
97212,PORTLAND,OR,14560,13612,-948,0.48317478347295184
97213,PORTLAND,OR,17488,15808,-1680,0.47477174435367614
97214,PORTLAND,OR,27866,24054,-3812,0.46328967642526964
97215,PORTLAND,OR,10383,9682,-701,0.48253177174183903
97216,PORTLAND,OR,8833,7833,-1000,0.46999879995199806
97217,PORTLAND,OR,26114,24972,-1142,0.48882276944759817
97218,PORTLAND,OR,7393,6471,-922,0.4667484131563762
97219,PORTLAND,OR,18932,18059,-873,0.4881998323916628
97220,PORTLAND,OR,15160,12811,-2349,0.45801008187050873
97221,PORTLAND,OR,5317,5551,234,0.5107655502392344
97222,MILWAUKIE,OR,5875,5270,-605,0.4728577837595334
97222,PORTLAND,OR,13105,11141,-1964,0.4594984739750887
97223,PORTLAND,OR,13749,13012,-737,0.4862299615111543
97223,TIGARD,OR,9948,9492,-456,0.4882716049382716
97224,KING CITY,OR,866,803,-63,0.4811264230077891
97224,PORTLAND,OR,10864,11144,280,0.5063613231552163
97224,TIGARD,OR,4365,4350,-15,0.4991394148020654
97225,PORTLAND,OR,15849,14978,-871,0.48587277386706457
97227,PORTLAND,OR,6532,5889,-643,0.47411641574752433
97228,PORTLAND,OR,1147,497,-650,0.30231143552311435
97229,PORTLAND,OR,29329,31664,2335,0.5191415408325546
97230,PORTLAND,OR,19672,16281,-3391,0.45284120935666006
97231,PORTLAND,OR,1734,1829,95,0.5133314622509122
97232,PORTLAND,OR,16369,15608,-761,0.48810082246614755
97233,PORTLAND,OR,19012,14967,-4045,0.44047794225845377
97236,PORTLAND,OR,15693,13481,-2212,0.46208953177486806
97238,PORTLAND,OR,318,365,47,0.5344070278184481
97239,PORTLAND,OR,15368,13988,-1380,0.4764954353454149
97242,PORTLAND,OR,63,100,37,0.6134969325153374
97266,PORTLAND,OR,15943,13853,-2090,0.4649281782789636
97267,MILWAUKIE,OR,3436,3068,-368,0.47170971709717097
97267,PORTLAND,OR,9893,8363,-1530,0.4580959684487292
97268,OAK GROVE,OR,70,37,-33,0.34579439252336447
97268,PORTLAND,OR,448,527,79,0.5405128205128205
97269,MILWAUKIE,OR,119,152,33,0.5608856088560885
97269,PORTLAND,OR,139,111,-28,0.444
97280,PORTLAND,OR,680,836,156,0.5514511873350924
97281,PORTLAND,OR,419,610,191,0.5928085519922255
97281,TIGARD,OR,409,510,101,0.5549510337323177
97282,PORTLAND,OR,279,260,-19,0.48237476808905383
97283,PORTLAND,OR,181,216,35,0.5440806045340051
97286,PORTLAND,OR,384,499,115,0.565118912797282
97290,PORTLAND,OR,505,523,18,0.5087548638132295
97291,PORTLAND,OR,189,0,-189,0
97292,PORTLAND,OR,823,1013,190,0.5517429193899782
97293,PORTLAND,OR,719,507,-212,0.41353996737357257
97294,PORTLAND,OR,912,1304,392,0.5884476534296029
97296,PORTLAND,OR,318,314,-4,0.49683544303797467
97298,PORTLAND,OR,172,249,77,0.5914489311163895
97301,SALEM,OR,39768,23855,-15913,0.3749430237492731
97302,SALEM,OR,25672,19758,-5914,0.4349108518600044
97303,KEIZER,OR,21508,16357,-5151,0.43198204146309255
97303,SALEM,OR,898,729,-169,0.4480639213275968
97304,SALEM,OR,15525,15076,-449,0.4926636384431881
97305,BROOKS,OR,423,371,-52,0.4672544080604534
97305,SALEM,OR,20022,15625,-4397,0.43832580581816144
97306,SALEM,OR,15997,15272,-725,0.4884070485145032
97307,KEIZER,OR,725,764,39,0.5130960376091337
97308,SALEM,OR,358,597,239,0.625130890052356
97309,SALEM,OR,1101,1307,206,0.5427740863787376
97317,SALEM,OR,8704,8810,106,0.5030261505081649
97321,ALBANY,OR,12922,13748,826,0.5154855643044619
97322,ALBANY,OR,15498,15686,188,0.5030143663417137
97324,ALSEA,OR,153,221,68,0.5909090909090909
97325,AUMSVILLE,OR,3112,2567,-545,0.4520162000352175
97326,BLODGETT,OR,54,33,-21,0.3793103448275862
97327,BROWNSVILLE,OR,1148,1393,245,0.5482093663911846
97330,CORVALLIS,OR,28120,21047,-7073,0.42807167409034513
97331,CORVALLIS,OR,11,41,30,0.7884615384615384
97333,CORVALLIS,OR,14334,11740,-2594,0.45025696095727546
97335,CRABTREE,OR,0,11,11,1
97338,DALLAS,OR,10986,10432,-554,0.48706695303016156
97339,CORVALLIS,OR,1212,1333,121,0.5237721021611002
97341,DEPOE BAY,OR,2227,2092,-135,0.48437138226441306
97342,DETROIT,OR,58,11,-47,0.15942028985507245
97343,EDDYVILLE,OR,0,24,24,1
97344,FALLS CITY,OR,437,469,32,0.5176600441501104
97345,FOSTER,OR,162,313,151,0.6589473684210526
97346,GATES,OR,245,134,-111,0.35356200527704484
97347,GRAND RONDE,OR,1154,1070,-84,0.48111510791366907
97348,HALSEY,OR,525,510,-15,0.4927536231884058
97350,IDANHA,OR,23,0,-23,0
97351,INDEPENDENCE,OR,5627,5040,-587,0.47248523483641136
97352,JEFFERSON,OR,2402,2394,-8,0.4991659716430359
97355,LEBANON,OR,16411,15011,-1400,0.47772261472853417
97358,LYONS,OR,1366,1153,-213,0.4577213179833267
97360,MILL CITY,OR,961,997,36,0.5091930541368743
97361,MONMOUTH,OR,7663,5640,-2023,0.4239645192813651
97362,MOUNT ANGEL,OR,1525,1417,-108,0.4816451393609789
97364,NEOTSU,OR,950,726,-224,0.4331742243436754
97365,NEWPORT,OR,7152,7443,291,0.5099691675231244
97366,NEWPORT,OR,36,15,-21,0.29411764705882354
97366,SOUTH BEACH,OR,1706,1192,-514,0.4113181504485852
97367,LINCOLN CITY,OR,8105,7952,-153,0.4952357227377468
97368,OTIS,OR,1914,1721,-193,0.4734525447042641
97370,PHILOMATH,OR,4062,4222,160,0.5096571704490584
97371,RICKREALL,OR,59,120,61,0.6703910614525139
97373,SAINT BENEDICT,OR,17,0,-17,0
97374,SCIO,OR,1645,1787,142,0.5206876456876457
97375,SCOTTS MILLS,OR,196,274,78,0.5829787234042553
97376,SEAL ROCK,OR,872,628,-244,0.4186666666666667
97377,SHEDD,OR,67,65,-2,0.49242424242424243
97378,SHERIDAN,OR,4167,3121,-1046,0.428238199780461
97380,SILETZ,OR,1505,928,-577,0.3814221126181669
97381,SILVERTON,OR,6824,6428,-396,0.4850588590401449
97383,STAYTON,OR,4327,3997,-330,0.4801777991350312
97385,SUBLIMITY,OR,1393,1701,308,0.5497737556561086
97386,ALBANY,OR,125,139,14,0.5265151515151515
97386,SWEET HOME,OR,6488,6619,131,0.5049973296711681
97388,GLENEDEN BCH,OR,43,64,21,0.5981308411214953
97388,GLENEDEN BEACH,OR,677,736,59,0.5208775654635527
97389,TANGENT,OR,841,862,21,0.5061655901350558
97390,TIDEWATER,OR,156,48,-108,0.23529411764705882
97391,TOLEDO,OR,2804,2352,-452,0.4561675717610551
97392,TURNER,OR,2359,2738,379,0.5371787325877967
97394,WALDPORT,OR,3283,3527,244,0.5179148311306901
97396,WILLAMINA,OR,1578,1545,-33,0.494716618635927
97401,EUGENE,OR,37143,28809,-8334,0.43681768558951967
97402,EUGENE,OR,30548,27689,-2859,0.4754537493346154
97403,EUGENE,OR,6792,4954,-1838,0.4217605993529712
97404,EUGENE,OR,15922,15596,-326,0.49482835205279524
97405,EUGENE,OR,23134,21074,-2060,0.47670104958378573
97408,EUGENE,OR,7867,8977,1110,0.5329494181904536
97410,AZALEA,OR,95,92,-3,0.4919786096256685
97411,BANDON,OR,4302,4383,81,0.5046632124352332
97412,BLACHLY,OR,11,11,0,0.5
97413,BLUE RIVER,OR,801,548,-253,0.4062268346923647
97413,CKENZIE BRIDGE,OR,58,60,2,0.5084745762711864
97413,MCKENZIE BRIDGE,OR,69,56,-13,0.448
97415,BROOKINGS,OR,6896,7852,956,0.5324111743965283
97416,CAMAS VALLEY,OR,50,94,44,0.6527777777777778
97417,CANYONVILLE,OR,1267,1125,-142,0.47031772575250835
97419,CHESHIRE,OR,269,304,35,0.5305410122164049
97420,CHARLESTON,OR,323,296,-27,0.4781906300484653
97420,COOS BAY,OR,16186,13969,-2217,0.463239927043608
97423,COQUILLE,OR,3227,3164,-63,0.4950711938663746
97424,COTTAGE GROVE,OR,7698,7948,250,0.5079892624312924
97426,CRESWELL,OR,4165,4112,-53,0.49679835689259394
97429,DAYS CREEK,OR,26,46,20,0.6388888888888888
97430,DEADWOOD,OR,0,11,11,1
97431,DEXTER,OR,880,1037,157,0.5409494001043297
97432,DILLARD,OR,11,34,23,0.7555555555555555
97434,DORENA,OR,79,129,50,0.6201923076923077
97435,DRAIN,OR,1166,920,-246,0.44103547459252157
97436,ELKTON,OR,259,220,-39,0.4592901878914405
97437,ELMIRA,OR,937,980,43,0.5112154407929056
97438,FALL CREEK,OR,209,100,-109,0.32362459546925565
97438,JASPER,OR,120,29,-91,0.19463087248322147
97439,FLORENCE,OR,8541,9279,738,0.5207070707070707
97440,EUGENE,OR,1362,1611,249,0.5418768920282543
97442,GLENDALE,OR,962,842,-120,0.46674057649667405
97443,GLIDE,OR,886,756,-130,0.46041412911084045
97444,GOLD BEACH,OR,2979,2870,-109,0.49068216789194735
97446,HARRISBURG,OR,2274,2016,-258,0.4699300699300699
97447,IDLEYLD PARK,OR,207,42,-165,0.1686746987951807
97448,JUNCTION CITY,OR,6165,5599,-566,0.4759435566133968
97449,LAKESIDE,OR,1514,1421,-93,0.48415672913117547
97450,LANGLOIS,OR,158,153,-5,0.4919614147909968
97452,LOWELL,OR,562,650,88,0.5363036303630363
97453,MAPLETON,OR,340,326,-14,0.4894894894894895
97454,MARCOLA,OR,691,656,-35,0.48700816629547145
97455,PLEASANT HILL,OR,814,970,156,0.5437219730941704
97456,MONROE,OR,1006,1176,170,0.538955087076077
97457,MYRTLE CREEK,OR,3697,4128,431,0.5275399361022364
97458,MYRTLE POINT,OR,1868,1899,31,0.5041146801168038
97458,NORWAY,OR,53,46,-7,0.46464646464646464
97459,NORTH BEND,OR,8098,7231,-867,0.4717202687716094
97461,NOTI,OR,45,38,-7,0.4578313253012048
97462,OAKLAND,OR,1588,1524,-64,0.4897172236503856
97463,OAKRIDGE,OR,2415,2022,-393,0.4557133198106829
97465,PORT ORFORD,OR,1376,1261,-115,0.47819491846795603
97466,POWERS,OR,88,60,-28,0.40540540540540543
97467,REEDSPORT,OR,2510,2631,121,0.5117681384944563
97467,WINCHESTER BAY,OR,763,762,-1,0.499672131147541
97469,RIDDLE,OR,1241,922,-319,0.42625982431807674
97470,ROSEBURG,OR,11352,10611,-741,0.48313071984701544
97471,ROSEBURG,OR,11484,12063,579,0.5122945598165372
97473,SCOTTSBURG,OR,0,14,14,1
97475,SPRINGFIELD,OR,1189,1399,210,0.5405718701700154
97477,SPRINGFIELD,OR,21673,18339,-3334,0.4583374987503749
97478,SPRINGFIELD,OR,16069,15104,-965,0.48452186186764185
97479,SUTHERLIN,OR,4845,5011,166,0.5084212662337663
97480,SWISSHOME,OR,0,12,12,1
97481,TENMILE,OR,29,11,-18,0.275
97486,UMPQUA,OR,78,79,1,0.5031847133757962
97487,VENETA,OR,3610,3718,108,0.5073689956331878
97488,VIDA,OR,770,420,-350,0.35294117647058826
97489,LEABURG,OR,61,54,-7,0.46956521739130436
97489,WALTERVILLE,OR,668,481,-187,0.4186248912097476
97491,WEDDERBURN,OR,24,0,-24,0
97492,WESTFIR,OR,11,23,12,0.6764705882352942
97493,WESTLAKE,OR,22,49,27,0.6901408450704225
97495,WINCHESTER,OR,1406,1085,-321,0.4355680449618627
97496,WINSTON,OR,3440,3469,29,0.5020987118251556
97497,WOLF CREEK,OR,623,480,-143,0.43517679057116954
97498,YACHATS,OR,1172,1404,232,0.5450310559006211
97499,YONCALLA,OR,886,898,12,0.5033632286995515
97501,MEDFORD,OR,25123,23635,-1488,0.48474096558513474
97502,CENTRAL POINT,OR,12120,12659,539,0.5108761451228863
97503,KIEZER,OR,92,76,-16,0.4523809523809524
97503,WHITE CITY,OR,4290,4871,581,0.5317105119528436
97504,MEDFORD,OR,23055,23163,108,0.5011683759574191
97520,ASHLAND,OR,18503,16750,-1753,0.47513686778430203
97522,BUTTE FALLS,OR,13,34,21,0.723404255319149
97523,CAVE JUNCTION,OR,2909,3042,133,0.5111745925054613
97524,EAGLE POINT,OR,6876,6828,-48,0.4982486865148862
97525,GOLD HILL,OR,2778,2560,-218,0.4795803671787186
97526,GOLD HILL,OR,271,292,21,0.5186500888099467
97526,GRANTS PASS,OR,14752,14720,-32,0.499457111834962
97527,GRANTS PASS,OR,13403,14201,798,0.5144544268946529
97528,GRANTS PASS,OR,1366,1605,239,0.5402221474251094
97530,JACKSONVILLE,OR,3809,3906,97,0.5062864549578743
97532,MERLIN,OR,1409,1546,137,0.5231810490693739
97533,MURPHY,OR,80,194,114,0.708029197080292
97534,O BRIEN,OR,61,47,-14,0.4351851851851852
97535,PHOENIX,OR,3150,2682,-468,0.45987654320987653
97536,PROSPECT,OR,201,205,4,0.5049261083743842
97537,ROGUE RIVER,OR,3455,3612,157,0.5111079666053489
97538,SELMA,OR,851,793,-58,0.48236009732360097
97539,SHADY COVE,OR,1734,1912,178,0.5244103126714207
97540,TALENT,OR,5775,4516,-1259,0.4388300456709746
97541,TRAIL,OR,537,576,39,0.5175202156334232
97543,WILDERVILLE,OR,180,294,114,0.620253164556962
97544,WILLIAMS,OR,1258,1082,-176,0.4623931623931624
97601,KLAMATH FALLS,OR,12168,11789,-379,0.4920899945736111
97602,KLAMATH FALLS,OR,25,0,-25,0
97603,KLAMATH FALLS,OR,11432,11755,323,0.5069651097597792
97621,BEATTY,OR,0,12,12,1
97622,BLY,OR,11,26,15,0.7027027027027027
97623,BONANZA,OR,872,932,60,0.516629711751663
97624,CHILOQUIN,OR,1850,1830,-20,0.49728260869565216
97627,KENO,OR,318,504,186,0.6131386861313869
97630,LAKEVIEW,OR,2806,2816,10,0.5008893632159374
97632,MALIN,OR,115,125,10,0.5208333333333334
97633,MERRILL,OR,336,295,-41,0.4675118858954041
97634,MIDLAND,OR,0,13,13,1
97635,NEW PINE CREEK,OR,22,0,-22,0
97638,CHRISTMAS VALLEY,OR,0,17,17,1
97638,SILVER LAKE,OR,105,181,76,0.6328671328671329
97639,SPRAGUE RIVER,OR,13,33,20,0.717391304347826
97641,CHRISTMAS VALLEY,OR,319,273,-46,0.46114864864864863
97701,BEND,OR,25157,24932,-225,0.4977539978837669
97702,BEND,OR,26628,29113,2485,0.5222905939972372
97703,BEND,OR,18222,18663,441,0.505978039853599
97707,BEND,OR,3097,4132,1035,0.5715866648222437
97707,SUNRIVER,OR,885,1063,178,0.545687885010267
97708,BEND,OR,3906,2222,-1684,0.36259791122715407
97709,BEND,OR,2242,1489,-753,0.3990887161618869
97720,BURNS,OR,2174,2024,-150,0.4821343496903287
97730,CAMP SHERMAN,OR,0,39,39,1
97731,CHEMULT,OR,74,25,-49,0.25252525252525254
97733,CRESCENT,OR,175,247,72,0.5853080568720379
97733,CRESCENT LAKE,OR,175,153,-22,0.46646341463414637
97734,CULVER,OR,1622,1356,-266,0.45533915379449297
97735,FORT ROCK,OR,15,0,-15,0
97737,GILCHRIST,OR,20,26,6,0.5652173913043478
97738,HINES,OR,696,787,91,0.5306810519217802
97739,LA PINE,OR,7105,7961,856,0.5284083366520642
97741,MADRAS,OR,6678,5413,-1265,0.44768836324538913
97741,METOLIUS,OR,738,547,-191,0.42568093385214006
97750,MITCHELL,OR,23,0,-23,0
97753,POWELL BUTTE,OR,1338,1642,304,0.5510067114093959
97754,PRINEVILLE,OR,12699,12215,-484,0.4902865858553424
97756,REDMOND,OR,24022,25519,1497,0.5151086978462284
97759,SISTERS,OR,4739,5770,1031,0.5490531925016653
97760,CRKD RVR RNCH,OR,105,105,0,0.5
97760,CROOKED RIVER RANCH,OR,273,382,109,0.583206106870229
97760,TERREBONNE,OR,3607,3663,56,0.5038514442916093
97761,WARM SPRINGS,OR,777,514,-263,0.3981409759876065
97801,PENDLETON,OR,11495,9766,-1729,0.45933869526362825
97810,ADAMS,OR,59,27,-32,0.313953488372093
97812,ARLINGTON,OR,218,165,-53,0.4308093994778068
97813,ATHENA,OR,296,293,-3,0.49745331069609505
97814,BAKER CITY,OR,6419,6189,-230,0.490878807106599
97818,BOARDMAN,OR,1814,1436,-378,0.44184615384615383
97820,CANYON CITY,OR,198,260,62,0.5676855895196506
97823,CONDON,OR,85,43,-42,0.3359375
97824,COVE,OR,568,560,-8,0.49645390070921985
97826,ECHO,OR,37,0,-37,0
97827,ELGIN,OR,1291,1252,-39,0.49233189146677153
97828,ENTERPRISE,OR,1783,1772,-11,0.49845288326300985
97830,FOSSIL,OR,38,24,-14,0.3870967741935484
97833,HAINES,OR,92,71,-21,0.43558282208588955
97834,HALFWAY,OR,266,263,-3,0.497164461247637
97836,HEPPNER,OR,579,535,-44,0.48025134649910234
97838,HERMISTON,OR,9108,9039,-69,0.49809885931558934
97841,IMBLER,OR,0,14,14,1
97843,IONE,OR,11,11,0,0.5
97844,IRRIGON,OR,1702,1285,-417,0.4301975225979243
97845,JOHN DAY,OR,1556,1434,-122,0.47959866220735786
97846,JOSEPH,OR,1311,1102,-209,0.4566929133858268
97850,ISLAND CITY,OR,211,175,-36,0.4533678756476684
97850,LA GRANDE,OR,10671,7836,-2835,0.4234073593775328
97857,LOSTINE,OR,24,13,-11,0.35135135135135137
97859,MEACHAM,OR,107,95,-12,0.47029702970297027
97862,MILTON FREEWATER,OR,4810,3226,-1584,0.4014435042309607
97865,MOUNT VERNON,OR,213,238,25,0.5277161862527716
97867,NORTH POWDER,OR,148,105,-43,0.4150197628458498
97868,PILOT ROCK,OR,643,620,-23,0.4908946951702296
97869,PRAIRIE CITY,OR,302,350,48,0.5368098159509203
97870,RICHLAND,OR,84,47,-37,0.35877862595419846
97873,SENECA,OR,11,0,-11,0
97874,SPRAY,OR,11,15,4,0.5769230769230769
97875,STANFIELD,OR,870,892,22,0.5062429057888763
97876,SUMMERVILLE,OR,72,102,30,0.5862068965517241
97877,GRANITE,OR,39,0,-39,0
97877,SUMPTER,OR,52,71,19,0.5772357723577236
97882,UMATILLA,OR,3715,2337,-1378,0.3861533377395902
97883,UNION,OR,1130,983,-147,0.4652153336488405
97885,WALLOWA,OR,467,438,-29,0.4839779005524862
97886,WESTON,OR,270,147,-123,0.35251798561151076
97901,ADRIAN,OR,11,42,31,0.7924528301886793
97907,HUNTINGTON,OR,78,90,12,0.5357142857142857
97910,JORDAN VALLEY,OR,12,22,10,0.6470588235294118
97913,NYSSA,OR,1992,1870,-122,0.4842050750906266
97914,ONTARIO,OR,8664,7434,-1230,0.46179649645918747
97918,VALE,OR,2150,1717,-433,0.4440134471166279
98001,ALGONA,WA,533,494,-39,0.4810126582278481
98001,AUBURN,WA,11121,11672,551,0.512087044267977
98001,FEDERAL WAY,WA,617,544,-73,0.46856158484065463
98002,AUBURN,WA,18824,16440,-2384,0.4661978221415608
98003,FEDERAL WAY,WA,27900,22423,-5477,0.44558154323072946
98004,BELLEVUE,WA,33453,29284,-4169,0.46677399301847394
98004,YARROW POINT,WA,1532,1429,-103,0.48260722728807837
98005,BELLEVUE,WA,14710,13430,-1280,0.47725657427149965
98006,BELLEVUE,WA,15486,16089,603,0.5095486935866983
98007,BELLEVUE,WA,23116,18709,-4407,0.44731619844590553
98008,BELLEVUE,WA,10946,11368,422,0.5094559469391413
98009,BELLEVUE,WA,1231,1611,380,0.5668543279380718
98010,BLACK DIAMOND,WA,2186,3822,1636,0.6361517976031957
98011,BOTHELL,WA,15112,14485,-627,0.4894077102409028
98012,BOTHELL,WA,17002,17802,800,0.5114929318469141
98012,MILL CREEK,WA,15444,15678,234,0.5037593984962406
98013,BURTON,WA,17,0,-17,0
98014,CARNATION,WA,2445,2535,90,0.5090361445783133
98015,BELLEVUE,WA,768,819,51,0.5160680529300568
98019,DUVALL,WA,3894,4297,403,0.5246001709193017
98020,EDMONDS,WA,7192,7356,164,0.5056365136101182
98020,WOODWAY,WA,1953,2139,186,0.5227272727272727
98021,BOTHELL,WA,11450,13392,1942,0.5390870300297883
98022,ENUMCLAW,WA,8878,9342,464,0.5127332601536773
98023,FEDERAL WAY,WA,23346,21719,-1627,0.48194829690447133
98024,FALL CITY,WA,1764,1760,-4,0.49943246311010214
98025,HOBART,WA,65,11,-54,0.14473684210526316
98026,EDMONDS,WA,14396,14385,-11,0.4998089017059866
98027,ISSAQUAH,WA,16078,15738,-340,0.4946567764646719
98028,KENMORE,WA,10435,10110,-325,0.49209053297639327
98029,ISSAQUAH,WA,11053,11664,611,0.5134480785314962
98029,SAMMAMISH,WA,3192,3326,134,0.5102792267566738
98030,KENT,WA,17478,14953,-2525,0.4610711973112146
98030,MV,WA,367,276,-91,0.42923794712286156
98031,KENT,WA,17165,16295,-870,0.4869994022713688
98032,KENT,WA,22158,20005,-2153,0.4744681355691009
98033,KIRKLAND,WA,23834,22965,-869,0.4907156135814868
98034,KIRKLAND,WA,27724,27182,-542,0.4950642916985393
98035,KENT,WA,346,687,341,0.665053242981607
98036,BRIER,WA,1596,1419,-177,0.47064676616915424
98036,LYNNWOOD,WA,17518,15996,-1522,0.47729307155218714
98037,LYNNWOOD,WA,14096,12769,-1327,0.47530243811650846
98038,MAPLE VALLEY,WA,13081,13214,133,0.5025289979083476
98039,MEDINA,WA,1232,1239,7,0.5014164305949008
98040,MERCER ISLAND,WA,12358,12591,233,0.5046695258326988
98041,BOTHELL,WA,1352,892,-460,0.39750445632798576
98042,COVINGTON,WA,6743,7182,439,0.5157630161579893
98042,KENT,WA,9908,10455,547,0.5134312232971566
98043,LNWD,WA,269,225,-44,0.45546558704453444
98043,MOUNTLAKE TERRACE,WA,11805,10620,-1185,0.4735785953177257
98045,NORTH BEND,WA,6047,6795,748,0.5291231895343405
98046,LYNNWOOD,WA,1343,1603,260,0.5441276306856755
98047,PACIFIC,WA,3567,2608,-959,0.4223481781376518
98050,PRESTON,WA,64,24,-40,0.2727272727272727
98051,RAVENSDALE,WA,1302,1349,47,0.5088645794039985
98052,REDMOND,WA,49295,47463,-1832,0.490533082535811
98053,REDMOND,WA,7452,7871,419,0.5136722573908503
98055,RENTON,WA,14412,12516,-1896,0.46479500891265596
98056,NEWCASTLE,WA,1544,1465,-79,0.48687271518777003
98056,RENTON,WA,17147,15177,-1970,0.4695272862269521
98057,RENTON,WA,11642,10086,-1556,0.4641936671575847
98058,RENTON,WA,18272,17534,-738,0.48969446461486904
98059,NEWCASTLE,WA,3397,3470,73,0.5053152759574778
98059,RENTON,WA,11284,11549,265,0.5058030044234222
98061,ROLLINGBAY,WA,77,25,-52,0.24509803921568626
98062,SEAHURST,WA,43,83,40,0.6587301587301587
98063,FEDERAL WAY,WA,1311,1066,-245,0.44846445098864113
98064,KENT,WA,875,1229,354,0.5841254752851711
98065,SNOQUALMIE,WA,5336,5541,205,0.5094235542888664
98070,VASHON,WA,4615,4945,330,0.5172594142259415
98071,AUBURN,WA,1129,1480,351,0.5672671521655807
98072,WOODINVILLE,WA,11517,11996,479,0.510185854633607
98073,REDMOND,WA,1963,1232,-731,0.38560250391236306
98074,REDMOND,WA,210,268,58,0.5606694560669456
98074,SAMMAMISH,WA,8159,9581,1422,0.5400789177001127
98075,SAMMAMISH,WA,7011,8351,1340,0.5436141127457362
98077,WOODINVILLE,WA,3215,3591,376,0.5276226858654128
98082,LYNNWOOD,WA,36,34,-2,0.4857142857142857
98082,MILL CREEK,WA,1295,1381,86,0.5160687593423019
98083,KIRKLAND,WA,1125,1319,194,0.5396890343698855
98087,LYNNWOOD,WA,22920,21712,-1208,0.48646710880086036
98089,KENT,WA,0,24,24,1
98092,AUBURN,WA,20438,18364,-2074,0.47327457347559404
98093,FEDERAL WAY,WA,1233,1694,461,0.5787495729415784
98101,SEATTLE,WA,24378,20080,-4298,0.45166224301588015
98102,SEATTLE,WA,29500,23977,-5523,0.4483609776165454
98103,SEATTLE,WA,42787,37080,-5707,0.4642718519538733
98104,SEATTLE,WA,16898,15029,-1869,0.4707301030475773
98105,SEATTLE,WA,28926,20976,-7950,0.4203438739930263
98106,SEATTLE,WA,14004,12670,-1334,0.4749943765464497
98107,SEATTLE,WA,27610,25092,-2518,0.4761109635307958
98108,SEATTLE,WA,10875,9515,-1360,0.4666503187837175
98109,SEATTLE,WA,46322,38526,-7796,0.45405902319441827
98110,BAINBRIDGE IS,WA,176,179,3,0.504225352112676
98110,BAINBRIDGE ISLAND,WA,11400,11984,584,0.5124871707150188
98111,SEATTLE,WA,1773,630,-1143,0.26217228464419473
98112,SEATTLE,WA,15105,13521,-1584,0.47233284426744915
98113,SEATTLE,WA,69,182,113,0.7250996015936255
98115,SEATTLE,WA,32754,31898,-856,0.49337994184247974
98116,SEATTLE,WA,19446,18608,-838,0.4889893309507542
98117,SEATTLE,WA,16513,16648,135,0.5020355236573083
98118,SEATTLE,WA,22185,20637,-1548,0.48192517864649015
98119,SEATTLE,WA,22124,18370,-3754,0.45364745394379413
98121,SEATTLE,WA,28819,24891,-3928,0.46343325265313723
98122,SEATTLE,WA,42721,34971,-7750,0.45012356484580135
98124,SEATTLE,WA,472,706,234,0.599320882852292
98125,SEATTLE,WA,26172,23413,-2759,0.4721790864172633
98126,SEATTLE,WA,12236,12097,-139,0.4971437964903629
98127,SEATTLE,WA,716,664,-52,0.4811594202898551
98133,SEATTLE,WA,20972,19621,-1351,0.4833591998620452
98133,SHORELINE,WA,8117,7504,-613,0.48037897701811666
98134,SEATTLE,WA,1107,834,-273,0.42967542503863987
98136,SEATTLE,WA,7942,8008,66,0.5020689655172413
98138,SEATTLE,WA,309,381,72,0.5521739130434783
98138,TUKWILA,WA,334,454,120,0.5761421319796954
98139,SEATTLE,WA,277,35,-242,0.11217948717948718
98144,SEATTLE,WA,20692,19998,-694,0.49147210616859177
98145,SEATTLE,WA,466,347,-119,0.4268142681426814
98146,BURIEN,WA,4612,4325,-287,0.48394315765916973
98146,SEATTLE,WA,6910,6339,-571,0.4784512038644426
98148,BURIEN,WA,3555,3256,-299,0.47805021289091176
98148,DES MOINES,WA,303,288,-15,0.4873096446700508
98148,NORMANDY PARK,WA,1285,1156,-129,0.4735764031134781
98148,SEATTLE,WA,395,311,-84,0.4405099150141643
98154,SEATTLE,WA,38,0,-38,0
98155,LAKE FOREST PARK,WA,4133,4265,132,0.5078590140509646
98155,SHORELINE,WA,10965,10980,15,0.5003417634996582
98164,SEATTLE,WA,44,15,-29,0.2542372881355932
98165,SEATTLE,WA,326,211,-115,0.3929236499068901
98166,BURIEN,WA,10826,9048,-1778,0.455268189594445
98166,NORMANDY PARK,WA,556,519,-37,0.4827906976744186
98168,BURIEN,WA,679,620,-59,0.47729022324865283
98168,SEATAC,WA,2860,2751,-109,0.4902869363749777
98168,SEATTLE,WA,3617,3426,-191,0.4864404373136448
98168,TUKWILA,WA,9029,7798,-1231,0.46342188149997027
98175,SEATTLE,WA,96,103,7,0.5175879396984925
98177,SEATTLE,WA,2163,2430,267,0.5290659699542782
98177,SHORELINE,WA,4331,4688,357,0.5197915511697527
98178,SEATTLE,WA,10097,9233,-864,0.47765131919296433
98178,TUKWILA,WA,238,216,-22,0.47577092511013214
98188,SEATAC,WA,8240,7142,-1098,0.4643089325185282
98188,SEATTLE,WA,962,835,-127,0.46466332776850305
98188,TUKWILA,WA,5608,4999,-609,0.4712925426605072
98194,SEATTLE,WA,17,35,18,0.6730769230769231
98195,SEATTLE,WA,0,15,15,1
98198,DES MOINES,WA,17080,15752,-1328,0.47977582846003897
98198,NORMANDY PARK,WA,712,704,-8,0.4971751412429379
98198,SEATAC,WA,1207,1188,-19,0.4960334029227557
98199,SEATTLE,WA,11705,11457,-248,0.4946464035920905
98201,EVERETT,WA,17787,16581,-1206,0.48245460893854747
98203,EVERETT,WA,16238,14798,-1440,0.47680113416677405
98204,EVERETT,WA,27100,23037,-4063,0.45948102199972074
98206,EVERETT,WA,1308,1871,563,0.5885498584460522
98208,EVERETT,WA,24302,22795,-1507,0.48400110410429537
98213,EVERETT,WA,252,313,61,0.5539823008849557
98220,ACME,WA,25,22,-3,0.46808510638297873
98221,ANACORTES,WA,11550,12280,730,0.5153168275283256
98223,ARLINGTON,WA,17987,18550,563,0.5077045187070641
98223,MARYSVILLE,WA,439,447,8,0.5045146726862303
98225,BELLINGHAM,WA,31795,26778,-5017,0.4571731002338962
98226,BELLINGHAM,WA,20877,21311,434,0.505143642742012
98227,BELLINGHAM,WA,1550,1352,-198,0.4658855961405927
98227,OAK HARBOR,WA,39,27,-12,0.4090909090909091
98228,BELLINGHAM,WA,1408,1605,197,0.5326916694324594
98229,BELLINGHAM,WA,16044,14512,-1532,0.4749312737269276
98230,BLAINE,WA,8347,9907,1560,0.5427303604689383
98231,BLAINE,WA,767,860,93,0.5285802089735709
98231,FULLERTON,CA,18,11,-7,0.3793103448275862
98232,BOW,WA,1458,1399,-59,0.4896744837241862
98233,BURLINGTON,WA,7380,6686,-694,0.47533058438788567
98235,CLEARLAKE,WA,246,164,-82,0.4
98236,CLINTON,WA,2892,2898,6,0.5005181347150259
98237,CONCRETE,WA,2313,1790,-523,0.4362661467219108
98238,CONWAY,WA,41,12,-29,0.22641509433962265
98239,COUPEVILLE,WA,4673,3814,-859,0.44939318958406976
98240,CUSTER,WA,1184,1250,66,0.5135579293344289
98241,DARRINGTON,WA,760,832,72,0.5226130653266332
98243,DEER HARBOR,WA,153,165,12,0.5188679245283019
98244,DEMING,WA,976,1008,32,0.5080645161290323
98245,EASTSOUND,WA,2881,2638,-243,0.4779851422359123
98247,EVERSON,WA,2797,2707,-90,0.49182412790697677
98248,FERNDALE,WA,11207,10949,-258,0.4941776493951977
98249,FREELAND,WA,2956,3289,333,0.5266613290632506
98250,FRIDAY HARBOR,WA,5127,5112,-15,0.4992675065924407
98250,ROCHE HARBOR,WA,79,139,60,0.6376146788990825
98251,GOLD BAR,WA,2299,1979,-320,0.46259934548854603
98252,GRANITE FALLS,WA,3967,4478,511,0.5302545885139136
98253,GREENBANK,WA,1006,1093,87,0.5207241543592187
98255,HAMILTON,WA,31,0,-31,0
98257,LA CONNER,WA,2198,2332,134,0.5147902869757175
98258,LAKE STEVENS,WA,18408,20340,1932,0.5249303189842056
98259,NORTH LAKEWOOD,WA,14,23,9,0.6216216216216216
98260,LANGLEY,WA,3172,3184,12,0.500943989930774
98261,LOPEZ ISLAND,WA,1439,1579,140,0.5231941683233929
98262,LUMMI ISLAND,WA,330,450,120,0.5769230769230769
98264,LYNDEN,WA,8151,8334,183,0.5055505004549591
98266,MAPLE FALLS,WA,2304,1885,-419,0.44998806397708285
98267,MARBLEMOUNT,WA,156,34,-122,0.17894736842105263
98270,MARYSVILLE,WA,22828,22449,-379,0.4958146520308324
98271,MARYSVILLE,WA,8719,8786,67,0.5019137389317337
98271,QUIL CEDA VILLAGE,WA,262,253,-9,0.4912621359223301
98271,TULALIP,WA,3310,3443,133,0.5098474751962091
98272,MONROE,WA,9767,10833,1066,0.5258737864077669
98273,MOUNT VERNON,WA,14020,11131,-2889,0.4425668959484712
98274,MOUNT VERNON,WA,6496,6417,-79,0.4969410671416402
98275,MUKILTEO,WA,11346,10550,-796,0.481823164048228
98276,EVERSON,WA,13,23,10,0.6388888888888888
98276,NOOKSACK,WA,312,343,31,0.5236641221374045
98277,OAK HARBOR,WA,23535,19409,-4126,0.45196069299552905
98278,OAK HARBOR,WA,0,59,59,1
98279,OLGA,WA,408,426,18,0.5107913669064749
98280,ORCAS,WA,141,186,45,0.5688073394495413
98281,POINT ROBERTS,WA,830,973,143,0.5396561286744315
98282,CAMANO ISLAND,WA,6556,6966,410,0.5151604792190504
98282,STANWOOD,WA,309,234,-75,0.430939226519337
98283,ROCKPORT,WA,59,12,-47,0.16901408450704225
98284,SEDRO WOOLLEY,WA,9569,9862,293,0.5075394987391282
98287,SILVANA,WA,23,38,15,0.6229508196721312
98288,SKYKOMISH,WA,13,0,-13,0
98290,SNOHOMISH,WA,12045,13014,969,0.5193343708847121
98291,SNOHOMISH,WA,776,907,131,0.5389185977421271
98292,STANWOOD,WA,9455,10213,758,0.519269880008135
98294,SULTAN,WA,2968,3652,684,0.5516616314199396
98295,SUMAS,WA,1181,1268,87,0.5177623519804002
98296,SNOHOMISH,WA,6982,7828,846,0.5285617825793383
98297,WALDRON,WA,0,11,11,1
98303,ANDERSON IS,WA,33,11,-22,0.25
98303,ANDERSON ISLAND,WA,686,783,97,0.5330156569094622
98304,ASHFORD,WA,240,152,-88,0.3877551020408163
98305,BEAVER,WA,0,12,12,1
98310,BREMERTON,WA,14759,10906,-3853,0.42493668420027275
98311,BREMERTON,WA,11607,9976,-1631,0.4622156326738637
98312,BREMERTON,WA,20593,16883,-3710,0.4505016543921443
98315,SILVERDALE,WA,2826,2052,-774,0.42066420664206644
98320,BRINNON,WA,863,902,39,0.5110481586402267
98321,BUCKLEY,WA,5346,6207,861,0.5372630485588159
98322,BURLEY,WA,174,137,-37,0.4405144694533762
98323,CARBONADO,WA,460,415,-45,0.4742857142857143
98324,CARLSBORG,WA,271,472,201,0.6352624495289367
98325,CHIMACUM,WA,972,996,24,0.5060975609756098
98326,CLALLAM BAY,WA,80,35,-45,0.30434782608695654
98327,DUPONT,WA,7084,6168,-916,0.4654391789918503
98328,EATONVILLE,WA,3631,3913,282,0.5186903499469777
98329,GIG HARBOR,WA,3189,3471,282,0.5211711711711712
98330,ELBE,WA,19,0,-19,0
98331,FORKS,WA,2548,1764,-784,0.4090909090909091
98332,GIG HARBOR,WA,7252,7937,685,0.5225492132464283
98333,FOX ISLAND,WA,1653,1654,1,0.5001511944360447
98335,GIG HARBOR,WA,13481,13875,394,0.5072013452259102
98336,GLENOMA,WA,169,176,7,0.5101449275362319
98337,BREMERTON,WA,6005,4841,-1164,0.44633966439240275
98338,GRAHAM,WA,10816,10945,129,0.5029640181976931
98339,PORT HADLOCK,WA,1894,1935,41,0.5053538782972056
98340,HANSVILLE,WA,1104,1368,264,0.5533980582524272
98342,INDIANOLA,WA,452,497,45,0.523709167544784
98343,JOYCE,WA,15,0,-15,0
98344,KAPOWSIN,WA,51,41,-10,0.44565217391304346
98345,KEYPORT,WA,249,175,-74,0.41273584905660377
98346,KINGSTON,WA,3885,4241,356,0.5219049963081467
98349,LAKEBAY,WA,2113,2377,264,0.5293986636971046
98350,LA PUSH,WA,13,0,-13,0
98351,LONGBRANCH,WA,133,321,188,0.7070484581497798
98353,MANCHESTER,WA,478,330,-148,0.4084158415841584
98354,MILTON,WA,5738,5262,-476,0.4783636363636364
98355,MINERAL,WA,58,60,2,0.5084745762711864
98356,MORTON,WA,1120,914,-206,0.44936086529006886
98357,NEAH BAY,WA,106,11,-95,0.09401709401709402
98358,NORDLAND,WA,151,346,195,0.6961770623742455
98359,OLALLA,WA,2012,1917,-95,0.48791040977347927
98360,ORTING,WA,5559,5961,402,0.5174479166666667
98361,PACKWOOD,WA,678,483,-195,0.4160206718346253
98362,PORT ANGELES,WA,11620,11478,-142,0.4969261407914105
98363,PORT ANGELES,WA,5008,5216,208,0.5101721439749609
98365,PORT HADLOCK,WA,65,83,18,0.5608108108108109
98365,PORT LUDLOW,WA,2759,2989,230,0.5200069589422408
98366,PORT ORCHARD,WA,19619,16646,-2973,0.4590100648007721
98367,PORT ORCHARD,WA,10022,10784,762,0.518312025377295
98368,PORT TOWNSEND,WA,9040,9538,498,0.5134029497254817
98370,POULSBO,WA,13176,13338,162,0.5030549898167006
98371,EDGEWOOD,WA,2175,2154,-21,0.49757449757449757
98371,PUYALLUP,WA,9021,9412,391,0.5106059784082895
98372,EDGEWOOD,WA,3525,3557,32,0.5022592487997741
98372,PUYALLUP,WA,9458,8876,-582,0.4841278498963674
98373,PUYALLUP,WA,15484,14633,-851,0.48587176677623933
98374,PUYALLUP,WA,18013,20355,2342,0.5305202251876564
98374,SOUTH HILL,WA,338,420,82,0.554089709762533
98375,PUYALLUP,WA,12576,12015,-561,0.48859338782481393
98375,SOUTH HILL,WA,246,269,23,0.5223300970873787
98376,QUILCENE,WA,1074,866,-208,0.4463917525773196
98377,RANDLE,WA,878,855,-23,0.4933641084824005
98380,SEABECK,WA,2030,2001,-29,0.49640287769784175
98381,SEKIU,WA,26,15,-11,0.36585365853658536
98382,SEQUIM,WA,15668,16209,541,0.5084857420710858
98383,SILVERDALE,WA,13999,12133,-1866,0.46429664778815244
98384,SOUTH COLBY,WA,114,114,0,0.5
98385,SOUTH PRAIRIE,WA,700,310,-390,0.3069306930693069
98386,SOUTHWORTH,WA,0,11,11,1
98387,SPANAWAY,WA,22097,20519,-1578,0.48148582691946684
98388,STEILACOOM,WA,3687,3468,-219,0.4846960167714885
98390,SUMNER,WA,7037,6600,-437,0.4839774143873286
98391,BONNEY LAKE,WA,17298,20256,2958,0.5393832880651861
98391,LAKE TAPPS,WA,1786,2134,348,0.5443877551020408
98391,SUMNER,WA,416,512,96,0.5517241379310345
98392,SUQUAMISH,WA,1403,1286,-117,0.47824470063220526
98393,BREMERTON,WA,0,14,14,1
98393,TRACYTON,WA,507,238,-269,0.3194630872483222
98394,VAUGHN,WA,858,782,-76,0.4768292682926829
98395,WAUNA,WA,462,447,-15,0.49174917491749176
98396,WILKESON,WA,43,110,67,0.7189542483660131
98401,TACOMA,WA,673,1049,376,0.6091753774680604
98402,TACOMA,WA,8936,7473,-1463,0.45542080565543297
98403,TACOMA,WA,6643,5139,-1504,0.43617382447801734
98404,TACOMA,WA,14300,12190,-2110,0.46017365043412606
98405,TACOMA,WA,15410,13245,-2165,0.46222299773163494
98406,TACOMA,WA,10752,9919,-833,0.479850998984084
98407,TACOMA,WA,12253,10892,-1361,0.470598401382588
98408,TACOMA,WA,9505,8557,-948,0.4737570590189348
98409,TACOMA,WA,16843,13787,-3056,0.45011426705843943
98411,TACOMA,WA,1192,1518,326,0.5601476014760147
98415,TACOMA,WA,0,66,66,1
98417,TACOMA,WA,492,545,53,0.5255544840887174
98418,TACOMA,WA,5415,4668,-747,0.46295745313894676
98419,TACOMA,WA,313,679,366,0.6844758064516129
98421,TACOMA,WA,128,237,109,0.6493150684931507
98422,TACOMA,WA,8447,8047,-400,0.4878743785619013
98424,FIFE,WA,7263,5459,-1804,0.42909919823927056
98424,TACOMA,WA,389,291,-98,0.4279411764705882
98433,JOINT BASE LEWIS MCCHORD,WA,9503,8573,-930,0.4742752821420668
98433,TACOMA,WA,578,455,-123,0.4404646660212972
98438,JOINT BASE LEWIS MCCHORD,WA,46,345,299,0.8823529411764706
98438,MCCHORD AFB,WA,60,467,407,0.8861480075901328
98438,TACOMA,WA,46,208,162,0.8188976377952756
98439,JOINT BASE LEWIS MCCHORD,WA,86,56,-30,0.39436619718309857
98439,LAKEWOOD,WA,2404,1777,-627,0.4250179382922746
98439,MCCHORD AFB,WA,1330,1064,-266,0.4444444444444444
98443,TACOMA,WA,1992,1787,-205,0.4728764223339508
98444,TACOMA,WA,18444,15292,-3152,0.4532843253497747
98445,TACOMA,WA,14392,11973,-2419,0.45412478664896644
98446,TACOMA,WA,5580,5594,14,0.5006264542688383
98448,TACOMA,WA,906,1036,130,0.533470648815654
98464,TACOMA,WA,599,963,364,0.6165172855313701
98464,UNIVERSITY PL,WA,43,86,43,0.6666666666666666
98464,UNIVERSITY PLACE,WA,175,242,67,0.580335731414868
98465,TACOMA,WA,3951,3555,-396,0.473621103117506
98466,FIRCREST,WA,3300,3127,-173,0.4865411545044344
98466,TACOMA,WA,1019,1026,7,0.5017114914425428
98466,UNIVERSITY PL,WA,566,491,-75,0.4645222327341533
98466,UNIVERSITY PLACE,WA,9775,9253,-522,0.4862833718730292
98467,TACOMA,WA,614,567,-47,0.48010160880609654
98467,UNIVERSITY PL,WA,566,517,-49,0.4773776546629732
98467,UNIVERSITY PLACE,WA,5534,5296,-238,0.48901200369344416
98490,TACOMA,WA,61,25,-36,0.29069767441860467
98496,LAKEWOOD,WA,1243,1768,525,0.5871803387578878
98496,TACOMA,WA,87,96,9,0.5245901639344263
98498,LAKEWOOD,WA,16661,12331,-4330,0.4253242273730684
98498,TACOMA,WA,562,478,-84,0.4596153846153846
98499,LAKEWOOD,WA,23239,15781,-7458,0.40443362378267556
98501,OLYMPIA,WA,18936,19416,480,0.5062578222778473
98501,TUMWATER,WA,2297,2234,-63,0.49304789229750606
98502,OLYMPIA,WA,18582,17070,-1512,0.47879501851228545
98503,LACEY,WA,18638,18060,-578,0.49212491143931547
98504,OLYMPIA,WA,0,24,24,1
98506,LACEY,WA,163,195,32,0.5446927374301676
98506,OLYMPIA,WA,8616,8201,-415,0.4876612951180353
98507,OLYMPIA,WA,1475,2140,665,0.5919778699861687
98508,OLYMPIA,WA,1179,1347,168,0.5332541567695962
98509,LACEY,WA,1499,1567,68,0.5110893672537509
98509,OLYMPIA,WA,89,104,15,0.538860103626943
98511,TUMWATER,WA,594,728,134,0.5506807866868382
98512,OLYMPIA,WA,6653,6156,-497,0.4805995784214224
98512,TUMWATER,WA,7862,7405,-457,0.4850330778803956
98513,LACEY,WA,4651,4652,1,0.5000537461034075
98513,OLYMPIA,WA,9190,9151,-39,0.4989368082438253
98516,LACEY,WA,10930,12567,1637,0.534834234157552
98516,OLYMPIA,WA,3604,3660,56,0.5038546255506607
98520,ABERDEEN,WA,10874,9240,-1634,0.4593815253057572
98524,ALLYN,WA,2045,1956,-89,0.4888777805548613
98528,BELFAIR,WA,4854,5066,212,0.5106854838709678
98530,BUCODA,WA,62,90,28,0.5921052631578947
98531,CENTRALIA,WA,11440,10673,-767,0.4826572604350382
98532,CHEHALIS,WA,9569,9843,274,0.5070574902122399
98533,CINEBAR,WA,33,35,2,0.5147058823529411
98535,COPALIS BEACH,WA,128,184,56,0.5897435897435898
98537,COSMOPOLIS,WA,784,733,-51,0.4831905075807515
98538,CURTIS,WA,0,14,14,1
98540,EAST OLYMPIA,WA,190,237,47,0.5550351288056206
98541,ELMA,WA,4182,3738,-444,0.471969696969697
98542,ETHEL,WA,0,41,41,1
98544,GALVIN,WA,11,11,0,0.5
98546,GRAPEVIEW,WA,1460,1409,-51,0.491111885674451
98547,GRAYLAND,WA,495,519,24,0.5118343195266272
98548,HOODSPORT,WA,1767,1482,-285,0.45614035087719296
98550,HOQUIAM,WA,5336,4740,-596,0.4704247717348154
98555,LILLIWAUP,WA,267,227,-40,0.45951417004048584
98556,LITTLEROCK,WA,0,11,11,1
98557,MCCLEARY,WA,1279,1495,216,0.5389329488103821
98558,MCKENNA,WA,200,286,86,0.588477366255144
98560,MATLOCK,WA,0,14,14,1
98562,MOCLIPS,WA,0,13,13,1
98563,MONTESANO,WA,3005,3096,91,0.5074577938042943
98564,MOSSYROCK,WA,1085,1219,134,0.5290798611111112
98565,NAPAVINE,WA,522,456,-66,0.4662576687116564
98568,OAKVILLE,WA,578,691,113,0.5445232466509062
98569,OCEAN SHORES,WA,5708,5763,55,0.5023973498387238
98570,ONALASKA,WA,1556,1705,149,0.5228457528365532
98571,PACIFIC BEACH,WA,121,167,46,0.5798611111111112
98572,PE ELL,WA,93,115,22,0.5528846153846154
98576,RAINIER,WA,1968,2123,155,0.5189440234661452
98577,RAYMOND,WA,2404,2345,-59,0.4937881659296694
98579,ROCHESTER,WA,5223,4726,-497,0.47502261533822493
98580,ROY,WA,3797,4000,203,0.5130178273695011
98581,RYDERWOOD,WA,36,0,-36,0
98582,SALKUM,WA,170,216,46,0.5595854922279793
98583,SATSOP,WA,14,0,-14,0
98584,SHELTON,WA,16612,15474,-1138,0.4822664090257433
98585,SILVER CREEK,WA,79,90,11,0.5325443786982249
98586,SOUTH BEND,WA,1110,780,-330,0.4126984126984127
98588,TAHUYA,WA,820,956,136,0.5382882882882883
98589,TENINO,WA,2888,3312,424,0.5341935483870968
98590,TOKELAND,WA,0,15,15,1
98591,TOLEDO,WA,1353,1660,307,0.5509459010952539
98592,UNION,WA,1542,1434,-108,0.48185483870967744
98593,VADER,WA,282,400,118,0.5865102639296188
98595,WESTPORT,WA,2519,1729,-790,0.407015065913371
98596,WINLOCK,WA,2979,2888,-91,0.49224475882052154
98597,YELM,WA,12133,11658,-475,0.4900172334075911
98601,AMBOY,WA,1234,1348,114,0.5220759101471727
98603,ARIEL,WA,125,190,65,0.6031746031746031
98604,BATTLE GROUND,WA,13260,14130,870,0.515881708652793
98605,BINGEN,WA,640,423,-217,0.39793038570084666
98606,BRUSH PRAIRIE,WA,3892,3976,84,0.505338078291815
98607,CAMAS,WA,14363,15639,1276,0.5212652489834011
98610,CARSON,WA,818,1015,197,0.5537370430987453
98611,CASTLE ROCK,WA,3873,4130,257,0.5160564788204424
98612,CATHLAMET,WA,1379,1537,158,0.5270919067215364
98613,CENTERVILLE,WA,11,12,1,0.5217391304347826
98614,CHINOOK,WA,85,73,-12,0.4620253164556962
98616,COUGAR,WA,52,67,15,0.5630252100840336
98617,DALLESPORT,WA,126,56,-70,0.3076923076923077
98617,HONOLULU,WA,11,0,-11,0
98619,GLENWOOD,WA,0,23,23,1
98620,GOLDENDALE,WA,4507,3836,-671,0.45978664748891285
98623,HUSUM,WA,13,11,-2,0.4583333333333333
98624,ILWACO,WA,745,778,33,0.5108338804990151
98625,KALAMA,WA,2640,2983,343,0.5304997332384848
98626,KELSO,WA,12082,10277,-1805,0.45963594078447156
98629,LA CENTER,WA,2844,3755,911,0.5690256099409001
98631,LONG BEACH,WA,2386,2469,83,0.5085478887744593
98632,LONGVIEW,WA,22148,21251,-897,0.4896656604990898
98635,LYLE,WA,1058,882,-176,0.45463917525773195
98637,NAHCOTTA,WA,12,0,-12,0
98638,NASELLE,WA,828,376,-452,0.3122923588039867
98639,NORTH BONNEVILLE,WA,878,159,-719,0.15332690453230471
98640,OCEAN PARK,WA,3499,3623,124,0.5087054198258916
98641,OYSTERVILLE,WA,13,0,-13,0
98642,RIDGEFIELD,WA,9979,12983,3004,0.5654124205208606
98643,ROSBURG,WA,39,14,-25,0.2641509433962264
98644,SEATTLE,WA,23,13,-10,0.3611111111111111
98644,SEAVIEW,WA,256,319,63,0.5547826086956522
98645,SILVERLAKE,WA,418,530,112,0.5590717299578059
98647,SKAMOKAWA,WA,0,39,39,1
98648,STEVENSON,WA,1170,1291,121,0.5245835026412028
98649,TOUTLE,WA,295,312,17,0.514003294892916
98650,TROUT LAKE,WA,248,200,-48,0.44642857142857145
98651,UNDERWOOD,WA,246,189,-57,0.43448275862068964
98660,VANCOUVER,WA,8914,8508,-406,0.4883480656641029
98661,VANCOUVER,WA,29500,25532,-3968,0.4639482482919029
98662,VANCOUVER,WA,16272,16515,243,0.5037057370299204
98663,VANCOUVER,WA,7761,7075,-686,0.4768805607980588
98664,VANCOUVER,WA,10934,10120,-814,0.48066875653082547
98665,VANCOUVER,WA,15462,14947,-515,0.4915321122036239
98666,VANCOUVER,WA,924,1338,414,0.5915119363395226
98668,VANCOUVER,WA,1398,2101,703,0.6004572735067162
98671,WASHOUGAL,WA,9209,9906,697,0.5182317551660999
98672,WHITE SALMON,WA,2848,2764,-84,0.4925160370634355
98673,WISHRAM,WA,63,0,-63,0
98674,WOODLAND,WA,5271,5702,431,0.5196391141893739
98675,YACOLT,WA,2669,1891,-778,0.41469298245614034
98682,VANCOUVER,WA,27839,29208,1369,0.511998878118043
98683,VANCOUVER,WA,18234,16958,-1276,0.48187087974539666
98684,VANCOUVER,WA,16305,17314,1009,0.5150063951931944
98685,VANCOUVER,WA,9804,10738,934,0.5227339110115861
98686,VANCOUVER,WA,8480,9896,1416,0.5385285154549412
98687,VANCOUVER,WA,1683,2271,588,0.5743550834597876
98801,WENATCHEE,WA,16680,16096,-584,0.491091042226019
98802,E WENATCHEE,WA,1272,1341,69,0.513203214695752
98802,EAST WENATCHEE,WA,9031,9364,333,0.509051372655613
98807,WENATCHEE,WA,1614,1878,264,0.5378006872852233
98812,BREMERTON,WA,34,55,21,0.6179775280898876
98812,BREWSTER,WA,672,527,-145,0.4395329441201001
98813,BRIDGEPORT,WA,77,14,-63,0.15384615384615385
98814,CARLTON,WA,55,14,-41,0.2028985507246377
98815,CASHMERE,WA,2341,2282,-59,0.4936188622106857
98816,CHELAN,WA,3970,3709,-261,0.4830055996874593
98821,DRYDEN,WA,34,14,-20,0.2916666666666667
98822,ENTIAT,WA,542,877,335,0.6180408738548273
98823,EPHRATA,WA,5009,4591,-418,0.47822916666666665
98824,GEORGE,WA,14,0,-14,0
98826,LEAVENWORTH,WA,4384,4296,-88,0.4949308755760369
98827,LOOMIS,WA,12,12,0,0.5
98828,MALAGA,WA,885,806,-79,0.47664104080425784
98829,MALOTT,WA,25,0,-25,0
98830,MANSFIELD,WA,0,15,15,1
98831,MANSON,WA,1410,1508,98,0.5167923235092529
98831,MOSES LAKE,WA,22,23,1,0.5111111111111111
98833,MAZAMA,WA,0,11,11,1
98834,METHOW,WA,14,0,-14,0
98837,MOSES LAKE,WA,17723,18165,442,0.5061580472581364
98840,OKANOGAN,WA,1805,1373,-432,0.4320327249842668
98841,OMAK,WA,4768,3042,-1726,0.3895006402048656
98843,ORONDO,WA,626,724,98,0.5362962962962963
98844,OROVILLE,WA,2087,2216,129,0.5149895421798745
98846,PATEROS,WA,235,229,-6,0.49353448275862066
98847,PESHASTIN,WA,502,369,-133,0.42365097588978184
98848,QUINCY,WA,4441,3524,-917,0.44243565599497803
98849,RIVERSIDE,WA,186,285,99,0.6050955414012739
98850,ROCK ISLAND,WA,426,607,181,0.5876089060987415
98851,SOAP LAKE,WA,1647,1504,-143,0.4773087908600444
98855,TONASKET,WA,2306,2392,86,0.5091528309919114
98856,TWISP,WA,1148,1129,-19,0.4958278436539306
98857,WARDEN,WA,1052,901,-151,0.46134152585765487
98858,WATERVILLE,WA,216,285,69,0.5688622754491018
98859,WAUCONDA,WA,0,12,12,1
98862,WINTHROP,WA,1354,1654,300,0.5498670212765957
98901,YAKIMA,WA,12657,9074,-3583,0.41756016750264596
98902,YAKIMA,WA,17140,13879,-3261,0.4474354427931268
98903,UNION GAP,WA,958,1002,44,0.5112244897959184
98903,YAKIMA,WA,4164,4646,482,0.527355278093076
98907,YAKIMA,WA,808,956,148,0.5419501133786848
98908,YAKIMA,WA,14147,14072,-75,0.49867110811864346
98909,YAKIMA,WA,1112,1588,476,0.5881481481481482
98922,CLE ELUM,WA,3916,4168,252,0.5155863433943593
98923,COWICHE,WA,78,37,-41,0.3217391304347826
98925,EASTON,WA,220,191,-29,0.46472019464720193
98926,ELLENSBURG,WA,21840,16291,-5549,0.4272376806273111
98930,GRANDVIEW,WA,4482,2794,-1688,0.3840021990104453
98932,GRANGER,WA,851,751,-100,0.46878901373283394
98933,HARRAH,WA,128,22,-106,0.14666666666666667
98934,KITTITAS,WA,421,346,-75,0.4511082138200782
98935,MABTON,WA,766,286,-480,0.2718631178707224
98936,MOXEE,WA,1849,1956,107,0.514060446780552
98937,NACHES,WA,2380,1554,-826,0.39501779359430605
98938,OUTLOOK,WA,93,102,9,0.5230769230769231
98939,PARKER,WA,0,12,12,1
98940,RONALD,WA,342,244,-98,0.41638225255972694
98941,ROSLYN,WA,491,412,-79,0.45625692137320045
98942,SELAH,WA,6397,6204,-193,0.49234187762875964
98943,S CLE ELUM,WA,54,31,-23,0.36470588235294116
98943,SOUTH CLE ELUM,WA,140,164,24,0.5394736842105263
98944,SUNNYSIDE,WA,4310,4008,-302,0.4818465977398413
98946,THORP,WA,11,24,13,0.6857142857142857
98947,TIETON,WA,574,593,19,0.508140531276778
98948,TOPPENISH,WA,3026,2081,-945,0.40747992950851775
98951,WAPATO,WA,2641,2042,-599,0.4360452701259876
98952,WHITE SWAN,WA,109,60,-49,0.35502958579881655
98953,ZILLAH,WA,1679,1570,-109,0.4832256078793475
99001,AIRWAY HEIGHTS,WA,4778,4596,-182,0.4902922978451035
99003,CHATTAROY,WA,2216,2274,58,0.5064587973273942
99004,CHENEY,WA,11696,10961,-735,0.4837798472878139
99005,COLBERT,WA,3499,3836,337,0.5229720518064076
99006,DEER PARK,WA,5718,6087,369,0.5156289707750953
99008,EDWALL,WA,11,12,1,0.5217391304347826
99009,ELK,WA,2193,1621,-572,0.42501310959622446
99011,FAIRCHILD AFB,WA,697,607,-90,0.46549079754601225
99011,FAIRCHILD AIR FORCE BASE,WA,1979,1475,-504,0.42704111175448756
99012,FAIRFIELD,WA,107,135,28,0.5578512396694215
99013,FORD,WA,244,292,48,0.5447761194029851
99016,GREENACRES,WA,5017,6091,1074,0.5483435361901332
99016,SPOKANE VALLEY,WA,2269,2765,496,0.5492649980135081
99019,LIBERTY LAKE,WA,6619,7441,822,0.5292318634423897
99021,MEAD,WA,3362,3736,374,0.5263454494223725
99022,MEDICAL LAKE,WA,3327,3312,-15,0.49887031179394487
99025,NEWMAN LAKE,WA,1640,1906,266,0.5375070501974055
99026,NINE MILE FALLS,WA,3375,3652,277,0.51970969119112
99027,CITY OF SPOKANE VALLEY,WA,264,262,-2,0.49809885931558934
99027,OTIS ORCHARDS,WA,1866,2042,176,0.522517911975435
99027,SPOKANE VALLEY,WA,130,172,42,0.5695364238410596
99027,SPOKANE VLY,WA,48,61,13,0.5596330275229358
99029,REARDAN,WA,335,414,79,0.5527369826435247
99030,ROCKFORD,WA,191,104,-87,0.3525423728813559
99031,SPANGLE,WA,189,270,81,0.5882352941176471
99032,SPRAGUE,WA,182,115,-67,0.3872053872053872
99033,TEKOA,WA,87,125,38,0.589622641509434
99034,TUMTUM,WA,0,12,12,1
99036,VALLEYFORD,WA,156,379,223,0.708411214953271
99037,CITY OF SPOKANE VALLEY,WA,1653,1799,146,0.5211471610660486
99037,SPOKANE VLY,WA,1423,1199,-224,0.4572845156369184
99037,VERADALE,WA,6234,5794,-440,0.4817093448619887
99040,WELLPINIT,WA,47,0,-47,0
99101,ADDY,WA,517,558,41,0.5190697674418605
99102,ALBION,WA,106,13,-93,0.1092436974789916
99109,CHEWELAH,WA,2518,2672,154,0.5148362235067437
99110,CLAYTON,WA,498,587,89,0.5410138248847927
99111,COLFAX,WA,1857,1706,-151,0.4788099915801291
99113,COLTON,WA,42,0,-42,0
99114,COLVILLE,WA,6071,5878,-193,0.49192401037743744
99115,COULEE CITY,WA,347,320,-27,0.47976011994003
99116,COULEE DAM,WA,397,295,-102,0.4263005780346821
99117,CRESTON,WA,37,13,-24,0.26
99118,CURLEW,WA,259,259,0,0.5
99119,CUSICK,WA,379,396,17,0.5109677419354839
99121,DANVILLE,WA,0,11,11,1
99122,DAVENPORT,WA,1663,1781,118,0.5171312427409989
99122,DEER MEADOWS,WA,120,148,28,0.5522388059701493
99122,SEVEN BAYS,WA,54,67,13,0.5537190082644629
99123,ELECTRIC CITY,WA,174,293,119,0.6274089935760171
99124,ELMER CITY,WA,11,11,0,0.5
99125,ENDICOTT,WA,22,13,-9,0.37142857142857144
99126,EVANS,WA,124,159,35,0.5618374558303887
99129,FRUITLAND,WA,44,52,8,0.5416666666666666
99130,GARFIELD,WA,40,75,35,0.6521739130434783
99133,GRAND COULEE,WA,780,634,-146,0.44837340876944837
99134,HARRINGTON,WA,52,74,22,0.5873015873015873
99137,HUNTERS,WA,102,38,-64,0.2714285714285714
99138,INCHELIUM,WA,212,293,81,0.5801980198019802
99139,IONE,WA,473,532,59,0.5293532338308458
99140,KELLER,WA,0,13,13,1
99141,KETTLE FALLS,WA,2743,2789,46,0.5041576283441793
99143,LACROSSE,WA,56,36,-20,0.391304347826087
99148,LOON LAKE,WA,1789,1667,-122,0.48234953703703703
99149,MALDEN,WA,37,0,-37,0
99150,MALO,WA,17,26,9,0.6046511627906976
99153,METALINE FALLS,WA,70,111,41,0.6132596685082873
99155,NESPELEM,WA,48,56,8,0.5384615384615384
99156,NEWPORT,WA,4476,4308,-168,0.49043715846994534
99157,NORTHPORT,WA,283,224,-59,0.4418145956607495
99158,OAKESDALE,WA,57,41,-16,0.41836734693877553
99159,ODESSA,WA,387,301,-86,0.4375
99161,PALOUSE,WA,423,351,-72,0.45348837209302323
99163,PULLMAN,WA,20981,15024,-5957,0.41727537841966394
99166,REPUBLIC,WA,2110,1918,-192,0.47616683217477657
99167,RICE,WA,73,100,27,0.5780346820809249
99169,RITZVILLE,WA,1033,1144,111,0.5254937988056959
99170,ROSALIA,WA,177,205,28,0.5366492146596858
99171,SAINT JOHN,WA,138,190,52,0.5792682926829268
99173,SPRINGDALE,WA,674,707,33,0.5119478638667632
99179,UNIONTOWN,WA,0,25,25,1
99180,USK,WA,605,547,-58,0.4748263888888889
99181,VALLEY,WA,777,848,71,0.5218461538461538
99185,WILBUR,WA,520,488,-32,0.48412698412698413
99201,SPOKANE,WA,13066,11347,-1719,0.46479334780649656
99202,SPOKANE,WA,11265,9853,-1412,0.4665688038640023
99203,SPOKANE,WA,8963,8768,-195,0.49450115616716483
99204,SPOKANE,WA,6037,4980,-1057,0.45202868294454024
99205,SPOKANE,WA,20752,17793,-2959,0.46161629264496046
99206,MILLWOOD,WA,467,471,4,0.502132196162047
99206,SPOKANE,WA,6590,6638,48,0.501814333232537
99206,SPOKANE VALLEY,WA,8392,8670,278,0.5081467588793811
99206,SPOKANE VLY,WA,1906,1832,-74,0.4901016586409845
99207,SPOKANE,WA,16747,14754,-1993,0.46836608361639315
99208,SPOKANE,WA,24961,24849,-112,0.4988757277655089
99209,SPOKANE,WA,1067,1404,337,0.5681910157830837
99210,SPOKANE,WA,1820,1998,178,0.5233106338397067
99211,SPOKANE VALLEY,WA,23,13,-10,0.3611111111111111
99212,MILLWOOD,WA,349,365,16,0.511204481792717
99212,SPOKANE,WA,3876,3995,119,0.5075593952483801
99212,SPOKANE VALLEY,WA,4284,4395,111,0.5063947459384722
99212,SPOKANE VLY,WA,443,404,-39,0.4769775678866588
99213,SPOKANE VALLEY,WA,109,29,-80,0.21014492753623187
99213,SPOKANE VLY,WA,39,39,0,0.5
99214,SPOKANE VALLEY,WA,1037,1218,181,0.5401330376940133
99214,SPOKANE VLY,WA,47,67,20,0.5877192982456141
99215,SPOKANE VALLEY,WA,13,0,-13,0
99216,SPOKANE,WA,1058,1035,-23,0.4945054945054945
99216,SPOKANE VALLEY,WA,11712,10822,-890,0.4802520635484157
99216,SPOKANE VLY,WA,3291,3069,-222,0.48254716981132073
99217,SPOKANE,WA,8234,8062,-172,0.4947226313205695
99218,SPOKANE,WA,7678,6654,-1024,0.4642757465810773
99219,SPOKANE,WA,104,114,10,0.5229357798165137
99220,SPOKANE,WA,672,777,105,0.5362318840579711
99223,SPOKANE,WA,15808,15531,-277,0.4955805864896774
99224,SPOKANE,WA,11993,12148,155,0.5032103061182222
99228,SPOKANE,WA,1235,1259,24,0.5048115477145149
99301,PASCO,WA,26396,24956,-1440,0.48597912447421715
99302,PASCO,WA,2644,1913,-731,0.41979372394118936
99320,BENTON CITY,WA,3739,3348,-391,0.4724142796669959
99321,BEVERLY,WA,80,192,112,0.7058823529411765
99323,BURBANK,WA,917,1025,108,0.527806385169928
99324,COLLEGE PLACE,WA,5464,4376,-1088,0.44471544715447153
99326,CONNELL,WA,645,726,81,0.5295404814004376
99328,DAYTON,WA,1768,1675,-93,0.48649433633459194
99330,ELTOPIA,WA,91,70,-21,0.43478260869565216
99336,KENNEWICK,WA,26005,22051,-3954,0.4588604960878975
99337,KENNEWICK,WA,9439,10338,899,0.5227284219042322
99338,KENNEWICK,WA,5970,7473,1503,0.5559027002901138
99341,LIND,WA,34,12,-22,0.2608695652173913
99343,MESA,WA,147,120,-27,0.449438202247191
99344,OTHELLO,WA,3565,3257,-308,0.47742597478745236
99346,PLYMOUTH,WA,11,0,-11,0
99347,POMEROY,WA,806,672,-134,0.4546684709066306
99348,PRESCOTT,WA,383,253,-130,0.3977987421383648
99349,DESERT AIRE,WA,28,47,19,0.6266666666666667
99349,MATTAWA,WA,4115,3371,-744,0.45030724018167245
99350,PROSSER,WA,3619,3648,29,0.501995321315536
99352,RICHLAND,WA,18346,18533,187,0.5025353182027712
99353,WEST RICHLAND,WA,5764,6620,856,0.5345607235142119
99354,RICHLAND,WA,12001,11145,-856,0.48150868400587576
99356,ROOSEVELT,WA,0,11,11,1
99357,ROYAL CITY,WA,581,361,-220,0.3832271762208068
99360,TOUCHET,WA,88,129,41,0.5944700460829493
99361,WAITSBURG,WA,347,411,64,0.5422163588390502
99362,WALLA WALLA,WA,16637,16232,-405,0.4938391797742554
99363,WALLULA,WA,0,11,11,1
99401,ANATONE,WA,11,0,-11,0
99402,ASOTIN,WA,491,516,25,0.5124131082423039
99403,CLARKSTON,WA,10438,8901,-1537,0.4602616474481617
99501,ANCHORAGE,AK,12870,11607,-1263,0.47420026964088735
99502,ANCHORAGE,AK,9721,8588,-1133,0.4690589327653067
99503,ANCHORAGE,AK,9050,8503,-547,0.48441861790007407
99504,ANCHORAGE,AK,19465,17199,-2266,0.4690977525638228
99505,ANC,AK,34,42,8,0.5526315789473685
99505,ANCHORAGE,AK,146,108,-38,0.4251968503937008
99505,FORT RICHARDSON,AK,290,270,-20,0.48214285714285715
99505,FT RICHARDSON,AK,58,55,-3,0.48672566371681414
99505,JBER,AK,1831,1838,7,0.5009539384028345
99506,ANCHORAGE,AK,196,143,-53,0.4218289085545723
99506,ELMENDORF AFB,AK,76,72,-4,0.4864864864864865
99506,JBER,AK,4114,3229,-885,0.43973852648781153
99507,ANCHORAGE,AK,15567,13977,-1590,0.4730909829406986
99508,ANCHORAGE,AK,18106,14568,-3538,0.44585909285670566
99509,ANCHORAGE,AK,808,835,27,0.5082166768107121
99511,ANCHORAGE,AK,1099,953,-146,0.4644249512670565
99514,ANCHORAGE,AK,407,692,285,0.629663330300273
99515,ANCHORAGE,AK,8343,7926,-417,0.4871842153789415
99516,ANCHORAGE,AK,5658,6121,463,0.5196536208506665
99517,ANCHORAGE,AK,7926,6815,-1111,0.46231598941727153
99518,ANCHORAGE,AK,4995,4463,-532,0.4718756608162402
99519,ANCHORAGE,AK,327,401,74,0.5508241758241759
99520,ANCHORAGE,AK,329,418,89,0.5595716198125836
99521,ANCHORAGE,AK,1014,586,-428,0.36625
99522,ANCHORAGE,AK,595,359,-236,0.37631027253668764
99523,ANCHORAGE,AK,752,807,55,0.517639512508018
99524,ANCHORAGE,AK,1000,808,-192,0.4469026548672566
99556,ANCHOR POINT,AK,1344,940,-404,0.4115586690017513
99556,NIKOLAEVSK,AK,156,82,-74,0.3445378151260504
99557,ANIAK,AK,11,0,-11,0
99559,BETHEL,AK,2554,1109,-1445,0.3027573027573028
99567,CHUGIAK,AK,2852,2726,-126,0.4887056292577985
99568,CLAM GULCH,AK,28,69,41,0.711340206185567
99571,COLD BAY,AK,0,18,18,1
99572,COOPER LANDING,AK,170,159,-11,0.48328267477203646
99572,COOPER LNDG,AK,0,38,38,1
99573,COPPER CENTER,AK,304,197,-107,0.3932135728542914
99574,CHENEGA BAY,AK,24,0,-24,0
99574,CORDOVA,AK,1887,890,-997,0.3204897371263954
99576,DILLINGHAM,AK,1216,578,-638,0.3221850613154961
99577,EAGLE RIVER,AK,12432,11716,-716,0.48517475567334767
99586,GAKONA,AK,95,57,-38,0.375
99586,SLANA,AK,51,12,-39,0.19047619047619047
99587,GIRDWOOD,AK,1183,716,-467,0.3770405476566614
99588,GLENNALLEN,AK,480,477,-3,0.49843260188087773
99603,FRITZ CREEK,AK,141,97,-44,0.40756302521008403
99603,HOMER,AK,5664,5232,-432,0.4801762114537445
99604,HOOPER BAY,AK,13,0,-13,0
99606,ILIAMNA,AK,0,22,22,1
99610,KASILOF,AK,1453,1163,-290,0.4445718654434251
99611,KENAI,AK,7807,5910,-1897,0.4308522271633739
99613,IGIUGIG,AK,32,16,-16,0.3333333333333333
99613,KING SALMON,AK,143,193,50,0.5744047619047619
99615,KODIAK,AK,7440,4697,-2743,0.38699843453901295
99620,KOTLIK,AK,0,11,11,1
99623,BIG LAKE,AK,191,207,16,0.5201005025125628
99623,MEADOW LAKE,AK,79,144,65,0.6457399103139013
99623,WASILLA,AK,4033,4798,765,0.5433133280489186
99629,WASILLA,AK,115,200,85,0.6349206349206349
99631,MOOSE PASS,AK,0,13,13,1
99633,NAKNEK,AK,137,177,40,0.5636942675159236
99635,NIKISKI,AK,423,228,-195,0.35023041474654376
99639,NINILCHIK,AK,1071,684,-387,0.38974358974358975
99645,PALMER,AK,9452,10626,1174,0.529235979679251
99652,BIG LAKE,AK,1341,1332,-9,0.4983164983164983
99653,PORT ALSWORTH,AK,0,11,11,1
99654,WASILLA,AK,12537,13297,760,0.5147092978245723
99661,SAND POINT,AK,52,11,-41,0.1746031746031746
99663,SELDOVIA,AK,316,108,-208,0.25471698113207547
99664,SEWARD,AK,3042,1752,-1290,0.36545682102628285
99669,SOLDOTNA,AK,7423,7203,-220,0.49247914672501025
99671,STEBBINS,AK,13,11,-2,0.4583333333333333
99672,STERLING,AK,1934,1729,-205,0.472017472017472
99674,CHICKALOON,AK,89,110,21,0.5527638190954773
99674,SUTTON,AK,207,283,76,0.5775510204081633
99676,TALKEETNA,AK,994,706,-288,0.4152941176470588
99678,TOGIAK,AK,17,49,32,0.7424242424242424
99683,TRAPPER CREEK,AK,51,86,35,0.6277372262773723
99684,UNALAKLEET,AK,24,0,-24,0
99685,UNALASKA,AK,47,22,-25,0.3188405797101449
99686,VALDEZ,AK,1869,1124,-745,0.3755429335115269
99687,WASILLA,AK,4760,5458,698,0.5341554120180074
99688,WILLOW,AK,1623,1406,-217,0.4641795972268075
99689,YAKUTAT,AK,48,39,-9,0.4482758620689655
99692,DUTCH HARBOR,AK,235,96,-139,0.29003021148036257
99693,WHITTIER,AK,22,21,-1,0.4883720930232558
99694,HOUSTON,AK,23,65,42,0.7386363636363636
99701,FAIRBANKS,AK,10629,8235,-2394,0.43654580152671757
99702,EIELSON AFB,AK,2066,2065,-1,0.49987896393125153
99703,FORT WAINWRIGHT,AK,3592,2829,-763,0.44058557857031616
99703,FT WAINWRIGHT,AK,788,582,-206,0.4248175182481752
99705,NORTH POLE,AK,9145,8102,-1043,0.4697628573085174
99706,FAIRBANKS,AK,598,682,84,0.5328125
99707,FAIRBANKS,AK,2045,1354,-691,0.3983524566048838
99708,FAIRBANKS,AK,2097,1394,-703,0.3993125179031796
99709,FAIRBANKS,AK,10782,8142,-2640,0.43024730500951175
99709,FBX,AK,232,217,-15,0.48329621380846327
99710,FAIRBANKS,AK,274,287,13,0.5115864527629234
99711,FAIRBANKS,AK,261,178,-83,0.4054669703872437
99712,FAIRBANKS,AK,3042,2795,-247,0.47884187082405344
99714,SALCHA,AK,226,280,54,0.5533596837944664
99716,TWO RIVERS,AK,0,22,22,1
99723,BARROW,AK,711,378,-333,0.34710743801652894
99725,ESTER,AK,175,23,-152,0.11616161616161616
99729,CANTWELL,AK,0,11,11,1
99731,DELTA JCT,AK,19,0,-19,0
99731,FORT GREELY,AK,303,82,-221,0.21298701298701297
99737,DELTA JCT,AK,25,29,4,0.5370370370370371
99737,DELTA JUNCTION,AK,1239,1005,-234,0.44786096256684493
99741,GALENA,AK,13,0,-13,0
99743,HEALY,AK,488,294,-194,0.37595907928388744
99752,KOTZEBUE,AK,729,376,-353,0.3402714932126697
99755,DENALI NATIONAL PARK,AK,355,341,-14,0.4899425287356322
99755,DENALI PARK,AK,62,43,-19,0.4095238095238095
99760,NENANA,AK,72,77,5,0.5167785234899329
99762,NOME,AK,1743,1227,-516,0.4131313131313131
99775,FAIRBANKS,AK,0,58,58,1
99780,MENTASTA LAKE,AK,0,16,16,1
99780,TOK,AK,322,344,22,0.5165165165165165
99801,JUNEAU,AK,10618,9676,-942,0.4767911698038829
99802,JUNEAU,AK,866,761,-105,0.4677320221266134
99803,JUNEAU,AK,1321,1288,-33,0.49367573783058644
99820,ANGOON,AK,11,30,19,0.7317073170731707
99821,AUKE BAY,AK,361,353,-8,0.4943977591036415
99821,JUNEAU,AK,0,11,11,1
99824,DOUGLAS,AK,1382,1076,-306,0.4377542717656631
99825,ELFIN COVE,AK,0,12,12,1
99826,GUSTAVUS,AK,163,189,26,0.5369318181818182
99827,HAINES,AK,1363,984,-379,0.4192586280357904
99829,HOONAH,AK,65,22,-43,0.25287356321839083
99833,PETERSBURG,AK,1063,930,-133,0.46663321625689913
99835,SITKA,AK,5107,4037,-1070,0.4414916885389326
99840,SKAGWAY,AK,1076,375,-701,0.2584424534803584
99901,KETCHIKAN,AK,5914,5501,-413,0.48190976784932105
99918,COFFMAN COVE,AK,13,24,11,0.6486486486486487
99919,THORNE BAY,AK,91,27,-64,0.2288135593220339
99921,CRAIG,AK,1123,458,-665,0.28969006957621757
99925,KLAWOCK,AK,348,157,-191,0.3108910891089109
99928,WARD COVE,AK,543,239,-304,0.30562659846547313
99929,WRANGELL,AK,828,666,-162,0.4457831325301205
